cell-line,group-id,mut-type,edit-len,wt-sequence,mut-sequence,protospacer-location-l,protospacer-location-r,pbs-location-l,pbs-location-r,rtt-location-wt-l,rtt-location-wt-r,rtt-location-mut-l,rtt-location-mut-r,lha-location-l,lha-location-r,rha-location-wt-l,rha-location-wt-r,rha-location-mut-l,rha-location-mut-r,spcas9-score,editing-efficiency
hek293t,7924,1,12,TAGCCTCCTAGGTTCCCCACCATAACCAAAGGACCGCTTCATGTGTTTCGAACACATCTAGTCGTTGGATAAAAAAAAATTCTAGTTGGTTTAACGCGT,TAGCCTCCTAGGTTCCCCACCATAACCAAAGGTCTTCTAGGCGGACCGCTTCATGTGTTTCGAACACATCTAGTCGTTGGATAAAAAAAAATTCTAGTT,10,30,14,27,27,39,27,51,27,32,32,39,44,51,66.16,4.367884276
hek293t,7924,1,12,TGGTTTCCTAGGTTCCCCACCATAACCAAAGGACCGCTTCATGTGTTTCGAACACATCTAGTCGTTGGATAAAACAAAAAAAATTCTAGTTGGTTTAAC,TGGTTTCCTAGGTTCCCCACCATAACCAAAGGTCTTCTAGGCGGACCGCTTCATGTGTTTCGAACACATCTAGTCGTTGGATAAAACAAAAAAAATTCT,10,30,14,27,27,35,27,47,27,32,32,35,44,47,66.16,0.0
hek293t,7926,1,6,TTGATAATAGGAAGGAGCAGAAGCAGTGATGGCAAATAAATGACATCAGTAAAGCAATAATGTCTGCAGTTCGAAAAAAATTCTAGTTGGTTTAACGCG,TTGATAATAGGAAGGAGCAGAAGCAGTGCGAGCTATGGCAAATAAATGACATCAGTAAAGCAATAATGTCTGCAGTTCGAAAAAAATTCTAGTTGGTTT,10,30,14,27,27,44,27,50,27,29,29,44,35,50,67.28,2.060453531
hek293t,7928,1,10,TCGATGTTTGCGTCCTGGCAGCACTCCAACGGCAACGAGAAGCGGGACAAATCGGTTTGAGAGCAAAAAAATTCTAGTTGGTTTAACGCGTAACTAGAT,TCGATGTTTGCGTCCTGGCAGCACTCCAACGGCTTTTGGGGTTAACGAGAAGCGGGACAAATCGGTTTGAGAGCAAAAAAATTCTAGTTGGTTTAACGC,10,30,14,27,27,49,27,59,27,34,34,49,44,59,63.35,12.65706023
hek293t,7928,1,10,CCACCGTTTGCGTCCTGGCAGCACTCCAACGGCAACGAGAAGCGGGACAAATCGGTTTGAGAGCGACCGCTGAAAAAAATTCTAGTTGGTTTAACGCGT,CCACCGTTTGCGTCCTGGCAGCACTCCAACGGCTTTTGGGGTTAACGAGAAGCGGGACAAATCGGTTTGAGAGCGACCGCTGAAAAAAATTCTAGTTGG,10,30,14,27,27,41,27,51,27,34,34,41,44,51,63.35,2.541887287
hek293t,7932,1,2,CGCAGGGGTATAGAAGCAGAAGTCAAGTTAGGTGTGTGCACCATGGTCAGGTGCTAGATAGCAGCTTTAATGTTGAAAAAAATTCTAGTTGGTTTAACG,CGCAGGGGTATAGAAGCAGAAGTCAAGTTAGGTGTGTGCCCACCATGGTCAGGTGCTAGATAGCAGCTTTAATGTTGAAAAAAATTCTAGTTGGTTTAA,10,30,14,27,27,46,27,48,27,39,39,46,41,48,59.55,81.69446515
hek293t,7934,1,6,TCAGAGCCTGTAAAGTCAAGGTATCAGCTTGGAAGGGTTGCTGCAAGAAAAATATTTTTGAGAGTGGGAAACAAAAAAATTCTAGTTGGTTTAACGCGT,TCAGAGCCTGTAAAGTCAAGGTATCAGCTGTTCTCTGGAAGGGTTGCTGCAAGAAAAATATTTTTGAGAGTGGGAAACAAAAAAATTCTAGTTGGTTTA,10,30,14,27,27,45,27,51,27,30,30,45,36,51,68.47,36.59302922
hek293t,7936,1,9,AAGAGAGCCTAAGTGACTTTATCTCCACTTGGGAGAACACTACTTTTTTGGTATCTGCACTCTAGGTTTAAAAAAATTCTAGTTGGTTTAACGCGTAAC,AAGAGAGCCTAAGTGACTTTATCTCCACTTGGGATATGGTCTGGAACACTACTTTTTTGGTATCTGCACTCTAGGTTTAAAAAAATTCTAGTTGGTTTA,10,30,14,27,27,45,27,54,27,35,35,45,44,54,31.92,20.26497437
hek293t,19933,1,9,CGATAACTAACACTTAATAAACAAGCAGTTGGGTGGGATGAGTAGTAAGCATGATTTGACACAAAATCACATAAAAAAATTCTAGTTGGTTTAACGCGT,CGATAACTAACACTTAATAAACAAGCAGTTGGTTTGACACGGTGGGATGAGTAGTAAGCATGATTTGACACAAAATCACATAAAAAAATTCTAGTTGGT,10,30,14,27,27,42,27,51,27,32,32,42,41,51,29.46,2.65243286
hek293t,7939,1,5,GGGCTTAGCATGTGTAATTCTCCAATCTGTGGGAGCAGAATGAATATTAGTGTATTATTAATACTTGTTATCATAAAAAAAAATTCTAGTTGGTTTAAC,GGGCTTAGCATGTGTAATTCTCCAATCTGTGGGAGCAGTGGATAATGAATATTAGTGTATTATTAATACTTGTTATCATAAAAAAAAATTCTAGTTGGT,10,30,14,27,27,42,27,47,27,39,39,42,44,47,52.82,0.027714184
hek293t,7939,1,5,GATCTTAGCATGTGTAATTCTCCAATCTGTGGGAGCAGAATGAATATTAGTGTATTATTAATACTTGTTATCAAAAAAATTCTAGTTGGTTTAACGCGT,GATCTTAGCATGTGTAATTCTCCAATCTGTGGGAGCAGTGGATAATGAATATTAGTGTATTATTAATACTTGTTATCAAAAAAATTCTAGTTGGTTTAA,10,30,14,27,27,46,27,51,27,39,39,46,44,51,52.82,2.53893684
hek293t,7943,1,8,GTATCAAAGTGAAGTCCTCACAGCTAAGGTGGTACTTGTAAATAAGGGAGAATGCCTGTGTTGTATTCTGCAAAAAAATTCTAGTTGGTTTAACGCGTA,GTATCAAAGTGAAGTCCTCACAGCTAAGGTGGTACTTGTAGACCGCCGAATAAGGGAGAATGCCTGTGTTGTATTCTGCAAAAAAATTCTAGTTGGTTT,10,30,14,27,27,44,27,52,27,41,41,44,49,52,59.49,0.095923261
hek293t,7943,1,8,TACACAAAGTGAAGTCCTCACAGCTAAGGTGGTACTTGTAAATAAGGGAGAATGCCTGTGTTGTAAAAAAATTCTAGTTGGTTTAACGCGTAACTAGAT,TACACAAAGTGAAGTCCTCACAGCTAAGGTGGTACTTGTAGACCGCCGAATAAGGGAGAATGCCTGTGTTGTAAAAAAATTCTAGTTGGTTTAACGCGT,10,30,14,27,27,51,27,59,27,41,41,51,49,59,59.49,0.0
hek293t,7945,1,6,CAAGATCTCCTCCCCATCTCCACTTCCCCAGGCCCTGCTTGTTTCCTCACAGCCTTCGCGCAGAAACACGATGGTAAAAAAAATTCTAGTTGGTTTAAC,CAAGATCTCCTCCCCATCTCCACTTCCCCAGTTTCCGGCCCTGCTTGTTTCCTCACAGCCTTCGCGCAGAAACACGATGGTAAAAAAAATTCTAGTTGG,10,30,14,27,27,41,27,47,27,31,31,41,37,47,46.72,51.31673631
hek293t,7947,1,3,TACACAAATTATCACAAATTATGATTTCAAGGGCTGTGACACTCAAGTTTTTCTGTTTTATGCAGTTTTAGGCTGCATTGATTTAGGCACAAAAAAATT,TACACAAATTATCACAAATTATGATTGTGTCAAGGGCTGTGACACTCAAGTTTTTCTGTTTTATGCAGTTTTAGGCTGCATTGATTTAGGCACAAAAAA,10,30,14,27,27,30,27,33,27,27,27,30,30,33,1.83,0.0
hek293t,7950,1,4,ATTTTTCTCCGGAGAATATACCAATATGATGGTGCTGAGCAGTGTATTGTGGAAAAATGATGGTGCCAAAAAAAATTCTAGTTGGTTTAACGCGTAACT,ATTTTTCTCCGGAGAATATACCAATATGATGGTGCTCCTTGAGCAGTGTATTGTGGAAAAATGATGGTGCCAAAAAAAATTCTAGTTGGTTTAACGCGT,10,30,14,27,27,51,27,55,27,36,36,51,40,55,47.96,10.00405084
hek293t,7950,1,4,TAGCATCTCCGGAGAATATACCAATATGATGGTGCTGAGCAGTGTATTGTGGAAAAATGATGGTGCCAGCACCACTCCCGAAAAAAATTCTAGTTGGTT,TAGCATCTCCGGAGAATATACCAATATGATGGTGCTCCTTGAGCAGTGTATTGTGGAAAAATGATGGTGCCAGCACCACTCCCGAAAAAAATTCTAGTT,10,30,14,27,27,39,27,43,27,36,36,39,40,43,47.96,0.0
hek293t,7952,1,8,CGAGGGCTCCAAAAACAGTGTCTTCGCTCTGGCTTGCTATCACGCTTCCTACCGTCCTAAGGGAGGGACACAAACCACGAAGAAAAAAATTCTAGTTGG,CGAGGGCTCCAAAAACAGTGTCTTCGCTCTAAAAAAGTGGCTTGCTATCACGCTTCCTACCGTCCTAAGGGAGGGACACAAACCACGAAGAAAAAAATT,10,30,14,27,27,33,27,41,27,30,30,33,38,41,32.24,0.0
hek293t,7952,1,8,ACCGTGCTCCAAAAACAGTGTCTTCGCTCTGGCTTGCTATCACGCTTCCTACCGTCCTAAGGGAGGGACACAAACAAAAAAATTCTAGTTGGTTTAACG,ACCGTGCTCCAAAAACAGTGTCTTCGCTCTAAAAAAGTGGCTTGCTATCACGCTTCCTACCGTCCTAAGGGAGGGACACAAACAAAAAAATTCTAGTTG,10,30,14,27,27,40,27,48,27,30,30,40,38,48,32.24,2.990298883
hek293t,7954,1,2,TGGATTAAGCTAAAGCTTCATTTTAAGCATGGAGTTGAAAATATTTTGGATGATGGACGGTTACCTATGAGAAAACATAAAAAAATTCTAGTTGGTTTA,TGGATTAAGCTAAAGCTTCATTTTAAGCATGGCCAGTTGAAAATATTTTGGATGATGGACGGTTACCTATGAGAAAACATAAAAAAATTCTAGTTGGTT,10,30,14,27,27,43,27,45,27,33,33,43,35,45,10.28,2.799546166
hek293t,7954,1,2,ATGAATAAGCTAAAGCTTCATTTTAAGCATGGAGTTGAAAATATTTTGGATGATGGACGGTTACCTATGAGAAAACATTTTAAAAAAATTCTAGTTGGT,ATGAATAAGCTAAAGCTTCATTTTAAGCATGGCCAGTTGAAAATATTTTGGATGATGGACGGTTACCTATGAGAAAACATTTTAAAAAAATTCTAGTTG,10,30,14,27,27,40,27,42,27,33,33,40,35,42,10.28,1.498370372
hek293t,7956,1,7,CGGAATCTCACAGAGCTCTCCGAGCAACATGGCTAGTATTTGGCTACCAAGTTTCCTCAGTAACTGGGGAAAAAAAAATTCTAGTTGGTTTAACGCGTA,CGGAATCTCACAGAGCTCTCCGAGCAACAAAGTTCTTGGCTAGTATTTGGCTACCAAGTTTCCTCAGTAACTGGGGAAAAAAAAATTCTAGTTGGTTTA,10,30,14,27,27,45,27,52,27,30,30,45,37,52,68.19,33.02007323
hek293t,7956,1,7,CGGAATCTCACAGAGCTCTCCGAGCAACATGGCTAGTATTTGGCTACCAAGTTTCCTCAGTAACTGGGGAAAACATCTCAAAAAAATTCTAGTTGGTTT,CGGAATCTCACAGAGCTCTCCGAGCAACAAAGTTCTTGGCTAGTATTTGGCTACCAAGTTTCCTCAGTAACTGGGGAAAACATCTCAAAAAAATTCTAG,10,30,14,27,27,37,27,44,27,30,30,37,37,44,68.19,23.03612703
hek293t,7958,1,12,GTCCATAAAATTGCCATTGAGTTATTACAAGGCTGTAATTTGCTTGAACATTTTAATGAAATTATAAAATGGGAAAAAAATTCTAGTTGGTTTAACGCG,GTCCATAAAATTGCCATTGAGTTATTACAAATACGCAATGCAGGCTGTAATTTGCTTGAACATTTTAATGAAATTATAAAATGGGAAAAAAATTCTAGT,10,30,14,27,27,38,27,50,27,31,31,38,43,50,43.12,2.942288888
hek293t,7958,1,12,CATCCTAAAATTGCCATTGAGTTATTACAAGGCTGTAATTTGCTTGAACATTTTAATGAAATTATAAAATGGGATATAAAAAAATTCTAGTTGGTTTAA,CATCCTAAAATTGCCATTGAGTTATTACAAATACGCAATGCAGGCTGTAATTTGCTTGAACATTTTAATGAAATTATAAAATGGGATATAAAAAAATTC,10,30,14,27,27,34,27,46,27,31,31,34,43,46,43.12,0.0
hek293t,7960,1,12,CATTATTGAGACTGCCAGACACTGAGGTCTGGTACCGCAGCCCTGTGACAATGACTAATGAGAAGAAAAAAAAATTCTAGTTGGTTTAACGCGTAACTA,CATTATTGAGACTGCCAGACACTGAGGTCTGGTACCGCACGCAGTATAGCAGCCCTGTGACAATGACTAATGAGAAGAAAAAAAAATTCTAGTTGGTTT,10,30,14,27,27,44,27,56,27,37,37,44,49,56,57.87,0.0
hek293t,7960,1,12,AGTGATTGAGACTGCCAGACACTGAGGTCTGGTACCGCAGCCCTGTGACAATGACTAATGAGAAAAAAAAATTCTAGTTGGTTTAACGCGTAACTAGAT,AGTGATTGAGACTGCCAGACACTGAGGTCTGGTACCGCACGCAGTATAGCAGCCCTGTGACAATGACTAATGAGAAAAAAAAATTCTAGTTGGTTTAAC,10,30,14,27,27,47,27,59,27,37,37,47,49,59,57.87,1.33680039
hek293t,7962,1,8,AACCTTAATATAATCTGATGCATATACGTAGGTGAGCTTGTTTGTGAAAAACTAGGTAGAGCGCTCTTGGAGGTACAAAAAAAATTCTAGTTGGTTTAA,AACCTTAATATAATCTGATGCATATACCTATTTAAGTAGGTGAGCTTGTTTGTGAAAAACTAGGTAGAGCGCTCTTGGAGGTACAAAAAAAATTCTAGT,10,30,14,27,27,38,27,46,27,28,28,38,36,46,63.83,43.17128047
hek293t,7964,1,7,GATACCTGAGATCAACATTTCATCAGTGGTGGCTTGGCCTTCGTAATGTAAGTTTGATATTCCTGGTAAAAAAATTCTAGTTGGTTTAACGCGTAACTA,GATACCTGAGATCAACATTTCATCAGTGGTGGCTTGGCACGATTTCTTCGTAATGTAAGTTTGATATTCCTGGTAAAAAAATTCTAGTTGGTTTAACGC,10,30,14,27,27,49,27,56,27,39,39,49,46,56,49.9,18.46801499
hek293t,7964,1,7,CTCCCCTGAGATCAACATTTCATCAGTGGTGGCTTGGCCTTCGTAATGTAAGTTTGATATTCCTGGTGTAAAAAAAATTCTAGTTGGTTTAACGCGTAA,CTCCCCTGAGATCAACATTTCATCAGTGGTGGCTTGGCACGATTTCTTCGTAATGTAAGTTTGATATTCCTGGTGTAAAAAAAATTCTAGTTGGTTTAA,10,30,14,27,27,46,27,53,27,39,39,46,46,53,49.9,7.386741999
hek293t,17459,1,6,CCTGCGTATTCGAGGTGTCACCGTACCGGAGGTACTGGGCAAGCAATTATTGCCACCCTTTTGTGCCATATAATGAAAAAAATTCTAGTTGGTTTAACG,CCTGCGTATTCGAGGTGTCACCGTACCGGAGGTACTGGAGCAATGCAAGCAATTATTGCCACCCTTTTGTGCCATATAATGAAAAAAATTCTAGTTGGT,10,30,14,27,27,42,27,48,27,39,39,42,45,48,69.93,1.670985629
hek293t,7970,1,6,CGCTACTTATGCATGGTGAACAAAAATGATGGAGAGCACTGACCTGCAGTGCTTTTGCAGGCATTGGGAGACTGCAAAAAAATTCTAGTTGGTTTAACG,CGCTACTTATGCATGGTGAACAAAAATGATGGAGAGCATGGACTCTGACCTGCAGTGCTTTTGCAGGCATTGGGAGACTGCAAAAAAATTCTAGTTGGT,10,30,14,27,27,42,27,48,27,39,39,42,45,48,60.18,0.0
hek293t,7970,1,6,TCCTGCTTATGCATGGTGAACAAAAATGATGGAGAGCACTGACCTGCAGTGCTTTTGCAGGCATTGGGAGAAAAAAAATTCTAGTTGGTTTAACGCGTA,TCCTGCTTATGCATGGTGAACAAAAATGATGGAGAGCATGGACTCTGACCTGCAGTGCTTTTGCAGGCATTGGGAGAAAAAAAATTCTAGTTGGTTTAA,10,30,14,27,27,46,27,52,27,39,39,46,45,52,60.18,0.0
hek293t,7972,1,6,GAGCCCAAGAAGCTGTGAGAAGGTCAATGAGGGCTCCTAGGGGTCACAGGATGCAACTGTACCCAAGCGCATATACAAAAAAAAAAATTCTAGTTGGTT,GAGCCCAAGAAGCTGTGAGAAGGTCAATGGACTCCAGGGCTCCTAGGGGTCACAGGATGCAACTGTACCCAAGCGCATATACAAAAAAAAAAATTCTAG,10,30,14,27,27,37,27,43,27,30,30,37,36,43,58.8,6.786638484
hek293t,7972,1,6,ATGGCCAAGAAGCTGTGAGAAGGTCAATGAGGGCTCCTAGGGGTCACAGGATGCAACTGTACCCAAGCGCATATACAAAATACAAAAAAAATTCTAGTT,ATGGCCAAGAAGCTGTGAGAAGGTCAATGGACTCCAGGGCTCCTAGGGGTCACAGGATGCAACTGTACCCAAGCGCATATACAAAATACAAAAAAAATT,10,30,14,27,27,33,27,39,27,30,30,33,36,39,58.8,0.253739316
hek293t,7974,1,12,TTCGTCTTACACCAGAAGCAACAGTAAACTGGAGATTATTTAAAGTCATCTGTGAGACTGAGAGAATTTGGCAAAAAAATTCTAGTTGGTTTAACGCGT,TTCGTCTTACACCAGAAGCAACAGTAAACGCAAACCATAGCTGGAGATTATTTAAAGTCATCTGTGAGACTGAGAGAATTTGGCAAAAAAATTCTAGTT,10,30,14,27,27,39,27,51,27,29,29,39,41,51,19.17,0.968296344
hek293t,7974,1,12,CCTCCCTTACACCAGAAGCAACAGTAAACTGGAGATTATTTAAAGTCATCTGTGAGACTGAGAGAATTTGGCCAGACACAAAAAAATTCTAGTTGGTTT,CCTCCCTTACACCAGAAGCAACAGTAAACGCAAACCATAGCTGGAGATTATTTAAAGTCATCTGTGAGACTGAGAGAATTTGGCCAGACACAAAAAAAT,10,30,14,27,27,32,27,44,27,29,29,32,41,44,19.17,0.0
hek293t,7976,1,15,GTGCATCTTACAAGAACAGACTATAGATGAGGTGATAAAAGCTCTTAGATGCAGAAGCCCTCCTTCTAACTAAAAAAATTCTAGTTGGTTTAACGCGTA,GTGCATCTTACAAGAACAGACTATAGATGAGGTTCGCTCTTGTTGGTCGATAAAAGCTCTTAGATGCAGAAGCCCTCCTTCTAACTAAAAAAATTCTAG,10,30,14,27,27,37,27,52,27,34,34,37,49,52,56.77,2.129942518
hek293t,7977,1,14,TTGCGGATGTGTTTCTTCATGGTGCTGAGTGGAGCTCTGTCTCGAGTGTTCAACTGACTTTTTGGTTATTATGAAAAAAATTCTAGTTGGTTTAACGCG,TTGCGGATGTGTTTCTTCATGGTGCTGATAACGATCCAGTGTGTGGAGCTCTGTCTCGAGTGTTCAACTGACTTTTTGGTTATTATGAAAAAAATTCTA,10,30,14,27,27,36,27,50,27,29,29,36,43,50,59.14,17.36122546
hek293t,7977,1,14,GCGGGGATGTGTTTCTTCATGGTGCTGAGTGGAGCTCTGTCTCGAGTGTTCAACTGACTTTTTGGAAAAAAATTCTAGTTGGTTTAACGCGTAACTAGA,GCGGGGATGTGTTTCTTCATGGTGCTGATAACGATCCAGTGTGTGGAGCTCTGTCTCGAGTGTTCAACTGACTTTTTGGAAAAAAATTCTAGTTGGTTT,10,30,14,27,27,44,27,58,27,29,29,44,43,58,59.14,45.65713911
hek293t,7979,1,14,TAGCACTTCATTTATAGTTTCCCTGACCTTGGGAAGAACACCTACACAAAGGAGTGAAGGTAATTCTATAAAAAAATTCTAGTTGGTTTAACGCGTAAC,TAGCACTTCATTTATAGTTTCCCTGACCTTGGCGGCTTCTGGACGAGAAGAACACCTACACAAAGGAGTGAAGGTAATTCTATAAAAAAATTCTAGTTG,10,30,14,27,27,40,27,54,27,33,33,40,47,54,37.8,16.77770247
hek293t,7981,1,14,TTCTCCAAAGGGTCAAATGGCTAAGAGCAAGGCACTCTTATACAGGGACCTGTGCAGTAGCATAGATCACTAAAAAAATTCTAGTTGGTTTAACGCGTA,TTCTCCAAAGGGTCAAATGGCTAAGAGCAAGTGCTGGCGTAGGAGGCACTCTTATACAGGGACCTGTGCAGTAGCATAGATCACTAAAAAAATTCTAGT,10,30,14,27,27,38,27,52,27,31,31,38,45,52,56.34,6.006828594
hek293t,7981,1,14,GCTTCCAAAGGGTCAAATGGCTAAGAGCAAGGCACTCTTATACAGGGACCTGTGCAGTAGCATAGATCACTGTGCAAAAAAATTCTAGTTGGTTTAACG,GCTTCCAAAGGGTCAAATGGCTAAGAGCAAGTGCTGGCGTAGGAGGCACTCTTATACAGGGACCTGTGCAGTAGCATAGATCACTGTGCAAAAAAATTC,10,30,14,27,27,34,27,48,27,31,31,34,45,48,56.34,0.225606317
hek293t,7983,1,9,AACTCAGAATTTTTGGGCCTCAGTTAAAAAGGAGTAAGAGGTTGCTTCTGTCTTGCATAGCAATTCCCTCTCCCTTAAAAAAAATTCTAGTTGGTTTAA,AACTCAGAATTTTTGGGCCTCAGTTAGAGAGCCCCAAAAGGAGTAAGAGGTTGCTTCTGTCTTGCATAGCAATTCCCTCTCCCTTAAAAAAAATTCTAG,10,30,14,27,27,37,27,46,27,27,27,37,36,46,7.81,0.0
hek293t,7983,1,9,AACCAAGAATTTTTGGGCCTCAGTTAAAAAGGAGTAAGAGGTTGCTTCTGTCTTGCATAGCAATTCCCTCTCAAAAAAATTCTAGTTGGTTTAACGCGT,AACCAAGAATTTTTGGGCCTCAGTTAGAGAGCCCCAAAAGGAGTAAGAGGTTGCTTCTGTCTTGCATAGCAATTCCCTCTCAAAAAAATTCTAGTTGGT,10,30,14,27,27,42,27,51,27,27,27,42,36,51,7.81,0.0
hek293t,7986,1,7,TAAAATCCATATACTTCAGGTCTTTGTTTTGGAGGGTTTTTGGTAACTCTTGTAGTAATTGCAACTCATGTGTGTTTCTTAAAAAAATTCTAGTTGGTT,TAAAATCCATATACTTCAGGTCTTTGTTTTGGTGACGATAGGGTTTTTGGTAACTCTTGTAGTAATTGCAACTCATGTGTGTTTCTTAAAAAAATTCTA,10,30,14,27,27,36,27,43,27,33,33,36,40,43,29.13,0.0
hek293t,7986,1,7,CTGCCTCCATATACTTCAGGTCTTTGTTTTGGAGGGTTTTTGGTAACTCTTGTAGTAATTGCAACTCATGTGTGTTAAAAAAATTCTAGTTGGTTTAAC,CTGCCTCCATATACTTCAGGTCTTTGTTTTGGTGACGATAGGGTTTTTGGTAACTCTTGTAGTAATTGCAACTCATGTGTGTTAAAAAAATTCTAGTTG,10,30,14,27,27,40,27,47,27,33,33,40,40,47,29.13,3.098392893
hek293t,7988,1,5,CGTCATTCAGACAACCGTCCGCCTTCTTCTGGCCAGTCTAAGCTTTGCAGCTAACCCTTTCAGACATGGTATGGCTAGAAAAAAAAATTCTAGTTGGTT,CGTCATTCAGACAACCGTCCGCCTTCTTTAACTCTGGCCAGTCTAAGCTTTGCAGCTAACCCTTTCAGACATGGTATGGCTAGAAAAAAAAATTCTAGT,10,30,14,27,27,38,27,43,27,28,28,38,33,43,21.12,72.76767644
hek293t,7988,1,5,ACCCATTCAGACAACCGTCCGCCTTCTTCTGGCCAGTCTAAGCTTTGCAGCTAACCCTTTCAGACATGGTATGGCTAGAATACAGGCAAAAAAATTCTA,ACCCATTCAGACAACCGTCCGCCTTCTTTAACTCTGGCCAGTCTAAGCTTTGCAGCTAACCCTTTCAGACATGGTATGGCTAGAATACAGGCAAAAAAA,10,30,14,27,27,31,27,36,27,28,28,31,33,36,21.12,3.929955112
hek293t,7990,1,5,TTACGTCAATAAAGATTGCGTGTTTCTCCTGGTAATATCCGGGACTACATTCCTCACTGGCAGCTTTCAAAAAAATTCTAGTTGGTTTAACGCGTAACT,TTACGTCAATAAAGATTGCGTGTTTCTCCTGGTAATATCCCGCCCGGGACTACATTCCTCACTGGCAGCTTTCAAAAAAATTCTAGTTGGTTTAACGCG,10,30,14,27,27,50,27,55,27,40,40,50,45,55,24.32,61.40309039
hek293t,7990,1,5,GAACGTCAATAAAGATTGCGTGTTTCTCCTGGTAATATCCGGGACTACATTCCTCACTGGCAGCTTTCTGTAAAAAAATTCTAGTTGGTTTAACGCGTA,GAACGTCAATAAAGATTGCGTGTTTCTCCTGGTAATATCCCGCCCGGGACTACATTCCTCACTGGCAGCTTTCTGTAAAAAAATTCTAGTTGGTTTAAC,10,30,14,27,27,47,27,52,27,40,40,47,45,52,24.32,60.3950479
hek293t,7992,1,7,CGAAGCTCTTCATTCCTGTTACAATCAAGTGGGCTTTTTTCCTCTTGTTCTAATCATGTCAACCATGTTCTGTAAAAAAAATTCTAGTTGGTTTAACGC,CGAAGCTCTTCATTCCTGTTACAATCGGTCCGGAAGTGGGCTTTTTTCCTCTTGTTCTAATCATGTCAACCATGTTCTGTAAAAAAAATTCTAGTTGGT,10,30,14,27,27,42,27,49,27,27,27,42,34,49,47.24,30.3107257
hek293t,7994,1,5,TACAGTCCTTCCAAAATGAGGGAGTTTCCTGGGAAATGAGATGTGCTGTATGAGCCCCCTTCCCATTTTTCTCCCCTTCTAATAAAAAAATTCTAGTTG,TACAGTCCTTCCAAAATGAGGGAGTTTAACTTCCTGGGAAATGAGATGTGCTGTATGAGCCCCCTTCCCATTTTTCTCCCCTTCTAATAAAAAAATTCT,10,30,14,27,27,35,27,40,27,28,28,35,33,40,9.7,75.77259629
hek293t,7994,1,5,AAACCTCCTTCCAAAATGAGGGAGTTTCCTGGGAAATGAGATGTGCTGTATGAGCCCCCTTCCCATTTTTCTCCCAAAAAAATTCTAGTTGGTTTAACG,AAACCTCCTTCCAAAATGAGGGAGTTTAACTTCCTGGGAAATGAGATGTGCTGTATGAGCCCCCTTCCCATTTTTCTCCCAAAAAAATTCTAGTTGGTT,10,30,14,27,27,43,27,48,27,28,28,43,33,48,9.7,63.60621261
hek293t,7997,1,1,TCCCTATATCCCTGACCTAATGAAAATTATGGTATTAGTATTTTAGCTGTCAACATGTATATTTAGAGACTTCGTATGTTAACAAAAAAAAATTCTAGT,TCCCTATATCCCTGACCTAATGAAAATTATGGTTATTAGTATTTTAGCTGTCAACATGTATATTTAGAGACTTCGTATGTTAACAAAAAAAAATTCTAG,10,30,14,27,27,37,27,38,27,34,34,37,35,38,22.14,0.0
hek293t,7998,1,10,GTTCGAAGCATATCTTGATATTGTGTTGATGGATTAAGTAAAACACACAGCATATCCTTTGACAGAAACATTATAAAAAAATTCTAGTTGGTTTAACGC,GTTCGAAGCATATCTTGATATTGTGTTGATGTCAATGGACAGATTAAGTAAAACACACAGCATATCCTTTGACAGAAACATTATAAAAAAATTCTAGTT,10,30,14,27,27,39,27,49,27,32,32,39,42,49,11.95,0.253406841
hek293t,7998,1,10,AGGCTAAGCATATCTTGATATTGTGTTGATGGATTAAGTAAAACACACAGCATATCCTTTGACAGAAAAAAAATTCTAGTTGGTTTAACGCGTAACTAG,AGGCTAAGCATATCTTGATATTGTGTTGATGTCAATGGACAGATTAAGTAAAACACACAGCATATCCTTTGACAGAAAAAAAATTCTAGTTGGTTTAAC,10,30,14,27,27,47,27,57,27,32,32,47,42,57,11.95,3.03422216
hek293t,8000,1,2,GGCGCACCTTCTTCACACCGGTGCCAGTGAGGAATCAAGCTCCTCTTTTGCTAAAGTGAAGCTGTATTCACTGAAACAAAAAAAATTCTAGTTGGTTTA,GGCGCACCTTCTTCACACCGGTGCCAGTGAGGAATCAAGTGCTCCTCTTTTGCTAAAGTGAAGCTGTATTCACTGAAACAAAAAAAATTCTAGTTGGTT,10,30,14,27,27,43,27,45,27,40,40,43,42,45,66.84,1.615438905
hek293t,8000,1,2,CAAAGACCTTCTTCACACCGGTGCCAGTGAGGAATCAAGCTCCTCTTTTGCTAAAGTGAAGCTGTATTCACTGAAAAAAAATTCTAGTTGGTTTAACGC,CAAAGACCTTCTTCACACCGGTGCCAGTGAGGAATCAAGTGCTCCTCTTTTGCTAAAGTGAAGCTGTATTCACTGAAAAAAAATTCTAGTTGGTTTAAC,10,30,14,27,27,47,27,49,27,40,40,47,42,49,66.84,75.50010875
hek293t,8002,1,15,TCTGCTCTGTTTTTAAAATGCTGTATAGTAGGAATTTTTATTCCATACAAATGAGTGAAAACATATTCTCTGAGAGCAAAAAAATTCTAGTTGGTTTAA,TCTGCTCTGTTTTTAAAATGCTGTATATCACATTCAGAGGAGGTAGGAATTTTTATTCCATACAAATGAGTGAAAACATATTCTCTGAGAGCAAAAAAA,10,30,14,27,27,31,27,46,27,28,28,31,43,46,7.64,0.0
hek293t,8006,1,12,TTGACGTTCTTGCTTTAGCTTTTCACAGGTGGAAAGTAGACGAAATGCAATGACCTGTGACAGATACAGAAAAAAATTCTAGTTGGTTTAACGCGTAAC,TTGACGTTCTTGCTTTAGCTTTTCACCCTAACGATCCCAGGTGGAAAGTAGACGAAATGCAATGACCTGTGACAGATACAGAAAAAAATTCTAGTTGGT,10,30,14,27,27,42,27,54,27,27,27,42,39,54,11.63,33.33826385
hek293t,8006,1,12,TTGGTGTTCTTGCTTTAGCTTTTCACAGGTGGAAAGTAGACGAAATGCAATGACCTGTGACAGATACAGCAAGTCCTTAAAAAAAAAATTCTAGTTGGT,TTGGTGTTCTTGCTTTAGCTTTTCACCCTAACGATCCCAGGTGGAAAGTAGACGAAATGCAATGACCTGTGACAGATACAGCAAGTCCTTAAAAAAAAA,10,30,14,27,27,30,27,42,27,27,27,30,39,42,11.63,0.0
hek293t,8008,1,13,CACGGCCACACAGAAATTCCACAGGGTTTTGGCTGATGGAGCAGTTGCAGAAGAGCCAATATTGTATACAAGGAAAGGAAAAAAATTCTAGTTGGTTTA,CACGGCCACACAGAAATTCCACAGGGTTTTAATTACAAGTCTTGGCTGATGGAGCAGTTGCAGAAGAGCCAATATTGTATACAAGGAAAGGAAAAAAAT,10,30,14,27,27,32,27,45,27,29,29,32,42,45,36.04,1.312167749
hek293t,8010,1,8,TATGCTTTTCATAAGAATTAGGAACACTTAGGTGGCTAAACGGAGCTGAAAAAACGTAGACATTTTCATAAGGAAAAAAATTCTAGTTGGTTTAACGCG,TATGCTTTTCATAAGAATTAGGAACACTTAGGTGTTAAGTTCGCTAAACGGAGCTGAAAAAACGTAGACATTTTCATAAGGAAAAAAATTCTAGTTGGT,10,30,14,27,27,42,27,50,27,35,35,42,43,50,33.78,4.661023046
hek293t,8010,1,8,CCAGCTTTTCATAAGAATTAGGAACACTTAGGTGGCTAAACGGAGCTGAAAAAACGTAGACATTTTCATAAAAAAAATTCTAGTTGGTTTAACGCGTAA,CCAGCTTTTCATAAGAATTAGGAACACTTAGGTGTTAAGTTCGCTAAACGGAGCTGAAAAAACGTAGACATTTTCATAAAAAAAATTCTAGTTGGTTTA,10,30,14,27,27,45,27,53,27,35,35,45,43,53,33.78,6.550790564
hek293t,8012,1,7,CCGTGAGCGAAGCATTAACATCAGAACCATGGATAAGTAGCAAAAAGATTAAGTTCTGGAATGACAGGTCAAAAAAATTCTAGTTGGTTTAACGCGTAA,CCGTGAGCGAAGCATTAACATCAGAACCATGGATAAGTACTGCACAGCAAAAAGATTAAGTTCTGGAATGACAGGTCAAAAAAATTCTAGTTGGTTTAA,10,30,14,27,27,46,27,53,27,39,39,46,46,53,74.44,0.033283408
hek293t,8012,1,7,TCGGAAGCGAAGCATTAACATCAGAACCATGGATAAGTAGCAAAAAGATTAAGTTCTGGAATGACAGAAAAAAATTCTAGTTGGTTTAACGCGTAACTA,TCGGAAGCGAAGCATTAACATCAGAACCATGGATAAGTACTGCACAGCAAAAAGATTAAGTTCTGGAATGACAGAAAAAAATTCTAGTTGGTTTAACGC,10,30,14,27,27,49,27,56,27,39,39,49,46,56,74.44,0.0
hek293t,8014,1,4,GCATACCTTCCACCTTCAGAACAGGTAGTTGGATTAGAATTGCATAGCTCTTTCGATGGGACACTACTCAAAAAAATTCTAGTTGGTTTAACGCGTAAC,GCATACCTTCCACCTTCAGAACAGGTAGTTGGATGGATTAGAATTGCATAGCTCTTTCGATGGGACACTACTCAAAAAAATTCTAGTTGGTTTAACGCG,10,30,14,27,27,50,27,54,27,35,35,50,39,54,31.03,52.86117758
hek293t,8014,1,4,TCTTTCCTTCCACCTTCAGAACAGGTAGTTGGATTAGAATTGCATAGCTCTTTCGATGGGACACTACTCCGCAGAAAAAAATTCTAGTTGGTTTAACGC,TCTTTCCTTCCACCTTCAGAACAGGTAGTTGGATGGATTAGAATTGCATAGCTCTTTCGATGGGACACTACTCCGCAGAAAAAAATTCTAGTTGGTTTA,10,30,14,27,27,45,27,49,27,35,35,45,39,49,31.03,49.64820441
hek293t,7449,1,7,GACACCAGGCAAAACAAATTACTGGGGAGAGGCAGGGCGGCTATATGGTTTGTCCTGTGAAAGCTGATAAAAAAAATTCTAGTTGGTTTAACGCGTAAC,GACACCAGGCAAAACAAATTACTGGGGAGAGGCAGGGCGACGAGCTGCTATATGGTTTGTCCTGTGAAAGCTGATAAAAAAAATTCTAGTTGGTTTAAC,10,30,14,27,27,47,27,54,27,40,40,47,47,54,39.49,0.170316302
hek293t,8017,1,12,TTTTTCTCCTGATATATCTGATCATGTGCTGGTCCATTACTTATTTCAGGAATGAAAGTTAACTTAATATGCAAAAAAATTCTAGTTGGTTTAACGCGT,TTTTTCTCCTGATATATCTGATCATGTGCTGGTCGTCTGCACCGTCCATTACTTATTTCAGGAATGAAAGTTAACTTAATATGCAAAAAAATTCTAGTT,10,30,14,27,27,39,27,51,27,32,32,39,44,51,40.12,0.0
hek293t,8017,1,12,TAAATCTCCTGATATATCTGATCATGTGCTGGTCCATTACTTATTTCAGGAATGAAAGTTAACTTAATATGCACCAAAAAAAATTCTAGTTGGTTTAAC,TAAATCTCCTGATATATCTGATCATGTGCTGGTCGTCTGCACCGTCCATTACTTATTTCAGGAATGAAAGTTAACTTAATATGCACCAAAAAAAATTCT,10,30,14,27,27,35,27,47,27,32,32,35,44,47,40.12,0.0
hek293t,8020,1,15,GCATGCAGGCCCAGTGCCATGAAACAGCCTGGAAAAGAGCTGAGAGTGCGGACTAGACTTAAAATCAAAAAAATTCTAGTTGGTTTAACGCGTAACTAG,GCATGCAGGCCCAGTGCCATGAAACATTCTTGAGTGGACATGCCTGGAAAAGAGCTGAGAGTGCGGACTAGACTTAAAATCAAAAAAATTCTAGTTGGT,10,30,14,27,27,42,27,57,27,27,27,42,42,57,24.17,3.598413122
hek293t,8022,1,4,GGCTTGAGAAAAATTAACAGGAATATGAGAGGATGGAGGATGTATGCAAAGATAATTCTCTTCAGAACTAAAAAAATTCTAGTTGGTTTAACGCGTAAC,GGCTTGAGAAAAATTAACAGGAATATGAGAGGATGAGTGGAGGATGTATGCAAAGATAATTCTCTTCAGAACTAAAAAAATTCTAGTTGGTTTAACGCG,10,30,14,27,27,50,27,54,27,35,35,50,39,54,52.98,4.015760078
hek293t,8022,1,4,GATCCGAGAAAAATTAACAGGAATATGAGAGGATGGAGGATGTATGCAAAGATAATTCTCTTCAGAACTTTTTTGCTAAAAAAATTCTAGTTGGTTTAA,GATCCGAGAAAAATTAACAGGAATATGAGAGGATGAGTGGAGGATGTATGCAAAGATAATTCTCTTCAGAACTTTTTTGCTAAAAAAATTCTAGTTGGT,10,30,14,27,27,42,27,46,27,35,35,42,39,46,52.98,4.700258413
hek293t,8024,1,12,CTATCCTCTGCTGTGTCTTCTGTTATAAATGGTTCTGTAGTAATGTGTCTCTGGAAACTTTTAAGGTAAAAAAATTCTAGTTGGTTTAACGCGTAACTA,CTATCCTCTGCTGTGTCTTCTGTTATAAATGGTTCTCCTAAATATAGAGTAGTAATGTGTCTCTGGAAACTTTTAAGGTAAAAAAATTCTAGTTGGTTT,10,30,14,27,27,44,27,56,27,37,37,44,49,56,17.91,0.0
hek293t,8025,1,4,GTTGAAGGCAACAGAGGAACAGAGAAATTAGGTTACTTACTGAAACAGACATTGGAATTTTAAATCCCCCCCCCTTAAAAAAAATTCTAGTTGGTTTAA,GTTGAAGGCAACAGAGGAACAGAGAAATTAGTGCGGTTACTTACTGAAACAGACATTGGAATTTTAAATCCCCCCCCCTTAAAAAAAATTCTAGTTGGT,10,30,14,27,27,42,27,46,27,32,32,42,36,46,26.07,76.09211992
hek293t,8025,1,4,GCCCGAGGCAACAGAGGAACAGAGAAATTAGGTTACTTACTGAAACAGACATTGGAATTTTAAATCCCCCCCCCTTAAAAAGAGAAAAAAATTCTAGTT,GCCCGAGGCAACAGAGGAACAGAGAAATTAGTGCGGTTACTTACTGAAACAGACATTGGAATTTTAAATCCCCCCCCCTTAAAAAGAGAAAAAAATTCT,10,30,14,27,27,35,27,39,27,32,32,35,36,39,26.07,2.720337537
hek293t,8027,1,7,GAGAACCTGCATCCGTGTAAGCCTTTTCATGGAAGAGTCTGCTTATGGATTAGCACGTAAGGGTCAACAGGATAAAAAAATTCTAGTTGGTTTAACGCG,GAGAACCTGCATCCGTGTAAGCCTTTTCACCCGACATGGAAGAGTCTGCTTATGGATTAGCACGTAAGGGTCAACAGGATAAAAAAATTCTAGTTGGTT,10,30,14,27,27,43,27,50,27,28,28,43,35,50,23.22,27.3522342
hek293t,8027,1,7,AGATGCCTGCATCCGTGTAAGCCTTTTCATGGAAGAGTCTGCTTATGGATTAGCACGTAAGGGTCAACAGGATGCTCCAAAAAAATTCTAGTTGGTTTA,AGATGCCTGCATCCGTGTAAGCCTTTTCACCCGACATGGAAGAGTCTGCTTATGGATTAGCACGTAAGGGTCAACAGGATGCTCCAAAAAAATTCTAGT,10,30,14,27,27,38,27,45,27,28,28,38,35,45,23.22,34.56725056
hek293t,8029,1,2,AGTGAAATCTTGCTTACTTCAACATGAACAGGATGGGATTTAAGAAAACAAAGTGATTATCAGTCACAGGACTCAAAAAAAATTCTAGTTGGTTTAACG,AGTGAAATCTTGCTTACTTCAACATGAACACAGGATGGGATTTAAGAAAACAAAGTGATTATCAGTCACAGGACTCAAAAAAAATTCTAGTTGGTTTAA,10,30,14,27,27,46,27,48,27,31,31,46,33,48,11.96,2.274787894
hek293t,8029,1,2,CAGCCAATCTTGCTTACTTCAACATGAACAGGATGGGATTTAAGAAAACAAAGTGATTATCAGTCACAGGACTCATGAGGAAAAAAATTCTAGTTGGTT,CAGCCAATCTTGCTTACTTCAACATGAACACAGGATGGGATTTAAGAAAACAAAGTGATTATCAGTCACAGGACTCATGAGGAAAAAAATTCTAGTTGG,10,30,14,27,27,41,27,43,27,31,31,41,33,43,11.96,5.014158901
hek293t,8031,1,4,TTATCGCATAGAATATTTCATTCCAGATCAGGTCAATTTTTGACCCTTAACTGTATTTTAAAGGTTCAAACACCAAGTCAAATTACAAAAAAAATTCTA,TTATCGCATAGAATATTTCATTCCAGATGAGACAGGTCAATTTTTGACCCTTAACTGTATTTTAAAGGTTCAAACACCAAGTCAAATTACAAAAAAAAT,10,30,14,27,27,32,27,36,27,29,29,32,33,36,13.95,3.162055336
hek293t,8035,1,10,ATTCATTAAAAGTCATGCTGCCACACTATAGGAAAACTTGGAATACTGTAGGATTCAACTCCACTGAAAAAAAATTCTAGTTGGTTTAACGCGTAACTA,ATTCATTAAAAGTCATGCTGCCACACTATAGACCATTAGAGGAAAACTTGGAATACTGTAGGATTCAACTCCACTGAAAAAAAATTCTAGTTGGTTTAA,10,30,14,27,27,46,27,56,27,31,31,46,41,56,33.07,8.13206607
hek293t,8035,1,10,TGGCTTTAAAAGTCATGCTGCCACACTATAGGAAAACTTGGAATACTGTAGGATTCAACTCCACTGAAAAGCAAAAAAAAAATTCTAGTTGGTTTAACG,TGGCTTTAAAAGTCATGCTGCCACACTATAGACCATTAGAGGAAAACTTGGAATACTGTAGGATTCAACTCCACTGAAAAGCAAAAAAAAAATTCTAGT,10,30,14,27,27,38,27,48,27,31,31,38,41,48,33.07,1.790475439
hek293t,8037,1,3,TTATTACAATTGATATTTGCCCTATGAGGTGGTCACTCTCTTTCTCATTGCTTTGTGCAGGAGTGAGAAGAAAAAAATTCTAGTTGGTTTAACGCGTAA,TTATTACAATTGATATTTGCCCTATGAGGTGGTCACTACTCTCTTTCTCATTGCTTTGTGCAGGAGTGAGAAGAAAAAAATTCTAGTTGGTTTAACGCG,10,30,14,27,27,50,27,53,27,35,35,50,38,53,53.59,83.30164961
hek293t,8039,1,6,ATCGAGGTAGGAGTCTGTGGGGTTTAGGCAGGATAGTGTTTTGGCCCACTTGCTTACATTAAGAGCTTGATCCTGGGAGAAAAAAAATTCTAGTTGGTT,ATCGAGGTAGGAGTCTGTGGGGTTTATTGTTAGGCAGGATAGTGTTTTGGCCCACTTGCTTACATTAAGAGCTTGATCCTGGGAGAAAAAAAATTCTAG,10,30,14,27,27,37,27,43,27,27,27,37,33,43,50.36,75.67098792
hek293t,8041,1,11,GACCAGCAACATGCAAGTAATTGCCTCACAGGTGGTATACATCAGATAATATGCCAGGTGATGTATTTTAAAAAAAATTCTAGTTGGTTTAACGCGTAA,GACCAGCAACATGCAAGTAATTGCCTCACAGGTGGTATGATCTTATGTTACATCAGATAATATGCCAGGTGATGTATTTTAAAAAAAATTCTAGTTGGT,10,30,14,27,27,42,27,53,27,39,39,42,50,53,39.68,0.0
hek293t,8042,1,14,TATGGGAAGTTCTATGGGAATAGCAGCTGTGGAAAACAAGCTCCACAACCCCATCTATTGGCTAATTAAAAAAAAATTCTAGTTGGTTTAACGCGTAAC,TATGGGAAGTTCTATGGGAATAGCAGCTGTCCCGACACTGGTTTGGAAAACAAGCTCCACAACCCCATCTATTGGCTAATTAAAAAAAAATTCTAGTTG,10,30,14,27,27,40,27,54,27,30,30,40,44,54,48.78,14.89149404
hek293t,8042,1,14,GCTTCGAAGTTCTATGGGAATAGCAGCTGTGGAAAACAAGCTCCACAACCCCATCTATTGGCTAATTAAGTCTTCAAAAAAAATTCTAGTTGGTTTAAC,GCTTCGAAGTTCTATGGGAATAGCAGCTGTCCCGACACTGGTTTGGAAAACAAGCTCCACAACCCCATCTATTGGCTAATTAAGTCTTCAAAAAAAATT,10,30,14,27,27,33,27,47,27,30,30,33,44,47,48.78,0.153609831
hek293t,8044,1,14,AGACGGCGTACAGGTCAGAGAAAAGGTTGGGGAAGGGAGTCGGAGAGCGAAGGGAGAGTGGATGCAAAAAAAATTCTAGTTGGTTTAACGCGTAACTAG,AGACGGCGTACAGGTCAGAGAAAAGGTTGGGGAAGCATACCGGGATTAGGGAGTCGGAGAGCGAAGGGAGAGTGGATGCAAAAAAAATTCTAGTTGGTT,10,30,14,27,27,43,27,57,27,36,36,43,50,57,61.87,0.148148148
hek293t,8045,1,4,ATCACAAGAGGAGTTAGCATAGTTCAAAAAGGAACCTAAGTGGAGAGTTCAGCCTCTTGTATTCAAAAAAATTCTAGTTGGTTTAACGCGTAACTAGAT,ATCACAAGAGGAGTTAGCATAGTTCAAAAAGGAACCTAAGCAAGTGGAGAGTTCAGCCTCTTGTATTCAAAAAAATTCTAGTTGGTTTAACGCGTAACT,10,30,14,27,27,55,27,59,27,40,40,55,44,59,39.54,9.30975215
hek293t,8045,1,4,CTGCAAAGAGGAGTTAGCATAGTTCAAAAAGGAACCTAAGTGGAGAGTTCAGCCTCTTGTATTCAGTGGAAAAAAATTCTAGTTGGTTTAACGCGTAAC,CTGCAAAGAGGAGTTAGCATAGTTCAAAAAGGAACCTAAGCAAGTGGAGAGTTCAGCCTCTTGTATTCAGTGGAAAAAAATTCTAGTTGGTTTAACGCG,10,30,14,27,27,50,27,54,27,40,40,50,44,54,39.54,5.162520835
hek293t,8047,1,2,GTCGATCTGCTGCCGACGGCCCCTTTCTCAGGCACAGCGCTTCACGTTGCCCCTCTCGGTTCCTGCAGCTGAAAAGCGGTCTGGGGCCTGCAAAAAAAT,GTCGATCTGCTGCCGACGGCCCCTTTTTCTCAGGCACAGCGCTTCACGTTGCCCCTCTCGGTTCCTGCAGCTGAAAAGCGGTCTGGGGCCTGCAAAAAA,10,30,14,27,27,30,27,32,27,27,27,30,29,32,19.06,16.24669348
hek293t,8049,1,2,GTGAAAGGCTGATGAAATGTAGTTGACTCCGGATCTGAAATATTTTATCCCTCCTCAATGTAGGTTAAATTATTCTTCACCTTTCCAAAAAAATTCTAG,GTGAAAGGCTGATGAAATGTAGTTGACGTTCCGGATCTGAAATATTTTATCCCTCCTCAATGTAGGTTAAATTATTCTTCACCTTTCCAAAAAAATTCT,10,30,14,27,27,35,27,37,27,28,28,35,30,37,39.43,26.56617512
hek293t,8051,1,12,CAACAGTAAAGACTACCTTGCAGTGCTTCTGGAACTCAAGGATATTCATGTGGACAGGCAGAATAATAAAAAAATTCTAGTTGGTTTAACGCGTAACTA,CAACAGTAAAGACTACCTTGCAGTGCTTCTGGACCTCAGGAAATCACTCAAGGATATTCATGTGGACAGGCAGAATAATAAAAAAATTCTAGTTGGTTT,10,30,14,27,27,44,27,56,27,34,34,44,46,56,10.86,1.755222446
hek293t,8051,1,12,TTCGCGTAAAGACTACCTTGCAGTGCTTCTGGAACTCAAGGATATTCATGTGGACAGGCAGAATAATTTTAAAAAAATTCTAGTTGGTTTAACGCGTAA,TTCGCGTAAAGACTACCTTGCAGTGCTTCTGGACCTCAGGAAATCACTCAAGGATATTCATGTGGACAGGCAGAATAATTTTAAAAAAATTCTAGTTGG,10,30,14,27,27,41,27,53,27,34,34,41,46,53,10.86,0.308641975
hek293t,8053,1,7,CATGTTCTCTAGGGCCAAGTCCTGAACCATGGCAAACCGAGCAAAGCAGTGCTGGGGAAACAGGCAAAAAAATTCTAGTTGGTTTAACGCGTAACTAGA,CATGTTCTCTAGGGCCAAGTCCTGAACCATGGCAAACCGAGAATGCTGCAAAGCAGTGCTGGGGAAACAGGCAAAAAAATTCTAGTTGGTTTAACGCGT,10,30,14,27,27,51,27,58,27,41,41,51,48,58,77.36,1.312425758
hek293t,8053,1,7,GACGTTCTCTAGGGCCAAGTCCTGAACCATGGCAAACCGAGCAAAGCAGTGCTGGGGAAACAGGCCTGAAAAAAATTCTAGTTGGTTTAACGCGTAACT,GACGTTCTCTAGGGCCAAGTCCTGAACCATGGCAAACCGAGAATGCTGCAAAGCAGTGCTGGGGAAACAGGCCTGAAAAAAATTCTAGTTGGTTTAACG,10,30,14,27,27,48,27,55,27,41,41,48,48,55,77.36,0.414529584
hek293t,8055,1,2,AATTCGACACTGGCCTACCCCTAGTAAGCCGGTATTAAAAGGCACATTCTCCATGACTGTTTCACAAGAAAAAAATTCTAGTTGGTTTAACGCGTAACT,AATTCGACACTGGCCTACCCCTAGTAAGCCGGTATTAGCAAAGGCACATTCTCCATGACTGTTTCACAAGAAAAAAATTCTAGTTGGTTTAACGCGTAA,10,30,14,27,27,53,27,55,27,38,38,53,40,55,44.15,54.91406088
hek293t,8055,1,2,CATATGACACTGGCCTACCCCTAGTAAGCCGGTATTAAAAGGCACATTCTCCATGACTGTTTCACAAGCCCAGAAAAAAATTCTAGTTGGTTTAACGCG,CATATGACACTGGCCTACCCCTAGTAAGCCGGTATTAGCAAAGGCACATTCTCCATGACTGTTTCACAAGCCCAGAAAAAAATTCTAGTTGGTTTAACG,10,30,14,27,27,48,27,50,27,38,38,48,40,50,44.15,45.49801456
hek293t,8057,1,12,ATCCGGGTCCCATAGAAATTGGAAAATGAAGGAAGCATTAATGAATCATCCAAGAAACCAGAAATCTTTCAGTGAAAAAAATTCTAGTTGGTTTAACGC,ATCCGGGTCCCATAGAAATTGGAAAATGACTAGTCAGTTTTAGGAAGCATTAATGAATCATCCAAGAAACCAGAAATCTTTCAGTGAAAAAAATTCTAG,10,30,14,27,27,37,27,49,27,30,30,37,42,49,49.44,0.065906339
hek293t,8057,1,12,TGTCTGGTCCCATAGAAATTGGAAAATGAAGGAAGCATTAATGAATCATCCAAGAAACCAGAAATCTTTCAAAAAAAATTCTAGTTGGTTTAACGCGTA,TGTCTGGTCCCATAGAAATTGGAAAATGACTAGTCAGTTTTAGGAAGCATTAATGAATCATCCAAGAAACCAGAAATCTTTCAAAAAAAATTCTAGTTG,10,30,14,27,27,40,27,52,27,30,30,40,42,52,49.44,0.064131179
hek293t,8059,1,12,ACTAATCGGGTACAACCCCTCAAACGAGGCGGGGACTGCAGAGGGAGAGTCCCTGCCGGCCCGGTGCGAAAAAAATTCTAGTTGGTTTAACGCGTAACT,ACTAATCGGGTACAACCCCTCAAACGAGGCGGGGACTGCATGTATCCCGGAAGAGGGAGAGTCCCTGCCGGCCCGGTGCGAAAAAAATTCTAGTTGGTT,10,30,14,27,27,43,27,55,27,40,40,43,52,55,46.63,0.0
hek293t,8060,1,3,TAATTGATGTCTGATACGTTGAAAGGGTTAGGTCACTGTCCTAAAATTTGGAGACATTAGTTCTGCACTAAAAAAAATTCTAGTTGGTTTAACGCGTAA,TAATTGATGTCTGATACGTTGAAAGGGTTAGGTCCGAACTGTCCTAAAATTTGGAGACATTAGTTCTGCACTAAAAAAAATTCTAGTTGGTTTAACGCG,10,30,14,27,27,50,27,53,27,35,35,50,38,53,42.42,13.32697863
hek293t,8060,1,3,TGTTAGATGTCTGATACGTTGAAAGGGTTAGGTCACTGTCCTAAAATTTGGAGACATTAGTTCTGCACTACACGCTTTTGGAAAAAAAATTCTAGTTGG,TGTTAGATGTCTGATACGTTGAAAGGGTTAGGTCCGAACTGTCCTAAAATTTGGAGACATTAGTTCTGCACTACACGCTTTTGGAAAAAAAATTCTAGT,10,30,14,27,27,38,27,41,27,35,35,38,38,41,42.42,0.0
hek293t,8064,1,15,GCACAGGGGACTGCAAAAGGCATTATTGGAGGCTGCTGTCATGTGCGAACTTGCTGCTAGCACGAAAAAAATTCTAGTTGGTTTAACGCGTAACTAGAT,GCACAGGGGACTGCAAAAGGCATTATTGGAGGCTGCACGGTTTATTCACGATGTCATGTGCGAACTTGCTGCTAGCACGAAAAAAATTCTAGTTGGTTT,10,30,14,27,27,44,27,59,27,37,37,44,52,59,64.45,0.0
hek293t,8067,1,12,AAGAACAGTACCAAACACTTTTCCATCTTTGGTTTTGAATAGTTTGATTTAAAAGGTTTTGTTGAAAAAAATTCTAGTTGGTTTAACGCGTAACTAGAT,AAGAACAGTACCAAACACTTTTCCATCTTTGGTTTTCCATCTGTTTGCGAATAGTTTGATTTAAAAGGTTTTGTTGAAAAAAATTCTAGTTGGTTTAAC,10,30,14,27,27,47,27,59,27,37,37,47,49,59,6.46,0.814433126
hek293t,8070,1,5,TAGCACACCTTAGCCTGAATATTGACAAATGGAGTTCTGGGCTGGCTGAAGAATGCCATGCCCAGCATGCGGGTGGCATAAAAAAATTCTAGTTGGTTT,TAGCACACCTTAGCCTGAATATTGACAAATGGATGGGAGTTCTGGGCTGGCTGAAGAATGCCATGCCCAGCATGCGGGTGGCATAAAAAAATTCTAGTT,10,30,14,27,27,39,27,44,27,32,32,39,37,44,31.88,31.076157
hek293t,8070,1,5,GAATGCACCTTAGCCTGAATATTGACAAATGGAGTTCTGGGCTGGCTGAAGAATGCCATGCCCAGCATGCGGGTGGAAAAAAATTCTAGTTGGTTTAAC,GAATGCACCTTAGCCTGAATATTGACAAATGGATGGGAGTTCTGGGCTGGCTGAAGAATGCCATGCCCAGCATGCGGGTGGAAAAAAATTCTAGTTGGT,10,30,14,27,27,42,27,47,27,32,32,42,37,47,31.88,47.88140708
hek293t,8072,1,10,TCCATCTGCCCAGATATCTGTGTGTATGATGGAGTGGATGAAAAAATATGCTTCCATTACTGAATTAAAAAAAATTCTAGTTGGTTTAACGCGTAACTA,TCCATCTGCCCAGATATCTGTGTGTATGATATACATCTTCGGAGTGGATGAAAAAATATGCTTCCATTACTGAATTAAAAAAAATTCTAGTTGGTTTAA,10,30,14,27,27,46,27,56,27,31,31,46,41,56,51.91,3.16343503
hek293t,8072,1,10,CGATACTGCCCAGATATCTGTGTGTATGATGGAGTGGATGAAAAAATATGCTTCCATTACTGAATTACTACTCTGAAAAAAATTCTAGTTGGTTTAACG,CGATACTGCCCAGATATCTGTGTGTATGATATACATCTTCGGAGTGGATGAAAAAATATGCTTCCATTACTGAATTACTACTCTGAAAAAAATTCTAGT,10,30,14,27,27,38,27,48,27,31,31,38,41,48,51.91,2.886979481
hek293t,8076,1,4,GTACATCAAATCAAGATGAAGTGAGTGGAAGGAGGTAAACATTGGCAAGCAGAGAAAAAGGAGCTGATTTGTGAAGAGAAAAAAATTCTAGTTGGTTTA,GTACATCAAATCAAGATGAAGTGAGTGGAACGACGGAGGTAAACATTGGCAAGCAGAGAAAAAGGAGCTGATTTGTGAAGAGAAAAAAATTCTAGTTGG,10,30,14,27,27,41,27,45,27,31,31,41,35,45,58.05,84.58814832
hek293t,8076,1,4,ATTCGTCAAATCAAGATGAAGTGAGTGGAAGGAGGTAAACATTGGCAAGCAGAGAAAAAGGAGCTGATTTGTGAAAAAAATTCTAGTTGGTTTAACGCG,ATTCGTCAAATCAAGATGAAGTGAGTGGAACGACGGAGGTAAACATTGGCAAGCAGAGAAAAAGGAGCTGATTTGTGAAAAAAATTCTAGTTGGTTTAA,10,30,14,27,27,46,27,50,27,31,31,46,35,50,58.05,52.33463936
hek293t,8080,1,3,GAATATTAAGCAGACCAGAAATAGCTGAGAGGGTAACTTTTGCAGAACCCCTGTTTCTGTGCAAAAAGAAAAAAAATTCTAGTTGGTTTAACGCGTAAC,GAATATTAAGCAGACCAGAAATAGCTGAGAGGGTAAAAACTTTTGCAGAACCCCTGTTTCTGTGCAAAAAGAAAAAAAATTCTAGTTGGTTTAACGCGT,10,30,14,27,27,51,27,54,27,36,36,51,39,54,69.7,10.08097057
hek293t,8080,1,3,TCACCTTAAGCAGACCAGAAATAGCTGAGAGGGTAACTTTTGCAGAACCCCTGTTTCTGTGCAAAAAGAGGTATAAAAAAATTCTAGTTGGTTTAACGC,TCACCTTAAGCAGACCAGAAATAGCTGAGAGGGTAAAAACTTTTGCAGAACCCCTGTTTCTGTGCAAAAAGAGGTATAAAAAAATTCTAGTTGGTTTAA,10,30,14,27,27,46,27,49,27,36,36,46,39,49,69.7,6.396106432
hek293t,8082,1,14,AACGCACAGTTACTTTTGAAAGAGGTAATAGGAAAACATAATACAAAACTATAGGAGAGAACTGGAAAAAAATTCTAGTTGGTTTAACGCGTAACTAGA,AACGCACAGTTACTTTTGAAAGAGGTAATAGGAACTATCTTGAGACAAAACATAATACAAAACTATAGGAGAGAACTGGAAAAAAATTCTAGTTGGTTT,10,30,14,27,27,44,27,58,27,34,34,44,48,58,15.57,0.0
hek293t,8084,1,15,CACGCACTTCTGTTGTAACATAGCTCATAAGGTAGGCAGCTAATCCACTGAAACAGGTTAAAAATAACCCCAAAAAAATTCTAGTTGGTTTAACGCGTA,CACGCACTTCTGTTGTAACATAGCTCGGATACCCGCGGAGAATAAGGTAGGCAGCTAATCCACTGAAACAGGTTAAAAATAACCCCAAAAAAATTCTAG,10,30,14,27,27,37,27,52,27,27,27,37,42,52,24.25,0.229009288
hek293t,8084,1,15,GGCAGACTTCTGTTGTAACATAGCTCATAAGGTAGGCAGCTAATCCACTGAAACAGGTTAAAAATAACCCCCCCGACCAAAAAAATTCTAGTTGGTTTA,GGCAGACTTCTGTTGTAACATAGCTCGGATACCCGCGGAGAATAAGGTAGGCAGCTAATCCACTGAAACAGGTTAAAAATAACCCCCCCGACCAAAAAA,10,30,14,27,27,30,27,45,27,27,27,30,42,45,24.25,0.0
hek293t,8086,1,1,ATCACGTTATATCTGTCAACTTTAGCTGTTGGAGCTTTTAGGAGGTATGAAACTGAAGACCTGATGCTAAAAAAATTCTAGTTGGTTTAACGCGTAACT,ATCACGTTATATCTGTCAACTTTAGCTGTTGGAGCTTTGTAGGAGGTATGAAACTGAAGACCTGATGCTAAAAAAATTCTAGTTGGTTTAACGCGTAAC,10,30,14,27,27,54,27,55,27,39,39,54,40,55,43.01,70.2752486
hek293t,8086,1,1,AGTGAGTTATATCTGTCAACTTTAGCTGTTGGAGCTTTTAGGAGGTATGAAACTGAAGACCTGATGCTTTCAATTAAAAAAAATTCTAGTTGGTTTAAC,AGTGAGTTATATCTGTCAACTTTAGCTGTTGGAGCTTTGTAGGAGGTATGAAACTGAAGACCTGATGCTTTCAATTAAAAAAAATTCTAGTTGGTTTAA,10,30,14,27,27,46,27,47,27,39,39,46,40,47,43.01,71.04688471
hek293t,8088,1,13,TAGGGCACCCTTGTGGTAAGTGGCAAGTCAGGCCGGGCTCCTCAGAGCGAGGGAAGGCCAGCTGCATAGAGAAAAAAATTCTAGTTGGTTTAACGCGTA,TAGGGCACCCTTGTGGTAAGTGGCAAGTCAGGTAATCCGCAAACGCCGGGCTCCTCAGAGCGAGGGAAGGCCAGCTGCATAGAGAAAAAAATTCTAGTT,10,30,14,27,27,39,27,52,27,32,32,39,45,52,46.65,3.631463549
hek293t,8088,1,13,AGGAACACCCTTGTGGTAAGTGGCAAGTCAGGCCGGGCTCCTCAGAGCGAGGGAAGGCCAGCTGCATAGAGAGGCAAAAAAATTCTAGTTGGTTTAACG,AGGAACACCCTTGTGGTAAGTGGCAAGTCAGGTAATCCGCAAACGCCGGGCTCCTCAGAGCGAGGGAAGGCCAGCTGCATAGAGAGGCAAAAAAATTCT,10,30,14,27,27,35,27,48,27,32,32,35,45,48,46.65,0.717994131
hek293t,8090,1,13,TGGGGGACACAAAGCAGAGCCGTTGCATGAGGCCCTGGGCAGGCTCCGGGTTTGCAGGGCGGGTGCCTCCCCCCCCAAAAAAATTCTAGTTGGTTTAAC,TGGGGGACACAAAGCAGAGCCGTTGCATGATGGGCACCATAGTGGCCCTGGGCAGGCTCCGGGTTTGCAGGGCGGGTGCCTCCCCCCCCAAAAAAATTC,10,30,14,27,27,34,27,47,27,31,31,34,44,47,44.62,0.108577633
hek293t,8090,1,13,GGGAGGACACAAAGCAGAGCCGTTGCATGAGGCCCTGGGCAGGCTCCGGGTTTGCAGGGCGGGTGCCTCCCCAAAAAAATTCTAGTTGGTTTAACGCGT,GGGAGGACACAAAGCAGAGCCGTTGCATGATGGGCACCATAGTGGCCCTGGGCAGGCTCCGGGTTTGCAGGGCGGGTGCCTCCCCAAAAAAATTCTAGT,10,30,14,27,27,38,27,51,27,31,31,38,44,51,44.62,12.82954187
hek293t,8092,1,5,TCGTAGTCTTAGCAGTCAGCTTTTTCAATAGGACCTACTTGCAAAGATACATCTAAAAGAAGTTACTTTAAAAAAAATTCTAGTTGGTTTAACGCGTAA,TCGTAGTCTTAGCAGTCAGCTTTTTCAATAGGACCTACTTCCGAAGCAAAGATACATCTAAAAGAAGTTACTTTAAAAAAAATTCTAGTTGGTTTAACG,10,30,14,27,27,48,27,53,27,41,41,48,46,53,7.38,4.841400952
hek293t,8093,1,1,AACCCTCGGTGCTGTCTGACAGGGTAAATAGGAGAATTAGCTTGCAGGCCTCAGCCCCAGTGTTGGCCGTACACTTGTAAAAAAATTCTAGTTGGTTTA,AACCCTCGGTGCTGTCTGACAGGGTAAATAGGAGAATTAGGCTTGCAGGCCTCAGCCCCAGTGTTGGCCGTACACTTGTAAAAAAATTCTAGTTGGTTT,10,30,14,27,27,44,27,45,27,41,41,44,42,45,18.41,34.74612881
hek293t,8095,1,15,CCCTCTGGCTTATGAAAAAGAATAAAGCCTGGGGCTCAAATTAGAGTAGATAAGAGGTTTTATGCCTAAAAAAATTCTAGTTGGTTTAACGCGTAACTA,CCCTCTGGCTTATGAAAAAGAATAAAGCCTGGGGCTCAGTAGCATGACCTATAAATTAGAGTAGATAAGAGGTTTTATGCCTAAAAAAATTCTAGTTGG,10,30,14,27,27,41,27,56,27,38,38,41,53,56,35.39,0.0
hek293t,8096,1,5,CCACAGAATAGAATGAGAAAGGATATCTGAGGGCTCTAAGCAGTGATATGGGGAGTACAGGGAATATGCTGAAAAAAATTCTAGTTGGTTTAACGCGTA,CCACAGAATAGAATGAGAAAGGATATCTGAGGGCTCTAAATGGTGCAGTGATATGGGGAGTACAGGGAATATGCTGAAAAAAATTCTAGTTGGTTTAAC,10,30,14,27,27,47,27,52,27,40,40,47,45,52,62.24,0.760354768
hek293t,8098,1,3,TTTATAAGAACAGCATCCTTTCTCTCCAGTGGAAAACTTGTGCATGCAAACTCACACACACTCTCTCACACTCCAAAAAAATTCTAGTTGGTTTAACGC,TTTATAAGAACAGCATCCTTTCTCTCCAGTGGAAAACTTAGTGTGCATGCAAACTCACACACACTCTCTCACACTCCAAAAAAATTCTAGTTGGTTTAA,10,30,14,27,27,46,27,49,27,39,39,46,42,49,56.49,41.22650343
hek293t,8098,1,3,TCCCTAAGAACAGCATCCTTTCTCTCCAGTGGAAAACTTGTGCATGCAAACTCACACACACTCTCTAAAAAAATTCTAGTTGGTTTAACGCGTAACTAG,TCCCTAAGAACAGCATCCTTTCTCTCCAGTGGAAAACTTAGTGTGCATGCAAACTCACACACACTCTCTAAAAAAATTCTAGTTGGTTTAACGCGTAAC,10,30,14,27,27,54,27,57,27,39,39,54,42,57,56.49,75.56950451
hek293t,20202,1,2,CTTGGACAAGATGGTATAGATGTAATGACAGGATAAATTAGCAAGGCCCATAGATACTGCTCCCTCTTCCTTGTCTAGAGATAAGACATAAAAAAATTC,CTTGGACAAGATGGTATAGATGTAATGATCCAGGATAAATTAGCAAGGCCCATAGATACTGCTCCCTCTTCCTTGTCTAGAGATAAGACATAAAAAAAT,10,30,14,27,27,32,27,34,27,29,29,32,31,34,71.28,4.062631381
hek293t,20202,1,2,GAAGGACAAGATGGTATAGATGTAATGACAGGATAAATTAGCAAGGCCCATAGATACTGCTCCCTCTTCCTTGTCTAGAGATAAAAAAATTCTAGTTGG,GAAGGACAAGATGGTATAGATGTAATGATCCAGGATAAATTAGCAAGGCCCATAGATACTGCTCCCTCTTCCTTGTCTAGAGATAAAAAAATTCTAGTT,10,30,14,27,27,39,27,41,27,29,29,39,31,41,71.28,69.71735209
hek293t,8102,1,9,CCGACCATAAGCATAACAATTTGACCTTTAGGTCAAAAACATTAAAAATACTTGAAAGAAATTGTTTATTTTAAAACAAAAAAATTCTAGTTGGTTTAA,CCGACCATAAGCATAACAATTTGACCTTTCCGACGTTGAGGTCAAAAACATTAAAAATACTTGAAAGAAATTGTTTATTTTAAAACAAAAAAATTCTAG,10,30,14,27,27,37,27,46,27,30,30,37,39,46,4.96,0.0
hek293t,8104,1,5,ACTCGAATAAAAAGCATACTTAAGATTAATGGAATATATTTGAAATCTGTTGTGTTACTGGGATACCTAAAAAAATTCTAGTTGGTTTAACGCGTAACT,ACTCGAATAAAAAGCATACTTAAGATTAATGGAAGGCATTATATTTGAAATCTGTTGTGTTACTGGGATACCTAAAAAAATTCTAGTTGGTTTAACGCG,10,30,14,27,27,50,27,55,27,35,35,50,40,55,2.82,4.286353834
hek293t,8104,1,5,TTTGAAATAAAAAGCATACTTAAGATTAATGGAATATATTTGAAATCTGTTGTGTTACTGGGATACCTTTGACTCCAAAAAAATTCTAGTTGGTTTAAC,TTTGAAATAAAAAGCATACTTAAGATTAATGGAAGGCATTATATTTGAAATCTGTTGTGTTACTGGGATACCTTTGACTCCAAAAAAATTCTAGTTGGT,10,30,14,27,27,42,27,47,27,35,35,42,40,47,2.82,4.012982994
hek293t,8106,1,11,CAGAGGCTAGTAATTCCCGGGCTACATGGTGGTACTTAATAAGAGTGGATTGTATTTTATTTGGGTGAAAAAAAAATTCTAGTTGGTTTAACGCGTAAC,CAGAGGCTAGTAATTCCCGGGCTACATGGTGGTACTTAAAACCCATACAATAAGAGTGGATTGTATTTTATTTGGGTGAAAAAAAAATTCTAGTTGGTT,10,30,14,27,27,43,27,54,27,40,40,43,51,54,73.86,0.327600328
hek293t,8107,1,4,CGCGTGTGGAAAGATAAATGGGAAAAGAGAGGAAACAAGAGTATCAAATATTGGTAATGTTAGAATATATCTCTGTTAGTGAAAAAAATTCTAGTTGGT,CGCGTGTGGAAAGATAAATGGGAAAAGAGAGGAAAGCAACAAGAGTATCAAATATTGGTAATGTTAGAATATATCTCTGTTAGTGAAAAAAATTCTAGT,10,30,14,27,27,38,27,42,27,35,35,38,39,42,62.01,0.030125019
hek293t,8107,1,4,ACTGTGTGGAAAGATAAATGGGAAAAGAGAGGAAACAAGAGTATCAAATATTGGTAATGTTAGAATATATCTCTAAAAAAATTCTAGTTGGTTTAACGC,ACTGTGTGGAAAGATAAATGGGAAAAGAGAGGAAAGCAACAAGAGTATCAAATATTGGTAATGTTAGAATATATCTCTAAAAAAATTCTAGTTGGTTTA,10,30,14,27,27,45,27,49,27,35,35,45,39,49,62.01,2.031312042
hek293t,8111,1,15,CCTAGCCTATAATTATTATTGAAATACTGTGGGTTCTTCACATCTTTCTGTATAATTGAGGCATGAAAAAAAATTCTAGTTGGTTTAACGCGTAACTAG,CCTAGCCTATAATTATTATTGAAATAGCACACGGGCTGTGACTGTGGGTTCTTCACATCTTTCTGTATAATTGAGGCATGAAAAAAAATTCTAGTTGGT,10,30,14,27,27,42,27,57,27,27,27,42,42,57,24.47,0.0
hek293t,8113,1,10,GGCTACGCTCTCCTCATCACCGACGCGTTTGGGTTTCGCAGGCGTTCCTGCCCAGCAGTCGATCGGCTGTCTGACCCCGGGAAAAAAATTCTAGTTGGT,GGCTACGCTCTCCTCATCACCGACGCGTGTGGACCCCTTTGGGTTTCGCAGGCGTTCCTGCCCAGCAGTCGATCGGCTGTCTGACCCCGGGAAAAAAAT,10,30,14,27,27,32,27,42,27,29,29,32,39,42,20.47,0.0
hek293t,8113,1,10,TATCGCGCTCTCCTCATCACCGACGCGTTTGGGTTTCGCAGGCGTTCCTGCCCAGCAGTCGATCGGCTGTCTGAAAAAAAATTCTAGTTGGTTTAACGC,TATCGCGCTCTCCTCATCACCGACGCGTGTGGACCCCTTTGGGTTTCGCAGGCGTTCCTGCCCAGCAGTCGATCGGCTGTCTGAAAAAAAATTCTAGTT,10,30,14,27,27,39,27,49,27,29,29,39,39,49,20.47,41.25535578
hek293t,8117,1,15,AGAATCCTAGTAATTTATACAGAATTTGAAGGGGAAGTGAGTTTGCTTTTGGGGAGCTGAAATATCTCTGCAAAAAAAAATTCTAGTTGGTTTAACGCG,AGAATCCTAGTAATTTATACAGAATTTGAAGTCAGGAATGGAGCCGGGGAAGTGAGTTTGCTTTTGGGGAGCTGAAATATCTCTGCAAAAAAAAATTCT,10,30,14,27,27,35,27,50,27,32,32,35,47,50,6.58,0.0
hek293t,8118,1,12,TGTATGCTTGGCTGTTCCCGTGAGTTAGGCGGTGAGGCCTCCTCAGGGCTGGATGGCCACCTCCCAGCCTGGCAGGAAAAAAATTCTAGTTGGTTTAAC,TGTATGCTTGGCTGTTCCCGTGAGTTACGCTATAAGGGAGGCGGTGAGGCCTCCTCAGGGCTGGATGGCCACCTCCCAGCCTGGCAGGAAAAAAATTCT,10,30,14,27,27,35,27,47,27,28,28,35,40,47,42.06,1.452095881
hek293t,8118,1,12,GGCCCGCTTGGCTGTTCCCGTGAGTTAGGCGGTGAGGCCTCCTCAGGGCTGGATGGCCACCTCCCAGCCTGGCAGGAATTAAAAAAATTCTAGTTGGTT,GGCCCGCTTGGCTGTTCCCGTGAGTTACGCTATAAGGGAGGCGGTGAGGCCTCCTCAGGGCTGGATGGCCACCTCCCAGCCTGGCAGGAATTAAAAAAA,10,30,14,27,27,31,27,43,27,28,28,31,40,43,42.06,9.00455022
hek293t,8120,1,9,CGCAATTCTATGGTTCTCCTGAGCATGTTAGGTAGATGTTATTTGTTGGTGGTGTTGGGCCCCCCCCAAAAAAATTCTAGTTGGTTTAACGCGTAACTA,CGCAATTCTATGGTTCTCCTGAGCATGTTAGGTAGATGTTACACGCGCTATTTGTTGGTGGTGTTGGGCCCCCCCCAAAAAAATTCTAGTTGGTTTAAC,10,30,14,27,27,47,27,56,27,40,40,47,49,56,39.02,0.222858962
hek293t,8120,1,9,GTGCGTTCTATGGTTCTCCTGAGCATGTTAGGTAGATGTTATTTGTTGGTGGTGTTGGGCCCCCCCCCCCAAAAAAAATTCTAGTTGGTTTAACGCGTA,GTGCGTTCTATGGTTCTCCTGAGCATGTTAGGTAGATGTTACACGCGCTATTTGTTGGTGGTGTTGGGCCCCCCCCCCCAAAAAAAATTCTAGTTGGTT,10,30,14,27,27,43,27,52,27,40,40,43,49,52,39.02,0.0
hek293t,8122,1,9,ATATACAGAAATGAAAACTAGCTCAGCTGAGGCAGCGATAAAGGCAAGTGAAGAGCTGGTGAAAGGAAAAAAAAATTCTAGTTGGTTTAACGCGTAACT,ATATACAGAAATGAAAACTAGCTCAGCTGATGTCTCGTGGGCAGCGATAAAGGCAAGTGAAGAGCTGGTGAAAGGAAAAAAAAATTCTAGTTGGTTTAA,10,30,14,27,27,46,27,55,27,31,31,46,40,55,73.23,24.11824837
hek293t,8124,1,4,CCTCACCACATGATAGTAATCTGAGAGAAAGGTGAGTCCTAGCATGGATGTGAGGCTTTGATGAGAAGCTAAAAAAATTCTAGTTGGTTTAACGCGTAA,CCTCACCACATGATAGTAATCTGAGAGAAAGGTTGCAGAGTCCTAGCATGGATGTGAGGCTTTGATGAGAAGCTAAAAAAATTCTAGTTGGTTTAACGC,10,30,14,27,27,49,27,53,27,34,34,49,38,53,41.07,80.85422218
hek293t,8124,1,4,AATACCCACATGATAGTAATCTGAGAGAAAGGTGAGTCCTAGCATGGATGTGAGGCTTTGATGAGAAGCTGAAGGAAAAAAAAAATTCTAGTTGGTTTA,AATACCCACATGATAGTAATCTGAGAGAAAGGTTGCAGAGTCCTAGCATGGATGTGAGGCTTTGATGAGAAGCTGAAGGAAAAAAAAAATTCTAGTTGG,10,30,14,27,27,41,27,45,27,34,34,41,38,45,41.07,74.81773506
hek293t,8126,1,2,GGACATTTGCTTCAAATTTTAGGATGCTCTGGAACAAATACTAAATGTGAAACTAATTTTGTGTTGAAAGTTCATAAAAAAAAATTCTAGTTGGTTTAA,GGACATTTGCTTCAAATTTTAGGATGCTCTGGAAGACAAATACTAAATGTGAAACTAATTTTGTGTTGAAAGTTCATAAAAAAAAATTCTAGTTGGTTT,10,30,14,27,27,44,27,46,27,34,34,44,36,46,5.72,0.082101806
hek293t,8128,1,9,CATGTTGTGATTAGAGGCAAATTATCTTGTGGACCTAATAACTTAGCCCTTTGTCCCACCCAGAGAGAAAAAAATTCTAGTTGGTTTAACGCGTAACTA,CATGTTGTGATTAGAGGCAAATTATCTTGTGGACCTAATGTGTCCTACAACTTAGCCCTTTGTCCCACCCAGAGAGAAAAAAATTCTAGTTGGTTTAAC,10,30,14,27,27,47,27,56,27,40,40,47,49,56,37.15,0.359306242
hek293t,8128,1,9,CTTGGTGTGATTAGAGGCAAATTATCTTGTGGACCTAATAACTTAGCCCTTTGTCCCACCCAGAGAGATGTAAAAAAATTCTAGTTGGTTTAACGCGTA,CTTGGTGTGATTAGAGGCAAATTATCTTGTGGACCTAATGTGTCCTACAACTTAGCCCTTTGTCCCACCCAGAGAGATGTAAAAAAATTCTAGTTGGTT,10,30,14,27,27,43,27,52,27,40,40,43,49,52,37.15,0.280701754
hek293t,8130,1,8,GTCGATCAGCTCAGAAAATAAAAGCTATGGGGAATTTTAATTATCAATTTCTTTGCACTACATGGAAACCGAAAAAAATTCTAGTTGGTTTAACGCGTA,GTCGATCAGCTCAGAAAATAAAAGCTATGGGGAATTGGGGTATCTTAATTATCAATTTCTTTGCACTACATGGAAACCGAAAAAAATTCTAGTTGGTTT,10,30,14,27,27,44,27,52,27,37,37,44,45,52,34.44,0.0
hek293t,8131,1,3,GTGTTCAGTTCAAGTGTGGGCCCTGTGAGAGGACCAGAACACCACAGCCCATCCCTAGGTGAACCCGCTCTGGCCACCAAAAAAAATTCTAGTTGGTTT,GTGTTCAGTTCAAGTGTGGGCCCTGTGAGAGCGGGACCAGAACACCACAGCCCATCCCTAGGTGAACCCGCTCTGGCCACCAAAAAAAATTCTAGTTGG,10,30,14,27,27,41,27,44,27,31,31,41,34,44,61.06,54.65512538
hek293t,8131,1,3,CAGCTCAGTTCAAGTGTGGGCCCTGTGAGAGGACCAGAACACCACAGCCCATCCCTAGGTGAACCCGCTCTGGCCACCAGGAGCTGAAAAAAATTCTAG,CAGCTCAGTTCAAGTGTGGGCCCTGTGAGAGCGGGACCAGAACACCACAGCCCATCCCTAGGTGAACCCGCTCTGGCCACCAGGAGCTGAAAAAAATTC,10,30,14,27,27,34,27,37,27,31,31,34,34,37,61.06,5.080485681
hek293t,17543,1,11,ACACAAAATGTAAGAAAATTTATGGGAAAAGGTGGTACTTCAAGTTAAATTGCATCACTGCAAGTTAAAAAAATTCTAGTTGGTTTAACGCGTAACTAG,ACACAAAATGTAAGAAAATTTATGGGAAAAGGTGGTACTGCGGACTTAGTTCAAGTTAAATTGCATCACTGCAAGTTAAAAAAATTCTAGTTGGTTTAA,10,30,14,27,27,46,27,57,27,39,39,46,50,57,0.69,0.0
hek293t,17543,1,11,TTTTGAAATGTAAGAAAATTTATGGGAAAAGGTGGTACTTCAAGTTAAATTGCATCACTGCAAGTTCCCCAAAAAAATTCTAGTTGGTTTAACGCGTAA,TTTTGAAATGTAAGAAAATTTATGGGAAAAGGTGGTACTGCGGACTTAGTTCAAGTTAAATTGCATCACTGCAAGTTCCCCAAAAAAATTCTAGTTGGT,10,30,14,27,27,42,27,53,27,39,39,42,50,53,0.69,0.0
hek293t,8135,1,4,AGGCAGGCCCCCTTTCTGGACCGCTACTGCGGTCGCTGCAAGATGGTAGTGCGTTACGGTCTCGCAGTCATTGCTAAAAAAATTCTAGTTGGTTTAACG,AGGCAGGCCCCCTTTCTGGACCGCTACTGCGGTCGCGACCTGCAAGATGGTAGTGCGTTACGGTCTCGCAGTCATTGCTAAAAAAATTCTAGTTGGTTT,10,30,14,27,27,44,27,48,27,37,37,44,41,48,54.42,2.527211632
hek293t,8137,1,5,GGCCGATGCATCACTCAAAGCTTGGTCTCAGGGAGGACCTGGTGTTGGGTATTTGCTCTTTGTAAGTAAAAAAATTCTAGTTGGTTTAACGCGTAACTA,GGCCGATGCATCACTCAAAGCTTGGTCTCAGGGAGGAGTAGACCTGGTGTTGGGTATTTGCTCTTTGTAAGTAAAAAAATTCTAGTTGGTTTAACGCGT,10,30,14,27,27,51,27,56,27,36,36,51,41,56,36.7,68.37099606
hek293t,8137,1,5,GCTCGATGCATCACTCAAAGCTTGGTCTCAGGGAGGACCTGGTGTTGGGTATTTGCTCTTTGTAAGTGATATTCAAAAAAAATTCTAGTTGGTTTAACG,GCTCGATGCATCACTCAAAGCTTGGTCTCAGGGAGGAGTAGACCTGGTGTTGGGTATTTGCTCTTTGTAAGTGATATTCAAAAAAAATTCTAGTTGGTT,10,30,14,27,27,43,27,48,27,36,36,43,41,48,36.7,42.2613597
hek293t,8139,1,3,AAACGTCTGGACTATCCTGGACAGCCTGCAGGGTTTCCGCTGCTCTCTTGTGGCCAAACATTAGAGCTGAAAAAAATTCTAGTTGGTTTAACGCGTAAC,AAACGTCTGGACTATCCTGGACAGCCTGCAGGGTTGCCTCCGCTGCTCTCTTGTGGCCAAACATTAGAGCTGAAAAAAATTCTAGTTGGTTTAACGCGT,10,30,14,27,27,51,27,54,27,36,36,51,39,54,46.21,61.55814216
hek293t,8139,1,3,GAACCTCTGGACTATCCTGGACAGCCTGCAGGGTTTCCGCTGCTCTCTTGTGGCCAAACATTAGAGCTGCAGTTGTCCCGGAAAAAAATTCTAGTTGGT,GAACCTCTGGACTATCCTGGACAGCCTGCAGGGTTGCCTCCGCTGCTCTCTTGTGGCCAAACATTAGAGCTGCAGTTGTCCCGGAAAAAAATTCTAGTT,10,30,14,27,27,39,27,42,27,36,36,39,39,42,46.21,8.152010683
hek293t,8141,1,4,ATCGTGTTGGCAACATGGACTTCTTTCCTTGGTCTTCAATTTCTGAATACCATGCTTTTGTTAACATGGAAAAAAAAAATTCTAGTTGGTTTAACGCGT,ATCGTGTTGGCAACATGGACTTCTTTCCTTGGTCTTTGTACAATTTCTGAATACCATGCTTTTGTTAACATGGAAAAAAAAAATTCTAGTTGGTTTAAC,10,30,14,27,27,47,27,51,27,37,37,47,41,51,28.81,79.23694293
hek293t,8141,1,4,CACTTGTTGGCAACATGGACTTCTTTCCTTGGTCTTCAATTTCTGAATACCATGCTTTTGTTAACATGGAAATCCAAAAAAATTCTAGTTGGTTTAACG,CACTTGTTGGCAACATGGACTTCTTTCCTTGGTCTTTGTACAATTTCTGAATACCATGCTTTTGTTAACATGGAAATCCAAAAAAATTCTAGTTGGTTT,10,30,14,27,27,44,27,48,27,37,37,44,41,48,28.81,66.66090484
hek293t,8143,1,12,GCAGGGAATTATTAGCTCAGTTTGTTGCCAGGCTATCTGCAGCCTCATGGCTTCTGGTTATAGAAGGGCAAAAAAAAAATTCTAGTTGGTTTAACGCGT,GCAGGGAATTATTAGCTCAGTTTGTTGCCAGGCTAGATGGCGTACTATCTGCAGCCTCATGGCTTCTGGTTATAGAAGGGCAAAAAAAAAATTCTAGTT,10,30,14,27,27,39,27,51,27,36,36,39,48,51,26.52,0.0
hek293t,10519,1,5,AGTTGTTCTTCATGTTAAGCATGTAGGTAAGGGGCTCCGTAACGGCCTGAAACACCATCTGCTCCGCCCCGGGGCAAAAAAAATTCTAGTTGGTTTAAC,AGTTGTTCTTCATGTTAAGCATGTAGGTAAGGGGAATGACTCCGTAACGGCCTGAAACACCATCTGCTCCGCCCCGGGGCAAAAAAAATTCTAGTTGGT,10,30,14,27,27,42,27,47,27,35,35,42,40,47,32.62,42.39761464
hek293t,10519,1,5,CCCCCTTCTTCATGTTAAGCATGTAGGTAAGGGGCTCCGTAACGGCCTGAAACACCATCTGCTCCGCCAAAAAAATTCTAGTTGGTTTAACGCGTAACT,CCCCCTTCTTCATGTTAAGCATGTAGGTAAGGGGAATGACTCCGTAACGGCCTGAAACACCATCTGCTCCGCCAAAAAAATTCTAGTTGGTTTAACGCG,10,30,14,27,27,50,27,55,27,35,35,50,40,55,32.62,26.92332787
hek293t,8148,1,11,GATCCTTCAGTAAGTGCAAAGTTTAACCAAGGAAACTACTACATATGAAACCCAATGACATAACTAAAAAAAATTCTAGTTGGTTTAACGCGTAACTAG,GATCCTTCAGTAAGTGCAAAGTTTAACCAAGGCAAGGTAGTGGAAACTACTACATATGAAACCCAATGACATAACTAAAAAAAATTCTAGTTGGTTTAA,10,30,14,27,27,46,27,57,27,31,31,46,42,57,66.46,5.186811372
hek293t,8148,1,11,TGTACTTCAGTAAGTGCAAAGTTTAACCAAGGAAACTACTACATATGAAACCCAATGACATAACTACACCCGCTTTTGAAAAAAATTCTAGTTGGTTTA,TGTACTTCAGTAAGTGCAAAGTTTAACCAAGGCAAGGTAGTGGAAACTACTACATATGAAACCCAATGACATAACTACACCCGCTTTTGAAAAAAATTC,10,30,14,27,27,34,27,45,27,31,31,34,42,45,66.46,0.0
hek293t,8150,1,12,TGGTTTTTTGTGGAAGTTCAGGGCATTTGAGGACAGATGATTTATGTAATCGGACTTCCTGCATATCAAAAAAATTCTAGTTGGTTTAACGCGTAACTA,TGGTTTTTTGTGGAAGTTCAGGGCATTTCATCTTTGCGCGGAGGACAGATGATTTATGTAATCGGACTTCCTGCATATCAAAAAAATTCTAGTTGGTTT,10,30,14,27,27,44,27,56,27,29,29,44,41,56,38.83,44.94867984
hek293t,8152,1,8,CATGATAGGGAAGATTTTCAAAGACAAAAAGGGTTTTGTAAATCTGGACAGATGATAAACAAGCCTCCTCCTGCACCAAGCCAAAAAAATTCTAGTTGG,CATGATAGGGAAGATTTTCAAAGACAAAAGCGGCCAGAGGGTTTTGTAAATCTGGACAGATGATAAACAAGCCTCCTCCTGCACCAAGCCAAAAAAATT,10,30,14,27,27,33,27,41,27,30,30,33,38,41,7.27,0.0
hek293t,8154,1,10,TAGTGTTTCTTTACATAACAGGGTGAAACTGGTCTTCCTGGCGCAAATGGATCACCAGGACAACCGGTAAAAAAAAATTCTAGTTGGTTTAACGCGTAA,TAGTGTTTCTTTACATAACAGGGTGAAGAGAAGCTGAACTGGTCTTCCTGGCGCAAATGGATCACCAGGACAACCGGTAAAAAAAAATTCTAGTTGGTT,10,30,14,27,27,43,27,53,27,28,28,43,38,53,18.64,25.23542025
hek293t,8154,1,10,GATCGTTTCTTTACATAACAGGGTGAAACTGGTCTTCCTGGCGCAAATGGATCACCAGGACAACCGGTAAATATTCCTAAAAAAATTCTAGTTGGTTTA,GATCGTTTCTTTACATAACAGGGTGAAGAGAAGCTGAACTGGTCTTCCTGGCGCAAATGGATCACCAGGACAACCGGTAAATATTCCTAAAAAAATTCT,10,30,14,27,27,35,27,45,27,28,28,35,38,45,18.64,39.08280646
hek293t,8156,1,12,GGTGAGCAGAGCCTGACAAGCTGTATGAAAGGCCAGGTGGCTGGCACAACCTGAAGAACTACACAGAACAAAAAAATTCTAGTTGGTTTAACGCGTAAC,GGTGAGCAGAGCCTGACAAGCTGTATGAAAGGCCAGGTTATCAGGAGTACGGCTGGCACAACCTGAAGAACTACACAGAACAAAAAAATTCTAGTTGGT,10,30,14,27,27,42,27,54,27,39,39,42,51,54,54.04,0.0
hek293t,8157,1,12,TCAGAAAAGTAATTCTGTTCTCTTAATAAAGGGAGAGAAAAAAGCTTGGCCTGGATGTTGATCTGCTTATGAAAAAAAATTCTAGTTGGTTTAACGCGT,TCAGAAAAGTAATTCTGTTCTCTTAATAAAGGGAGTATATGTCCTAGAGAAAAAAGCTTGGCCTGGATGTTGATCTGCTTATGAAAAAAAATTCTAGTT,10,30,14,27,27,39,27,51,27,36,36,39,48,51,19.11,0.0
hek293t,8158,1,3,ACTGTGGGAATGGGATGCCTGTTTCTGGGAGGGTTGGTGACGTGCAGAAAGAGGTGAACGTGCGCTCCCAGGCAGCGTGCAGCACTGGAAAAAAATTCT,ACTGTGGGAATGGGATGCCTGTTTCTGGATGGAGGGTTGGTGACGTGCAGAAAGAGGTGAACGTGCGCTCCCAGGCAGCGTGCAGCACTGGAAAAAAAT,10,30,14,27,27,32,27,35,27,29,29,32,32,35,66.44,5.199093552
hek293t,8158,1,3,ACGCAGGGAATGGGATGCCTGTTTCTGGGAGGGTTGGTGACGTGCAGAAAGAGGTGAACGTGCGCTCCCAGGCAGCGTGCAGCAAAAAAAATTCTAGTT,ACGCAGGGAATGGGATGCCTGTTTCTGGATGGAGGGTTGGTGACGTGCAGAAAGAGGTGAACGTGCGCTCCCAGGCAGCGTGCAGCAAAAAAAATTCTA,10,30,14,27,27,36,27,39,27,29,29,36,32,39,66.44,81.32509914
hek293t,8160,1,7,TGACCCCCCCATAGCCGAGCAGCAGGAGGAGGAACATGGCGAAAGCGGAGCAGGCCTCAGCCTGGAAAAAAAATTCTAGTTGGTTTAACGCGTAACTAG,TGACCCCCCCATAGCCGAGCAGCAGGAGGAGGAAGAAGACACATGGCGAAAGCGGAGCAGGCCTCAGCCTGGAAAAAAAATTCTAGTTGGTTTAACGCG,10,30,14,27,27,50,27,57,27,35,35,50,42,57,60.31,4.595553718
hek293t,8162,1,14,GCACGTGATAATGTCTTTGGCAAAGCTGAAGGGCCCCCCCCCATGGCCTTCTCTTTCCAAGAAGTAAAGTCCAAAAAAAATTCTAGTTGGTTTAACGCG,GCACGTGATAATGTCTTTGGCAAAGCTGAAGGTAATGTGGCCCCTTGCCCCCCCCCATGGCCTTCTCTTTCCAAGAAGTAAAGTCCAAAAAAAATTCTA,10,30,14,27,27,36,27,50,27,33,33,36,47,50,28.75,0.252255794
hek293t,8164,1,4,CAACATTAATTGTTAAGACTTTATGGGTTAGGGTGCTTGGTGCAGAACAGCTTTCTGCAGTGCATCACCCCCGCGCGAAAAAAATTCTAGTTGGTTTAA,CAACATTAATTGTTAAGACTTTATGGGTTAGAGTCGGTGCTTGGTGCAGAACAGCTTTCTGCAGTGCATCACCCCCGCGCGAAAAAAATTCTAGTTGGT,10,30,14,27,27,42,27,46,27,32,32,42,36,46,17.21,45.40644563
hek293t,8164,1,4,CCCTTTTAATTGTTAAGACTTTATGGGTTAGGGTGCTTGGTGCAGAACAGCTTTCTGCAGTGCATCACCCCCGCGCGAAGGGCTAAAAAAATTCTAGTT,CCCTTTTAATTGTTAAGACTTTATGGGTTAGAGTCGGTGCTTGGTGCAGAACAGCTTTCTGCAGTGCATCACCCCCGCGCGAAGGGCTAAAAAAATTCT,10,30,14,27,27,35,27,39,27,32,32,35,36,39,17.21,1.350448307
hek293t,8166,1,4,AGCCGAGTACTTTCTCCAGAACAGATGTTAGGATCAAGATAGCTCTGAAATGATAGAGTCAATAAATAAATGATAAAATGCTTCTAAAAAAATTCTAGT,AGCCGAGTACTTTCTCCAGAACAGATCCATGTTAGGATCAAGATAGCTCTGAAATGATAGAGTCAATAAATAAATGATAAAATGCTTCTAAAAAAATTC,10,30,14,27,27,34,27,38,27,27,27,34,31,38,42.78,74.56096857
hek293t,8166,1,4,AGAGTAGTACTTTCTCCAGAACAGATGTTAGGATCAAGATAGCTCTGAAATGATAGAGTCAATAAATAAATGATAAAATGCTAAAAAAATTCTAGTTGG,AGAGTAGTACTTTCTCCAGAACAGATCCATGTTAGGATCAAGATAGCTCTGAAATGATAGAGTCAATAAATAAATGATAAAATGCTAAAAAAATTCTAG,10,30,14,27,27,37,27,41,27,27,27,37,31,41,42.78,52.49549178
hek293t,8168,1,6,TGAACACTTTTGTTTTACTCCTATGATGGTGGAGGGACGAGATACGTCAGCTAAACATCAGCATTTTGACAAAAAAATTCTAGTTGGTTTAACGCGTAA,TGAACACTTTTGTTTTACTCCTATGATGGTGGAGGGCCGCTGACGAGATACGTCAGCTAAACATCAGCATTTTGACAAAAAAATTCTAGTTGGTTTAAC,10,30,14,27,27,47,27,53,27,37,37,47,43,53,41.92,23.7685576
hek293t,8168,1,6,TAGCAACTTTTGTTTTACTCCTATGATGGTGGAGGGACGAGATACGTCAGCTAAACATCAGCATTTTGACAGAAACAAAAAAAATTCTAGTTGGTTTAA,TAGCAACTTTTGTTTTACTCCTATGATGGTGGAGGGCCGCTGACGAGATACGTCAGCTAAACATCAGCATTTTGACAGAAACAAAAAAAATTCTAGTTG,10,30,14,27,27,40,27,46,27,37,37,40,43,46,41.92,0.0
hek293t,8170,1,1,ACGACCTATGATGTGAAGGCCGGTTCAGCTGGTATTGGTTACCCTCAGCCCATTGTAAGATGATAGTCTTTTCTCTTTCCTTCCAAAAAAATTCTAGTT,ACGACCTATGATGTGAAGGCCGGTTCAGGCTGGTATTGGTTACCCTCAGCCCATTGTAAGATGATAGTCTTTTCTCTTTCCTTCCAAAAAAATTCTAGT,10,30,14,27,27,38,27,39,27,28,28,38,29,39,35.78,75.44876684
hek293t,8170,1,1,GATTGCTATGATGTGAAGGCCGGTTCAGCTGGTATTGGTTACCCTCAGCCCATTGTAAGATGATAGTCTTTTCTCTTTCCTTCCTTTAAAAAAATTCTA,GATTGCTATGATGTGAAGGCCGGTTCAGGCTGGTATTGGTTACCCTCAGCCCATTGTAAGATGATAGTCTTTTCTCTTTCCTTCCTTTAAAAAAATTCT,10,30,14,27,27,35,27,36,27,28,28,35,29,36,35.78,65.17913138
hek293t,8172,1,4,CAGCGCGCTGAAGGGTGTCCCCCTGGAACAGGGCACCTCTGAGGAGGGTTGTGGTGCAGCCCGTCACCGAGGCGCAAAAAAAATTCTAGTTGGTTTAAC,CAGCGCGCTGAAGGGTGTCCCCCTGGAACAGGGCACCTCACCGTGAGGAGGGTTGTGGTGCAGCCCGTCACCGAGGCGCAAAAAAAATTCTAGTTGGTT,10,30,14,27,27,43,27,47,27,40,40,43,44,47,53.38,1.280523987
hek293t,8174,1,1,CGCCCTACAGAACTCTGAGGGCTGTTTTTAGGACAGTTCTAAAATTAACTTTGTAAGATCTTTCCATAAATGACCTTTCTATGAATGCAAAAAAAATTC,CGCCCTACAGAACTCTGAGGGCTGTTTTTCAGGACAGTTCTAAAATTAACTTTGTAAGATCTTTCCATAAATGACCTTTCTATGAATGCAAAAAAAATT,10,30,14,27,27,33,27,34,27,30,30,33,31,34,2.82,0.297619048
hek293t,8180,1,13,CTTACAAATGAATCCACAGCCGATCACTGGGGAGCCAAACGTCATTATCTGCCCAACCGCCATTGGGGCCAAGATATTGAAAAAAATTCTAGTTGGTTT,CTTACAAATGAATCCACAGCCGATCACGCGTCAGGTGAAATGGGGAGCCAAACGTCATTATCTGCCCAACCGCCATTGGGGCCAAGATATTGAAAAAAA,10,30,14,27,27,31,27,44,27,28,28,31,41,44,71.67,1.776939203
hek293t,8180,1,13,ACAAGAAATGAATCCACAGCCGATCACTGGGGAGCCAAACGTCATTATCTGCCCAACCGCCATTGGGGCCAAGATAAAAAAATTCTAGTTGGTTTAACG,ACAAGAAATGAATCCACAGCCGATCACGCGTCAGGTGAAATGGGGAGCCAAACGTCATTATCTGCCCAACCGCCATTGGGGCCAAGATAAAAAAATTCT,10,30,14,27,27,35,27,48,27,28,28,35,41,48,71.67,6.65419487
hek293t,8182,1,13,CACACCGCCCCCCCCTGGGATATATCACTAGGATAATTCATAATTTGGAATCCTCTTATTATGTGTGCAGGTAAAAAAATTCTAGTTGGTTTAACGCGT,CACACCGCCCCCCCCTGGGATATATCACTAGGATGAACGGGAAATGGAATTCATAATTTGGAATCCTCTTATTATGTGTGCAGGTAAAAAAATTCTAGT,10,30,14,27,27,38,27,51,27,35,35,38,48,51,37.28,0.462630667
hek293t,8183,1,9,ACAATACTGGAGGACTTCTATAATCTTCAAGGCACATCCAGTTTAACAAGTGAGGATAAAGGTAAAAAAAATTCTAGTTGGTTTAACGCGTAACTAGAT,ACAATACTGGAGGACTTCTATAATCTTCAAGGCAAACCTCAAGCATCCAGTTTAACAAGTGAGGATAAAGGTAAAAAAAATTCTAGTTGGTTTAACGCG,10,30,14,27,27,50,27,59,27,35,35,50,44,59,30.17,2.541712514
hek293t,8183,1,9,GGTCCACTGGAGGACTTCTATAATCTTCAAGGCACATCCAGTTTAACAAGTGAGGATAAAGGTAGTGCTGTAAAAAAAATTCTAGTTGGTTTAACGCGT,GGTCCACTGGAGGACTTCTATAATCTTCAAGGCAAACCTCAAGCATCCAGTTTAACAAGTGAGGATAAAGGTAGTGCTGTAAAAAAAATTCTAGTTGGT,10,30,14,27,27,42,27,51,27,35,35,42,44,51,30.17,1.445871211
hek293t,8185,1,5,GATCCCTGCCCCAAACTGGCAAATGTCACAGGTCGATGTCTCTTTTTGATTGGTTTCACCTGAGCCTTCATTGACAAAAAAATTCTAGTTGGTTTAACG,GATCCCTGCCCCAAACTGGCAAATGTCACAGGTCGATGTCCTTTCTCTTTTTGATTGGTTTCACCTGAGCCTTCATTGACAAAAAAATTCTAGTTGGTT,10,30,14,27,27,43,27,48,27,40,40,43,45,48,31.67,0.0
hek293t,8185,1,5,TTAAGCTGCCCCAAACTGGCAAATGTCACAGGTCGATGTCTCTTTTTGATTGGTTTCACCTGAGCCTTAAAAAAATTCTAGTTGGTTTAACGCGTAACT,TTAAGCTGCCCCAAACTGGCAAATGTCACAGGTCGATGTCCTTTCTCTTTTTGATTGGTTTCACCTGAGCCTTAAAAAAATTCTAGTTGGTTTAACGCG,10,30,14,27,27,50,27,55,27,40,40,50,45,55,31.67,3.034124578
hek293t,8187,1,3,GGTTTACTTACAGGTTTACTGATAATTAGAGGTGGTCGAATTTTTTCTGACAGTACATTTTTCTATCTAAAAAAATTCTAGTTGGTTTAACGCGTAACT,GGTTTACTTACAGGTTTACTGATAATTAGAGGTGGTAAGCGAATTTTTTCTGACAGTACATTTTTCTATCTAAAAAAATTCTAGTTGGTTTAACGCGTA,10,30,14,27,27,52,27,55,27,37,37,52,40,55,35.65,65.5752314
hek293t,8187,1,3,CTGAAACTTACAGGTTTACTGATAATTAGAGGTGGTCGAATTTTTTCTGACAGTACATTTTTCTATCTCCATCACTAAGTAAAAAAATTCTAGTTGGTT,CTGAAACTTACAGGTTTACTGATAATTAGAGGTGGTAAGCGAATTTTTTCTGACAGTACATTTTTCTATCTCCATCACTAAGTAAAAAAATTCTAGTTG,10,30,14,27,27,40,27,43,27,37,37,40,40,43,35.65,0.0
hek293t,8189,1,2,CAACTAAGGAGATTAAAAGCAGTAGGTGAAGGGATTAATTCTGTATGTAAAACCAAATCAGATTTGGGTGCATAAAGGTTGAAAAAAATTCTAGTTGGT,CAACTAAGGAGATTAAAAGCAGTAGGTGACTAGGGATTAATTCTGTATGTAAAACCAAATCAGATTTGGGTGCATAAAGGTTGAAAAAAATTCTAGTTG,10,30,14,27,27,40,27,42,27,30,30,40,32,42,55.08,43.75619186
hek293t,8189,1,2,CCGCGAAGGAGATTAAAAGCAGTAGGTGAAGGGATTAATTCTGTATGTAAAACCAAATCAGATTTGGGTGCATAAAGGTTGGGCCCTAAAAAAAATTCT,CCGCGAAGGAGATTAAAAGCAGTAGGTGACTAGGGATTAATTCTGTATGTAAAACCAAATCAGATTTGGGTGCATAAAGGTTGGGCCCTAAAAAAAATT,10,30,14,27,27,33,27,35,27,30,30,33,32,35,55.08,0.800849142
hek293t,8191,1,3,TAGGCTGCTTACATTCCCCTCCGTATATTAGGGATATTATGAAGAGGCACTTAAAAGATGGTAGGAAAACTTCAAAAAAAAATTCTAGTTGGTTTAACG,TAGGCTGCTTACATTCCCCTCCGTATATTTGTAGGGATATTATGAAGAGGCACTTAAAAGATGGTAGGAAAACTTCAAAAAAAAATTCTAGTTGGTTTA,10,30,14,27,27,45,27,48,27,30,30,45,33,48,7.43,51.85779468
hek293t,8191,1,3,AGTCTTGCTTACATTCCCCTCCGTATATTAGGGATATTATGAAGAGGCACTTAAAAGATGGTAGGAAAACTTCAATGACCTTTCTTCAAAAAAATTCTA,AGTCTTGCTTACATTCCCCTCCGTATATTTGTAGGGATATTATGAAGAGGCACTTAAAAGATGGTAGGAAAACTTCAATGACCTTTCTTCAAAAAAATT,10,30,14,27,27,33,27,36,27,30,30,33,33,36,7.43,0.0
hek293t,8195,1,15,GAAGGCAAGCTGTGAATTTATTTGTATCCAGGAAGGAATGGAAGTGACCAGAATGAGGAAAAGGAAGTTAAAAAAAATTCTAGTTGGTTTAACGCGTAA,GAAGGCAAGCTGTGAATTTATTTGTATCCAGGCGAGAATTGTCGTGGAAGGAATGGAAGTGACCAGAATGAGGAAAAGGAAGTTAAAAAAAATTCTAGT,10,30,14,27,27,38,27,53,27,31,31,38,46,53,9.43,0.0
hek293t,8195,1,15,TAACTCAAGCTGTGAATTTATTTGTATCCAGGAAGGAATGGAAGTGACCAGAATGAGGAAAAGGAAGTTATATAAAAAAAATTCTAGTTGGTTTAACGC,TAACTCAAGCTGTGAATTTATTTGTATCCAGGCGAGAATTGTCGTGGAAGGAATGGAAGTGACCAGAATGAGGAAAAGGAAGTTATATAAAAAAAATTC,10,30,14,27,27,34,27,49,27,31,31,34,46,49,9.43,0.0
hek293t,8197,1,6,CAGCCGATAGCCTTAAGAGAACAATTTTCTGGGAAAATAAATTGTGGACTGCAGCTTCTTAAAGGATTATAAACTACAAAAAAAATTCTAGTTGGTTTA,CAGCCGATAGCCTTAAGAGAACAATTTTCCTGGCCTGGGAAAATAAATTGTGGACTGCAGCTTCTTAAAGGATTATAAACTACAAAAAAAATTCTAGTT,10,30,14,27,27,39,27,45,27,29,29,39,35,45,1.66,0.543930307
hek293t,8197,1,6,GTGTCGATAGCCTTAAGAGAACAATTTTCTGGGAAAATAAATTGTGGACTGCAGCTTCTTAAAGGATTATAAAAAAAAAATTCTAGTTGGTTTAACGCG,GTGTCGATAGCCTTAAGAGAACAATTTTCCTGGCCTGGGAAAATAAATTGTGGACTGCAGCTTCTTAAAGGATTATAAAAAAAAAATTCTAGTTGGTTT,10,30,14,27,27,44,27,50,27,29,29,44,35,50,1.66,0.0
hek293t,8199,1,1,CATATAATATTCTTGTAATAAAGAGTAATAGGACCATGCCATACAAACACAGAGGCTCTCTGCATACCAGGGTCTGACATGCCAAAAAAAATTCTAGTT,CATATAATATTCTTGTAATAAAGAGTAATAGGACGCATGCCATACAAACACAGAGGCTCTCTGCATACCAGGGTCTGACATGCCAAAAAAAATTCTAGT,10,30,14,27,27,38,27,39,27,35,35,38,36,39,9.11,0.368324125
hek293t,8199,1,1,GATGAAATATTCTTGTAATAAAGAGTAATAGGACCATGCCATACAAACACAGAGGCTCTCTGCATACCAGGGTCTGAAAAAAAATTCTAGTTGGTTTAA,GATGAAATATTCTTGTAATAAAGAGTAATAGGACGCATGCCATACAAACACAGAGGCTCTCTGCATACCAGGGTCTGAAAAAAAATTCTAGTTGGTTTA,10,30,14,27,27,45,27,46,27,35,35,45,36,46,9.11,3.009364682
hek293t,8201,1,2,CATCCGTGCCAAGCACTCCCTCTTTTAGTAGGGAGGAGGCTAAAGCATACAAAACAAAGATTATGTATCAAGGCTACAGCAAAAAAATTCTAGTTGGTT,CATCCGTGCCAAGCACTCCCTCTTTTAGTAGGGGAAGGAGGCTAAAGCATACAAAACAAAGATTATGTATCAAGGCTACAGCAAAAAAATTCTAGTTGG,10,30,14,27,27,41,27,43,27,34,34,41,36,43,17.08,7.669223414
hek293t,8201,1,2,CTTCTGTGCCAAGCACTCCCTCTTTTAGTAGGGAGGAGGCTAAAGCATACAAAACAAAGATTATGTATCAAGGCTACAGCAAAAAAAAAAATTCTAGTT,CTTCTGTGCCAAGCACTCCCTCTTTTAGTAGGGGAAGGAGGCTAAAGCATACAAAACAAAGATTATGTATCAAGGCTACAGCAAAAAAAAAAATTCTAG,10,30,14,27,27,37,27,39,27,34,34,37,36,39,17.08,0.028686173
hek293t,8203,1,2,CACGCTGTATACAAGCCATTTTGATAAAGTGGCTGAATACTAAGCAACTCCATTAAAATATTTGCATGTTATTTTAATGAAAAAAATTCTAGTTGGTTT,CACGCTGTATACAAGCCATTTTGATAAAGTGGCTCCGAATACTAAGCAACTCCATTAAAATATTTGCATGTTATTTTAATGAAAAAAATTCTAGTTGGT,10,30,14,27,27,42,27,44,27,35,35,42,37,44,9.5,9.5209904
hek293t,8203,1,2,CGACGTGTATACAAGCCATTTTGATAAAGTGGCTGAATACTAAGCAACTCCATTAAAATATTTGCATGTTATTTTAATGAAATAAAAAAATTCTAGTTG,CGACGTGTATACAAGCCATTTTGATAAAGTGGCTCCGAATACTAAGCAACTCCATTAAAATATTTGCATGTTATTTTAATGAAATAAAAAAATTCTAGT,10,30,14,27,27,38,27,40,27,35,35,38,37,40,9.5,0.0
hek293t,8205,1,4,CATCCACCCTGCTCACAGTGAGAGGTAAATGGAGGTCGTCTTCACAAGATGGAGAACTGAACCAATGAAACTGTGCCACAGAAAAAAAATTCTAGTTGG,CATCCACCCTGCTCACAGTGAGAGGTAAACCGATGGAGGTCGTCTTCACAAGATGGAGAACTGAACCAATGAAACTGTGCCACAGAAAAAAAATTCTAG,10,30,14,27,27,37,27,41,27,30,30,37,34,41,26.6,73.42302464
hek293t,8207,1,2,GAAAGTGTGGAAGAGTAGAACAAACTGTAAGGCCTATGGTGAAGTGTTAAATCAGTTGATATAATCTTACTAGCTGAAAAAAAATTCTAGTTGGTTTAA,GAAAGTGTGGAAGAGTAGAACAAACTGTAAGGCCTATGGTAGGAAGTGTTAAATCAGTTGATATAATCTTACTAGCTGAAAAAAAATTCTAGTTGGTTT,10,30,14,27,27,44,27,46,27,41,41,44,43,46,51.91,0.0
hek293t,8207,1,2,CCGCGTGTGGAAGAGTAGAACAAACTGTAAGGCCTATGGTGAAGTGTTAAATCAGTTGATATAATAAAAAAATTCTAGTTGGTTTAACGCGTAACTAGA,CCGCGTGTGGAAGAGTAGAACAAACTGTAAGGCCTATGGTAGGAAGTGTTAAATCAGTTGATATAATAAAAAAATTCTAGTTGGTTTAACGCGTAACTA,10,30,14,27,27,56,27,58,27,41,41,56,43,58,51.91,9.875947122
hek293t,8209,1,8,CTCTATTATTGAAGGATGTGCAATTCATCTGGAACAAACACTGAAAGAAACAGGTGTTTTGAGAAGGCAGTATAAAAAAATTCTAGTTGGTTTAACGCG,CTCTATTATTGAAGGATGTGCAATTCATCTGTATCCTGAGAACAAACACTGAAAGAAACAGGTGTTTTGAGAAGGCAGTATAAAAAAATTCTAGTTGGT,10,30,14,27,27,42,27,50,27,32,32,42,40,50,13.9,43.11976387
hek293t,8209,1,8,GAGCTTTATTGAAGGATGTGCAATTCATCTGGAACAAACACTGAAAGAAACAGGTGTTTTGAGAAGGCAAAAAAATTCTAGTTGGTTTAACGCGTAACT,GAGCTTTATTGAAGGATGTGCAATTCATCTGTATCCTGAGAACAAACACTGAAAGAAACAGGTGTTTTGAGAAGGCAAAAAAATTCTAGTTGGTTTAAC,10,30,14,27,27,47,27,55,27,32,32,47,40,55,13.9,25.4278912
hek293t,8211,1,10,GCCCGGCTTGGGAAGGGAGGAAGCACAGAAGGTCAGACAGCGCGGCTCAGCTCTCCCCATCATTCCAAAAAAATTCTAGTTGGTTTAACGCGTAACTAG,GCCCGGCTTGGGAAGGGAGGAAGCACAGAAGGTCAGCGTTGGGTACACAGCGCGGCTCAGCTCTCCCCATCATTCCAAAAAAATTCTAGTTGGTTTAAC,10,30,14,27,27,47,27,57,27,37,37,47,47,57,61.79,7.177313844
hek293t,406,1,4,GATTCTACAGGCTTTGTGGAGATACGTGGTGGAGGGCAGGAAGGCAAAGTGGGACACCTGGGTAGAAAAAAATTCTAGTTGGTTTAACGCGTAACTAGA,GATTCTACAGGCTTTGTGGAGATACGTGGTGGAGGGCATGTAGGAAGGCAAAGTGGGACACCTGGGTAGAAAAAAATTCTAGTTGGTTTAACGCGTAAC,10,30,14,27,27,54,27,58,27,39,39,54,43,58,56.72,8.360254656
hek293t,406,1,4,ATCGTTACAGGCTTTGTGGAGATACGTGGTGGAGGGCAGGAAGGCAAAGTGGGACACCTGGGTAGGAGACAAAAAAATTCTAGTTGGTTTAACGCGTAA,ATCGTTACAGGCTTTGTGGAGATACGTGGTGGAGGGCATGTAGGAAGGCAAAGTGGGACACCTGGGTAGGAGACAAAAAAATTCTAGTTGGTTTAACGC,10,30,14,27,27,49,27,53,27,39,39,49,43,53,56.72,30.16947134
hek293t,8214,1,7,TACGCGGAGCCTGGTTCTGATTCCAGTCCAGGGCTGGATAGTGCCCTGCTGCTGCGTGCAATGTGTAAAAAAATTCTAGTTGGTTTAACGCGTAACTAG,TACGCGGAGCCTGGTTCTGATTCCAGTCCAGGGCTGGATGGTGATTAGTGCCCTGCTGCTGCGTGCAATGTGTAAAAAAATTCTAGTTGGTTTAACGCG,10,30,14,27,27,50,27,57,27,40,40,50,47,57,44.6,34.24956478
hek293t,8216,1,6,GTAGGCTGTTGAAGGATCTGCGATACTAGAGGAAAACACAAACACCTTTATTTGATCCTTCTAGTTAGCAAGACCTAAAAAAAAATTCTAGTTGGTTTA,GTAGGCTGTTGAAGGATCTGCGATACTAGAGGAAAAGGCCCACACAAACACCTTTATTTGATCCTTCTAGTTAGCAAGACCTAAAAAAAAATTCTAGTT,10,30,14,27,27,39,27,45,27,36,36,39,42,45,41.18,0.09362862
hek293t,8216,1,6,AGTACCTGTTGAAGGATCTGCGATACTAGAGGAAAACACAAACACCTTTATTTGATCCTTCTAGTTAGCAAGACAAAAAAATTCTAGTTGGTTTAACGC,AGTACCTGTTGAAGGATCTGCGATACTAGAGGAAAAGGCCCACACAAACACCTTTATTTGATCCTTCTAGTTAGCAAGACAAAAAAATTCTAGTTGGTT,10,30,14,27,27,43,27,49,27,36,36,43,42,49,41.18,1.625720744
hek293t,8218,1,10,CATTTTCTGCTGTGTAAGGGTAACGTGAGAGGAATGGCATAGGTTGATGGTAGAGATAAAAGAAAGACTAAAAAAATTCTAGTTGGTTTAACGCGTAAC,CATTTTCTGCTGTGTAAGGGTAACGTGAAAACGGATTGGAGGAATGGCATAGGTTGATGGTAGAGATAAAAGAAAGACTAAAAAAATTCTAGTTGGTTT,10,30,14,27,27,44,27,54,27,29,29,44,39,54,47.3,1.433365115
hek293t,8220,1,10,ATGACGACTTCACTTCTCACTAGACAAGCCGGACCCTTCTCCTAGTATTGTCCATGCTCTGGATTAAGAGAACACATAAAAAAATTCTAGTTGGTTTAA,ATGACGACTTCACTTCTCACTAGACAAGCCGGGTTAGTAAAGACCCTTCTCCTAGTATTGTCCATGCTCTGGATTAAGAGAACACATAAAAAAATTCTA,10,30,14,27,27,36,27,46,27,33,33,36,43,46,29.06,0.0
hek293t,8224,1,12,TGTCTCAAATTAACAATGCTATCAAAGATTGGTGTTGTATCAAAATGCTTAATATATGTAGGCCAGAAAAAAATTCTAGTTGGTTTAACGCGTAACTAG,TGTCTCAAATTAACAATGCTATCAAAGATTTGTGTACATCTTGGTGTTGTATCAAAATGCTTAATATATGTAGGCCAGAAAAAAATTCTAGTTGGTTTA,10,30,14,27,27,45,27,57,27,30,30,45,42,57,18.63,0.29966777
hek293t,8224,1,12,AAGCGCAAATTAACAATGCTATCAAAGATTGGTGTTGTATCAAAATGCTTAATATATGTAGGCCAGTTACCATGAAAAAAATTCTAGTTGGTTTAACGC,AAGCGCAAATTAACAATGCTATCAAAGATTTGTGTACATCTTGGTGTTGTATCAAAATGCTTAATATATGTAGGCCAGTTACCATGAAAAAAATTCTAG,10,30,14,27,27,37,27,49,27,30,30,37,42,49,18.63,0.0
hek293t,8226,1,10,TGTCGCAGGAAAGAATATGAATCAGAGCTTGGAAAAGATGTAGACAGATCCAGAGACCAGCTTTATTGGAAAAAAAATTCTAGTTGGTTTAACGCGTAA,TGTCGCAGGAAAGAATATGAATCAGAGCTTGGAAAGAGCGTATTTAGATGTAGACAGATCCAGAGACCAGCTTTATTGGAAAAAAAATTCTAGTTGGTT,10,30,14,27,27,43,27,53,27,36,36,43,46,53,44.66,0.916488193
hek293t,8226,1,10,TGGGTCAGGAAAGAATATGAATCAGAGCTTGGAAAAGATGTAGACAGATCCAGAGACCAGCTTTATTGGACTGAAAAAAAATTCTAGTTGGTTTAACGC,TGGGTCAGGAAAGAATATGAATCAGAGCTTGGAAAGAGCGTATTTAGATGTAGACAGATCCAGAGACCAGCTTTATTGGACTGAAAAAAAATTCTAGTT,10,30,14,27,27,39,27,49,27,36,36,39,46,49,44.66,0.373817227
hek293t,8228,1,10,TATTCAGTAGATGTAAATTCTGAGTGCAAAGGAAAGTAGAATTGGGCTGCTTACAGTATCACAAAAAAAAATTCTAGTTGGTTTAACGCGTAACTAGAT,TATTCAGTAGATGTAAATTCTGAGTGCAAAGGAAAGTACCGGTGGGGAGAATTGGGCTGCTTACAGTATCACAAAAAAAAATTCTAGTTGGTTTAACGC,10,30,14,27,27,49,27,59,27,39,39,49,49,59,29.8,10.64932002
hek293t,8229,1,11,CCACTCATTATAACTTAATAATATAGCCAAGGAGCATGCTTCCTATTTTCAATTAATTTGAGCATCTAGAAAAAAATTCTAGTTGGTTTAACGCGTAAC,CCACTCATTATAACTTAATAATATAGCCAAGGTTACAAAAGGAAGCATGCTTCCTATTTTCAATTAATTTGAGCATCTAGAAAAAAATTCTAGTTGGTT,10,30,14,27,27,43,27,54,27,33,33,43,44,54,32.02,0.0
hek293t,8229,1,11,GATCTCATTATAACTTAATAATATAGCCAAGGAGCATGCTTCCTATTTTCAATTAATTTGAGCATCTAGATGAAAAAAATTCTAGTTGGTTTAACGCGT,GATCTCATTATAACTTAATAATATAGCCAAGGTTACAAAAGGAAGCATGCTTCCTATTTTCAATTAATTTGAGCATCTAGATGAAAAAAATTCTAGTTG,10,30,14,27,27,40,27,51,27,33,33,40,44,51,32.02,0.0
hek293t,8233,1,12,GTATTCATCTGTGCTAACCCTAGGACAGCAGGTAAAGGGGAATGCAAAGCAGAAATAGCTGCACTGGCTAGAAGTAGAAAAAAATTCTAGTTGGTTTAA,GTATTCATCTGTGCTAACCCTAGGACTAGCCTCCGTACAGCAGGTAAAGGGGAATGCAAAGCAGAAATAGCTGCACTGGCTAGAAGTAGAAAAAAATTC,10,30,14,27,27,34,27,46,27,27,27,34,39,46,47.22,4.405080214
hek293t,8233,1,12,AATTACATCTGTGCTAACCCTAGGACAGCAGGTAAAGGGGAATGCAAAGCAGAAATAGCTGCACTGGCTAGAAGAAAAAAATTCTAGTTGGTTTAACGC,AATTACATCTGTGCTAACCCTAGGACTAGCCTCCGTACAGCAGGTAAAGGGGAATGCAAAGCAGAAATAGCTGCACTGGCTAGAAGAAAAAAATTCTAG,10,30,14,27,27,37,27,49,27,27,27,37,39,49,47.22,36.4796731
hek293t,8235,1,5,CGGTGGGGGAGCCCATTCTGCTGATTTGGAGGCTCAGGGTATACCATCTGCAGGCAGTGCCAGTCCTCATAACGAAAAAAATTCTAGTTGGTTTAACGC,CGGTGGGGGAGCCCATTCTGCTGATTTGGAGGCTCAGGGTCGTTTATACCATCTGCAGGCAGTGCCAGTCCTCATAACGAAAAAAATTCTAGTTGGTTT,10,30,14,27,27,44,27,49,27,41,41,44,46,49,41.3,0.205089068
hek293t,8237,1,15,GGGATCTTCAATTGCATTACACAGCAGAGCGGCTCGCACTTCTAGCCTGAGTTGTCAGCCTTTAAAAAAAAATTCTAGTTGGTTTAACGCGTAACTAGA,GGGATCTTCAATTGCATTACACAGCAGAGCGGCTTTGCAGACAACGACTCGCACTTCTAGCCTGAGTTGTCAGCCTTTAAAAAAAAATTCTAGTTGGTT,10,30,14,27,27,43,27,58,27,33,33,43,48,58,65.46,5.308609318
hek293t,8238,1,11,GGAACAAGAGAAAGGAAAGCCAGTTAAACAGGGAGGAGCAATTGCTAACAGTTTGCAGCTTCTTGTCATCTTTGGGGAAAAAAATTCTAGTTGGTTTAA,GGAACAAGAGAAAGGAAAGCCAGTTAAACAGATACTCTTGACGGAGGAGCAATTGCTAACAGTTTGCAGCTTCTTGTCATCTTTGGGGAAAAAAATTCT,10,30,14,27,27,35,27,46,27,32,32,35,43,46,21.92,7.352618383
hek293t,8238,1,11,ACGTTAAGAGAAAGGAAAGCCAGTTAAACAGGGAGGAGCAATTGCTAACAGTTTGCAGCTTCTTGAAAAAAATTCTAGTTGGTTTAACGCGTAACTAGA,ACGTTAAGAGAAAGGAAAGCCAGTTAAACAGATACTCTTGACGGAGGAGCAATTGCTAACAGTTTGCAGCTTCTTGAAAAAAATTCTAGTTGGTTTAAC,10,30,14,27,27,47,27,58,27,32,32,47,43,58,21.92,35.28664253
hek293t,8240,1,7,TGACAGTGAATCCACACTCTAATACATCTTGGTTAAATACTGGCCTGTTCTTCATTTTACCATAATGAAGAGGAGCAAAAAAATTCTAGTTGGTTTAAC,TGACAGTGAATCCACACTCTAATACATCTGTCACGGTGGTTAAATACTGGCCTGTTCTTCATTTTACCATAATGAAGAGGAGCAAAAAAATTCTAGTTG,10,30,14,27,27,40,27,47,27,30,30,40,37,47,29.29,5.081382541
hek293t,8240,1,7,TCAAGGTGAATCCACACTCTAATACATCTTGGTTAAATACTGGCCTGTTCTTCATTTTACCATAATGAAGAGGAGCAGATTCTAAAAAAATTCTAGTTG,TCAAGGTGAATCCACACTCTAATACATCTGTCACGGTGGTTAAATACTGGCCTGTTCTTCATTTTACCATAATGAAGAGGAGCAGATTCTAAAAAAATT,10,30,14,27,27,33,27,40,27,30,30,33,37,40,29.29,0.253635173
hek293t,8244,1,1,TCTCTCCTTAGATCATGAAGACCAATGTGGGGATAAGAATTTCATTTACAATGAAGCAATTTACACTTCTCTGATAAAAAAAAATTCTAGTTGGTTTAA,TCTCTCCTTAGATCATGAAGACCAATGTGGGGATAAGTAATTTCATTTACAATGAAGCAATTTACACTTCTCTGATAAAAAAAAATTCTAGTTGGTTTA,10,30,14,27,27,45,27,46,27,38,38,45,39,46,75.46,58.48399816
hek293t,8244,1,1,AAAGGCCTTAGATCATGAAGACCAATGTGGGGATAAGAATTTCATTTACAATGAAGCAATTTACACTTCTCTGATAAAGTAAAAAAAATTCTAGTTGGT,AAAGGCCTTAGATCATGAAGACCAATGTGGGGATAAGTAATTTCATTTACAATGAAGCAATTTACACTTCTCTGATAAAGTAAAAAAAATTCTAGTTGG,10,30,14,27,27,41,27,42,27,38,38,41,39,42,75.46,1.399646098
hek293t,8246,1,6,TCTGGATATTATATTACTTTTGTGGTGCTTGGCACCACCCCTGAAGAATTTTATAGAAATATATAGCTGGGTATAGAGAAAAAAATTCTAGTTGGTTTA,TCTGGATATTATATTACTTTTGTGGTGCTTGGCGGATGCACCACCCCTGAAGAATTTTATAGAAATATATAGCTGGGTATAGAGAAAAAAATTCTAGTT,10,30,14,27,27,39,27,45,27,32,32,39,38,45,25.05,0.0
hek293t,8248,1,1,TATGGTGCAGCCCTTAGCAGTTCCCCAGGAGGACTGTGTCACTTAAGGTTGTTGGCTTTGGAGGGGTCCTAGCAAAAAAAATTCTAGTTGGTTTAACGC,TATGGTGCAGCCCTTAGCAGTTCCCCAGGAGGACTGTGTCCACTTAAGGTTGTTGGCTTTGGAGGGGTCCTAGCAAAAAAAATTCTAGTTGGTTTAACG,10,30,14,27,27,48,27,49,27,41,41,48,42,49,56.12,76.38229431
hek293t,8250,1,2,CATCAAAGCTGAGATATGTATTTTTTAACTGGCTTCTATAACACAGAACTTTACAAAAGGTTCAGTATAAAATCTAGGAAAAAAATTCTAGTTGGTTTA,CATCAAAGCTGAGATATGTATTTTTTAACTGGTGCTTCTATAACACAGAACTTTACAAAAGGTTCAGTATAAAATCTAGGAAAAAAATTCTAGTTGGTT,10,30,14,27,27,43,27,45,27,33,33,43,35,45,2.71,0.666030994
hek293t,8250,1,2,GGATGAAGCTGAGATATGTATTTTTTAACTGGCTTCTATAACACAGAACTTTACAAAAGGTTCAGTATAAAATCTAGGGCTAAAAAAATTCTAGTTGGT,GGATGAAGCTGAGATATGTATTTTTTAACTGGTGCTTCTATAACACAGAACTTTACAAAAGGTTCAGTATAAAATCTAGGGCTAAAAAAATTCTAGTTG,10,30,14,27,27,40,27,42,27,33,33,40,35,42,2.71,2.215940476
hek293t,8252,1,2,CCCACATACTCTTTAGTCAGAGAAGATTCTGGTGGAGAAAAAGGAGGTATGTGCTGCTTTCCAGCCTCAGAACACAGTCTGAAAAAAATTCTAGTTGGT,CCCACATACTCTTTAGTCAGAGAAGATTCCATGGTGGAGAAAAAGGAGGTATGTGCTGCTTTCCAGCCTCAGAACACAGTCTGAAAAAAATTCTAGTTG,10,30,14,27,27,40,27,42,27,30,30,40,32,42,38.07,80.5540325
hek293t,8252,1,2,AGCTGATACTCTTTAGTCAGAGAAGATTCTGGTGGAGAAAAAGGAGGTATGTGCTGCTTTCCAGCCTCAGAACACAGTCTGCCCAAAAAAATTCTAGTT,AGCTGATACTCTTTAGTCAGAGAAGATTCCATGGTGGAGAAAAAGGAGGTATGTGCTGCTTTCCAGCCTCAGAACACAGTCTGCCCAAAAAAATTCTAG,10,30,14,27,27,37,27,39,27,30,30,37,32,39,38.07,75.7141878
hek293t,8254,1,9,ACTCAGTACTGCAGCTCTTTGCCACTTTATGGCTGCGCATCTTTAGACCTCATACATAGTGAGATGAATATTAAAAAAATTCTAGTTGGTTTAACGCGT,ACTCAGTACTGCAGCTCTTTGCCACTTTATGGCTACTCCTGGAGCGCATCTTTAGACCTCATACATAGTGAGATGAATATTAAAAAAATTCTAGTTGGT,10,30,14,27,27,42,27,51,27,35,35,42,44,51,4.21,0.399547457
hek293t,8255,1,15,TTACCTGCAGCAGAGCAGAGATCTGGTAAAGGGCTTGTCTGTCATCCTTGTCACTGCTACACTTAAAAAAATTCTAGTTGGTTTAACGCGTAACTAGAT,TTACCTGCAGCAGAGCAGAGATCTGGTAACTCATAGTTACCCCAAGGGCTTGTCTGTCATCCTTGTCACTGCTACACTTAAAAAAATTCTAGTTGGTTT,10,30,14,27,27,44,27,59,27,29,29,44,44,59,35.9,57.39421064
hek293t,8255,1,15,ATATATGCAGCAGAGCAGAGATCTGGTAAAGGGCTTGTCTGTCATCCTTGTCACTGCTACACTTAAGGAAAAAAAATTCTAGTTGGTTTAACGCGTAAC,ATATATGCAGCAGAGCAGAGATCTGGTAACTCATAGTTACCCCAAGGGCTTGTCTGTCATCCTTGTCACTGCTACACTTAAGGAAAAAAAATTCTAGTT,10,30,14,27,27,39,27,54,27,29,29,39,44,54,35.9,25.77888077
hek293t,8257,1,11,ATACGGATTACGCTGGCTCCCTGGAAACGTGGTCTGTGGCTCCATGGTATGTCCTTCCTATCCAAGAGCTGAAAAAAATTCTAGTTGGTTTAACGCGTA,ATACGGATTACGCTGGCTCCCTGGAAACGTGGTCTGTACCCCGTTTTTGGCTCCATGGTATGTCCTTCCTATCCAAGAGCTGAAAAAAATTCTAGTTGG,10,30,14,27,27,41,27,52,27,38,38,41,49,52,70.1,0.798279722
hek293t,8257,1,11,GTGTTGATTACGCTGGCTCCCTGGAAACGTGGTCTGTGGCTCCATGGTATGTCCTTCCTATCCAAGAAAAAAAATTCTAGTTGGTTTAACGCGTAACTA,GTGTTGATTACGCTGGCTCCCTGGAAACGTGGTCTGTACCCCGTTTTTGGCTCCATGGTATGTCCTTCCTATCCAAGAAAAAAAATTCTAGTTGGTTTA,10,30,14,27,27,45,27,56,27,38,38,45,49,56,70.1,1.385900603
hek293t,8259,1,13,GTCGAAGCAGACCCAGGCCTGCACCAGTGCGGCCGGGGGCCTCAAAGAGGTCGTGAAAAACAAGTTAAAAAAAATTCTAGTTGGTTTAACGCGTAACTA,GTCGAAGCAGACCCAGGCCTGCACCAGTTTTTACACGGGATGCGGCCGGGGGCCTCAAAGAGGTCGTGAAAAACAAGTTAAAAAAAATTCTAGTTGGTT,10,30,14,27,27,43,27,56,27,28,28,43,41,56,71.8,43.22035475
hek293t,8259,1,13,TCTTCAGCAGACCCAGGCCTGCACCAGTGCGGCCGGGGGCCTCAAAGAGGTCGTGAAAAACAAGTTAATGCCAAAAAAAAAATTCTAGTTGGTTTAACG,TCTTCAGCAGACCCAGGCCTGCACCAGTTTTTACACGGGATGCGGCCGGGGGCCTCAAAGAGGTCGTGAAAAACAAGTTAATGCCAAAAAAAAAATTCT,10,30,14,27,27,35,27,48,27,28,28,35,41,48,71.8,11.22503047
hek293t,8261,1,14,ACGCCTTTATGGAAACGAAAGAGTGCCTGTGGAGCATACCTGAAAATTCATGTTACTAAACCTTAAAAAAATTCTAGTTGGTTTAACGCGTAACTAGAT,ACGCCTTTATGGAAACGAAAGAGTGCCTGTGGAGCGTTATGCACTCCACATACCTGAAAATTCATGTTACTAAACCTTAAAAAAATTCTAGTTGGTTTA,10,30,14,27,27,45,27,59,27,35,35,45,49,59,46.5,0.327333332
hek293t,8266,1,7,CGAATTCGCTATTATGTTAGGTGGTGTTCTGGTGTTTGGTTGTGGGTCTGTCACAAGCCTGAGCCTGTGTAAAAAAAATTCTAGTTGGTTTAACGCGTA,CGAATTCGCTATTATGTTAGGTGGTGTTCGCTTATCTGGTGTTTGGTTGTGGGTCTGTCACAAGCCTGAGCCTGTGTAAAAAAAATTCTAGTTGGTTTA,10,30,14,27,27,45,27,52,27,30,30,45,37,52,27.03,22.70116101
hek293t,8266,1,7,TCATGTCGCTATTATGTTAGGTGGTGTTCTGGTGTTTGGTTGTGGGTCTGTCACAAGCCTGAGCCTGTGTACGCTGAAAAAAATTCTAGTTGGTTTAAC,TCATGTCGCTATTATGTTAGGTGGTGTTCGCTTATCTGGTGTTTGGTTGTGGGTCTGTCACAAGCCTGAGCCTGTGTACGCTGAAAAAAATTCTAGTTG,10,30,14,27,27,40,27,47,27,30,30,40,37,47,27.03,38.41352507
hek293t,8268,1,9,CTGATATCAAAATTGTCCATTGCACCTTTAGGATTGGCTCTTTCAAAAGGCACAGTGTCTGGCCTAACTGAAAAAAATTCTAGTTGGTTTAACGCGTAA,CTGATATCAAAATTGTCCATTGCACCTTTAGGATTGGCTCCACGACTTTTTTCAAAAGGCACAGTGTCTGGCCTAACTGAAAAAAATTCTAGTTGGTTT,10,30,14,27,27,44,27,53,27,41,41,44,50,53,8.08,1.529961267
hek293t,8270,1,6,CAACTGACGGAGTAGAGCGGAAGGGGTAACGGGGCTCCATAACTGTCTAGCTCTGTTCTGTGTAGGGTAAAAAAATTCTAGTTGGTTTAACGCGTAACT,CAACTGACGGAGTAGAGCGGAAGGGGTAACGGGGCTCCTATGACATAACTGTCTAGCTCTGTTCTGTGTAGGGTAAAAAAATTCTAGTTGGTTTAACGC,10,30,14,27,27,49,27,55,27,39,39,49,45,55,43.61,13.33033028
hek293t,8270,1,6,TGGTCGACGGAGTAGAGCGGAAGGGGTAACGGGGCTCCATAACTGTCTAGCTCTGTTCTGTGTAGGGTAAAAAAAAAATTCTAGTTGGTTTAACGCGTA,TGGTCGACGGAGTAGAGCGGAAGGGGTAACGGGGCTCCTATGACATAACTGTCTAGCTCTGTTCTGTGTAGGGTAAAAAAAAAATTCTAGTTGGTTTAA,10,30,14,27,27,46,27,52,27,39,39,46,45,52,43.61,1.746822176
hek293t,8272,1,12,AGCGTTTGCCTTTGCAAGTTTCTGAAGATTGGGGCTGCTAGGGGCACAGCTGAAAGAAACCGAAACCTAAAAAAATTCTAGTTGGTTTAACGCGTAACT,AGCGTTTGCCTTTGCAAGTTTCTGAAGATTGGGGCTGCTCGGAAGTGTTGAAGGGGCACAGCTGAAAGAAACCGAAACCTAAAAAAATTCTAGTTGGTT,10,30,14,27,27,43,27,55,27,40,40,43,52,55,5.56,0.0
hek293t,8273,1,15,CGACTAATCTTGTTTGAACCATAGATTTGAGGCATTGCTAATCATCTATGTCTGGAATAATTGATCAAAAAAAATTCTAGTTGGTTTAACGCGTAACTA,CGACTAATCTTGTTTGAACCATAGATTTGAGAAAACGGCTCTTTAGGCATTGCTAATCATCTATGTCTGGAATAATTGATCAAAAAAAATTCTAGTTGG,10,30,14,27,27,41,27,56,27,31,31,41,46,56,36.24,2.358439911
hek293t,8275,1,9,ACTATAATGCAAGAACTTCTTGAAATCAAAGGGATAAATCATTCTCCATTTCTCTGAAGTTGCTAGAGGGCCACACAAAAAAATTCTAGTTGGTTTAAC,ACTATAATGCAAGAACTTCTTGAAATCAAATATAAGGAGGGGATAAATCATTCTCCATTTCTCTGAAGTTGCTAGAGGGCCACACAAAAAAATTCTAGT,10,30,14,27,27,38,27,47,27,31,31,38,40,47,10.57,0.350233016
hek293t,8275,1,9,GCAGGAATGCAAGAACTTCTTGAAATCAAAGGGATAAATCATTCTCCATTTCTCTGAAGTTGCTAGAGAAAAAAATTCTAGTTGGTTTAACGCGTAACT,GCAGGAATGCAAGAACTTCTTGAAATCAAATATAAGGAGGGGATAAATCATTCTCCATTTCTCTGAAGTTGCTAGAGAAAAAAATTCTAGTTGGTTTAA,10,30,14,27,27,46,27,55,27,31,31,46,40,55,10.57,4.438172954
hek293t,8277,1,10,CTCAGGGAGCAAATCAGGACTGGGAGAAATGGGAAGGAGTTGAGAGAGAAGGAGAGACAAAGATCCTGTAAAAAAAATTCTAGTTGGTTTAACGCGTAA,CTCAGGGAGCAAATCAGGACTGGGAGAAATGGGAACCACTGGCTGGGAGTTGAGAGAGAAGGAGAGACAAAGATCCTGTAAAAAAAATTCTAGTTGGTT,10,30,14,27,27,43,27,53,27,36,36,43,46,53,19.59,3.005511195
hek293t,8279,1,2,TAGTCAATTTCTCTTCCAGTAGAAAATGGAGGGTCAAATCCAGATTTATTTATCTTTGGACTGTAGGAAGCATAAAAAAATTCTAGTTGGTTTAACGCG,TAGTCAATTTCTCTTCCAGTAGAAAATGGAGGGTCAAATCTTCAGATTTATTTATCTTTGGACTGTAGGAAGCATAAAAAAATTCTAGTTGGTTTAACG,10,30,14,27,27,48,27,50,27,41,41,48,43,50,61.56,2.805814779
hek293t,8281,1,4,CAGCAACCCAAATTTAGTAGAGACAGCCTTGGCAGGAGCAGTAGCACTGAGTACTCTCCTCCTTCTCTTCCATCTCTGCAGAAAAAAAATTCTAGTTGG,CAGCAACCCAAATTTAGTAGAGACAGCTAACCTTGGCAGGAGCAGTAGCACTGAGTACTCTCCTCCTTCTCTTCCATCTCTGCAGAAAAAAAATTCTAG,10,30,14,27,27,37,27,41,27,27,27,37,31,41,47.89,51.97767117
hek293t,8281,1,4,ATCCAACCCAAATTTAGTAGAGACAGCCTTGGCAGGAGCAGTAGCACTGAGTACTCTCCTCCTTCTCTTCCATCTCTGCAGAGCAAAAAAAATTCTAGT,ATCCAACCCAAATTTAGTAGAGACAGCTAACCTTGGCAGGAGCAGTAGCACTGAGTACTCTCCTCCTTCTCTTCCATCTCTGCAGAGCAAAAAAAATTC,10,30,14,27,27,34,27,38,27,27,27,34,31,38,47.89,47.85963576
hek293t,8283,1,14,CACTGCTGGAAGCGGTTTCTTTTCAGTTCAGGCTGTGCAGGAATTCCTGGTGGCACATTAGCCAAATAAAAAAATTCTAGTTGGTTTAACGCGTAACTA,CACTGCTGGAAGCGGTTTCTTTTCAGTTCAGCTGCCGGTGTCTCAGCTGTGCAGGAATTCCTGGTGGCACATTAGCCAAATAAAAAAATTCTAGTTGGT,10,30,14,27,27,42,27,56,27,32,32,42,46,56,12.61,2.172814574
hek293t,8284,1,12,TGCGGTACAAGTATGTTAACTGATCCCTTTGGAAGTTGAAATGCCCTTTTTAACAAAAAGTAAAACAGCTTTTGCAAAAAAAATTCTAGTTGGTTTAAC,TGCGGTACAAGTATGTTAACTGATCCCTTTGGCCTTTTGTTTCGAAGTTGAAATGCCCTTTTTAACAAAAAGTAAAACAGCTTTTGCAAAAAAAATTCT,10,30,14,27,27,35,27,47,27,32,32,35,44,47,55.58,0.057770075
hek293t,8287,1,1,GACGATAATTTTATTTTTCATATCATCTACGGCTTTGTTTTTCAGCCATAATTGATGGGCCTCTCCAGATTTGTGGACCACTTCTAAAAGATAAAAAAA,GACGATAATTTTATTTTTCATATCATCCTACGGCTTTGTTTTTCAGCCATAATTGATGGGCCTCTCCAGATTTGTGGACCACTTCTAAAAGATAAAAAA,10,30,14,27,27,30,27,31,27,27,27,30,28,31,0.38,0.0
hek293t,8287,1,1,GCCCTTAATTTTATTTTTCATATCATCTACGGCTTTGTTTTTCAGCCATAATTGATGGGCCTCTCCAGATTTGTGGACCAAAAAAAATTCTAGTTGGTT,GCCCTTAATTTTATTTTTCATATCATCCTACGGCTTTGTTTTTCAGCCATAATTGATGGGCCTCTCCAGATTTGTGGACCAAAAAAAATTCTAGTTGGT,10,30,14,27,27,42,27,43,27,27,27,42,28,43,0.38,2.370311663
hek293t,8290,1,7,CTGGAGACAGACAGACCGACCGACCTCACTGGTTTTCGTGCCGCCCTATTCGAGTTTCCATCGCACACCTCCGAAAAAAAAAATTCTAGTTGGTTTAAC,CTGGAGACAGACAGACCGACCGACCTCACTGGTTTTAATACCCCGTGCCGCCCTATTCGAGTTTCCATCGCACACCTCCGAAAAAAAAAATTCTAGTTG,10,30,14,27,27,40,27,47,27,37,37,40,44,47,46.69,0.0
hek293t,8292,1,9,TCCTTGGATGTTAACAGGGTAGATAAATCAGGTTTCTTCCATCCTCACTCATCATTCTGGGATGTACATTACTTATTCTTACATAAAAAAATTCTAGTT,TCCTTGGATGTTAACAGGGTAGATAATTTGTTCGAATCAGGTTTCTTCCATCCTCACTCATCATTCTGGGATGTACATTACTTATTCTTACATAAAAAA,10,30,14,27,27,30,27,39,27,27,27,30,36,39,21.14,1.331905973
hek293t,8292,1,9,GCCCAGGATGTTAACAGGGTAGATAAATCAGGTTTCTTCCATCCTCACTCATCATTCTGGGATGTACATTACTTATTCTTAAAAAAATTCTAGTTGGTT,GCCCAGGATGTTAACAGGGTAGATAATTTGTTCGAATCAGGTTTCTTCCATCCTCACTCATCATTCTGGGATGTACATTACTTATTCTTAAAAAAATTC,10,30,14,27,27,34,27,43,27,27,27,34,36,43,21.14,6.410176723
hek293t,3181,1,6,GCAACTTTGAGACTTGGAGGGGGAAATAATGGAGGGGCTTTGGGTGAGGGGGCTGCTTGTTGTTCGCAAGCTGACTGTGGAAAAAAATTCTAGTTGGTT,GCAACTTTGAGACTTGGAGGGGGAAAAGGCTTTAATGGAGGGGCTTTGGGTGAGGGGGCTGCTTGTTGTTCGCAAGCTGACTGTGGAAAAAAATTCTAG,10,30,14,27,27,37,27,43,27,27,27,37,33,43,26.43,11.40100438
hek293t,3181,1,6,AGAAGTTTGAGACTTGGAGGGGGAAATAATGGAGGGGCTTTGGGTGAGGGGGCTGCTTGTTGTTCGCAAGCTGACTGTGGTGTGTACAAAAAAATTCTA,AGAAGTTTGAGACTTGGAGGGGGAAAAGGCTTTAATGGAGGGGCTTTGGGTGAGGGGGCTGCTTGTTGTTCGCAAGCTGACTGTGGTGTGTACAAAAAA,10,30,14,27,27,30,27,36,27,27,27,30,33,36,26.43,0.0
hek293t,8296,1,10,GAAATTCTTTCAAATTATATCAGGAAGCTAGGATCAGTAATGTGGAAAATAGGTTTAAAATGAAAAAAGATGGAAAAAAATTCTAGTTGGTTTAACGCG,GAAATTCTTTCAAATTATATCAGGAAGCTCCGGTATGTAAGGATCAGTAATGTGGAAAATAGGTTTAAAATGAAAAAAGATGGAAAAAAATTCTAGTTG,10,30,14,27,27,40,27,50,27,30,30,40,40,50,24.11,0.624806736
hek293t,8298,1,1,GGAGGTAACAGTATACATCCATCCAAGCATGGACTGTGTCTAAAGGCTTGGAGACATACTCATGCTCTGAGTTGGAGCTCAAGTAAAAAAATTCTAGTT,GGAGGTAACAGTATACATCCATCCAAGCATTGGACTGTGTCTAAAGGCTTGGAGACATACTCATGCTCTGAGTTGGAGCTCAAGTAAAAAAATTCTAGT,10,30,14,27,27,38,27,39,27,31,31,38,32,39,57.87,75.11232379
hek293t,8298,1,1,GTATGTAACAGTATACATCCATCCAAGCATGGACTGTGTCTAAAGGCTTGGAGACATACTCATGCTCTGAGTTGGAAAAAAAATTCTAGTTGGTTTAAC,GTATGTAACAGTATACATCCATCCAAGCATTGGACTGTGTCTAAAGGCTTGGAGACATACTCATGCTCTGAGTTGGAAAAAAAATTCTAGTTGGTTTAA,10,30,14,27,27,46,27,47,27,31,31,46,32,47,57.87,52.26370223
hek293t,8300,1,2,TCCATTAGCATAGTCAGTAGACTATACTATGGACTTCAGTTATGTCAGAAAACAGCTTTTCTTCCTTCTCTCTAAGAACAAAAAAAAAATTCTAGTTGG,TCCATTAGCATAGTCAGTAGACTATACTACATGGACTTCAGTTATGTCAGAAAACAGCTTTTCTTCCTTCTCTCTAAGAACAAAAAAAAAATTCTAGTT,10,30,14,27,27,39,27,41,27,29,29,39,31,41,76.77,50.10402409
hek293t,8300,1,2,ATCTGTAGCATAGTCAGTAGACTATACTATGGACTTCAGTTATGTCAGAAAACAGCTTTTCTTCCTTCTCTCTAAGAACAAATTTAAAAAAATTCTAGT,ATCTGTAGCATAGTCAGTAGACTATACTACATGGACTTCAGTTATGTCAGAAAACAGCTTTTCTTCCTTCTCTCTAAGAACAAATTTAAAAAAATTCTA,10,30,14,27,27,36,27,38,27,29,29,36,31,38,76.77,48.28940905
hek293t,8302,1,10,AGACGTCTGGAAACTGCTCTTGTCAAGTATGGCTAACTCAAAGCACTACGTATCCCATCCCCCCCCCCCCCAAATCTGCATCAAAAAAAATTCTAGTTG,AGACGTCTGGAAACTGCTCTTGTCAAAGGGGGTTGCGTATGGCTAACTCAAAGCACTACGTATCCCATCCCCCCCCCCCCCAAATCTGCATCAAAAAAA,10,30,14,27,27,30,27,40,27,27,27,30,37,40,30.11,0.0
hek293t,8304,1,1,CAATGATTTATAATACGTACAGCATCCTTTGGCATTCAGCTAACCTTACTCATCTACACAAGGGAGAGAAAAAAATTCTAGTTGGTTTAACGCGTAACT,CAATGATTTATAATACGTACAGCATCCTTTGGCATTCAGGCTAACCTTACTCATCTACACAAGGGAGAGAAAAAAATTCTAGTTGGTTTAACGCGTAAC,10,30,14,27,27,54,27,55,27,39,39,54,40,55,50.81,69.14441952
hek293t,8308,1,10,TCTGTTTCAGGTGAATTTTTGTGCTGTTGGGGTGTTTGAACGTTTCCTAGACTACAAGGAATATAAAAAGTATCAAAAAAAATTCTAGTTGGTTTAACG,TCTGTTTCAGGTGAATTTTTGTGCTGTATAGCGTAGGTGGGGTGTTTGAACGTTTCCTAGACTACAAGGAATATAAAAAGTATCAAAAAAAATTCTAGT,10,30,14,27,27,38,27,48,27,28,28,38,38,48,20.65,4.811796068
hek293t,8308,1,10,CGATCTTCAGGTGAATTTTTGTGCTGTTGGGGTGTTTGAACGTTTCCTAGACTACAAGGAATATAAAAAGTATCAGGACAAAAAAAAAATTCTAGTTGG,CGATCTTCAGGTGAATTTTTGTGCTGTATAGCGTAGGTGGGGTGTTTGAACGTTTCCTAGACTACAAGGAATATAAAAAGTATCAGGACAAAAAAAAAA,10,30,14,27,27,31,27,41,27,28,28,31,38,41,20.65,0.031193608
hek293t,8310,1,2,GCGATATGATGTGGATAGATATAAGTAAGTGGATGATGCAACAGATGATTCTGGGGTGTCACTGCGGAAAAAAATTCTAGTTGGTTTAACGCGTAACTA,GCGATATGATGTGGATAGATATAAGTAAGTGGATGATGAACAACAGATGATTCTGGGGTGTCACTGCGGAAAAAAATTCTAGTTGGTTTAACGCGTAAC,10,30,14,27,27,54,27,56,27,39,39,54,41,56,61.6,4.603133922
hek293t,8310,1,2,CGCAGATGATGTGGATAGATATAAGTAAGTGGATGATGCAACAGATGATTCTGGGGTGTCACTGCGGCTGGAAGTAAAAAAATTCTAGTTGGTTTAACG,CGCAGATGATGTGGATAGATATAAGTAAGTGGATGATGAACAACAGATGATTCTGGGGTGTCACTGCGGCTGGAAGTAAAAAAATTCTAGTTGGTTTAA,10,30,14,27,27,46,27,48,27,39,39,46,41,48,61.6,14.19973726
hek293t,8312,1,4,CAGTGAGTTAGGTTTACGTTGCTCCTGGGAGGCGATTCTGTTATGCTCACCGTTAATACAGCTACGTCCAGACAAATAAAAAAATTCTAGTTGGTTTAA,CAGTGAGTTAGGTTTACGTTGCTCCTGGGAGGCGGATGATTCTGTTATGCTCACCGTTAATACAGCTACGTCCAGACAAATAAAAAAATTCTAGTTGGT,10,30,14,27,27,42,27,46,27,35,35,42,39,46,65.07,43.75159985
hek293t,8313,1,13,CGGCGCACTTCTATATTCCAGTGGAATTGTGGTCAGCTTTCCATCTATGTCACTATTTTGGGGAGAGAAAAAAAAAAATTCTAGTTGGTTTAACGCGTA,CGGCGCACTTCTATATTCCAGTGGAATTGTGGTCATAGTTGGCCTCAAGCTTTCCATCTATGTCACTATTTTGGGGAGAGAAAAAAAAAAATTCTAGTT,10,30,14,27,27,39,27,52,27,36,36,39,49,52,60.66,0.065616798
hek293t,8313,1,13,AGTGTCACTTCTATATTCCAGTGGAATTGTGGTCAGCTTTCCATCTATGTCACTATTTTGGGGAAAAAAAATTCTAGTTGGTTTAACGCGTAACTAGAT,AGTGTCACTTCTATATTCCAGTGGAATTGTGGTCATAGTTGGCCTCAAGCTTTCCATCTATGTCACTATTTTGGGGAAAAAAAATTCTAGTTGGTTTAA,10,30,14,27,27,46,27,59,27,36,36,46,49,59,60.66,28.66624344
hek293t,8315,1,10,TCGGGCTTTCTTCGAATTGTATCAATTAGAGGCTTAACCTTAAGGGGTGTTGAAAAGCATTGGCCCAAAAAAAAATTCTAGTTGGTTTAACGCGTAACT,TCGGGCTTTCTTCGAATTGTATCAATTAGAGGCTTAACTACTACTAACCTTAAGGGGTGTTGAAAAGCATTGGCCCAAAAAAAAATTCTAGTTGGTTTA,10,30,14,27,27,45,27,55,27,38,38,45,48,55,3.01,0.0
hek293t,8315,1,10,TGTGGCTTTCTTCGAATTGTATCAATTAGAGGCTTAACCTTAAGGGGTGTTGAAAAGCATTGGCCCAACACTAAAAAAATTCTAGTTGGTTTAACGCGT,TGTGGCTTTCTTCGAATTGTATCAATTAGAGGCTTAACTACTACTAACCTTAAGGGGTGTTGAAAAGCATTGGCCCAACACTAAAAAAATTCTAGTTGG,10,30,14,27,27,41,27,51,27,38,38,41,48,51,3.01,0.0
hek293t,8317,1,1,GTGTGGTTAGTCACGGGCTTGATCCCATGAGGTCTGCCGATGTTACTGAGAGCTGAGGGCATTCAGCAGCAAAAAAATTCTAGTTGGTTTAACGCGTAA,GTGTGGTTAGTCACGGGCTTGATCCCATGAGGTCTGTCCGATGTTACTGAGAGCTGAGGGCATTCAGCAGCAAAAAAATTCTAGTTGGTTTAACGCGTA,10,30,14,27,27,52,27,53,27,37,37,52,38,53,52.6,74.16963
hek293t,8317,1,1,TCGATGTTAGTCACGGGCTTGATCCCATGAGGTCTGCCGATGTTACTGAGAGCTGAGGGCATTCAGCAGCTCACAGAAGTGAAAAAAAATTCTAGTTGG,TCGATGTTAGTCACGGGCTTGATCCCATGAGGTCTGTCCGATGTTACTGAGAGCTGAGGGCATTCAGCAGCTCACAGAAGTGAAAAAAAATTCTAGTTG,10,30,14,27,27,40,27,41,27,37,37,40,38,41,52.6,5.516173557
hek293t,17690,1,10,GCGTTTTTAATTCAGTTGTGGTGCTAACATGGGTCTCTTATCTATCTGGAGGATAAATGGCACCTTTGTGATGTAAAAAAATTCTAGTTGGTTTAACGC,GCGTTTTTAATTCAGTTGTGGTGCTAACATGGGTCATTAAATCGCTCTTATCTATCTGGAGGATAAATGGCACCTTTGTGATGTAAAAAAATTCTAGTT,10,30,14,27,27,39,27,49,27,36,36,39,46,49,20.5,2.643112694
hek293t,8320,1,4,TAAGCGAGAGAGCCCTCAAAATTGAATTGTGGATCACAGGCAAGGTAGCTAGGCAGACAGGAGATACCAGAATATGTGAAAAAAATTCTAGTTGGTTTA,TAAGCGAGAGAGCCCTCAAAATTGAATTGTGACGGGATCACAGGCAAGGTAGCTAGGCAGACAGGAGATACCAGAATATGTGAAAAAAATTCTAGTTGG,10,30,14,27,27,41,27,45,27,31,31,41,35,45,55.56,17.2478877
hek293t,8320,1,4,CGAGCGAGAGAGCCCTCAAAATTGAATTGTGGATCACAGGCAAGGTAGCTAGGCAGACAGGAGATACCAGAATAAAAAAATTCTAGTTGGTTTAACGCG,CGAGCGAGAGAGCCCTCAAAATTGAATTGTGACGGGATCACAGGCAAGGTAGCTAGGCAGACAGGAGATACCAGAATAAAAAAATTCTAGTTGGTTTAA,10,30,14,27,27,46,27,50,27,31,31,46,35,50,55.56,6.969295022
hek293t,8322,1,14,TCCAATGAAAATTTCTTTCATAGGAAGGAAGGAAAAACTTCAGTTTCTCTTTTGTTCAGAGAAATAGGATTTAAAAAAATTCTAGTTGGTTTAACGCGT,TCCAATGAAAATTTCTTTCATAGGAATGCTTCCAGCACTTGGAAGGAAAAACTTCAGTTTCTCTTTTGTTCAGAGAAATAGGATTTAAAAAAATTCTAG,10,30,14,27,27,37,27,51,27,27,27,37,41,51,36.04,3.48284881
hek293t,8322,1,14,CACAGTGAAAATTTCTTTCATAGGAAGGAAGGAAAAACTTCAGTTTCTCTTTTGTTCAGAGAAATAGGATTTACTAAAAAAAAAAATTCTAGTTGGTTT,CACAGTGAAAATTTCTTTCATAGGAATGCTTCCAGCACTTGGAAGGAAAAACTTCAGTTTCTCTTTTGTTCAGAGAAATAGGATTTACTAAAAAAAAAA,10,30,14,27,27,30,27,44,27,27,27,30,41,44,36.04,0.0
hek293t,22707,1,11,CATCTCTGTACAATTAATAAAATTTCATTTGGTAGGAAACCCAAGAGACAAGGTAGCATGGACAGGGCAAAAAAATTCTAGTTGGTTTAACGCGTAACT,CATCTCTGTACAATTAATAAAATTTCATTTGGTAGGTGAACGGACCGAAACCCAAGAGACAAGGTAGCATGGACAGGGCAAAAAAATTCTAGTTGGTTT,10,30,14,27,27,44,27,55,27,37,37,44,48,55,2.47,0.0
hek293t,8325,1,3,TCCGCCCAGTAACATCTGAAAACCAGTGTAGGTGGCCGTGTAGCAAGGCCCTCTTGCAGATGGGAGGGACTGTTAAAAAAATTCTAGTTGGTTTAACGC,TCCGCCCAGTAACATCTGAAAACCAGTGTAGGTGGCCGCCGTGTAGCAAGGCCCTCTTGCAGATGGGAGGGACTGTTAAAAAAATTCTAGTTGGTTTAA,10,30,14,27,27,46,27,49,27,39,39,46,42,49,46.64,76.07278605
hek293t,8325,1,3,GCCATCCAGTAACATCTGAAAACCAGTGTAGGTGGCCGTGTAGCAAGGCCCTCTTGCAGATGGGAGGGACTAAAAAAATTCTAGTTGGTTTAACGCGTA,GCCATCCAGTAACATCTGAAAACCAGTGTAGGTGGCCGCCGTGTAGCAAGGCCCTCTTGCAGATGGGAGGGACTAAAAAAATTCTAGTTGGTTTAACGC,10,30,14,27,27,49,27,52,27,39,39,49,42,52,46.64,76.93079113
hek293t,8327,1,5,GCCCCACTTTGTCATTTAAAGGTTAATGTTGGAAAAAATGTGGTATTTTAATTACCTCAAACTAGAAAAAAATTCTAGTTGGTTTAACGCGTAACTAGA,GCCCCACTTTGTCATTTAAAGGTTAATGTTGGAAAAAGCGTTATGTGGTATTTTAATTACCTCAAACTAGAAAAAAATTCTAGTTGGTTTAACGCGTAA,10,30,14,27,27,53,27,58,27,38,38,53,43,58,27.69,0.495811662
hek293t,8327,1,5,CTAACACTTTGTCATTTAAAGGTTAATGTTGGAAAAAATGTGGTATTTTAATTACCTCAAACTAGATATTAAAATACAAAAAAATTCTAGTTGGTTTAA,CTAACACTTTGTCATTTAAAGGTTAATGTTGGAAAAAGCGTTATGTGGTATTTTAATTACCTCAAACTAGATATTAAAATACAAAAAAATTCTAGTTGG,10,30,14,27,27,41,27,46,27,38,38,41,43,46,27.69,0.0
hek293t,8329,1,5,GTTTCGAGTAGGAGGAAAGCAACAAAACAAGGGAGAACCAGCAGCATTTACAGGCAAGAAATGGACATATTCTCCTTTTAAAAAAATTCTAGTTGGTTT,GTTTCGAGTAGGAGGAAAGCAACAAAACAAGGGAGAGTTTAACCAGCAGCATTTACAGGCAAGAAATGGACATATTCTCCTTTTAAAAAAATTCTAGTT,10,30,14,27,27,39,27,44,27,36,36,39,41,44,59.2,0.0
hek293t,8330,1,11,GTAATTCTCTTCCCCTCACAAAAATTACCTGGAGACAGAGCATAGCCTATTCAACTATGCAGTGACTAAAAAAATTCTAGTTGGTTTAACGCGTAACTA,GTAATTCTCTTCCCCTCACAAAAATTACCAACTAACCGCGTGGAGACAGAGCATAGCCTATTCAACTATGCAGTGACTAAAAAAATTCTAGTTGGTTTA,10,30,14,27,27,45,27,56,27,30,30,45,41,56,17.66,0.509069921
hek293t,8332,1,10,GTATGTTCTGATGTTTTAACATAGAATATTGGAGGGGATGAAAGAAATTTCTTTGCCCCCCCCACAGAGCAAAAAAAATTCTAGTTGGTTTAACGCGTA,GTATGTTCTGATGTTTTAACATAGAATATTGGAGCGGTTGACCAGGGATGAAAGAAATTTCTTTGCCCCCCCCACAGAGCAAAAAAAATTCTAGTTGGT,10,30,14,27,27,42,27,52,27,35,35,42,45,52,23.8,0.804398601
hek293t,7753,1,4,TCGCGCTTTCTTTTGTCCCTGATAGAACATGGTCACTCTCACTGCCTTTACCGGTGTCAGTATATGGGCATAATAGTGAATCAAAAAAATTCTAGTTGG,TCGCGCTTTCTTTTGTCCCTGATAGAGGTTACATGGTCACTCTCACTGCCTTTACCGGTGTCAGTATATGGGCATAATAGTGAATCAAAAAAATTCTAG,10,30,14,27,27,37,27,41,27,27,27,37,31,41,45.47,38.56020169
hek293t,2584,1,8,ATCAAAAGCGATGTGCCCTGAGCCCTGGCTGGCGAGGACCGTACTCACCGTGAGTGGCCCATCTGTTAAGCAAAAAAATTCTAGTTGGTTTAACGCGTA,ATCAAAAGCGATGTGCCCTGAGCCCTGGCTGGCAGCAGCACGAGGACCGTACTCACCGTGAGTGGCCCATCTGTTAAGCAAAAAAATTCTAGTTGGTTT,10,30,14,27,27,44,27,52,27,34,34,44,42,52,59.91,18.54920169
hek293t,8338,1,2,TAAAGGCACATCAGAGAAATGCGCTGCTCCGGGAAGCAGGTCCTGACTTGAACCCAAGTCTACACACTGTAAAACTAAAAAAAAATTCTAGTTGGTTTA,TAAAGGCACATCAGAGAAATGCGCTGCTCCGGGAAGCAGAAGTCCTGACTTGAACCCAAGTCTACACACTGTAAAACTAAAAAAAAATTCTAGTTGGTT,10,30,14,27,27,43,27,45,27,40,40,43,42,45,39.4,0.541655256
hek293t,8338,1,2,AGTAGGCACATCAGAGAAATGCGCTGCTCCGGGAAGCAGGTCCTGACTTGAACCCAAGTCTACACACTGTAAAAAAAATTCTAGTTGGTTTAACGCGTA,AGTAGGCACATCAGAGAAATGCGCTGCTCCGGGAAGCAGAAGTCCTGACTTGAACCCAAGTCTACACACTGTAAAAAAAATTCTAGTTGGTTTAACGCG,10,30,14,27,27,50,27,52,27,40,40,50,42,52,39.4,74.93896722
hek293t,8340,1,5,ACGCCGCACGGGATCAGAAGCAGTGATGATGGGAACTTGACCTTCCGGAAAGTACCAATCAGGGCTAGAGCTTACATAAAAAAAAATTCTAGTTGGTTT,ACGCCGCACGGGATCAGAAGCAGTGATGATGTCTTAGGAACTTGACCTTCCGGAAAGTACCAATCAGGGCTAGAGCTTACATAAAAAAAAATTCTAGTT,10,30,14,27,27,39,27,44,27,32,32,39,37,44,52.64,62.05557058
hek293t,8340,1,5,GCGATGCACGGGATCAGAAGCAGTGATGATGGGAACTTGACCTTCCGGAAAGTACCAATCAGGGCTAGAGCAAAAAAATTCTAGTTGGTTTAACGCGTA,GCGATGCACGGGATCAGAAGCAGTGATGATGTCTTAGGAACTTGACCTTCCGGAAAGTACCAATCAGGGCTAGAGCAAAAAAATTCTAGTTGGTTTAAC,10,30,14,27,27,47,27,52,27,32,32,47,37,52,52.64,74.9249943
hek293t,8342,1,11,CGCCAAGAGCGGTGCTCCAGCGAAGGGGCAGGTGAGCCTCGTCCCCAGCCGCGCTCCTGCAGCGCAAAAAAAATTCTAGTTGGTTTAACGCGTAACTAG,CGCCAAGAGCGGTGCTCCAGCGAAGGGGCAGGTGAATAAACAGTAGGCCTCGTCCCCAGCCGCGCTCCTGCAGCGCAAAAAAAATTCTAGTTGGTTTAA,10,30,14,27,27,46,27,57,27,36,36,46,47,57,43.06,2.315878348
hek293t,8344,1,5,GATTGGTTCTCACCTTGACAGTATGTCTTAGGAGGTAGTGGTGTAATTACTGACGAATAAGGACTACCTATGAACAAAAAAATTCTAGTTGGTTTAACG,GATTGGTTCTCACCTTGACAGTATGTCTTAGGAAGCGAGGTAGTGGTGTAATTACTGACGAATAAGGACTACCTATGAACAAAAAAATTCTAGTTGGTT,10,30,14,27,27,43,27,48,27,33,33,43,38,48,39.63,65.21518448
hek293t,8344,1,5,TGTGGGTTCTCACCTTGACAGTATGTCTTAGGAGGTAGTGGTGTAATTACTGACGAATAAGGACTACCTATGAACTACATATAAAAAAATTCTAGTTGG,TGTGGGTTCTCACCTTGACAGTATGTCTTAGGAAGCGAGGTAGTGGTGTAATTACTGACGAATAAGGACTACCTATGAACTACATATAAAAAAATTCTA,10,30,14,27,27,36,27,41,27,33,33,36,38,41,39.63,0.0
hek293t,8349,1,11,AGATCGACTATACAGTACAAAGTTGGAAAAGGGGCAGTAGCTTTCCTTAAAGCTCCCTGAAAGATAAATAAAAAAAATTCTAGTTGGTTTAACGCGTAA,AGATCGACTATACAGTACAAAGTTGGAAAAGTTGCCAAATTTGGGCAGTAGCTTTCCTTAAAGCTCCCTGAAAGATAAATAAAAAAAATTCTAGTTGGT,10,30,14,27,27,42,27,53,27,32,32,42,43,53,35.69,3.459426887
hek293t,8349,1,11,CCGTAGACTATACAGTACAAAGTTGGAAAAGGGGCAGTAGCTTTCCTTAAAGCTCCCTGAAAGATAAAAAAATTCTAGTTGGTTTAACGCGTAACTAGA,CCGTAGACTATACAGTACAAAGTTGGAAAAGTTGCCAAATTTGGGCAGTAGCTTTCCTTAAAGCTCCCTGAAAGATAAAAAAATTCTAGTTGGTTTAAC,10,30,14,27,27,47,27,58,27,32,32,47,43,58,35.69,13.37491111
hek293t,22790,1,5,GTAGAACAAGCACTGCCACAATTTTGCAGAGGCTCCAGAGATGCTTAAGGGTAAAGCATGGATTATTTAAAAAAATTCTAGTTGGTTTAACGCGTAACT,GTAGAACAAGCACTGCCACAATTTTGCAGAGGCTCCAGAAGATAGATGCTTAAGGGTAAAGCATGGATTATTTAAAAAAATTCTAGTTGGTTTAACGCG,10,30,14,27,27,50,27,55,27,40,40,50,45,55,38.3,4.670440477
hek293t,8352,1,4,CATAGAAACAAATGAAACTAAAAATACCAAGGATATACTTAAAGCCAGGAGAAGAGAGTACATTCACAGTAATAAAAAAATTCTAGTTGGTTTAACGCG,CATAGAAACAAATGAAACTAAAAATACCAAGGATATACTCCATTAAAGCCAGGAGAAGAGAGTACATTCACAGTAATAAAAAAATTCTAGTTGGTTTAA,10,30,14,27,27,46,27,50,27,39,39,46,43,50,33.73,0.0
hek293t,8352,1,4,TAATTAAACAAATGAAACTAAAAATACCAAGGATATACTTAAAGCCAGGAGAAGAGAGTACATTCACAGTAAAAAAATTCTAGTTGGTTTAACGCGTAA,TAATTAAACAAATGAAACTAAAAATACCAAGGATATACTCCATTAAAGCCAGGAGAAGAGAGTACATTCACAGTAAAAAAATTCTAGTTGGTTTAACGC,10,30,14,27,27,49,27,53,27,39,39,49,43,53,33.73,0.0
hek293t,8354,1,14,ATGCAAGCTTGGTCATAGCCTCATATTACAGGTAAAGTAGGTCAATAGATGTAACAAGCACACTGTGTAAAAAAATTCTAGTTGGTTTAACGCGTAACT,ATGCAAGCTTGGTCATAGCCTCATATTACAGGTAAAGTAGCTAGGTGACAATAGGTCAATAGATGTAACAAGCACACTGTGTAAAAAAATTCTAGTTGG,10,30,14,27,27,41,27,55,27,38,38,41,52,55,17.81,0.0
hek293t,8355,1,1,GGTATTACCTGCAGATTTTTGCTGTTAAATGGCAATGCTAAATTAATGGTGATGGTCCATGGCCACCCTAGACTTGCTATCAAAAAAATTCTAGTTGGT,GGTATTACCTGCAGATTTTTGCTGTTAAATGGCAATGGCTAAATTAATGGTGATGGTCCATGGCCACCCTAGACTTGCTATCAAAAAAATTCTAGTTGG,10,30,14,27,27,41,27,42,27,38,38,41,39,42,1.04,0.089285714
hek293t,8355,1,1,TCGACTACCTGCAGATTTTTGCTGTTAAATGGCAATGCTAAATTAATGGTGATGGTCCATGGCCACCCTAAAAAAATTCTAGTTGGTTTAACGCGTAAC,TCGACTACCTGCAGATTTTTGCTGTTAAATGGCAATGGCTAAATTAATGGTGATGGTCCATGGCCACCCTAAAAAAATTCTAGTTGGTTTAACGCGTAA,10,30,14,27,27,53,27,54,27,38,38,53,39,54,1.04,4.71144833
hek293t,8357,1,15,GATAACAGTGGGAGACAAAGAAAATGGGAAGGGGAAAAGTCAGAAAATATTTCCAGGCCTTTTTCTAAAAAAAAATTCTAGTTGGTTTAACGCGTAACT,GATAACAGTGGGAGACAAAGAAAATGGGAGCGAACTCCTGGTGAAGGGGAAAAGTCAGAAAATATTTCCAGGCCTTTTTCTAAAAAAAAATTCTAGTTG,10,30,14,27,27,40,27,55,27,30,30,40,45,55,51.2,0.0
hek293t,8358,1,5,AGCGAAACAGAGTGTGCGTTTCTCTTGCCAGGAAGAATAAGTGTGTATTTCCAAGATCCCAAAGATTATAGAGAAATAGAAAAAAAATTCTAGTTGGTT,AGCGAAACAGAGTGTGCGTTTCTCTTGCCAGCCCAGGAAGAATAAGTGTGTATTTCCAAGATCCCAAAGATTATAGAGAAATAGAAAAAAAATTCTAGT,10,30,14,27,27,38,27,43,27,31,31,38,36,43,35.45,27.41031508
hek293t,8358,1,5,TCCACAACAGAGTGTGCGTTTCTCTTGCCAGGAAGAATAAGTGTGTATTTCCAAGATCCCAAAGATTATAGAGAAATAGACCGGAAAAAAATTCTAGTT,TCCACAACAGAGTGTGCGTTTCTCTTGCCAGCCCAGGAAGAATAAGTGTGTATTTCCAAGATCCCAAAGATTATAGAGAAATAGACCGGAAAAAAATTC,10,30,14,27,27,34,27,39,27,31,31,34,36,39,35.45,0.0
hek293t,8360,1,7,GATGTAAAAGGTCTCAGTCTCCTCATATGTGGGGAGAGAGAGGGAACAGATACTAATTTCAGCCTTCACTATGCCTACAAAAAAATTCTAGTTGGTTTA,GATGTAAAAGGTCTCAGTCTCCTCATATGTCGGCTACGGGGAGAGAGAGGGAACAGATACTAATTTCAGCCTTCACTATGCCTACAAAAAAATTCTAGT,10,30,14,27,27,38,27,45,27,31,31,38,38,45,49.64,37.63558751
hek293t,8360,1,7,GTGGAAAAAGGTCTCAGTCTCCTCATATGTGGGGAGAGAGAGGGAACAGATACTAATTTCAGCCTTCACTAAAAAAATTCTAGTTGGTTTAACGCGTAA,GTGGAAAAAGGTCTCAGTCTCCTCATATGTCGGCTACGGGGAGAGAGAGGGAACAGATACTAATTTCAGCCTTCACTAAAAAAATTCTAGTTGGTTTAA,10,30,14,27,27,46,27,53,27,31,31,46,38,53,49.64,39.99501866
hek293t,8362,1,4,GCTGCAAGTAGCTATGTTTCACAAATTTTAGGATACCAGGAATGAAATATTTGATTACAATTGACTATATTTTAAAAAAATTCTAGTTGGTTTAACGCG,GCTGCAAGTAGCTATGTTTCACAAATTTTACGGGGGATACCAGGAATGAAATATTTGATTACAATTGACTATATTTTAAAAAAATTCTAGTTGGTTTAA,10,30,14,27,27,46,27,50,27,31,31,46,35,50,1.08,4.920431295
hek293t,8362,1,4,GAAGAAAGTAGCTATGTTTCACAAATTTTAGGATACCAGGAATGAAATATTTGATTACAATTGACTATATTTTTAAGCAAAAAAATTCTAGTTGGTTTA,GAAGAAAGTAGCTATGTTTCACAAATTTTACGGGGGATACCAGGAATGAAATATTTGATTACAATTGACTATATTTTTAAGCAAAAAAATTCTAGTTGG,10,30,14,27,27,41,27,45,27,31,31,41,35,45,1.08,3.449390878
hek293t,8364,1,3,TGCTAATGTTCCCAGTGCCAGGAAGGAAGGGGACAGCATTGAGAAAAGGGCAGGACTCCTAATGAAAAAAATTCTAGTTGGTTTAACGCGTAACTAGAT,TGCTAATGTTCCCAGTGCCAGGAAGGAAGGGGACAGCATTCGAGAGAAAAGGGCAGGACTCCTAATGAAAAAAATTCTAGTTGGTTTAACGCGTAACTA,10,30,14,27,27,56,27,59,27,41,41,56,44,59,68.75,52.3813807
hek293t,8364,1,3,GGTAAATGTTCCCAGTGCCAGGAAGGAAGGGGACAGCATTGAGAAAAGGGCAGGACTCCTAATGGACTTGCATAAAAAAAAAATTCTAGTTGGTTTAAC,GGTAAATGTTCCCAGTGCCAGGAAGGAAGGGGACAGCATTCGAGAGAAAAGGGCAGGACTCCTAATGGACTTGCATAAAAAAAAAATTCTAGTTGGTTT,10,30,14,27,27,44,27,47,27,41,41,44,44,47,68.75,0.506578897
hek293t,8367,1,7,TAATTGACATAGCACAATATGGAGAGAGGTGGGGGAGCTTTGTTTATTGTTCTGCCTGTTGTACTTTATGTGCCTAAAAAAATTCTAGTTGGTTTAACG,TAATTGACATAGCACAATATGGAGAGAGGTAATGGAAGGGGGAGCTTTGTTTATTGTTCTGCCTGTTGTACTTTATGTGCCTAAAAAAATTCTAGTTGG,10,30,14,27,27,41,27,48,27,31,31,41,38,48,44.88,36.66357063
hek293t,8367,1,7,ACGGCGACATAGCACAATATGGAGAGAGGTGGGGGAGCTTTGTTTATTGTTCTGCCTGTTGTACTTTATGTGCCTGAGAAAAAAATTCTAGTTGGTTTA,ACGGCGACATAGCACAATATGGAGAGAGGTAATGGAAGGGGGAGCTTTGTTTATTGTTCTGCCTGTTGTACTTTATGTGCCTGAGAAAAAAATTCTAGT,10,30,14,27,27,38,27,45,27,31,31,38,38,45,44.88,20.02479665
hek293t,8369,1,10,CTCAGATCCCTCACGCTAATTAATTTCAATGGGAGTGGGTAAAATGGTAAGAACCGTATCTGTAAGATAGCCCAAAAAAATTCTAGTTGGTTTAACGCG,CTCAGATCCCTCACGCTAATTAATTTCAATGGAAGCGGGACAGAGTGGGTAAAATGGTAAGAACCGTATCTGTAAGATAGCCCAAAAAAATTCTAGTTG,10,30,14,27,27,40,27,50,27,33,33,40,43,50,5.87,0.168776371
hek293t,8369,1,10,TCCGGATCCCTCACGCTAATTAATTTCAATGGGAGTGGGTAAAATGGTAAGAACCGTATCTGTAAAAAAAAATTCTAGTTGGTTTAACGCGTAACTAGA,TCCGGATCCCTCACGCTAATTAATTTCAATGGAAGCGGGACAGAGTGGGTAAAATGGTAAGAACCGTATCTGTAAAAAAAAATTCTAGTTGGTTTAACG,10,30,14,27,27,48,27,58,27,33,33,48,43,58,5.87,0.03345041
hek293t,8371,1,11,CGTGGATCAAATATTTTATGAAAAAGCTAAGGAAAATGTCCCTACAAATACTTTGATATCTCTTAAAAAAAATTCTAGTTGGTTTAACGCGTAACTAGA,CGTGGATCAAATATTTTATGAAAAAGCTAAGGGTCATCTGCAGAAAATGTCCCTACAAATACTTTGATATCTCTTAAAAAAAATTCTAGTTGGTTTAAC,10,30,14,27,27,47,27,58,27,32,32,47,43,58,24.06,0.0
hek293t,8374,1,8,TGTCATTTCTCAGCCACCTAACAATATTTAGGGGTTTGCTGCATTGCTGTCTAGCATAGTGACCTTGTAAAAAAATTCTAGTTGGTTTAACGCGTAACT,TGTCATTTCTCAGCCACCTAACAATATTTAGGGGTTGGTTCTAATGCTGCATTGCTGTCTAGCATAGTGACCTTGTAAAAAAATTCTAGTTGGTTTAAC,10,30,14,27,27,47,27,55,27,37,37,47,45,55,15.86,1.269255309
hek293t,8375,1,3,GATCAAATCCTTTGGAGCTGTTACGATGTTGGGGGCGATAGGGTGATGGAGAAACGAAGATTCAGTTCTTAATTCTAAGTGAAAAAAATTCTAGTTGGT,GATCAAATCCTTTGGAGCTGTTACGATGTTGGGGGTCTCGATAGGGTGATGGAGAAACGAAGATTCAGTTCTTAATTCTAAGTGAAAAAAATTCTAGTT,10,30,14,27,27,39,27,42,27,36,36,39,39,42,42.11,0.132958286
hek293t,8377,1,8,ATTTGATGCAATAGTTAATAAAAATGCAAAGGAAGTATATGAATGTAGACCTCTCAAAGTGATAAAAAAAATTCTAGTTGGTTTAACGCGTAACTAGAT,ATTTGATGCAATAGTTAATAAAAATGCAAAGGAAGTTAATATGTATATGAATGTAGACCTCTCAAAGTGATAAAAAAAATTCTAGTTGGTTTAACGCGT,10,30,14,27,27,51,27,59,27,36,36,51,44,59,25.27,0.0
hek293t,8379,1,14,CCCAGTAGCACCTCAGATTTCTTAATATTTGGAGTTTCATTTAAAGGTCAATTTTATTTTGACAAGGCAAAAAAATTCTAGTTGGTTTAACGCGTAACT,CCCAGTAGCACCTCAGATTTCTTAATATTTGGAAATGCGCCGACTCAGTTTCATTTAAAGGTCAATTTTATTTTGACAAGGCAAAAAAATTCTAGTTGG,10,30,14,27,27,41,27,55,27,34,34,41,48,55,6.11,0.172000633
hek293t,8380,1,15,TGTACTCTGCCATTAATTTCCCCAGCAGAAGGGATATTTTAAGCAGTTACAGGTTTTCGCTACAACGGAAAAAAATTCTAGTTGGTTTAACGCGTAACT,TGTACTCTGCCATTAATTTCCCCAGCAGAAGGGATACAATGAGGCGTAGTCTTTTAAGCAGTTACAGGTTTTCGCTACAACGGAAAAAAATTCTAGTTG,10,30,14,27,27,40,27,55,27,37,37,40,52,55,18.14,0.0
hek293t,8381,1,10,CCAATCACAGTACCCATGTTTACTAATAAAGGATATTTGTAGTAAAAAATAAGGATATTTTTCACCTAAAAAAATTCTAGTTGGTTTAACGCGTAACTA,CCAATCACAGTACCCATGTTTACTAATAAAGGATACATGAAAGAGTTTGTAGTAAAAAATAAGGATATTTTTCACCTAAAAAAATTCTAGTTGGTTTAA,10,30,14,27,27,46,27,56,27,36,36,46,46,56,21.25,0.128585398
hek293t,8384,1,11,GTCCATAGCAGACTAGTGTATACGGGCAGAGGGTAAAACCTGAGAAGCCTTTCACCCATATAGAGTTCTCTTGAAAATCAGAAAAAAATTCTAGTTGGT,GTCCATAGCAGACTAGTGTATACGGGCTTCCGATGTCAAGAGGGTAAAACCTGAGAAGCCTTTCACCCATATAGAGTTCTCTTGAAAATCAGAAAAAAA,10,30,14,27,27,31,27,42,27,28,28,31,39,42,38.63,1.3850767
hek293t,8384,1,11,TTGCATAGCAGACTAGTGTATACGGGCAGAGGGTAAAACCTGAGAAGCCTTTCACCCATATAGAGTTCTCTTGAAAAAAAATTCTAGTTGGTTTAACGC,TTGCATAGCAGACTAGTGTATACGGGCTTCCGATGTCAAGAGGGTAAAACCTGAGAAGCCTTTCACCCATATAGAGTTCTCTTGAAAAAAAATTCTAGT,10,30,14,27,27,38,27,49,27,28,28,38,39,49,38.63,20.0607532
hek293t,8386,1,6,CCACACTTTGTGATGGAAAGCAATACCAAAGGAGTTCTTTTTGCATGGGCAAGTTAACTGTAATCTGCTACAAAAAAATTCTAGTTGGTTTAACGCGTA,CCACACTTTGTGATGGAAAGCAATACCAAAGGAGTTCTCTCCAGTTTTGCATGGGCAAGTTAACTGTAATCTGCTACAAAAAAATTCTAGTTGGTTTAA,10,30,14,27,27,46,27,52,27,39,39,46,45,52,65.67,2.813874167
hek293t,8386,1,6,TAATCCTTTGTGATGGAAAGCAATACCAAAGGAGTTCTTTTTGCATGGGCAAGTTAACTGTAATCTGCTACATAGAAAAAAATTCTAGTTGGTTTAACG,TAATCCTTTGTGATGGAAAGCAATACCAAAGGAGTTCTCTCCAGTTTTGCATGGGCAAGTTAACTGTAATCTGCTACATAGAAAAAAATTCTAGTTGGT,10,30,14,27,27,42,27,48,27,39,39,42,45,48,65.67,1.389923791
hek293t,8388,1,7,CAGATCCTGCTGAACTCGGGCTGGCTCTGCGGAGAGGCTGACTCTGTGTCTCCCTACTGTGCTCAAAAAAATTCTAGTTGGTTTAACGCGTAACTAGAT,CAGATCCTGCTGAACTCGGGCTGGCTCTGCGGAGAGGACAGAAGCTGACTCTGTGTCTCCCTACTGTGCTCAAAAAAATTCTAGTTGGTTTAACGCGTA,10,30,14,27,27,52,27,59,27,37,37,52,44,59,50.23,39.78688681
hek293t,8388,1,7,ATAAGCCTGCTGAACTCGGGCTGGCTCTGCGGAGAGGCTGACTCTGTGTCTCCCTACTGTGCTCCCCCTCAAAAAAAAATTCTAGTTGGTTTAACGCGT,ATAAGCCTGCTGAACTCGGGCTGGCTCTGCGGAGAGGACAGAAGCTGACTCTGTGTCTCCCTACTGTGCTCCCCCTCAAAAAAAAATTCTAGTTGGTTT,10,30,14,27,27,44,27,51,27,37,37,44,44,51,50.23,23.38351034
hek293t,8390,1,2,CTCCGTGTTAAGTATCTCGAGGAGCTAGCTGGCGTCCCTTGACACTTTGTAGTTAGTGGAGAATGGCAGTCATCTTCACAGGCATAAAAAAATTCTAGT,CTCCGTGTTAAGTATCTCGAGGAGCTAGTCCTGGCGTCCCTTGACACTTTGTAGTTAGTGGAGAATGGCAGTCATCTTCACAGGCATAAAAAAATTCTA,10,30,14,27,27,36,27,38,27,29,29,36,31,38,29.85,87.57983487
hek293t,8390,1,2,TACCCTGTTAAGTATCTCGAGGAGCTAGCTGGCGTCCCTTGACACTTTGTAGTTAGTGGAGAATGGCAGTCATCTTCACAGGAAAAAAATTCTAGTTGG,TACCCTGTTAAGTATCTCGAGGAGCTAGTCCTGGCGTCCCTTGACACTTTGTAGTTAGTGGAGAATGGCAGTCATCTTCACAGGAAAAAAATTCTAGTT,10,30,14,27,27,39,27,41,27,29,29,39,31,41,29.85,86.54435619
hek293t,20574,1,8,AGCAGCCTATAAATTGTTGTGAGTATGTGAGGGCTGGGTCAAATGTAAACCTGGCAAGAAAAAGCTGAGGGACTGAAGTTAAAAAAAATTCTAGTTGGT,AGCAGCCTATAAATTGTTGTGAGTATCTGAATAGGTGAGGGCTGGGTCAAATGTAAACCTGGCAAGAAAAAGCTGAGGGACTGAAGTTAAAAAAAATTC,10,30,14,27,27,34,27,42,27,27,27,34,35,42,31.38,2.812238751
hek293t,20574,1,8,TATCCCCTATAAATTGTTGTGAGTATGTGAGGGCTGGGTCAAATGTAAACCTGGCAAGAAAAAGCTGAGGGACTGAAGTTACGATAAAAAAATTCTAGT,TATCCCCTATAAATTGTTGTGAGTATCTGAATAGGTGAGGGCTGGGTCAAATGTAAACCTGGCAAGAAAAAGCTGAGGGACTGAAGTTACGATAAAAAA,10,30,14,27,27,30,27,38,27,27,27,30,35,38,31.38,0.06844627
hek293t,8394,1,11,CTCAGTAATTTGGCAGATCAAGGAGCCACTGGCATCTATATTTGTGCTATACTGCTGTCTTGGACAAGCTAAAAAAATTCTAGTTGGTTTAACGCGTAA,CTCAGTAATTTGGCAGATCAAGGAGCTCGATGGGGTCCACTGGCATCTATATTTGTGCTATACTGCTGTCTTGGACAAGCTAAAAAAATTCTAGTTGGT,10,30,14,27,27,42,27,53,27,27,27,42,38,53,57.35,48.1614028
hek293t,8394,1,11,GGCTGTAATTTGGCAGATCAAGGAGCCACTGGCATCTATATTTGTGCTATACTGCTGTCTTGGACAAGCTCAGATAAAAAAATTCTAGTTGGTTTAACG,GGCTGTAATTTGGCAGATCAAGGAGCTCGATGGGGTCCACTGGCATCTATATTTGTGCTATACTGCTGTCTTGGACAAGCTCAGATAAAAAAATTCTAG,10,30,14,27,27,37,27,48,27,27,27,37,38,48,57.35,34.56719311
hek293t,8396,1,10,CGAACATGGTCAGCTGTGGCTGTTCTCTAAGGTACTGTCATGATTCGCTAATTCAAAGTGCAGCACAGTTGTGGATCCTTCCCAAAAAAATTCTAGTTG,CGAACATGGTCAGCTGTGGCTGTTCTTTGCAAGTCGCTAAGGTACTGTCATGATTCGCTAATTCAAAGTGCAGCACAGTTGTGGATCCTTCCCAAAAAA,10,30,14,27,27,30,27,40,27,27,27,30,37,40,50.55,1.04732953
hek293t,8396,1,10,CCTTCATGGTCAGCTGTGGCTGTTCTCTAAGGTACTGTCATGATTCGCTAATTCAAAGTGCAGCACAGTTGTGGATCCTAAAAAAATTCTAGTTGGTTT,CCTTCATGGTCAGCTGTGGCTGTTCTTTGCAAGTCGCTAAGGTACTGTCATGATTCGCTAATTCAAAGTGCAGCACAGTTGTGGATCCTAAAAAAATTC,10,30,14,27,27,34,27,44,27,27,27,34,37,44,50.55,7.826444418
hek293t,8398,1,14,CCACTTGGGAAGGGCAATCTGTTTCCCAGAGGAACCCCCCACCCCAAGACCTCTCCCACCATCAAAAAAAATTCTAGTTGGTTTAACGCGTAACTAGAT,CCACTTGGGAAGGGCAATCTGTTTCCCAGAGGAACCCGTACTAAAACCGGTCCCACCCCAAGACCTCTCCCACCATCAAAAAAAATTCTAGTTGGTTTA,10,30,14,27,27,45,27,59,27,38,38,45,52,59,55.75,0.0
hek293t,8399,1,15,AAGGTGATACTGCCCAGTTAAAGGCAGAATGGTTTCACTGTATCTGAGGGTGAAGACCCCCCCCAAAAAAATTCTAGTTGGTTTAACGCGTAACTAGAT,AAGGTGATACTGCCCAGTTAAAGGCAGAATGGTTTCCCAAGTGCGAGAAACACTGTATCTGAGGGTGAAGACCCCCCCCAAAAAAATTCTAGTTGGTTT,10,30,14,27,27,44,27,59,27,37,37,44,52,59,26.78,1.94855852
hek293t,8400,1,13,GACCTCCTAAAAAAGATATGTTTTTATAGTGGTTAATTCCAGTGAATTATGTCACTTTAAAACACCTAAAAAAATTCTAGTTGGTTTAACGCGTAACTA,GACCTCCTAAAAAAGATATGTTTTTATAGTGGGCGGACACTCCAATTAATTCCAGTGAATTATGTCACTTTAAAACACCTAAAAAAATTCTAGTTGGTT,10,30,14,27,27,43,27,56,27,33,33,43,46,56,6.15,0.082272487
hek293t,8401,1,14,GCTGATTTGACAAGTCATTTGACACAGTTTGGTGTTTTTCCTCATGTGATTAAGTGTGTTTATGTGAAAAAAAATTCTAGTTGGTTTAACGCGTAACTA,GCTGATTTGACAAGTCATTTGACACAACGTGGGTCCCTGTGTTTGGTGTTTTTCCTCATGTGATTAAGTGTGTTTATGTGAAAAAAAATTCTAGTTGGT,10,30,14,27,27,42,27,56,27,27,27,42,41,56,13.13,24.52221069
hek293t,8401,1,14,ATGTATTTGACAAGTCATTTGACACAGTTTGGTGTTTTTCCTCATGTGATTAAGTGTGTTTATGTGACTATTTTGAAAAAAATTCTAGTTGGTTTAACG,ATGTATTTGACAAGTCATTTGACACAACGTGGGTCCCTGTGTTTGGTGTTTTTCCTCATGTGATTAAGTGTGTTTATGTGACTATTTTGAAAAAAATTC,10,30,14,27,27,34,27,48,27,27,27,34,41,48,13.13,1.318068913
hek293t,8403,1,9,GAGTCTGACTCATACATTCACAAAGCAAGAGGGGAGCAAACTTCAGAATTCAAACCGTGTATTCTCTGGTCTTTTACAATTAAAAAAATTCTAGTTGGT,GAGTCTGACTCATACATTCACAAAGCAAGAATAATCTCAGGGGAGCAAACTTCAGAATTCAAACCGTGTATTCTCTGGTCTTTTACAATTAAAAAAATT,10,30,14,27,27,33,27,42,27,30,30,33,39,42,36.69,0.0
hek293t,8403,1,9,TAGATTGACTCATACATTCACAAAGCAAGAGGGGAGCAAACTTCAGAATTCAAACCGTGTATTCTCTGGTCTTTTACAAAAAAATTCTAGTTGGTTTAA,TAGATTGACTCATACATTCACAAAGCAAGAATAATCTCAGGGGAGCAAACTTCAGAATTCAAACCGTGTATTCTCTGGTCTTTTACAAAAAAATTCTAG,10,30,14,27,27,37,27,46,27,30,30,37,39,46,36.69,0.407959895
hek293t,8405,1,3,AGCGACCCCTCAGTCATGCACATAAAGACTGGGGTTATTTTTACTCCCTCCTTTATACCCTCTGTGTGTATTTGGCTTTTTATAAAAAAAATTCTAGTT,AGCGACCCCTCAGTCATGCACATAAAGACTGGATAGGTTATTTTTACTCCCTCCTTTATACCCTCTGTGTGTATTTGGCTTTTTATAAAAAAAATTCTA,10,30,14,27,27,36,27,39,27,33,33,36,36,39,46.16,0.0
hek293t,8407,1,13,CACGATGTTGCCCCATGTCTTTAATAACATGGTCAGTTTTTTAGCCTAGCCAACATATCATTGACTTTAACAGAAAAAAATTCTAGTTGGTTTAACGCG,CACGATGTTGCCCCATGTCTTTAATAACATGGTATCACAAACGTTACAGTTTTTTAGCCTAGCCAACATATCATTGACTTTAACAGAAAAAAATTCTAG,10,30,14,27,27,37,27,50,27,34,34,37,47,50,33.39,0.0
hek293t,8407,1,13,CCGGGTGTTGCCCCATGTCTTTAATAACATGGTCAGTTTTTTAGCCTAGCCAACATATCATTGACTAAAAAAATTCTAGTTGGTTTAACGCGTAACTAG,CCGGGTGTTGCCCCATGTCTTTAATAACATGGTATCACAAACGTTACAGTTTTTTAGCCTAGCCAACATATCATTGACTAAAAAAATTCTAGTTGGTTT,10,30,14,27,27,44,27,57,27,34,34,44,47,57,33.39,8.910661232
hek293t,8409,1,12,GAGACCTAAGGAGTCATTTAGCACAATTCAGGCCTACAGTATTTATCATTATTAGGTCTTAGAACTTCTGAAAAAAATTCTAGTTGGTTTAACGCGTAA,GAGACCTAAGGAGTCATTTAGCACAATTCACATCGTCCCACCGGCCTACAGTATTTATCATTATTAGGTCTTAGAACTTCTGAAAAAAATTCTAGTTGG,10,30,14,27,27,41,27,53,27,31,31,41,43,53,18.41,14.65079258
hek293t,695,1,4,TTGTTCCAAACTGAAGGTACTTAAAACTTAGGAAAACAGGGATTGTCTTTCCAGGACCACAGAATGAGTCTCTCAAAAAAAATTCTAGTTGGTTTAACG,TTGTTCCAAACTGAAGGTACTTAAAACTACGTTAGGAAAACAGGGATTGTCTTTCCAGGACCACAGAATGAGTCTCTCAAAAAAAATTCTAGTTGGTTT,10,30,14,27,27,44,27,48,27,29,29,44,33,48,59.65,0.036114121
hek293t,695,1,4,CGATCCCAAACTGAAGGTACTTAAAACTTAGGAAAACAGGGATTGTCTTTCCAGGACCACAGAATGAGTCTCTCACAGACTCCTTGGAAAAAAATTCTA,CGATCCCAAACTGAAGGTACTTAAAACTACGTTAGGAAAACAGGGATTGTCTTTCCAGGACCACAGAATGAGTCTCTCACAGACTCCTTGGAAAAAAAT,10,30,14,27,27,32,27,36,27,29,29,32,33,36,59.65,0.064350064
hek293t,8415,1,4,GGTCATGTTTTTCCAGGGTAACCCTGGCTCGGATGGCTCGCCTGGACGTGATGGATCCCCAGGAGGCAAAGTAAGGAACGAAAAAAATTCTAGTTGGTT,GGTCATGTTTTTCCAGGGTAACCCTGGCTCGGATGCCCCGCTCGCCTGGACGTGATGGATCCCCAGGAGGCAAAGTAAGGAACGAAAAAAATTCTAGTT,10,30,14,27,27,39,27,43,27,36,36,39,40,43,27.32,0.067069081
hek293t,8415,1,4,CATGGTGTTTTTCCAGGGTAACCCTGGCTCGGATGGCTCGCCTGGACGTGATGGATCCCCAGGAGGCAAAGTAAAAAAAATTCTAGTTGGTTTAACGCG,CATGGTGTTTTTCCAGGGTAACCCTGGCTCGGATGCCCCGCTCGCCTGGACGTGATGGATCCCCAGGAGGCAAAGTAAAAAAAATTCTAGTTGGTTTAA,10,30,14,27,27,46,27,50,27,36,36,46,40,50,27.32,19.20713089
hek293t,8417,1,1,ACTGCTGTAGAAGCAGCGGTTAGCTGAACCGGTGGCGGAGCCCGGCTGAACGAAGAGCTGCTGAAAGGAAAAAAAATTCTAGTTGGTTTAACGCGTAAC,ACTGCTGTAGAAGCAGCGGTTAGCTGAACCGGTGGCGTGAGCCCGGCTGAACGAAGAGCTGCTGAAAGGAAAAAAAATTCTAGTTGGTTTAACGCGTAA,10,30,14,27,27,53,27,54,27,38,38,53,39,54,46.58,73.7063031
hek293t,8417,1,1,TTCTCTGTAGAAGCAGCGGTTAGCTGAACCGGTGGCGGAGCCCGGCTGAACGAAGAGCTGCTGAAAGGAAGCAGAAGGGGAAAAAAAATTCTAGTTGGT,TTCTCTGTAGAAGCAGCGGTTAGCTGAACCGGTGGCGTGAGCCCGGCTGAACGAAGAGCTGCTGAAAGGAAGCAGAAGGGGAAAAAAAATTCTAGTTGG,10,30,14,27,27,41,27,42,27,38,38,41,39,42,46.58,2.934704185
hek293t,8419,1,3,ATAATCCTACATCAGGAAAAAGGCCTGTAAGGAACAAAACAAAACAAGTGAAGGGAGAATCTGTTATTCTAATCATAAAAAAATTCTAGTTGGTTTAAC,ATAATCCTACATCAGGAAAAAGGCCTGTAAGAAGGAACAAAACAAAACAAGTGAAGGGAGAATCTGTTATTCTAATCATAAAAAAATTCTAGTTGGTTT,10,30,14,27,27,44,27,47,27,29,29,44,32,47,46.7,0.611522679
hek293t,8419,1,3,CGGACCCTACATCAGGAAAAAGGCCTGTAAGGAACAAAACAAAACAAGTGAAGGGAGAATCTGTTATTCTAATCATAAATGAAAAAAATTCTAGTTGGT,CGGACCCTACATCAGGAAAAAGGCCTGTAAGAAGGAACAAAACAAAACAAGTGAAGGGAGAATCTGTTATTCTAATCATAAATGAAAAAAATTCTAGTT,10,30,14,27,27,39,27,42,27,29,29,39,32,42,46.7,5.645628065
hek293t,8421,1,9,CTAAGAGACTGTCAACAGTGACCACAATAAGGATGATTAACAAAAGAATGAAAGGGAACAGCAGCAACACCAAAAAAATTCTAGTTGGTTTAACGCGTA,CTAAGAGACTGTCAACAGTGACCACAATGCTATCACTAAGGATGATTAACAAAAGAATGAAAGGGAACAGCAGCAACACCAAAAAAATTCTAGTTGGTT,10,30,14,27,27,43,27,52,27,28,28,43,37,52,26.22,29.60465513
hek293t,8421,1,9,GGCTCAGACTGTCAACAGTGACCACAATAAGGATGATTAACAAAAGAATGAAAGGGAACAGCAGCAACACCAGACGGAAAAAAAAATTCTAGTTGGTTT,GGCTCAGACTGTCAACAGTGACCACAATGCTATCACTAAGGATGATTAACAAAAGAATGAAAGGGAACAGCAGCAACACCAGACGGAAAAAAAAATTCT,10,30,14,27,27,35,27,44,27,28,28,35,37,44,26.22,14.72534228
hek293t,8423,1,3,ATTGCCAGCCTTGAGGCTGAGGTAAGCAGTGGGGTGGCCCCTGCTGTGAAAAGGTTTGGGAAGTCCGAGCATGGGCTACTGCCAAGTGCTAAAAAAATT,ATTGCCAGCCTTGAGGCTGAGGTAAGCCACAGTGGGGTGGCCCCTGCTGTGAAAAGGTTTGGGAAGTCCGAGCATGGGCTACTGCCAAGTGCTAAAAAA,10,30,14,27,27,30,27,33,27,27,27,30,30,33,63.34,1.33744856
hek293t,8423,1,3,CCTGTCAGCCTTGAGGCTGAGGTAAGCAGTGGGGTGGCCCCTGCTGTGAAAAGGTTTGGGAAGTCCGAGCATGGGCTACTGCCAAGAAAAAAATTCTAG,CCTGTCAGCCTTGAGGCTGAGGTAAGCCACAGTGGGGTGGCCCCTGCTGTGAAAAGGTTTGGGAAGTCCGAGCATGGGCTACTGCCAAGAAAAAAATTC,10,30,14,27,27,34,27,37,27,27,27,34,30,37,63.34,79.25437163
hek293t,8425,1,7,GCATAAATACAGGCTTGTTTCGGAGCTAAAGGACAGAAGTTTTACTGTGGAAATTGCATGCAAATGCTTGGCCTTAAAAAAATTCTAGTTGGTTTAACG,GCATAAATACAGGCTTGTTTCGGAGCTAAATACCGGCGGACAGAAGTTTTACTGTGGAAATTGCATGCAAATGCTTGGCCTTAAAAAAATTCTAGTTGG,10,30,14,27,27,41,27,48,27,31,31,41,38,48,22.51,41.82280764
hek293t,8425,1,7,CGCTTAATACAGGCTTGTTTCGGAGCTAAAGGACAGAAGTTTTACTGTGGAAATTGCATGCAAATGCTTGGCCTTTGATCACAAAAAAATTCTAGTTGG,CGCTTAATACAGGCTTGTTTCGGAGCTAAATACCGGCGGACAGAAGTTTTACTGTGGAAATTGCATGCAAATGCTTGGCCTTTGATCACAAAAAAATTC,10,30,14,27,27,34,27,41,27,31,31,34,38,41,22.51,0.0
hek293t,8427,1,15,AAATATGAAGGTAAGAGGGAGGTGACAAGGGGGCAGATGTGTATTTTAGCAGCTGTTGGGATGGTGGTGTAAAAAAATTCTAGTTGGTTTAACGCGTAA,AAATATGAAGGTAAGAGGGAGGTGACAAGGGGGCTTCTATTATAATGATAGATGTGTATTTTAGCAGCTGTTGGGATGGTGGTGTAAAAAAATTCTAGT,10,30,14,27,27,38,27,53,27,35,35,38,50,53,59.62,0.237247924
hek293t,8432,1,5,CACCAAATTAAAATTCCTTCCAGCTGTTTTGGAGCTTGCTACTCATAATTAAGAGTATTGTCTTAGCCTTTTGACTAAAAAAAAAAATTCTAGTTGGTT,CACCAAATTAAAATTCCTTCCAGCTGTTTTCGTACGGAGCTTGCTACTCATAATTAAGAGTATTGTCTTAGCCTTTTGACTAAAAAAAAAAATTCTAGT,10,30,14,27,27,38,27,43,27,31,31,38,36,43,0.89,61.98250793
hek293t,8432,1,5,GCAGCAATTAAAATTCCTTCCAGCTGTTTTGGAGCTTGCTACTCATAATTAAGAGTATTGTCTTAGCCTTTTGACTAAAAAAAATTCTAGTTGGTTTAA,GCAGCAATTAAAATTCCTTCCAGCTGTTTTCGTACGGAGCTTGCTACTCATAATTAAGAGTATTGTCTTAGCCTTTTGACTAAAAAAAATTCTAGTTGG,10,30,14,27,27,41,27,46,27,31,31,41,36,46,0.89,65.35721595
hek293t,8436,1,13,CAAGTTCCCTTTTAATGTTTGAGTGATAAAGGGTACAGATTTGTTGGTCGGCTTCATGGTCTTAGAAAAAAAATTCTAGTTGGTTTAACGCGTAACTAG,CAAGTTCCCTTTTAATGTTTGAGTGATAAAGGGTACAGATAGGTCAGCCCTAGTTGTTGGTCGGCTTCATGGTCTTAGAAAAAAAATTCTAGTTGGTTT,10,30,14,27,27,44,27,57,27,41,41,44,54,57,0.0,0.0
hek293t,12513,1,5,ATGCCTGTCCTCTAGTGCACACTTTGGGGTGGGAGAAGGCAAAAGAGATAAATGTCACTAGACCCGTCCTCACGTTACCTAAAAAAATTCTAGTTGGTT,ATGCCTGTCCTCTAGTGCACACTTTGGACAGAGGTGGGAGAAGGCAAAAGAGATAAATGTCACTAGACCCGTCCTCACGTTACCTAAAAAAATTCTAGT,10,30,14,27,27,38,27,43,27,28,28,38,33,43,51.41,82.14244498
hek293t,12513,1,5,TTACCTGTCCTCTAGTGCACACTTTGGGGTGGGAGAAGGCAAAAGAGATAAATGTCACTAGACCCGTCCTCACGTTACCTGATAATTAAAAAAATTCTA,TTACCTGTCCTCTAGTGCACACTTTGGACAGAGGTGGGAGAAGGCAAAAGAGATAAATGTCACTAGACCCGTCCTCACGTTACCTGATAATTAAAAAAA,10,30,14,27,27,31,27,36,27,28,28,31,33,36,51.41,0.25974026
hek293t,8439,1,7,GCGCATATTTAAAATTGTTTGTGTTTATAAGGTTTGGGGAAATTCTTGAAAGCTTGAACTCAGCTTAAGCGAAAAAAATTCTAGTTGGTTTAACGCGTA,GCGCATATTTAAAATTGTTTGTGTTTATATGAAAAGAGGTTTGGGGAAATTCTTGAAAGCTTGAACTCAGCTTAAGCGAAAAAAATTCTAGTTGGTTTA,10,30,14,27,27,45,27,52,27,30,30,45,37,52,-0.01,0.235944423
hek293t,8441,1,3,ACTTAGCTCAAAGAAACTTGAGGTATCTTTGGATAAACCTAGATATTTAACAAATAGAGGGATAGACATGTAAGAAATAAAAAAAATTCTAGTTGGTTT,ACTTAGCTCAAAGAAACTTGAGGTATCTTTGGAAGCTAAACCTAGATATTTAACAAATAGAGGGATAGACATGTAAGAAATAAAAAAAATTCTAGTTGG,10,30,14,27,27,41,27,44,27,34,34,41,37,44,13.8,66.23448988
hek293t,8441,1,3,AGGAGGCTCAAAGAAACTTGAGGTATCTTTGGATAAACCTAGATATTTAACAAATAGAGGGATAGACATGTAAGAAATACTGGAAAAAAATTCTAGTTG,AGGAGGCTCAAAGAAACTTGAGGTATCTTTGGAAGCTAAACCTAGATATTTAACAAATAGAGGGATAGACATGTAAGAAATACTGGAAAAAAATTCTAG,10,30,14,27,27,37,27,40,27,34,34,37,37,40,13.8,0.325024866
hek293t,8443,1,5,CCGGCTTTAAAAATCAGCATGGTTTTTAGAGGCCATTATGAAAATGTGCTTTAGTTACTCACAGACCATCATGACTCTATAACTAAAAAAATTCTAGTT,CCGGCTTTAAAAATCAGCATGGTTTTTGAACTAGAGGCCATTATGAAAATGTGCTTTAGTTACTCACAGACCATCATGACTCTATAACTAAAAAAATTC,10,30,14,27,27,34,27,39,27,27,27,34,32,39,7.27,7.5318761
hek293t,8443,1,5,AGTACTTTAAAAATCAGCATGGTTTTTAGAGGCCATTATGAAAATGTGCTTTAGTTACTCACAGACCATCATGACTCTATAAAAAAAATTCTAGTTGGT,AGTACTTTAAAAATCAGCATGGTTTTTGAACTAGAGGCCATTATGAAAATGTGCTTTAGTTACTCACAGACCATCATGACTCTATAAAAAAAATTCTAG,10,30,14,27,27,37,27,42,27,27,27,37,32,42,7.27,43.9525341
hek293t,8445,1,3,TTCCAACAGAAGCAAGGCCCTACGTACAGGGGCACCTTGTGGTCCAATTCGACCTCTTTCTCCTGGCATTCCTCTAGGTCCCTTGAAGAGAAAAAAATT,TTCCAACAGAAGCAAGGCCCTACGTAGAGCAGGGGCACCTTGTGGTCCAATTCGACCTCTTTCTCCTGGCATTCCTCTAGGTCCCTTGAAGAGAAAAAA,10,30,14,27,27,30,27,33,27,27,27,30,30,33,67.97,15.81988246
hek293t,8445,1,3,GCATCACAGAAGCAAGGCCCTACGTACAGGGGCACCTTGTGGTCCAATTCGACCTCTTTCTCCTGGCATTCCTCTAGGAAAAAAATTCTAGTTGGTTTA,GCATCACAGAAGCAAGGCCCTACGTAGAGCAGGGGCACCTTGTGGTCCAATTCGACCTCTTTCTCCTGGCATTCCTCTAGGAAAAAAATTCTAGTTGGT,10,30,14,27,27,42,27,45,27,27,27,42,30,45,67.97,22.00466872
hek293t,8447,1,2,ATTTAATGTGTGTAGCTCTGTTAGTGCAGAGGTGTTTCCCAGCTGCTCTGGGAGTTACAGATAGGCGGAGCATCGTGAGAAAAAAATTCTAGTTGGTTT,ATTTAATGTGTGTAGCTCTGTTAGTGCAGAGCCGTGTTTCCCAGCTGCTCTGGGAGTTACAGATAGGCGGAGCATCGTGAGAAAAAAATTCTAGTTGGT,10,30,14,27,27,42,27,44,27,32,32,42,34,44,56.09,83.5862607
hek293t,8447,1,2,CCCCGATGTGTGTAGCTCTGTTAGTGCAGAGGTGTTTCCCAGCTGCTCTGGGAGTTACAGATAGGCGGAGCATCGTGAGCAGAAAAAAATTCTAGTTGG,CCCCGATGTGTGTAGCTCTGTTAGTGCAGAGCCGTGTTTCCCAGCTGCTCTGGGAGTTACAGATAGGCGGAGCATCGTGAGCAGAAAAAAATTCTAGTT,10,30,14,27,27,39,27,41,27,32,32,39,34,41,56.09,85.18109552
hek293t,8449,1,12,GAATATATGCTGCCTGAGCAAATTAATCCAGGAAACTGAAGAAAGAGCAGCAGAATTTGGGGGAAGTATGGATAAGAAAAAAAAAAATTCTAGTTGGTT,GAATATATGCTGCCTGAGCAAATTAATGACGGGGTATATCCAGGAAACTGAAGAAAGAGCAGCAGAATTTGGGGGAAGTATGGATAAGAAAAAAAAAAA,10,30,14,27,27,31,27,43,27,28,28,31,40,43,23.77,0.0
hek293t,8449,1,12,ATGAGTATGCTGCCTGAGCAAATTAATCCAGGAAACTGAAGAAAGAGCAGCAGAATTTGGGGGAAGTATGGATAAGAAAAAAATTCTAGTTGGTTTAAC,ATGAGTATGCTGCCTGAGCAAATTAATGACGGGGTATATCCAGGAAACTGAAGAAAGAGCAGCAGAATTTGGGGGAAGTATGGATAAGAAAAAAATTCT,10,30,14,27,27,35,27,47,27,28,28,35,40,47,23.77,1.711355359
hek293t,8451,1,1,GCGAAAGCCTACAAATTTCAGTATTAATTTGGTAAGCTATATTTTGCATTAATATTCAGTTTATCCTGTTGTGCCAAAAAAAAATTCTAGTTGGTTTAA,GCGAAAGCCTACAAATTTCAGTATTAATTTGGTAAAGCTATATTTTGCATTAATATTCAGTTTATCCTGTTGTGCCAAAAAAAAATTCTAGTTGGTTTA,10,30,14,27,27,45,27,46,27,35,35,45,36,46,2.49,0.932128039
hek293t,8451,1,1,ATAACAGCCTACAAATTTCAGTATTAATTTGGTAAGCTATATTTTGCATTAATATTCAGTTTATCCTGTTGTGCCAATAGACATAAAAAAATTCTAGTT,ATAACAGCCTACAAATTTCAGTATTAATTTGGTAAAGCTATATTTTGCATTAATATTCAGTTTATCCTGTTGTGCCAATAGACATAAAAAAATTCTAGT,10,30,14,27,27,38,27,39,27,35,35,38,36,39,2.49,0.401606426
hek293t,8453,1,13,CACAATCAGCCTCTGCAAAACCAGCAGCACGGTTCTCCTGTGCCTCGGCAACTGACCCCCCTTTTATTAAAAAAATTCTAGTTGGTTTAACGCGTAACT,CACAATCAGCCTCTGCAAAACCAGCAGCACGGTTCTCCCAGATAAGCTTGTTGTGCCTCGGCAACTGACCCCCCTTTTATTAAAAAAATTCTAGTTGGT,10,30,14,27,27,42,27,55,27,39,39,42,52,55,69.87,0.116959064
hek293t,18080,1,8,TTGCCGCCAGTACTAAATTGTCTAAGACTAGGAACTTGCCGTATACTTTCCTTTCTCATCTGTCTCAAACATGCTCGGTACAGAAAAAAATTCTAGTTG,TTGCCGCCAGTACTAAATTGTCTAAGACTGTCCGCCTAGGAACTTGCCGTATACTTTCCTTTCTCATCTGTCTCAAACATGCTCGGTACAGAAAAAAAT,10,30,14,27,27,32,27,40,27,29,29,32,37,40,52.16,1.350622081
hek293t,18080,1,8,CCTCGGCCAGTACTAAATTGTCTAAGACTAGGAACTTGCCGTATACTTTCCTTTCTCATCTGTCTCAAACATGCTCGGTAAAAAAATTCTAGTTGGTTT,CCTCGGCCAGTACTAAATTGTCTAAGACTGTCCGCCTAGGAACTTGCCGTATACTTTCCTTTCTCATCTGTCTCAAACATGCTCGGTAAAAAAATTCTA,10,30,14,27,27,36,27,44,27,29,29,36,37,44,52.16,12.71786883
hek293t,181,1,1,GTGCTTTTGAAAGAAAATACAGAAGAGATTGGAGGCAGCTCATTTTTTGATTTGTAAACCAATGAATTTAAAAGCTTAAAAAAATTCTAGTTGGTTTAA,GTGCTTTTGAAAGAAAATACAGAAGAGATGTGGAGGCAGCTCATTTTTTGATTTGTAAACCAATGAATTTAAAAGCTTAAAAAAATTCTAGTTGGTTTA,10,30,14,27,27,45,27,46,27,30,30,45,31,46,34.72,0.706973374
hek293t,181,1,1,TAGACTTTGAAAGAAAATACAGAAGAGATTGGAGGCAGCTCATTTTTTGATTTGTAAACCAATGAATTTAAAAGCTTTAACCAAAAAAATTCTAGTTGG,TAGACTTTGAAAGAAAATACAGAAGAGATGTGGAGGCAGCTCATTTTTTGATTTGTAAACCAATGAATTTAAAAGCTTTAACCAAAAAAATTCTAGTTG,10,30,14,27,27,40,27,41,27,30,30,40,31,41,34.72,1.38697245
hek293t,8458,1,3,TAGATTAGTGACTACAAACAATGTTGAAACGGTAAGGAATAATTTCATGGAATCTTGTGTTTCTAGTAACTCTAAAAAAATTCTAGTTGGTTTAACGCG,TAGATTAGTGACTACAAACAATGTTGAAACGGTAAGGAATCATAATTTCATGGAATCTTGTGTTTCTAGTAACTCTAAAAAAATTCTAGTTGGTTTAAC,10,30,14,27,27,47,27,50,27,40,40,47,43,50,22.29,4.389953914
hek293t,8458,1,3,CACATTAGTGACTACAAACAATGTTGAAACGGTAAGGAATAATTTCATGGAATCTTGTGTTTCTAGTAACTCTCCATAAAAAAATTCTAGTTGGTTTAA,CACATTAGTGACTACAAACAATGTTGAAACGGTAAGGAATCATAATTTCATGGAATCTTGTGTTTCTAGTAACTCTCCATAAAAAAATTCTAGTTGGTT,10,30,14,27,27,43,27,46,27,40,40,43,43,46,22.29,0.0
hek293t,8460,1,2,ACACCTTACAGATAACAGTACGACCAGTGTGGCATATCCCATTGGTACCATGACCGTCGGCAAGGGAAATGAAAAAAATTCTAGTTGGTTTAACGCGTA,ACACCTTACAGATAACAGTACGACCAGTGTGGCATATCCGACATTGGTACCATGACCGTCGGCAAGGGAAATGAAAAAAATTCTAGTTGGTTTAACGCG,10,30,14,27,27,50,27,52,27,40,40,50,42,52,63.4,79.96873801
hek293t,8460,1,2,CGCTCTTACAGATAACAGTACGACCAGTGTGGCATATCCCATTGGTACCATGACCGTCGGCAAGGGAAATGTGCATGAAAAAAAATTCTAGTTGGTTTA,CGCTCTTACAGATAACAGTACGACCAGTGTGGCATATCCGACATTGGTACCATGACCGTCGGCAAGGGAAATGTGCATGAAAAAAAATTCTAGTTGGTT,10,30,14,27,27,43,27,45,27,40,40,43,42,45,63.4,1.087304016
hek293t,8462,1,5,CTCATATCCACTGACTGTATAGAAAGCAGTGGAGCAGACTAGCCTCACCAAGCTGATGTTAGCTGTTGTGAACAAAAAAAATTCTAGTTGGTTTAACGC,CTCATATCCACTGACTGTATAGAAAGCAGTGGAGCATGGCAGACTAGCCTCACCAAGCTGATGTTAGCTGTTGTGAACAAAAAAAATTCTAGTTGGTTT,10,30,14,27,27,44,27,49,27,34,34,44,39,49,69.93,17.32723894
hek293t,8464,1,6,GCCTCGTCCAATTAGAGTGTTATAATTTATGGAATACTAGTTCTAGCAACAGAATGTAATTATATACAAAAAAAATTCTAGTTGGTTTAACGCGTAACT,GCCTCGTCCAATTAGAGTGTTATAATTTATGGATCGCGGATACTAGTTCTAGCAACAGAATGTAATTATATACAAAAAAAATTCTAGTTGGTTTAACGC,10,30,14,27,27,49,27,55,27,34,34,49,40,55,8.03,2.080135106
hek293t,8464,1,6,TCCCTGTCCAATTAGAGTGTTATAATTTATGGAATACTAGTTCTAGCAACAGAATGTAATTATATACACTACAGTAATTCAAAAAAATTCTAGTTGGTT,TCCCTGTCCAATTAGAGTGTTATAATTTATGGATCGCGGATACTAGTTCTAGCAACAGAATGTAATTATATACACTACAGTAATTCAAAAAAATTCTAG,10,30,14,27,27,37,27,43,27,34,34,37,40,43,8.03,0.258397933
hek293t,8466,1,14,CCTGCTTAAACAAATTGTAGAATGGTTAATGGTGTTAACACCTCTTAGATCAAGAAGTATCCTCAAAGACCAAAAAAATTCTAGTTGGTTTAACGCGTA,CCTGCTTAAACAAATTGTAGAATGGTTAATGGTGAGATGCTTTTAGCTTTAACACCTCTTAGATCAAGAAGTATCCTCAAAGACCAAAAAAATTCTAGT,10,30,14,27,27,38,27,52,27,35,35,38,49,52,11.77,0.009116597
hek293t,8466,1,14,TGTCTTTAAACAAATTGTAGAATGGTTAATGGTGTTAACACCTCTTAGATCAAGAAGTATCCTCAAAAAAAAAATTCTAGTTGGTTTAACGCGTAACTA,TGTCTTTAAACAAATTGTAGAATGGTTAATGGTGAGATGCTTTTAGCTTTAACACCTCTTAGATCAAGAAGTATCCTCAAAAAAAAAATTCTAGTTGGT,10,30,14,27,27,42,27,56,27,35,35,42,49,56,11.77,0.400285341
hek293t,8468,1,3,ACTCTTATTTAAATCAAAGTGGAGAAAGAAGGGTGATGAGGAATGAAGAAAAGGATTAGTATATTCTGGGACACTGGAAATGAGGTCAAAAAAATTCTA,ACTCTTATTTAAATCAAAGTGGAGAAAGAAGAAGGGTGATGAGGAATGAAGAAAAGGATTAGTATATTCTGGGACACTGGAAATGAGGTCAAAAAAATT,10,30,14,27,27,33,27,36,27,30,30,33,33,36,30.24,0.0
hek293t,8468,1,3,GAGTTTATTTAAATCAAAGTGGAGAAAGAAGGGTGATGAGGAATGAAGAAAAGGATTAGTATATTCTGGGACACTGGAAAAAAAAAATTCTAGTTGGTT,GAGTTTATTTAAATCAAAGTGGAGAAAGAAGAAGGGTGATGAGGAATGAAGAAAAGGATTAGTATATTCTGGGACACTGGAAAAAAAAAATTCTAGTTG,10,30,14,27,27,40,27,43,27,30,30,40,33,43,30.24,3.660944743
hek293t,8472,1,3,ATTGCTGTTTTACAGCAGATGGACTTGCTTGGTCATAAAAAGGTTTATAGTGGTTTTGGGCAAACCTTTAGTACCATTATAATAATAAAAAAATTCTAG,ATTGCTGTTTTACAGCAGATGGACTTGCTTGTAGGTCATAAAAAGGTTTATAGTGGTTTTGGGCAAACCTTTAGTACCATTATAATAATAAAAAAATTC,10,30,14,27,27,34,27,37,27,31,31,34,34,37,43.07,0.0
hek293t,8472,1,3,TGCCTTGTTTTACAGCAGATGGACTTGCTTGGTCATAAAAAGGTTTATAGTGGTTTTGGGCAAACCTTTAGTACCATTATAAAAAAAAATTCTAGTTGG,TGCCTTGTTTTACAGCAGATGGACTTGCTTGTAGGTCATAAAAAGGTTTATAGTGGTTTTGGGCAAACCTTTAGTACCATTATAAAAAAAAATTCTAGT,10,30,14,27,27,38,27,41,27,31,31,38,34,41,43.07,60.27773491
hek293t,8474,1,4,TGTTACTGAATATTTGGAATCAAGTACTTTGGAAAACATAAGACCTTACATGATCACTGAAGAAAAAAAAATTCTAGTTGGTTTAACGCGTAACTAGAT,TGTTACTGAATATTTGGAATCAAGTACTTTGGAAAACATACAAAAGACCTTACATGATCACTGAAGAAAAAAAAATTCTAGTTGGTTTAACGCGTAACT,10,30,14,27,27,55,27,59,27,40,40,55,44,59,31.33,2.951515009
hek293t,8474,1,4,TTCAGCTGAATATTTGGAATCAAGTACTTTGGAAAACATAAGACCTTACATGATCACTGAAGAAATCATTTATTTCAAAAAAATTCTAGTTGGTTTAAC,TTCAGCTGAATATTTGGAATCAAGTACTTTGGAAAACATACAAAAGACCTTACATGATCACTGAAGAAATCATTTATTTCAAAAAAATTCTAGTTGGTT,10,30,14,27,27,43,27,47,27,40,40,43,44,47,31.33,0.0
hek293t,8476,1,4,TTATCCAATTTTAAAAAGAGGAAAATCAAAGGGGCAAGATGTGAAAGATCTAATTTATGTGAAGAAAGAGTAAGATTTTGAAAAAAATTCTAGTTGGTT,TTATCCAATTTTAAAAAGAGGAAAATCAAAGGGGCATCTAAGATGTGAAAGATCTAATTTATGTGAAGAAAGAGTAAGATTTTGAAAAAAATTCTAGTT,10,30,14,27,27,39,27,43,27,36,36,39,40,43,9.91,0.0
hek293t,8476,1,4,GTTGCCAATTTTAAAAAGAGGAAAATCAAAGGGGCAAGATGTGAAAGATCTAATTTATGTGAAGAAAGAGTAAAAAAAAATTCTAGTTGGTTTAACGCG,GTTGCCAATTTTAAAAAGAGGAAAATCAAAGGGGCATCTAAGATGTGAAAGATCTAATTTATGTGAAGAAAGAGTAAAAAAAAATTCTAGTTGGTTTAA,10,30,14,27,27,46,27,50,27,36,36,46,40,50,9.91,0.0
hek293t,8478,1,5,TAGCGTTCCAGTTTGAAAACTCAGATTTCTGGTTTGAAATTGTCCATTCCTGCATGCTTCTGTTTACATGCAAAAAAATTCTAGTTGGTTTAACGCGTA,TAGCGTTCCAGTTTGAAAACTCAGATTTCTGGTTTGCCTACAAATTGTCCATTCCTGCATGCTTCTGTTTACATGCAAAAAAATTCTAGTTGGTTTAAC,10,30,14,27,27,47,27,52,27,37,37,47,42,52,8.96,24.57131525
hek293t,8478,1,5,CGGGTTTCCAGTTTGAAAACTCAGATTTCTGGTTTGAAATTGTCCATTCCTGCATGCTTCTGTTTACATGCAACACAGAAAAAAATTCTAGTTGGTTTA,CGGGTTTCCAGTTTGAAAACTCAGATTTCTGGTTTGCCTACAAATTGTCCATTCCTGCATGCTTCTGTTTACATGCAACACAGAAAAAAATTCTAGTTG,10,30,14,27,27,40,27,45,27,37,37,40,42,45,8.96,0.29976405
hek293t,8480,1,9,GATCCGTTTAACCACTTCTTTTCCTTTTTTGGAGCTGGGGAGTTGAGTCATCAGTACTTTGTCTAAGCAAATTCAGAAAAAAATTCTAGTTGGTTTAAC,GATCCGTTTAACCACTTCTTTTCCTTTATGGGCTAATTTGGAGCTGGGGAGTTGAGTCATCAGTACTTTGTCTAAGCAAATTCAGAAAAAAATTCTAGT,10,30,14,27,27,38,27,47,27,28,28,38,37,47,-4.76,0.0
hek293t,8481,1,15,TCTAATACAGTTCTCCTTGTCTAGTTTTAAGGAGTATCTTATTTCTTTACCAGAGGTGCATAACAAGAAAAAAAAAAATTCTAGTTGGTTTAACGCGTA,TCTAATACAGTTCTCCTTGTCTAGTTGAGACAAGGCTGAACTTAAGGAGTATCTTATTTCTTTACCAGAGGTGCATAACAAGAAAAAAAAAAATTCTAG,10,30,14,27,27,37,27,52,27,27,27,37,42,52,6.82,0.608132321
hek293t,8481,1,15,TACTTTACAGTTCTCCTTGTCTAGTTTTAAGGAGTATCTTATTTCTTTACCAGAGGTGCATAACAAGAAAAGAGAAAAAAATTCTAGTTGGTTTAACGC,TACTTTACAGTTCTCCTTGTCTAGTTGAGACAAGGCTGAACTTAAGGAGTATCTTATTTCTTTACCAGAGGTGCATAACAAGAAAAGAGAAAAAAATTC,10,30,14,27,27,34,27,49,27,27,27,34,42,49,6.82,0.035273369
hek293t,8483,1,15,TCCCTGCAATGTGAATTACATTTATGCAAAGGCTGATATATTCCTGTAAGAGATTATTTTCTTATAAAAAAAATTCTAGTTGGTTTAACGCGTAACTAG,TCCCTGCAATGTGAATTACATTTATGCAAAGTACTTTTACAATGACGCTGATATATTCCTGTAAGAGATTATTTTCTTATAAAAAAAATTCTAGTTGGT,10,30,14,27,27,42,27,57,27,32,32,42,47,57,36.68,0.431778929
hek293t,8485,1,15,TCCACATTATTATAGTTTGTTGCCATTCATGGAGAGGTGCACAAAATGCAAATGTGCATTTAACCCATAGTAGCTAAAAAAATTCTAGTTGGTTTAACG,TCCACATTATTATAGTTTGTTGCCATTCATAGTAGGTCCCCTTATGGAGAGGTGCACAAAATGCAAATGTGCATTTAACCCATAGTAGCTAAAAAAATT,10,30,14,27,27,33,27,48,27,30,30,33,45,48,7.35,0.0
hek293t,8487,1,13,CTTCCAAATGAGGATGAGTGTTGGTCTTCTGGCACAGAGATATCATTTTGCACATTTCCTCATTGAAAAAAATTCTAGTTGGTTTAACGCGTAACTAGA,CTTCCAAATGAGGATGAGTGTTGGTCTTCTGGCACAGACACCTCTGCGTTAGATATCATTTTGCACATTTCCTCATTGAAAAAAATTCTAGTTGGTTTA,10,30,14,27,27,45,27,58,27,38,38,45,51,58,18.91,0.16722408
hek293t,8488,1,6,CCGATGTATTCTCATATTCAGTACCCGAGGGGTTTGATGTAAAGCATCCTTAAAGATAAAATGTTGGCTAAAAAAAATTCTAGTTGGTTTAACGCGTAA,CCGATGTATTCTCATATTCAGTACCCGAGGGGTTTGATGTTATTTTAAAGCATCCTTAAAGATAAAATGTTGGCTAAAAAAAATTCTAGTTGGTTTAAC,10,30,14,27,27,47,27,53,27,40,40,47,46,53,52.32,0.909768769
hek293t,8488,1,6,ATCCCGTATTCTCATATTCAGTACCCGAGGGGTTTGATGTAAAGCATCCTTAAAGATAAAATGTTGGCTAATGTAAAAAAATTCTAGTTGGTTTAACGC,ATCCCGTATTCTCATATTCAGTACCCGAGGGGTTTGATGTTATTTTAAAGCATCCTTAAAGATAAAATGTTGGCTAATGTAAAAAAATTCTAGTTGGTT,10,30,14,27,27,43,27,49,27,40,40,43,46,49,52.32,0.0
hek293t,8490,1,9,CCACCCAGGAAAAGACTGGTGCCTCTAGCTGGGTTCCAGACTCTCTCCCTGCCCTTGGGAAAGCGATCTGTATTGGTAAAAAAATTCTAGTTGGTTTAA,CCACCCAGGAAAAGACTGGTGCCTCTAGCTGGGCCCTGTCCCTTCCAGACTCTCTCCCTGCCCTTGGGAAAGCGATCTGTATTGGTAAAAAAATTCTAG,10,30,14,27,27,37,27,46,27,34,34,37,43,46,21.07,0.0
hek293t,8490,1,9,CAGCTCAGGAAAAGACTGGTGCCTCTAGCTGGGTTCCAGACTCTCTCCCTGCCCTTGGGAAAGCGATCTGAAAAAAATTCTAGTTGGTTTAACGCGTAA,CAGCTCAGGAAAAGACTGGTGCCTCTAGCTGGGCCCTGTCCCTTCCAGACTCTCTCCCTGCCCTTGGGAAAGCGATCTGAAAAAAATTCTAGTTGGTTT,10,30,14,27,27,44,27,53,27,34,34,44,43,53,21.07,3.614702826
hek293t,8492,1,4,TCAAGTACCTTTGCTTTTGTCCCACTCCATGGTTTTGTCTCCACTGAACAGAGATACAACTGTGTGGGGAGCAAAAAAATTCTAGTTGGTTTAACGCGT,TCAAGTACCTTTGCTTTTGTCCCACTCCATGGTGTGTTTTGTCTCCACTGAACAGAGATACAACTGTGTGGGGAGCAAAAAAATTCTAGTTGGTTTAAC,10,30,14,27,27,47,27,51,27,32,32,47,36,51,40.22,55.75929863
hek293t,8492,1,4,CCCACTACCTTTGCTTTTGTCCCACTCCATGGTTTTGTCTCCACTGAACAGAGATACAACTGTGTGGGGAGCAACCTGTAAAACAAAAAAATTCTAGTT,CCCACTACCTTTGCTTTTGTCCCACTCCATGGTGTGTTTTGTCTCCACTGAACAGAGATACAACTGTGTGGGGAGCAACCTGTAAAACAAAAAAATTCT,10,30,14,27,27,35,27,39,27,32,32,35,36,39,40.22,0.242490206
hek293t,8494,1,1,CAAAGAGTTACAGGAGTTCAGCTGACAGGTGGTAACTGGATAATCTTTGCAGTTCAGTTGCACGTGATTGTATAAAAAAATTCTAGTTGGTTTAACGCG,CAAAGAGTTACAGGAGTTCAGCTGACAGGTGGTAACTGCGATAATCTTTGCAGTTCAGTTGCACGTGATTGTATAAAAAAATTCTAGTTGGTTTAACGC,10,30,14,27,27,49,27,50,27,39,39,49,40,50,69.12,67.77694758
hek293t,8494,1,1,CGCTGAGTTACAGGAGTTCAGCTGACAGGTGGTAACTGGATAATCTTTGCAGTTCAGTTGCACGTGATTGTATCTGAAAAAAATTCTAGTTGGTTTAAC,CGCTGAGTTACAGGAGTTCAGCTGACAGGTGGTAACTGCGATAATCTTTGCAGTTCAGTTGCACGTGATTGTATCTGAAAAAAATTCTAGTTGGTTTAA,10,30,14,27,27,46,27,47,27,39,39,46,40,47,69.12,74.71829318
hek293t,8496,1,3,TGTGTATTTGTGCCAGGCACTGTACAAATAGGTATGTTCTAGCTGCTGCAATTATAGTCCATTTTCCTGGGTACAGCTGATATACAAAAAAAATTCTAG,TGTGTATTTGTGCCAGGCACTGTACAAATAAGGGGTATGTTCTAGCTGCTGCAATTATAGTCCATTTTCCTGGGTACAGCTGATATACAAAAAAAATTC,10,30,14,27,27,34,27,37,27,31,31,34,34,37,33.47,2.37376912
hek293t,8496,1,3,TCCACATTTGTGCCAGGCACTGTACAAATAGGTATGTTCTAGCTGCTGCAATTATAGTCCATTTTCCTGGGTACAAAAAAATTCTAGTTGGTTTAACGC,TCCACATTTGTGCCAGGCACTGTACAAATAAGGGGTATGTTCTAGCTGCTGCAATTATAGTCCATTTTCCTGGGTACAAAAAAATTCTAGTTGGTTTAA,10,30,14,27,27,46,27,49,27,31,31,46,34,49,33.47,60.04805782
hek293t,8498,1,13,AATCAATGTTTCACAAATTTTAGGATACCAGGAATGAAATATTTGATTACAATTGACTATATTTAAAAAAATTCTAGTTGGTTTAACGCGTAACTAGAT,AATCAATGTTTCACAAATTTTAGGATACCAGGAATGAAATAGTGATCTTGAATATTTGATTACAATTGACTATATTTAAAAAAATTCTAGTTGGTTTAA,10,30,14,27,27,46,27,59,27,39,39,46,52,59,13.65,0.0
hek293t,8501,1,5,TGAGGAATAAAACTCTGGGAGACCAGCTCTGGCTCTTTGTCCCCCTGTATTACCCAAAAATCTAGCTAATACAGGCAATATAAAAAAATTCTAGTTGGT,TGAGGAATAAAACTCTGGGAGACCAGCTCTCTCTTGGCTCTTTGTCCCCCTGTATTACCCAAAAATCTAGCTAATACAGGCAATATAAAAAAATTCTAG,10,30,14,27,27,37,27,42,27,30,30,37,35,42,40.19,7.501689979
hek293t,8503,1,2,ATTTCTCAGGAATTCTATCTTTATTTTCCAGGTGGAAAATAGTGGTATCCATGCCTTTTCATATTGTACATCAAAAAAAATTCTAGTTGGTTTAACGCG,ATTTCTCAGGAATTCTATCTTTATTTTCCAGGCATGGAAAATAGTGGTATCCATGCCTTTTCATATTGTACATCAAAAAAAATTCTAGTTGGTTTAACG,10,30,14,27,27,48,27,50,27,33,33,48,35,50,3.21,0.0
hek293t,8505,1,7,AATTACAGAGAGGTTCATAATTTCTTGAGTGGGAGAAATGAATCTCAGATTCTGTCTTCTCCAAACACCCCCCAAAAAAATTCTAGTTGGTTTAACGCG,AATTACAGAGAGGTTCATAATTTCTTGAGTGGGAGAAATGCCTGTGGAATCTCAGATTCTGTCTTCTCCAAACACCCCCCAAAAAAATTCTAGTTGGTT,10,30,14,27,27,43,27,50,27,40,40,43,47,50,44.23,0.0
hek293t,8506,1,13,TCTTTATTATGAGAGATTCACCTCTATAATGGACCTATAATTAAGATATCACAATGTTTTCTTTCTAAAAAAATTCTAGTTGGTTTAACGCGTAACTAG,TCTTTATTATGAGAGATTCACCTCTATAATGGACCTATAAATAACACGAATCGTTAAGATATCACAATGTTTTCTTTCTAAAAAAATTCTAGTTGGTTT,10,30,14,27,27,44,27,57,27,41,41,44,54,57,26.8,0.057471264
hek293t,8507,1,14,CACTTAGAGCTTTCACTTGCCCCCCCACAAGGTGAGCCATAACTTGCAACTATACTCTCAGCTTACTAAACATCCAAAAAAATTCTAGTTGGTTTAACG,CACTTAGAGCTTTCACTTGCCCCCCCACAAGCGGATATCCGTCGGGTGAGCCATAACTTGCAACTATACTCTCAGCTTACTAAACATCCAAAAAAATTC,10,30,14,27,27,34,27,48,27,31,31,34,45,48,35.9,0.164203612
hek293t,8507,1,14,AGGTTAGAGCTTTCACTTGCCCCCCCACAAGGTGAGCCATAACTTGCAACTATACTCTCAGCTTACTAAACAAAAAAATTCTAGTTGGTTTAACGCGTA,AGGTTAGAGCTTTCACTTGCCCCCCCACAAGCGGATATCCGTCGGGTGAGCCATAACTTGCAACTATACTCTCAGCTTACTAAACAAAAAAATTCTAGT,10,30,14,27,27,38,27,52,27,31,31,38,45,52,35.9,1.078778468
hek293t,8511,1,11,GCGCGGGTAAACGGTTATGTACTGATACGTGGTGACTTGGTGGTGGCCACATTTGAATTGCATGAAAAAAAAATTCTAGTTGGTTTAACGCGTAACTAG,GCGCGGGTAAACGGTTATGTACTGATACGTGGTGATGTGGCACACGCTTGGTGGTGGCCACATTTGAATTGCATGAAAAAAAAATTCTAGTTGGTTTAA,10,30,14,27,27,46,27,57,27,36,36,46,47,57,65.7,0.705467372
hek293t,8512,1,12,TAGACTTCATTGCCTTTAGATCTACACTGGGGCAAATCATGGTCCTGTCCTGTGCCACAGATCAAAAAAAAAATTCTAGTTGGTTTAACGCGTAACTAG,TAGACTTCATTGCCTTTAGATCTACACTGGGGCAAATTGACCTGTTGGTCATGGTCCTGTCCTGTGCCACAGATCAAAAAAAAAATTCTAGTTGGTTTA,10,30,14,27,27,45,27,57,27,38,38,45,50,57,72.0,0.137174211
hek293t,8516,1,2,TATGTAAGGTATATAGGATGCAAGTCCTCTGGAGCATGTGGGTTTTTTTGACAATTTAAACTGATCTAAGCCATCACTGCTGTAGGAAAAAAATTCTAG,TATGTAAGGTATATAGGATGCAAGTCCGCTCTGGAGCATGTGGGTTTTTTTGACAATTTAAACTGATCTAAGCCATCACTGCTGTAGGAAAAAAATTCT,10,30,14,27,27,35,27,37,27,28,28,35,30,37,50.63,69.24658579
hek293t,8516,1,2,ACAGGAAGGTATATAGGATGCAAGTCCTCTGGAGCATGTGGGTTTTTTTGACAATTTAAACTGATCTAAGCCATCACTGCTGTAAAAAAATTCTAGTTG,ACAGGAAGGTATATAGGATGCAAGTCCGCTCTGGAGCATGTGGGTTTTTTTGACAATTTAAACTGATCTAAGCCATCACTGCTGTAAAAAAATTCTAGT,10,30,14,27,27,38,27,40,27,28,28,38,30,40,50.63,75.04957857
hek293t,8518,1,15,GCAGAATTTACAGAAACCCTAGCCGTTAGAGGTCTGACCATAAGTACTACAACCAGTATGCGTTTAAAAAAAATTCTAGTTGGTTTAACGCGTAACTAG,GCAGAATTTACAGAAACCCTAGCCGTTCCGCGACGACCAAATAGAGGTCTGACCATAAGTACTACAACCAGTATGCGTTTAAAAAAAATTCTAGTTGGT,10,30,14,27,27,42,27,57,27,27,27,42,42,57,44.32,24.69298964
hek293t,8520,1,8,CGCCGATTAATTCAAAATCTGCCAGGTGAAGGTTGTGGTGATAAAAATTTGGTATTGTTAGAAAAGAAACATTATAATGAAAAAAATTCTAGTTGGTTT,CGCCGATTAATTCAAAATCTGCCAGGTGGGATGGATAAGGTTGTGGTGATAAAAATTTGGTATTGTTAGAAAAGAAACATTATAATGAAAAAAATTCTA,10,30,14,27,27,36,27,44,27,29,29,36,37,44,27.62,3.099272792
hek293t,8520,1,8,CTCGCATTAATTCAAAATCTGCCAGGTGAAGGTTGTGGTGATAAAAATTTGGTATTGTTAGAAAAGAAACATTATAAAAAAAATTCTAGTTGGTTTAAC,CTCGCATTAATTCAAAATCTGCCAGGTGGGATGGATAAGGTTGTGGTGATAAAAATTTGGTATTGTTAGAAAAGAAACATTATAAAAAAAATTCTAGTT,10,30,14,27,27,39,27,47,27,29,29,39,37,47,27.62,5.259302594
hek293t,22578,1,6,ATTGCCCTCTCTGGAGCCAACATTCCTTGAGGCAATGGGATGCTGGCACATATCCACTAATACACGTAAAACATCTTGGAAAAGCAAAAAAAAATTCTA,ATTGCCCTCTCTGGAGCCAACATTCCAGGGTATTGAGGCAATGGGATGCTGGCACATATCCACTAATACACGTAAAACATCTTGGAAAAGCAAAAAAAA,10,30,14,27,27,30,27,36,27,27,27,30,33,36,54.91,0.542888165
hek293t,22578,1,6,CAAGACCTCTCTGGAGCCAACATTCCTTGAGGCAATGGGATGCTGGCACATATCCACTAATACACGTAAAACATCTTGGAAAAAAAATTCTAGTTGGTT,CAAGACCTCTCTGGAGCCAACATTCCAGGGTATTGAGGCAATGGGATGCTGGCACATATCCACTAATACACGTAAAACATCTTGGAAAAAAAATTCTAG,10,30,14,27,27,37,27,43,27,27,27,37,33,43,54.91,49.15220141
hek293t,8526,1,13,ATTCTTTTGTAAGCTCCTGCTCTGCTCCCTGGGGAATCACCCCGGCTCCATTCAGCAGAATCCATTATAAAAAAAATTCTAGTTGGTTTAACGCGTAAC,ATTCTTTTGTAAGCTCCTGCTCTGCTCCCTGTAATTATGCTTAGGGGAATCACCCCGGCTCCATTCAGCAGAATCCATTATAAAAAAAATTCTAGTTGG,10,30,14,27,27,41,27,54,27,31,31,41,44,54,54.4,26.35408408
hek293t,8528,1,5,ATGTGGTACAAAGGAAGCAGTTATATTAAAGGTACTTGCAGGCAGAGAAATATCTGTCCATCATGTAAGTACAAAAAAAATTCTAGTTGGTTTAACGCG,ATGTGGTACAAAGGAAGCAGTTATATTAAATAGCAGGTACTTGCAGGCAGAGAAATATCTGTCCATCATGTAAGTACAAAAAAAATTCTAGTTGGTTTA,10,30,14,27,27,45,27,50,27,30,30,45,35,50,16.97,12.96979291
hek293t,8528,1,5,GGGCTGTACAAAGGAAGCAGTTATATTAAAGGTACTTGCAGGCAGAGAAATATCTGTCCATCATGTAAGTACAAAACATAGCAATAAAAAAATTCTAGT,GGGCTGTACAAAGGAAGCAGTTATATTAAATAGCAGGTACTTGCAGGCAGAGAAATATCTGTCCATCATGTAAGTACAAAACATAGCAATAAAAAAATT,10,30,14,27,27,33,27,38,27,30,30,33,35,38,16.97,0.34700871
hek293t,13345,1,3,ACAGAGTTAATTGTGTAAGCTAATAGGAGTGGTGCTCACAATGTCATTTTGAAAGTTAAAGAGGAAATGGATGAGAAAAAAAAATTCTAGTTGGTTTAA,ACAGAGTTAATTGTGTAAGCTAATAGGACAAGTGGTGCTCACAATGTCATTTTGAAAGTTAAAGAGGAAATGGATGAGAAAAAAAAATTCTAGTTGGTT,10,30,14,27,27,43,27,46,27,28,28,43,31,46,51.77,78.54491802
hek293t,13345,1,3,TGGCTGTTAATTGTGTAAGCTAATAGGAGTGGTGCTCACAATGTCATTTTGAAAGTTAAAGAGGAAATGGATGAGAATTATTGTTAAAAAAATTCTAGT,TGGCTGTTAATTGTGTAAGCTAATAGGACAAGTGGTGCTCACAATGTCATTTTGAAAGTTAAAGAGGAAATGGATGAGAATTATTGTTAAAAAAATTCT,10,30,14,27,27,35,27,38,27,28,28,35,31,38,51.77,52.10684579
hek293t,8532,1,10,ATATCCAGGAGCTTTAGAATGAAATAGTCTGGTTCAAAAGACAGTGTATGGACTCTAAGTACAGAGTACATTGATAATCATTAAAAAAATTCTAGTTGG,ATATCCAGGAGCTTTAGAATGAAATAGCGCATAAGACTCTGGTTCAAAAGACAGTGTATGGACTCTAAGTACAGAGTACATTGATAATCATTAAAAAAA,10,30,14,27,27,31,27,41,27,28,28,31,38,41,24.02,0.0
hek293t,8534,1,9,GGGAGTATTTTCAGTTATTTTACTGCCTATGGATAACCAAAACTTATTAATGTGGAGAGAGGGGAGAAAGGAGGGAGAGACCCCAAAAAAATTCTAGTT,GGGAGTATTTTCAGTTATTTTACTGCTCATGCATACTATGGATAACCAAAACTTATTAATGTGGAGAGAGGGGAGAAAGGAGGGAGAGACCCCAAAAAA,10,30,14,27,27,30,27,39,27,27,27,30,36,39,-2.02,0.0
hek293t,8534,1,9,AGTCTTATTTTCAGTTATTTTACTGCCTATGGATAACCAAAACTTATTAATGTGGAGAGAGGGGAGAAAGGAAAAAAAATTCTAGTTGGTTTAACGCGT,AGTCTTATTTTCAGTTATTTTACTGCTCATGCATACTATGGATAACCAAAACTTATTAATGTGGAGAGAGGGGAGAAAGGAAAAAAAATTCTAGTTGGT,10,30,14,27,27,42,27,51,27,27,27,42,36,51,-2.02,0.0
hek293t,8536,1,14,CCACTCAAAGGACTTATATTTAGACCATAAGGTCCTGGTCTAAAGAATCACACAAACCTTTCCCCCCCCTTAAAAAAATTCTAGTTGGTTTAACGCGTA,CCACTCAAAGGACTTATATTTAGACCATAACTACTCCATAACGGGGTCCTGGTCTAAAGAATCACACAAACCTTTCCCCCCCCTTAAAAAAATTCTAGT,10,30,14,27,27,38,27,52,27,31,31,38,45,52,9.71,1.383186298
hek293t,8536,1,14,GCACCCAAAGGACTTATATTTAGACCATAAGGTCCTGGTCTAAAGAATCACACAAACCTTTCCCCCCCCTTTCAAAAAAAAATTCTAGTTGGTTTAACG,GCACCCAAAGGACTTATATTTAGACCATAACTACTCCATAACGGGGTCCTGGTCTAAAGAATCACACAAACCTTTCCCCCCCCTTTCAAAAAAAAATTC,10,30,14,27,27,34,27,48,27,31,31,34,45,48,9.71,0.0
hek293t,8538,1,13,ACTTCTAAAATGCCCAGTGGAAGGGAGGGTGGGAAGTTGCATAAGTGTTGGGCAAGACTTAATATGAAAAAAAAATTCTAGTTGGTTTAACGCGTAACT,ACTTCTAAAATGCCCAGTGGAAGGGAGGGTGGGAGTACAAGCGCAGTAGTTGCATAAGTGTTGGGCAAGACTTAATATGAAAAAAAAATTCTAGTTGGT,10,30,14,27,27,42,27,55,27,35,35,42,48,55,18.14,1.022503414
hek293t,8538,1,13,GGCTCTAAAATGCCCAGTGGAAGGGAGGGTGGGAAGTTGCATAAGTGTTGGGCAAGACTTAATATGAAAAGTAAAAAAATTCTAGTTGGTTTAACGCGT,GGCTCTAAAATGCCCAGTGGAAGGGAGGGTGGGAGTACAAGCGCAGTAGTTGCATAAGTGTTGGGCAAGACTTAATATGAAAAGTAAAAAAATTCTAGT,10,30,14,27,27,38,27,51,27,35,35,38,48,51,18.14,1.007002137
hek293t,8540,1,11,CAAATCAGTGGGCGATAGACTTTGCCAAGAGGACCTCAGTGGGCTGCACGGCCGGCCCAAGCAAGCTGCAAAAAAATTCTAGTTGGTTTAACGCGTAAC,CAAATCAGTGGGCGATAGACTTTGCCAAGAGGACCGATACTAGTTATCAGTGGGCTGCACGGCCGGCCCAAGCAAGCTGCAAAAAAATTCTAGTTGGTT,10,30,14,27,27,43,27,54,27,36,36,43,47,54,45.74,40.89562255
hek293t,8542,1,1,TGGGAAGGTCATCTTTTTAGAAGTACTCTTGGGGTTTTTTGCCCACTATTTTCATCCCCTCCTCTGTCTTATTCATTTTCTCAAAAAAATTCTAGTTGG,TGGGAAGGTCATCTTTTTAGAAGTACTCTTGGTGGTTTTTTGCCCACTATTTTCATCCCCTCCTCTGTCTTATTCATTTTCTCAAAAAAATTCTAGTTG,10,30,14,27,27,40,27,41,27,33,33,40,34,41,2.58,18.17924639
hek293t,8544,1,3,AGCTATCTGTCAGCTCGGGGGGTGTTGTATGGCGTGCCCAGCCTAGGAGCCAGACTTTGTCACGAGAGGAAAGGGGTATGCAAAAAAATTCTAGTTGGT,AGCTATCTGTCAGCTCGGGGGGTGTTGTATGGCGTCGTGCCCAGCCTAGGAGCCAGACTTTGTCACGAGAGGAAAGGGGTATGCAAAAAAATTCTAGTT,10,30,14,27,27,39,27,42,27,36,36,39,39,42,26.94,8.425312021
hek293t,8544,1,3,ATAATTCTGTCAGCTCGGGGGGTGTTGTATGGCGTGCCCAGCCTAGGAGCCAGACTTTGTCACGAGAGGAAAGGGGTAAAAAAATTCTAGTTGGTTTAA,ATAATTCTGTCAGCTCGGGGGGTGTTGTATGGCGTCGTGCCCAGCCTAGGAGCCAGACTTTGTCACGAGAGGAAAGGGGTAAAAAAATTCTAGTTGGTT,10,30,14,27,27,43,27,46,27,36,36,43,39,46,26.94,74.84286213
hek293t,8546,1,10,GGAAAAACATGACTGTCTAACAACAATGAAGGCAATCATGTAATGTTGCATGTCAATGAGCATCAATGGACATTGGGGAAAAAAAATTCTAGTTGGTTT,GGAAAAACATGACTGTCTAACAACAACTGGGGGGCCTGAAGGCAATCATGTAATGTTGCATGTCAATGAGCATCAATGGACATTGGGGAAAAAAAATTC,10,30,14,27,27,34,27,44,27,27,27,34,37,44,71.13,0.660514485
hek293t,8546,1,10,TGACCAACATGACTGTCTAACAACAATGAAGGCAATCATGTAATGTTGCATGTCAATGAGCATCAATGGACAAAAAAATTCTAGTTGGTTTAACGCGTA,TGACCAACATGACTGTCTAACAACAACTGGGGGGCCTGAAGGCAATCATGTAATGTTGCATGTCAATGAGCATCAATGGACAAAAAAATTCTAGTTGGT,10,30,14,27,27,42,27,52,27,27,27,42,37,52,71.13,36.66975619
hek293t,8548,1,2,TGTGGCAGTTCTTCCCCACTTCCCACATCAGGCTGTTTCTCCTCCCGTCCTTCACTCACGTTACAGCTAATCTGTAATTAAAAAAATTCTAGTTGGTTT,TGTGGCAGTTCTTCCCCACTTCCCACAAATCAGGCTGTTTCTCCTCCCGTCCTTCACTCACGTTACAGCTAATCTGTAATTAAAAAAATTCTAGTTGGT,10,30,14,27,27,42,27,44,27,27,27,42,29,44,38.47,80.99789697
hek293t,8550,1,6,TGCCTGCTAGAAAAGGGGATAGAAAAGGATGGAAGGTATGTTGAATAGGACATGTGAACTGACCCAGTCAAAAAAAATTCTAGTTGGTTTAACGCGTAA,TGCCTGCTAGAAAAGGGGATAGAAAAGGATGATGATTGAAGGTATGTTGAATAGGACATGTGAACTGACCCAGTCAAAAAAAATTCTAGTTGGTTTAAC,10,30,14,27,27,47,27,53,27,32,32,47,38,53,67.85,3.412756054
hek293t,8550,1,6,GCCACGCTAGAAAAGGGGATAGAAAAGGATGGAAGGTATGTTGAATAGGACATGTGAACTGACCCAGTCATATAAAATAAAAAAATTCTAGTTGGTTTA,GCCACGCTAGAAAAGGGGATAGAAAAGGATGATGATTGAAGGTATGTTGAATAGGACATGTGAACTGACCCAGTCATATAAAATAAAAAAATTCTAGTT,10,30,14,27,27,39,27,45,27,32,32,39,38,45,67.85,1.562584781
hek293t,8552,1,3,AGATATCCTAAGAAGGACTTAGTTACATGTGGAGTTTGGAACTTGCTCTATCATTTTGATGGGAAAACTGCTTGAACTAAAAAAATTCTAGTTGGTTTA,AGATATCCTAAGAAGGACTTAGTTACATGATGTGGAGTTTGGAACTTGCTCTATCATTTTGATGGGAAAACTGCTTGAACTAAAAAAATTCTAGTTGGT,10,30,14,27,27,42,27,45,27,27,27,42,30,45,56.59,83.76381866
hek293t,8554,1,7,GTGCGGGTTGAAATACAGGAGCAAATCTTTGGTTATACATGGTAGCAACACGCTATTATAGTTTTTGAAGTTCTCCAAAAAAATTCTAGTTGGTTTAAC,GTGCGGGTTGAAATACAGGAGCAAATCTTTGGTAAAAGTTTATACATGGTAGCAACACGCTATTATAGTTTTTGAAGTTCTCCAAAAAAATTCTAGTTG,10,30,14,27,27,40,27,47,27,33,33,40,40,47,28.84,0.0
hek293t,8554,1,7,GGTTTGGTTGAAATACAGGAGCAAATCTTTGGTTATACATGGTAGCAACACGCTATTATAGTTTTTGAAAAAAAATTCTAGTTGGTTTAACGCGTAACT,GGTTTGGTTGAAATACAGGAGCAAATCTTTGGTAAAAGTTTATACATGGTAGCAACACGCTATTATAGTTTTTGAAAAAAAATTCTAGTTGGTTTAACG,10,30,14,27,27,48,27,55,27,33,33,48,40,55,28.84,0.0
hek293t,8556,1,6,TGTCAATTTTCATTTAAAAATACAGCATGTGGGATTCTAAATGAGACAAAAAGCTAAAAAATAACAAGTTTTAAAAAAATTCTAGTTGGTTTAACGCGT,TGTCAATTTTCATTTAAAAATACAGCATGTGGGATTCGCAACCTAAATGAGACAAAAAGCTAAAAAATAACAAGTTTTAAAAAAATTCTAGTTGGTTTA,10,30,14,27,27,45,27,51,27,38,38,45,44,51,19.05,0.0
hek293t,8558,1,12,CTGTTAGAACAGAGAGCAGCCACACAGCCAGGTTTCAGAAGGGACAGAAAGGAGGAGTTTTTCCTGGATAAAAAAATTCTAGTTGGTTTAACGCGTAAC,CTGTTAGAACAGAGAGCAGCCACACAGCCAGGTTTCCGACGGGTCTTCAGAAGGGACAGAAAGGAGGAGTTTTTCCTGGATAAAAAAATTCTAGTTGGT,10,30,14,27,27,42,27,54,27,35,35,42,47,54,36.42,0.127969468
hek293t,8558,1,12,TCAGTAGAACAGAGAGCAGCCACACAGCCAGGTTTCAGAAGGGACAGAAAGGAGGAGTTTTTCCTGAAAAAAATTCTAGTTGGTTTAACGCGTAACTAG,TCAGTAGAACAGAGAGCAGCCACACAGCCAGGTTTCCGACGGGTCTTCAGAAGGGACAGAAAGGAGGAGTTTTTCCTGAAAAAAATTCTAGTTGGTTTA,10,30,14,27,27,45,27,57,27,35,35,45,47,57,36.42,2.11235188
hek293t,8560,1,13,CTAGCAAAGTGAATCCTTTTCCCAAAGACCGGTAGGTGTTTGTACTGCCACCTGGAAGGAGAGATGCAAAAAAATTCTAGTTGGTTTAACGCGTAACTA,CTAGCAAAGTGAATCCTTTTCCCAAAGACCGGTAGGTGTCTACTACTCTCCCTTGTACTGCCACCTGGAAGGAGAGATGCAAAAAAATTCTAGTTGGTT,10,30,14,27,27,43,27,56,27,40,40,43,53,56,49.96,0.0
hek293t,8561,1,13,GATAAAAGACTTTCAAAATAGCAAGAAAGGGGACTTATCAAAGCGTTTTGAGGCTAGCCAAACAATTAGCACGGAAAAAAATTCTAGTTGGTTTAACGC,GATAAAAGACTTTCAAAATAGCAAGAAAGGGGGAGAAGCACATGGACTTATCAAAGCGTTTTGAGGCTAGCCAAACAATTAGCACGGAAAAAAATTCTA,10,30,14,27,27,36,27,49,27,33,33,36,46,49,27.72,0.0
hek293t,8562,1,5,TACATACACCTGTTCTTAATCCTCCAAGCAGGAATAATACCCTCTACACTGTCCAGTACTGCTATGCCTGAGAAAAAAAATTCTAGTTGGTTTAACGCG,TACATACACCTGTTCTTAATCCTCCAAGCAGGAAAATGATAATACCCTCTACACTGTCCAGTACTGCTATGCCTGAGAAAAAAAATTCTAGTTGGTTTA,10,30,14,27,27,45,27,50,27,35,35,45,40,50,45.15,7.412168537
hek293t,8562,1,5,ATCGTACACCTGTTCTTAATCCTCCAAGCAGGAATAATACCCTCTACACTGTCCAGTACTGCTATGCCAAAAAAATTCTAGTTGGTTTAACGCGTAACT,ATCGTACACCTGTTCTTAATCCTCCAAGCAGGAAAATGATAATACCCTCTACACTGTCCAGTACTGCTATGCCAAAAAAATTCTAGTTGGTTTAACGCG,10,30,14,27,27,50,27,55,27,35,35,50,40,55,45.15,24.53887925
hek293t,8565,1,12,GCTGCAGAGACTGGTCCAGCAGGTGCCCCAGGTCCAGTGGGTGCCCGTGGTGGTCCTGTAAGTAAGAGTTCTAAAAAAATTCTAGTTGGTTTAACGCGT,GCTGCAGAGACTGGTCCAGCAGGTGCCCCAGGTCCTGTACATCGGCGAGTGGGTGCCCGTGGTGGTCCTGTAAGTAAGAGTTCTAAAAAAATTCTAGTT,10,30,14,27,27,39,27,51,27,36,36,39,48,51,52.37,0.975913387
hek293t,8566,1,11,GTACGCTGAAGCTGTCCTATGCAGCTCTCTGGGCATGCTGGAGGGCAGCACTGGGAGAGACTCTCAAAAAAAAAATTCTAGTTGGTTTAACGCGTAACT,GTACGCTGAAGCTGTCCTATGCAGCTCTCTGGGCATGCTGTGGTTGATAACGAGGGCAGCACTGGGAGAGACTCTCAAAAAAAAAATTCTAGTTGGTTT,10,30,14,27,27,44,27,55,27,41,41,44,52,55,14.55,0.0
hek293t,8567,1,11,TTCCCTGTTAGATAGTGAAAGATGCTGCCTGGCTTTTTCCTCTGCACAATTAAATGTCTCAACTCACTAAAAAAAATTCTAGTTGGTTTAACGCGTAAC,TTCCCTGTTAGATAGTGAAAGATGCTGACGGCTAGCAACCTGGCTTTTTCCTCTGCACAATTAAATGTCTCAACTCACTAAAAAAAATTCTAGTTGGTT,10,30,14,27,27,43,27,54,27,28,28,43,39,54,65.91,32.04751497
hek293t,7822,1,3,ATCGGGATTTATAGGAGCTCTCATAGCTGGGGCAGGTGGCACAGGGATATTTATAGCCATCTTCCCCGCAGAACAGAAAAAAATTCTAGTTGGTTTAAC,ATCGGGATTTATAGGAGCTCTCATAGCTGGGGCAGGTGGCACGACAGGGATATTTATAGCCATCTTCCCCGCAGAACAGAAAAAAATTCTAGTTGGTTT,10,30,14,27,27,44,27,47,27,41,41,44,44,47,68.34,1.353738554
hek293t,7822,1,3,ACGCTGATTTATAGGAGCTCTCATAGCTGGGGCAGGTGGCACAGGGATATTTATAGCCATCTTCCCCGCAGAAAAAAAATTCTAGTTGGTTTAACGCGT,ACGCTGATTTATAGGAGCTCTCATAGCTGGGGCAGGTGGCACGACAGGGATATTTATAGCCATCTTCCCCGCAGAAAAAAAATTCTAGTTGGTTTAACG,10,30,14,27,27,48,27,51,27,41,41,48,44,51,68.34,46.80635148
hek293t,8571,1,7,AGTGTTCACAGGAGGATCATGCCTTAAGTAGGATTTTGAGGGTAAATACTGAGAAGGATTTGTGAGTCTTCCACACAGTTAGGTAAAAAAAATTCTAGT,AGTGTTCACAGGAGGATCATGCCTTAAAATAATAGTAGGATTTTGAGGGTAAATACTGAGAAGGATTTGTGAGTCTTCCACACAGTTAGGTAAAAAAAA,10,30,14,27,27,31,27,38,27,28,28,31,35,38,49.59,0.0
hek293t,8571,1,7,CGCGTTCACAGGAGGATCATGCCTTAAGTAGGATTTTGAGGGTAAATACTGAGAAGGATTTGTGAGTCTTCCACACAGTTAAAAAAAATTCTAGTTGGT,CGCGTTCACAGGAGGATCATGCCTTAAAATAATAGTAGGATTTTGAGGGTAAATACTGAGAAGGATTTGTGAGTCTTCCACACAGTTAAAAAAAATTCT,10,30,14,27,27,35,27,42,27,28,28,35,35,42,49.59,5.617937171
hek293t,8573,1,14,CCCACTTTTAACCTTCGAGCCTGTGAGGAAGGCAAGAATGGAATAACATCTATAGAGAAAGAAGACACTGAAAAAAATTCTAGTTGGTTTAACGCGTAA,CCCACTTTTAACCTTCGAGCCTGTGAGGTAAACGATTCTTGTAAGGCAAGAATGGAATAACATCTATAGAGAAAGAAGACACTGAAAAAAATTCTAGTT,10,30,14,27,27,39,27,53,27,29,29,39,43,53,38.7,7.109743458
hek293t,8573,1,14,CGGATTTTTAACCTTCGAGCCTGTGAGGAAGGCAAGAATGGAATAACATCTATAGAGAAAGAAGACACTGGAGAAAAAAATTCTAGTTGGTTTAACGCG,CGGATTTTTAACCTTCGAGCCTGTGAGGTAAACGATTCTTGTAAGGCAAGAATGGAATAACATCTATAGAGAAAGAAGACACTGGAGAAAAAAATTCTA,10,30,14,27,27,36,27,50,27,29,29,36,43,50,38.7,1.111026966
hek293t,8580,1,1,CATGTATGAAGAGTATACTTTTTTCAGAATGGTACATTTCTATTATTCTGTATTGGACAAACATTGTTTGAAGTGGCGAAATAAAAAAATTCTAGTTGG,CATGTATGAAGAGTATACTTTTTTCAGAATGGTACAGTTTCTATTATTCTGTATTGGACAAACATTGTTTGAAGTGGCGAAATAAAAAAATTCTAGTTG,10,30,14,27,27,40,27,41,27,37,37,40,38,41,9.24,0.0
hek293t,8580,1,1,GTAGCATGAAGAGTATACTTTTTTCAGAATGGTACATTTCTATTATTCTGTATTGGACAAACATTGTTTGAAGTGGCGAAAAAAATTCTAGTTGGTTTA,GTAGCATGAAGAGTATACTTTTTTCAGAATGGTACAGTTTCTATTATTCTGTATTGGACAAACATTGTTTGAAGTGGCGAAAAAAATTCTAGTTGGTTT,10,30,14,27,27,44,27,45,27,37,37,44,38,45,9.24,0.579046469
hek293t,8582,1,5,ATATAGCTGGTCTTCCTTATATAAGATCCTGGAGAATCAGACAGTACCAGTGATAAAGCCTATACAAAATAATGCAGAAAAAAATTCTAGTTGGTTTAA,ATATAGCTGGTCTTCCTTATATAAGATCCTGGAGGCGTGAATCAGACAGTACCAGTGATAAAGCCTATACAAAATAATGCAGAAAAAAATTCTAGTTGG,10,30,14,27,27,41,27,46,27,34,34,41,39,46,48.09,3.070294156
hek293t,8582,1,5,TAATTGCTGGTCTTCCTTATATAAGATCCTGGAGAATCAGACAGTACCAGTGATAAAGCCTATACAAAATAATGAAAAAAATTCTAGTTGGTTTAACGC,TAATTGCTGGTCTTCCTTATATAAGATCCTGGAGGCGTGAATCAGACAGTACCAGTGATAAAGCCTATACAAAATAATGAAAAAAATTCTAGTTGGTTT,10,30,14,27,27,44,27,49,27,34,34,44,39,49,48.09,15.12453057
hek293t,8584,1,9,GCCTGTTCGATTTTATTAGCATACAATCCTGGCACAAGGTAATTTATGAAACAGAGAAAGATGCAAAAAAAAAAAAATTCTAGTTGGTTTAACGCGTAA,GCCTGTTCGATTTTATTAGCATACAATCCTGGCACAAGCACCTTAAGGTAATTTATGAAACAGAGAAAGATGCAAAAAAAAAAAAATTCTAGTTGGTTT,10,30,14,27,27,44,27,53,27,37,37,44,46,53,39.18,0.0
hek293t,8586,1,10,AGTTCAAAGAGAATCCTCATGGAAACCACAGGATCATGTGTGAGCCCTCTGTAATTGCATTCCACATAAAAAAATTCTAGTTGGTTTAACGCGTAACTA,AGTTCAAAGAGAATCCTCATGGAAACCACACTAATCAGGTGGATCATGTGTGAGCCCTCTGTAATTGCATTCCACATAAAAAAATTCTAGTTGGTTTAA,10,30,14,27,27,46,27,56,27,31,31,46,41,56,55.24,21.67367961
hek293t,8586,1,10,CCGCTAAAGAGAATCCTCATGGAAACCACAGGATCATGTGTGAGCCCTCTGTAATTGCATTCCACATTAAAGCAGAAAAAAATTCTAGTTGGTTTAACG,CCGCTAAAGAGAATCCTCATGGAAACCACACTAATCAGGTGGATCATGTGTGAGCCCTCTGTAATTGCATTCCACATTAAAGCAGAAAAAAATTCTAGT,10,30,14,27,27,38,27,48,27,31,31,38,41,48,55.24,19.33596465
hek293t,8588,1,7,CTCTGAACAAAAACAACTCTCCCCAAACCTGGTCATGTGGCGAGAACAAAATAGAGGGGAACAATGCCAAAGCTTAGTAGGATAAAAAAATTCTAGTTG,CTCTGAACAAAAACAACTCTCCCCAAACCTGTAAATTGGTCATGTGGCGAGAACAAAATAGAGGGGAACAATGCCAAAGCTTAGTAGGATAAAAAAATT,10,30,14,27,27,33,27,40,27,30,30,33,37,40,54.91,1.66695849
hek293t,8588,1,7,TTTCCAACAAAAACAACTCTCCCCAAACCTGGTCATGTGGCGAGAACAAAATAGAGGGGAACAATGCCAAAGCTTAAAAAAAATTCTAGTTGGTTTAAC,TTTCCAACAAAAACAACTCTCCCCAAACCTGTAAATTGGTCATGTGGCGAGAACAAAATAGAGGGGAACAATGCCAAAGCTTAAAAAAAATTCTAGTTG,10,30,14,27,27,40,27,47,27,30,30,40,37,47,54.91,19.91092229
hek293t,8590,1,10,GAGAGTTGTTAAGGATGTCCTACATACTTTGGCAAATATTGATGACATTGGTAAAAGAAGATAGAGTAGCTTACGAAAAAAATTCTAGTTGGTTTAACG,GAGAGTTGTTAAGGATGTCCTACATACTTTTCTGCCAAGAGGCAAATATTGATGACATTGGTAAAAGAAGATAGAGTAGCTTACGAAAAAAATTCTAGT,10,30,14,27,27,38,27,48,27,31,31,38,41,48,50.79,2.206402059
hek293t,8590,1,10,CTATGTTGTTAAGGATGTCCTACATACTTTGGCAAATATTGATGACATTGGTAAAAGAAGATAGAGTAAAAAAATTCTAGTTGGTTTAACGCGTAACTA,CTATGTTGTTAAGGATGTCCTACATACTTTTCTGCCAAGAGGCAAATATTGATGACATTGGTAAAAGAAGATAGAGTAAAAAAATTCTAGTTGGTTTAA,10,30,14,27,27,46,27,56,27,31,31,46,41,56,50.79,3.600751539
hek293t,8592,1,11,GCCCTGATTGCTTCAGTTACCTCCTCACTAGGTATAACAAATACATCTATTAAAATTCTCTCCAGTTAAAAAAAATTCTAGTTGGTTTAACGCGTAACT,GCCCTGATTGCTTCAGTTACCTCCTCACTAGGTATAACAATCCTTAAGGTGATACATCTATTAAAATTCTCTCCAGTTAAAAAAAATTCTAGTTGGTTT,10,30,14,27,27,44,27,55,27,41,41,44,52,55,43.08,1.246995631
hek293t,8592,1,11,GTTCAGATTGCTTCAGTTACCTCCTCACTAGGTATAACAAATACATCTATTAAAATTCTCTCCAAAAAAAATTCTAGTTGGTTTAACGCGTAACTAGAT,GTTCAGATTGCTTCAGTTACCTCCTCACTAGGTATAACAATCCTTAAGGTGATACATCTATTAAAATTCTCTCCAAAAAAAATTCTAGTTGGTTTAACG,10,30,14,27,27,48,27,59,27,41,41,48,52,59,43.08,0.072150072
hek293t,8594,1,10,TTTCGTGGTTAAGTCAACTGCTATGTATTTGGTCAGGACCACTATCCGAAGGGACGTATGTAACATTAACAAAAAAATTCTAGTTGGTTTAACGCGTAA,TTTCGTGGTTAAGTCAACTGCTATGTATTTGGTCAATGCTAACTGGGACCACTATCCGAAGGGACGTATGTAACATTAACAAAAAAATTCTAGTTGGTT,10,30,14,27,27,43,27,53,27,36,36,43,46,53,25.81,18.83113937
hek293t,8595,1,14,ATCTATAAAAAACATTTCATCAGGAAACGTGGTCTTTCTGATGCTCGGTGCTTCAGCTTCCTATACAAAAAAATTCTAGTTGGTTTAACGCGTAACTAG,ATCTATAAAAAACATTTCATCAGGAAACGTGGTCTTTCTACCGTAGTTTAATTGATGCTCGGTGCTTCAGCTTCCTATACAAAAAAATTCTAGTTGGTT,10,30,14,27,27,43,27,57,27,40,40,43,54,57,41.25,0.0
hek293t,8596,1,2,TTCAAAGTAAAAATCTTGTATCTAATGCAAGGTGTTTTATGGAAGCTTCTCTTTTATATCATAATCTGTCACAAAAAAATTCTAGTTGGTTTAACGCGT,TTCAAAGTAAAAATCTTGTATCTAATGCAAGGTGTTTTCAATGGAAGCTTCTCTTTTATATCATAATCTGTCACAAAAAAATTCTAGTTGGTTTAACGC,10,30,14,27,27,49,27,51,27,39,39,49,41,51,53.64,38.97188557
hek293t,8596,1,2,GCTGAAGTAAAAATCTTGTATCTAATGCAAGGTGTTTTATGGAAGCTTCTCTTTTATATCATAATCTAAAAAAATTCTAGTTGGTTTAACGCGTAACTA,GCTGAAGTAAAAATCTTGTATCTAATGCAAGGTGTTTTCAATGGAAGCTTCTCTTTTATATCATAATCTAAAAAAATTCTAGTTGGTTTAACGCGTAAC,10,30,14,27,27,54,27,56,27,39,39,54,41,56,53.64,28.92648521
hek293t,8598,1,4,GCTCCTTTTGCCTTAGCTCCTGGTTTTCTTGGAATCTAAACCTTATTTGTAAGCTAACATTTAGGCAGAACTTGAGAAAAAAATTCTAGTTGGTTTAAC,GCTCCTTTTGCCTTAGCTCCTGGTTTTGATCCTTGGAATCTAAACCTTATTTGTAAGCTAACATTTAGGCAGAACTTGAGAAAAAAATTCTAGTTGGTT,10,30,14,27,27,43,27,47,27,28,28,43,32,47,4.05,81.03935743
hek293t,8598,1,4,GACGATTTTGCCTTAGCTCCTGGTTTTCTTGGAATCTAAACCTTATTTGTAAGCTAACATTTAGGCAGAACTTGAGCCTAGCTTAGATAAAAAAATTCT,GACGATTTTGCCTTAGCTCCTGGTTTTGATCCTTGGAATCTAAACCTTATTTGTAAGCTAACATTTAGGCAGAACTTGAGCCTAGCTTAGATAAAAAAA,10,30,14,27,27,31,27,35,27,28,28,31,32,35,4.05,0.71360738
hek293t,8600,1,15,GGGGGATGCTTACCAACACCCCCCCCAACTGGAAAACAAAAATAAATGCAACAACCTTAACATTCTTCCCAAAAAAAATTCTAGTTGGTTTAACGCGTA,GGGGGATGCTTACCAACACCCCCCCCAACTGGAGGACTCCGCGAAAAAAAACAAAAATAAATGCAACAACCTTAACATTCTTCCCAAAAAAAATTCTAG,10,30,14,27,27,37,27,52,27,34,34,37,49,52,36.11,0.0
hek293t,8601,1,13,TGCACGTGACGATACCATTGCCTATAGAAAGGAAGGTCAGATTATTGCAGAGGAAGAGCTGGATAAAAAAATTCTAGTTGGTTTAACGCGTAACTAGAT,TGCACGTGACGATACCATTGCCTATAGAAAGGAAGGTCCCTGACAGAATCGAGATTATTGCAGAGGAAGAGCTGGATAAAAAAATTCTAGTTGGTTTAA,10,30,14,27,27,46,27,59,27,39,39,46,52,59,63.85,0.317998715
hek293t,8601,1,13,TACGTGTGACGATACCATTGCCTATAGAAAGGAAGGTCAGATTATTGCAGAGGAAGAGCTGGATAGCTAAAAAAATTCTAGTTGGTTTAACGCGTAACT,TACGTGTGACGATACCATTGCCTATAGAAAGGAAGGTCCCTGACAGAATCGAGATTATTGCAGAGGAAGAGCTGGATAGCTAAAAAAATTCTAGTTGGT,10,30,14,27,27,42,27,55,27,39,39,42,52,55,63.85,0.0
hek293t,8603,1,3,GCCATGGGGGTGGAGAGGGAAGAGGAATGAGGAGAAGGGCTGCAACAGTGAGATTACTGCAAACAAGTTGTAAAAAAATTCTAGTTGGTTTAACGCGTA,GCCATGGGGGTGGAGAGGGAAGAGGAATGAGGACGCGAAGGGCTGCAACAGTGAGATTACTGCAAACAAGTTGTAAAAAAATTCTAGTTGGTTTAACGC,10,30,14,27,27,49,27,52,27,34,34,49,37,52,59.9,60.81882749
hek293t,8603,1,3,ATACGGGGGGTGGAGAGGGAAGAGGAATGAGGAGAAGGGCTGCAACAGTGAGATTACTGCAAACAAGTTGTAAATGATTAAAAAAATTCTAGTTGGTTT,ATACGGGGGGTGGAGAGGGAAGAGGAATGAGGACGCGAAGGGCTGCAACAGTGAGATTACTGCAAACAAGTTGTAAATGATTAAAAAAATTCTAGTTGG,10,30,14,27,27,41,27,44,27,34,34,41,37,44,59.9,66.49973966
hek293t,8605,1,4,TATGCAGGTTGGGGGAGGTCTTCTCCGCATGGTGCACAGCACAGGAGAGCAACTCGGCCTCCTGCACGGCCCAGAGCTTTCGCTGAAAAAAAATTCTAG,TATGCAGGTTGGGGGAGGTCTTCTCCGCAACCTTGGTGCACAGCACAGGAGAGCAACTCGGCCTCCTGCACGGCCCAGAGCTTTCGCTGAAAAAAAATT,10,30,14,27,27,33,27,37,27,30,30,33,34,37,50.48,1.102653531
hek293t,8607,1,6,ATGCAGATAGTAGAAGACACTGATCCTGAAGGTAAGTGTGGTCAAAATATAGCTTGCTCTTACTTGCCACCTTTAAAAAAATTCTAGTTGGTTTAACGC,ATGCAGATAGTAGAAGACACTGATCCTGAAGGTAAAAGTACGTGTGGTCAAAATATAGCTTGCTCTTACTTGCCACCTTTAAAAAAATTCTAGTTGGTT,10,30,14,27,27,43,27,49,27,36,36,43,42,49,55.36,3.080982674
hek293t,8607,1,6,CAGCCGATAGTAGAAGACACTGATCCTGAAGGTAAGTGTGGTCAAAATATAGCTTGCTCTTACTTGAAAAAAATTCTAGTTGGTTTAACGCGTAACTAG,CAGCCGATAGTAGAAGACACTGATCCTGAAGGTAAAAGTACGTGTGGTCAAAATATAGCTTGCTCTTACTTGAAAAAAATTCTAGTTGGTTTAACGCGT,10,30,14,27,27,51,27,57,27,36,36,51,42,57,55.36,8.516777888
hek293t,8609,1,15,ATTTTAAAAGGATGGTTGGTGGGTTATAGTGGCAGATTCTGCGTTCAAAGGAAAGGCTGAAGAAGCAAAAAAATTCTAGTTGGTTTAACGCGTAACTAG,ATTTTAAAAGGATGGTTGGTGGGTTATAGTGGCAGATTATCCGTTCATGCCGGCTGCGTTCAAAGGAAAGGCTGAAGAAGCAAAAAAATTCTAGTTGGT,10,30,14,27,27,42,27,57,27,39,39,42,54,57,41.14,0.0
hek293t,8610,1,4,ACATAACAAAATGCCTGAGGTGCCTCATTTGGCAGGTGCTGAAAGCAGTCTCAGCCTGCAGTCATGTTGTTAAAACATGGTGCAAAAAAATTCTAGTTG,ACATAACAAAATGCCTGAGGTGCCTCATTTGGTTTACAGGTGCTGAAAGCAGTCTCAGCCTGCAGTCATGTTGTTAAAACATGGTGCAAAAAAATTCTA,10,30,14,27,27,36,27,40,27,33,33,36,37,40,15.32,2.252211467
hek293t,8610,1,4,GCGGGACAAAATGCCTGAGGTGCCTCATTTGGCAGGTGCTGAAAGCAGTCTCAGCCTGCAGTCATGTTGTTAAAACATGAAAAAAATTCTAGTTGGTTT,GCGGGACAAAATGCCTGAGGTGCCTCATTTGGTTTACAGGTGCTGAAAGCAGTCTCAGCCTGCAGTCATGTTGTTAAAACATGAAAAAAATTCTAGTTG,10,30,14,27,27,40,27,44,27,33,33,40,37,44,15.32,79.54745616
hek293t,8612,1,9,GAGCACTATCTCAGAGCCAGTTCCTCCAATGGATGTGAAGCAAAACTGTTTCCTTCCCTTGTCCAGTAACAAAAAAAATTCTAGTTGGTTTAACGCGTA,GAGCACTATCTCAGAGCCAGTTCCTCCAATGGATGTTGGTTAAATGAAGCAAAACTGTTTCCTTCCCTTGTCCAGTAACAAAAAAAATTCTAGTTGGTT,10,30,14,27,27,43,27,52,27,36,36,43,45,52,34.45,0.0
hek293t,8613,1,14,CATCTGTAGCTGTCTTAAAATAGGGGTAAAGGGAATTCGAACAGGATTGTTACATACTGGTTTATTTTTAATAACTAGAAAAAAATTCTAGTTGGTTTA,CATCTGTAGCTGTCTTAAAATAGGGGTTAGGAACGAGTTTAAAAGGGAATTCGAACAGGATTGTTACATACTGGTTTATTTTTAATAACTAGAAAAAAA,10,30,14,27,27,31,27,45,27,28,28,31,42,45,13.07,0.0
hek293t,8613,1,14,CATTCGTAGCTGTCTTAAAATAGGGGTAAAGGGAATTCGAACAGGATTGTTACATACTGGTTTATTTTTAATAAAAAAAAATTCTAGTTGGTTTAACGC,CATTCGTAGCTGTCTTAAAATAGGGGTTAGGAACGAGTTTAAAAGGGAATTCGAACAGGATTGTTACATACTGGTTTATTTTTAATAAAAAAAAATTCT,10,30,14,27,27,35,27,49,27,28,28,35,42,49,13.07,0.0
hek293t,8615,1,1,AACAAAACCCAAATACTGCCAGGCACGTCAGGCTCCCATTAGTGCCGGCACCACCAGTTAGTCACGGGCTTGATCAAAAAAATTCTAGTTGGTTTAACG,AACAAAACCCAAATACTGCCAGGCACGTCAGGCTCCCCATTAGTGCCGGCACCACCAGTTAGTCACGGGCTTGATCAAAAAAATTCTAGTTGGTTTAAC,10,30,14,27,27,47,27,48,27,37,37,47,38,48,25.92,77.81772069
hek293t,16046,1,12,CATTGGAGAGTTCAGCCTCTTGTATTCAGTGGGTTCCACTATTGCCAAAGAAAGGGACAGCCTTGTTTAAAAAAATTCTAGTTGGTTTAACGCGTAACT,CATTGGAGAGTTCAGCCTCTTGTATTCAGTGGGTTCCACGGCGATGTTTCGTATTGCCAAAGAAAGGGACAGCCTTGTTTAAAAAAATTCTAGTTGGTT,10,30,14,27,27,43,27,55,27,40,40,43,52,55,41.62,0.297718093
hek293t,16046,1,12,AGCAAGAGAGTTCAGCCTCTTGTATTCAGTGGGTTCCACTATTGCCAAAGAAAGGGACAGCCTTAAAAAAATTCTAGTTGGTTTAACGCGTAACTAGAT,AGCAAGAGAGTTCAGCCTCTTGTATTCAGTGGGTTCCACGGCGATGTTTCGTATTGCCAAAGAAAGGGACAGCCTTAAAAAAATTCTAGTTGGTTTAAC,10,30,14,27,27,47,27,59,27,40,40,47,52,59,41.62,2.010256883
hek293t,8620,1,6,CGAAGTACTGGAATTGCATACCCACACTAAGGAGGAAAAATATTCCAAATAGTAAGTTCACGTCATGCAACTCATTTCCAAAAAAATTCTAGTTGGTTT,CGAAGTACTGGAATTGCATACCCACACTAATCACCGGGAGGAAAAATATTCCAAATAGTAAGTTCACGTCATGCAACTCATTTCCAAAAAAATTCTAGT,10,30,14,27,27,38,27,44,27,31,31,38,37,44,66.47,26.8220987
hek293t,8622,1,12,AAGTAGAGAGTAGCATCTTCTCAACAGCAAGGCATTCTTGGGGGATGAGGATGAGAGGATTAGACTGAGGAAAAAAATTCTAGTTGGTTTAACGCGTAA,AAGTAGAGAGTAGCATCTTCTCAACAGCAATCTGACAACCTAGGCATTCTTGGGGGATGAGGATGAGAGGATTAGACTGAGGAAAAAAATTCTAGTTGG,10,30,14,27,27,41,27,53,27,31,31,41,43,53,69.07,4.437124277
hek293t,8622,1,12,GCGTCGAGAGTAGCATCTTCTCAACAGCAAGGCATTCTTGGGGGATGAGGATGAGAGGATTAGACTGAGGACCATTTAAAAAAATTCTAGTTGGTTTAA,GCGTCGAGAGTAGCATCTTCTCAACAGCAATCTGACAACCTAGGCATTCTTGGGGGATGAGGATGAGAGGATTAGACTGAGGACCATTTAAAAAAATTC,10,30,14,27,27,34,27,46,27,31,31,34,43,46,69.07,1.796756314
hek293t,8624,1,12,TTACATAGCACAGCTTCTCTCAGCCTCTGAGGCTAAGTCCTGCTGCATGGTATGGCTGGGCAATAAATCCAGAAGAAAAAAATTCTAGTTGGTTTAACG,TTACATAGCACAGCTTCTCTCAGCCTCTTGGCGTTACTATGAGGCTAAGTCCTGCTGCATGGTATGGCTGGGCAATAAATCCAGAAGAAAAAAATTCTA,10,30,14,27,27,36,27,48,27,29,29,36,41,48,52.65,1.706137952
hek293t,8624,1,12,GGCATTAGCACAGCTTCTCTCAGCCTCTGAGGCTAAGTCCTGCTGCATGGTATGGCTGGGCAATAAATCCAGAAGGTACAAAAAAATTCTAGTTGGTTT,GGCATTAGCACAGCTTCTCTCAGCCTCTTGGCGTTACTATGAGGCTAAGTCCTGCTGCATGGTATGGCTGGGCAATAAATCCAGAAGGTACAAAAAAAT,10,30,14,27,27,32,27,44,27,29,29,32,41,44,52.65,3.692256086
hek293t,8626,1,3,CAATTAGTGCTAACCCCAGCACTGTGCCGAGGAAAAACTGGTGGACCAGTGAAAGCAGTGAAAGGAAACATGTTTGGAAAAAAATTCTAGTTGGTTTAA,CAATTAGTGCTAACCCCAGCACTGTGCCGAGGAAAAACTCGTGGTGGACCAGTGAAAGCAGTGAAAGGAAACATGTTTGGAAAAAAATTCTAGTTGGTT,10,30,14,27,27,43,27,46,27,40,40,43,43,46,64.13,0.0
hek293t,8626,1,3,CTGAAAGTGCTAACCCCAGCACTGTGCCGAGGAAAAACTGGTGGACCAGTGAAAGCAGTGAAAGGAAACATGTAAAAAAATTCTAGTTGGTTTAACGCG,CTGAAAGTGCTAACCCCAGCACTGTGCCGAGGAAAAACTCGTGGTGGACCAGTGAAAGCAGTGAAAGGAAACATGTAAAAAAATTCTAGTTGGTTTAAC,10,30,14,27,27,47,27,50,27,40,40,47,43,50,64.13,0.410675069
hek293t,8628,1,4,TCCTGTAGAAATGTGCCAGTTACTAGGGGTGGTGGACTGAGCAAATTTCTTGTCAAACTACTCGGTCAGTGCAAAAAAAATTCTAGTTGGTTTAACGCG,TCCTGTAGAAATGTGCCAGTTACTAGGGGTACGAGGTGGACTGAGCAAATTTCTTGTCAAACTACTCGGTCAGTGCAAAAAAAATTCTAGTTGGTTTAA,10,30,14,27,27,46,27,50,27,31,31,46,35,50,42.44,66.60189861
hek293t,8628,1,4,GCGACTAGAAATGTGCCAGTTACTAGGGGTGGTGGACTGAGCAAATTTCTTGTCAAACTACTCGGTCAGTGCAGTGATAAAAAAATTCTAGTTGGTTTA,GCGACTAGAAATGTGCCAGTTACTAGGGGTACGAGGTGGACTGAGCAAATTTCTTGTCAAACTACTCGGTCAGTGCAGTGATAAAAAAATTCTAGTTGG,10,30,14,27,27,41,27,45,27,31,31,41,35,45,42.44,85.31995766
hek293t,8630,1,14,AGTCGACCGTGCCATTGCCTTATGGCAGTTGGTACAAAATTAAGTATTTCCCCATGCAGAGTTCATTAGGAAAAAAATTCTAGTTGGTTTAACGCGTAA,AGTCGACCGTGCCATTGCCTTATGGCAGTTGGCGCTGGCGGGAGTGTACAAAATTAAGTATTTCCCCATGCAGAGTTCATTAGGAAAAAAATTCTAGTT,10,30,14,27,27,39,27,53,27,32,32,39,46,53,19.62,0.0
hek293t,8630,1,14,AAACCACCGTGCCATTGCCTTATGGCAGTTGGTACAAAATTAAGTATTTCCCCATGCAGAGTTCATTAGGCATCAAAAAAATTCTAGTTGGTTTAACGC,AAACCACCGTGCCATTGCCTTATGGCAGTTGGCGCTGGCGGGAGTGTACAAAATTAAGTATTTCCCCATGCAGAGTTCATTAGGCATCAAAAAAATTCT,10,30,14,27,27,35,27,49,27,32,32,35,46,49,19.62,0.149031297
hek293t,8632,1,8,GGCAACTTGACTCCGTACAAAGGGTTGGTTGGCATAGCTAAGGAAGTGACATTCCCTTGTAAAATCAGAAAAAAATTCTAGTTGGTTTAACGCGTAACT,GGCAACTTGACTCCGTACAAAGGGTTGGTTGGCATATGCTTTGTGCTAAGGAAGTGACATTCCCTTGTAAAATCAGAAAAAAATTCTAGTTGGTTTAAC,10,30,14,27,27,47,27,55,27,37,37,47,45,55,53.02,4.480838019
hek293t,8633,1,6,GGCTCCCCCTTTTGAGCATTAGTCGTGTATGGTTAAGCCATGAACATGTTTATGGAGTGGAGTGATAACCTGATGGTGTTGAAAAAAATTCTAGTTGGT,GGCTCCCCCTTTTGAGCATTAGTCGTGTCGACGAATGGTTAAGCCATGAACATGTTTATGGAGTGGAGTGATAACCTGATGGTGTTGAAAAAAATTCTA,10,30,14,27,27,36,27,42,27,29,29,36,35,42,22.56,0.794798342
hek293t,8633,1,6,GAGATCCCCTTTTGAGCATTAGTCGTGTATGGTTAAGCCATGAACATGTTTATGGAGTGGAGTGATAACCTGAAAAAAAATTCTAGTTGGTTTAACGCG,GAGATCCCCTTTTGAGCATTAGTCGTGTCGACGAATGGTTAAGCCATGAACATGTTTATGGAGTGGAGTGATAACCTGAAAAAAAATTCTAGTTGGTTT,10,30,14,27,27,44,27,50,27,29,29,44,35,50,22.56,4.78433468
hek293t,8635,1,14,TATCTGATTACTGCAACCCAGTGACTATGAGGATACCCTCATAGACTCCTTTGCTGATGTGTCTGCCAAAAAAATTCTAGTTGGTTTAACGCGTAACTA,TATCTGATTACTGCAACCCAGTGACTATGAGTCTTTCGAAACTAAGATACCCTCATAGACTCCTTTGCTGATGTGTCTGCCAAAAAAATTCTAGTTGGT,10,30,14,27,27,42,27,56,27,32,32,42,46,56,59.99,19.94261526
hek293t,8637,1,3,CTCGAGCTATCTGTAGCTGTTGTTCACTAAGGGTGCTTTCTGGAAGACTGAGTAGCCAGGGTAGACTTCTCATTAAAAAAATTCTAGTTGGTTTAACGC,CTCGAGCTATCTGTAGCTGTTGTTCACTAAGGGTGCTTGTATCTGGAAGACTGAGTAGCCAGGGTAGACTTCTCATTAAAAAAATTCTAGTTGGTTTAA,10,30,14,27,27,46,27,49,27,39,39,46,42,49,46.48,76.95455639
hek293t,8637,1,3,TTATCGCTATCTGTAGCTGTTGTTCACTAAGGGTGCTTTCTGGAAGACTGAGTAGCCAGGGTAGACTTCTCATTGTTGAAAAAAATTCTAGTTGGTTTA,TTATCGCTATCTGTAGCTGTTGTTCACTAAGGGTGCTTGTATCTGGAAGACTGAGTAGCCAGGGTAGACTTCTCATTGTTGAAAAAAATTCTAGTTGGT,10,30,14,27,27,42,27,45,27,39,39,42,42,45,46.48,0.0
hek293t,17674,1,1,TGACTATTAATCTAGGAGGAAAAAGTGGGTGGTGGCAGGGAAGAGAAGGAGTGCCATCTCTAGGTGCTTGAAAGTGAGATAAAAAAATTCTAGTTGGTT,TGACTATTAATCTAGGAGGAAAAAGTGGGTGGTGTGCAGGGAAGAGAAGGAGTGCCATCTCTAGGTGCTTGAAAGTGAGATAAAAAAATTCTAGTTGGT,10,30,14,27,27,42,27,43,27,35,35,42,36,43,48.23,3.468559722
hek293t,8642,1,7,GAACCATTACAAAAGAGAAATTAAGTGTGTGGCAAGCAGATTTTATAATTGCTGCAAGTCAAACTCAGATTATAAAAAAATTCTAGTTGGTTTAACGCG,GAACCATTACAAAAGAGAAATTAAGTGTGTGGATCATACCAAGCAGATTTTATAATTGCTGCAAGTCAAACTCAGATTATAAAAAAATTCTAGTTGGTT,10,30,14,27,27,43,27,50,27,33,33,43,40,50,56.84,0.974310912
hek293t,8642,1,7,TTCGAATTACAAAAGAGAAATTAAGTGTGTGGCAAGCAGATTTTATAATTGCTGCAAGTCAAACTCAGATTATGCTAATTAAAAAAATTCTAGTTGGTT,TTCGAATTACAAAAGAGAAATTAAGTGTGTGGATCATACCAAGCAGATTTTATAATTGCTGCAAGTCAAACTCAGATTATGCTAATTAAAAAAATTCTA,10,30,14,27,27,36,27,43,27,33,33,36,40,43,56.84,0.0
hek293t,8644,1,14,AGGCGACAAGCAGGTCTATGTCTAAGCCGTGGAGGTTTGCTCATGATGCAGAGCAGAGACAACCAGGAAACCTGAAAAAAATTCTAGTTGGTTTAACGC,AGGCGACAAGCAGGTCTATGTCTAAGCCGTGGAGAATGACCCGTAGAGGTTTGCTCATGATGCAGAGCAGAGACAACCAGGAAACCTGAAAAAAATTCT,10,30,14,27,27,35,27,49,27,32,32,35,46,49,65.6,0.0
hek293t,8644,1,14,CATGGACAAGCAGGTCTATGTCTAAGCCGTGGAGGTTTGCTCATGATGCAGAGCAGAGACAACCAGGAAAAAAATTCTAGTTGGTTTAACGCGTAACTA,CATGGACAAGCAGGTCTATGTCTAAGCCGTGGAGAATGACCCGTAGAGGTTTGCTCATGATGCAGAGCAGAGACAACCAGGAAAAAAATTCTAGTTGGT,10,30,14,27,27,42,27,56,27,32,32,42,46,56,65.6,7.957693115
hek293t,8646,1,3,TCAGAATTGCCTGTTTTTAGTAAACAGTCAGGGTCATTGCCAGTACTTATATTTAAAGAGGCTTACACAAACCCAAAAAAAATTCTAGTTGGTTTAACG,TCAGAATTGCCTGTTTTTAGTAAACAGTCGATAGGGTCATTGCCAGTACTTATATTTAAAGAGGCTTACACAAACCCAAAAAAAATTCTAGTTGGTTTA,10,30,14,27,27,45,27,48,27,30,30,45,33,48,17.56,1.097418691
hek293t,8646,1,3,TATCAATTGCCTGTTTTTAGTAAACAGTCAGGGTCATTGCCAGTACTTATATTTAAAGAGGCTTACACAAACCCAGTCCTTCCCCAGAAAAAAATTCTA,TATCAATTGCCTGTTTTTAGTAAACAGTCGATAGGGTCATTGCCAGTACTTATATTTAAAGAGGCTTACACAAACCCAGTCCTTCCCCAGAAAAAAATT,10,30,14,27,27,33,27,36,27,30,30,33,33,36,17.56,0.110011001
hek293t,15286,1,9,CGATCGAACAAGAGGCAGCGGTGATGTGGTGGGATGCTGTTACGATTTGTTCTTTGAGTTACGGTACCACCTAGGAAAAAAATTCTAGTTGGTTTAACG,CGATCGAACAAGAGGCAGCGGTGATGTGTGTTGCCCAGTGGGATGCTGTTACGATTTGTTCTTTGAGTTACGGTACCACCTAGGAAAAAAATTCTAGTT,10,30,14,27,27,39,27,48,27,29,29,39,38,48,65.06,44.95677223
hek293t,15286,1,9,GAGGGGAACAAGAGGCAGCGGTGATGTGGTGGGATGCTGTTACGATTTGTTCTTTGAGTTACGGTACCACAAAAAAATTCTAGTTGGTTTAACGCGTAA,GAGGGGAACAAGAGGCAGCGGTGATGTGTGTTGCCCAGTGGGATGCTGTTACGATTTGTTCTTTGAGTTACGGTACCACAAAAAAATTCTAGTTGGTTT,10,30,14,27,27,44,27,53,27,29,29,44,38,53,65.06,46.09311478
hek293t,8652,1,13,TAGCACATCTGATGCCACAAATGATGGAAAGGACAGAGCAGAGCAGACTGGAGAATTTAAAAATAAAAAAATTCTAGTTGGTTTAACGCGTAACTAGAT,TAGCACATCTGATGCCACAAATGATGGAAAGGACAGAGTACGGAGAAGGCGCAGAGCAGACTGGAGAATTTAAAAATAAAAAAATTCTAGTTGGTTTAA,10,30,14,27,27,46,27,59,27,39,39,46,52,59,43.83,0.114394249
hek293t,8655,1,12,TTGGGGTTAAGAATAGTGACATTAACAGAAGGCCATGTAGTTGCGATTCTGGAAAGCACCAGTACAAGGCATAAAAAAATTCTAGTTGGTTTAACGCGT,TTGGGGTTAAGAATAGTGACATTAACAGAAGTTGCTTGGCTCGGCCATGTAGTTGCGATTCTGGAAAGCACCAGTACAAGGCATAAAAAAATTCTAGTT,10,30,14,27,27,39,27,51,27,32,32,39,44,51,55.34,7.652179203
hek293t,8655,1,12,CTGACGTTAAGAATAGTGACATTAACAGAAGGCCATGTAGTTGCGATTCTGGAAAGCACCAGTACAAGGAAAAAAATTCTAGTTGGTTTAACGCGTAAC,CTGACGTTAAGAATAGTGACATTAACAGAAGTTGCTTGGCTCGGCCATGTAGTTGCGATTCTGGAAAGCACCAGTACAAGGAAAAAAATTCTAGTTGGT,10,30,14,27,27,42,27,54,27,32,32,42,44,54,55.34,21.56748797
hek293t,8657,1,7,ATCAGAGGGGTAAAAAGTCCATTTATATGGGGGTCTGTGAGGAATTCATCATGGCAGAACCTTCTCTGCCTAAAAAAAATTCTAGTTGGTTTAACGCGT,ATCAGAGGGGTAAAAAGTCCATTTATATGGGGGTCTGGATATCGTGAGGAATTCATCATGGCAGAACCTTCTCTGCCTAAAAAAAATTCTAGTTGGTTT,10,30,14,27,27,44,27,51,27,37,37,44,44,51,29.47,0.0
hek293t,8657,1,7,TTAAAAGGGGTAAAAAGTCCATTTATATGGGGGTCTGTGAGGAATTCATCATGGCAGAACCTTCTCTGCAAAAAAATTCTAGTTGGTTTAACGCGTAAC,TTAAAAGGGGTAAAAAGTCCATTTATATGGGGGTCTGGATATCGTGAGGAATTCATCATGGCAGAACCTTCTCTGCAAAAAAATTCTAGTTGGTTTAAC,10,30,14,27,27,47,27,54,27,37,37,47,44,54,29.47,0.811250941
hek293t,8659,1,15,TCTGGTGTTACCGTGAAGGTGTACTCCTTAGGTGAACTCATGAGTAAAGGACAAAACAACTTAAGGGAAGCAGTAAAAAAATTCTAGTTGGTTTAACGC,TCTGGTGTTACCGTGAAGGTGTACTCCTTAGTGATTGAGACTGCAGGTGAACTCATGAGTAAAGGACAAAACAACTTAAGGGAAGCAGTAAAAAAATTC,10,30,14,27,27,34,27,49,27,31,31,34,46,49,38.74,0.653203843
hek293t,8660,1,1,ACCATGTGGTAATAATTGTTGCTCTTTTATGGTATGTGAGCAATGTGGAAAAACTTGGACAATTTTGTAATATGCTGTAAAAAAATTCTAGTTGGTTTA,ACCATGTGGTAATAATTGTTGCTCTTTTTATGGTATGTGAGCAATGTGGAAAAACTTGGACAATTTTGTAATATGCTGTAAAAAAATTCTAGTTGGTTT,10,30,14,27,27,44,27,45,27,29,29,44,30,45,3.91,2.520310102
hek293t,8660,1,1,CGGAAGTGGTAATAATTGTTGCTCTTTTATGGTATGTGAGCAATGTGGAAAAACTTGGACAATTTTGTAATATGCTGTATGCCAAGAACGAAAAAAATT,CGGAAGTGGTAATAATTGTTGCTCTTTTTATGGTATGTGAGCAATGTGGAAAAACTTGGACAATTTTGTAATATGCTGTATGCCAAGAACGAAAAAAAT,10,30,14,27,27,32,27,33,27,29,29,32,30,33,3.91,6.156023373
hek293t,8662,1,5,GGTGTGTGTAAAACTCAGACAGCACAAAATGGAAAAGGCAGATGTGGATGGGATAATGCAACTGCAATCCAAACATTCCAGAAAAAAATTCTAGTTGGT,GGTGTGTGTAAAACTCAGACAGCACAAAAAGCCCTGGAAAAGGCAGATGTGGATGGGATAATGCAACTGCAATCCAAACATTCCAGAAAAAAATTCTAG,10,30,14,27,27,37,27,42,27,30,30,37,35,42,30.01,1.657568192
hek293t,15064,1,11,GGAATAATTTGTATCAATTAAGATGGCAGAGGATACTTTAAGATGCTATTCCAGATCATACTGTAGCAAAAGCAAAAAAATTCTAGTTGGTTTAACGCG,GGAATAATTTGTATCAATTAAGATGGCAGAGTAACTTGAATGGATACTTTAAGATGCTATTCCAGATCATACTGTAGCAAAAGCAAAAAAATTCTAGTT,10,30,14,27,27,39,27,50,27,32,32,39,43,50,35.13,0.132824761
hek293t,15064,1,11,TGCCCAATTTGTATCAATTAAGATGGCAGAGGATACTTTAAGATGCTATTCCAGATCATACTGTAAAAAAAATTCTAGTTGGTTTAACGCGTAACTAGA,TGCCCAATTTGTATCAATTAAGATGGCAGAGTAACTTGAATGGATACTTTAAGATGCTATTCCAGATCATACTGTAAAAAAAATTCTAGTTGGTTTAAC,10,30,14,27,27,47,27,58,27,32,32,47,43,58,35.13,2.268238106
hek293t,8666,1,2,GGACTGTTACTCTTTGTATCATGTAGATCTGGTCCAGCATTCACCTGACTTTCTACTAAATCAAGTGTAAAACAAAAAAATTCTAGTTGGTTTAACGCG,GGACTGTTACTCTTTGTATCATGTAGATCTGGACTCCAGCATTCACCTGACTTTCTACTAAATCAAGTGTAAAACAAAAAAATTCTAGTTGGTTTAACG,10,30,14,27,27,48,27,50,27,33,33,48,35,50,11.91,56.63312794
hek293t,8668,1,5,GGTCGAAGGCTTTAAAGACCTAATTGCAACGGTCCAGAGCATGTCCAACTCCCTTTAAGTCCAGTTCAAGTTATCGAAAAAAAATTCTAGTTGGTTTAA,GGTCGAAGGCTTTAAAGACCTAATTGCAACGGTCCAGTTCTAAGCATGTCCAACTCCCTTTAAGTCCAGTTCAAGTTATCGAAAAAAAATTCTAGTTGG,10,30,14,27,27,41,27,46,27,38,38,41,43,46,30.97,0.0
hek293t,8668,1,5,TCCTGAAGGCTTTAAAGACCTAATTGCAACGGTCCAGAGCATGTCCAACTCCCTTTAAGTCCAGTTCAAGAAAAAAATTCTAGTTGGTTTAACGCGTAA,TCCTGAAGGCTTTAAAGACCTAATTGCAACGGTCCAGTTCTAAGCATGTCCAACTCCCTTTAAGTCCAGTTCAAGAAAAAAATTCTAGTTGGTTTAACG,10,30,14,27,27,48,27,53,27,38,38,48,43,53,30.97,2.653408086
hek293t,8670,1,13,AATCACTGCACACAGGCACGCTGGGGTCGAGGCGGAGTGTGGCAGAAATGCCATTCCAGCCCCCCCTGGAAAAAAAAAATTCTAGTTGGTTTAACGCGT,AATCACTGCACACAGGCACGCTGGGGTCGAGGCGTACGGAGCATAACGAGTGTGGCAGAAATGCCATTCCAGCCCCCCCTGGAAAAAAAAAATTCTAGT,10,30,14,27,27,38,27,51,27,35,35,38,48,51,56.12,0.306062777
hek293t,8671,1,8,AATAGATTTTAACTGCATAGGTGTAGATTTGGCAAGATTTCAATCACATAAGCATCACTATGAGCTCAAAAAAATTCTAGTTGGTTTAACGCGTAACTA,AATAGATTTTAACTGCATAGGTGTAGATTTGGCAAGATTTGTCCGAGCCAATCACATAAGCATCACTATGAGCTCAAAAAAATTCTAGTTGGTTTAACG,10,30,14,27,27,48,27,56,27,41,41,48,49,56,27.14,4.090684786
hek293t,8672,1,1,GACAAGCAGAGATTTGCCCTGAATAATTCAGGGTTGAGTGACAAACAGAGGTCAAATGTTGCCCTTTTCGGAAGGAAAGATAAAATGCCTCAAAAAAAT,GACAAGCAGAGATTTGCCCTGAATAATGTCAGGGTTGAGTGACAAACAGAGGTCAAATGTTGCCCTTTTCGGAAGGAAAGATAAAATGCCTCAAAAAAA,10,30,14,27,27,31,27,32,27,28,28,31,29,32,8.41,1.509110287
hek293t,8672,1,1,GACATGCAGAGATTTGCCCTGAATAATTCAGGGTTGAGTGACAAACAGAGGTCAAATGTTGCCCTTTTCGGAAGGAAAGAAAAAAATTCTAGTTGGTTT,GACATGCAGAGATTTGCCCTGAATAATGTCAGGGTTGAGTGACAAACAGAGGTCAAATGTTGCCCTTTTCGGAAGGAAAGAAAAAAATTCTAGTTGGTT,10,30,14,27,27,43,27,44,27,28,28,43,29,44,8.41,3.070402259
hek293t,8674,1,1,CCAGAGATACCAGTAGACTGCTAAGCCAGGGGATTTCAGGCATCTGAGGTAAGTTGCTGTTCTTCAGTTATATAAGGAAAAAAATTCTAGTTGGTTTAA,CCAGAGATACCAGTAGACTGCTAAGCCAGGGGATTTTCAGGCATCTGAGGTAAGTTGCTGTTCTTCAGTTATATAAGGAAAAAAATTCTAGTTGGTTTA,10,30,14,27,27,45,27,46,27,35,35,45,36,46,63.19,78.12926235
hek293t,8675,1,5,AGGACGTCTTTATTGTTTCGACATTTTAAAGGTAGCCTTTTTGTTTCTGATTCAGCTTTACTCAGCTGTATTTATCTTAAAAAAATTCTAGTTGGTTTA,AGGACGTCTTTATTGTTTCGACATTTTAAAGGTAGCCAGGGCTTTTTGTTTCTGATTCAGCTTTACTCAGCTGTATTTATCTTAAAAAAATTCTAGTTG,10,30,14,27,27,40,27,45,27,37,37,40,42,45,4.73,0.067340067
hek293t,8677,1,3,CGAGGACTAAATCAAAGCCAATGCATCTGAGGCGTATAGTGATGATAGCAAAAATTACAAAGATCTTTCATATGCAAAATCCAAAAAAATTCTAGTTGG,CGAGGACTAAATCAAAGCCAATGCATCTGAGGCGCGTTATAGTGATGATAGCAAAAATTACAAAGATCTTTCATATGCAAAATCCAAAAAAATTCTAGT,10,30,14,27,27,38,27,41,27,35,35,38,38,41,46.09,4.038227351
hek293t,8677,1,3,GCTTTACTAAATCAAAGCCAATGCATCTGAGGCGTATAGTGATGATAGCAAAAATTACAAAGATCTTTCAAAAAAAATTCTAGTTGGTTTAACGCGTAA,GCTTTACTAAATCAAAGCCAATGCATCTGAGGCGCGTTATAGTGATGATAGCAAAAATTACAAAGATCTTTCAAAAAAAATTCTAGTTGGTTTAACGCG,10,30,14,27,27,50,27,53,27,35,35,50,38,53,46.09,81.80984078
hek293t,8679,1,11,TAGTTGAGTAATTCTGCTGTGTAAAGAACAGGCCTGAACACTGCTGTCACGTCCAGAACCTTTTACCAGCAAAAAAATTCTAGTTGGTTTAACGCGTAA,TAGTTGAGTAATTCTGCTGTGTAAAGAACAGGCCTGGGAGGGCTGTGAACACTGCTGTCACGTCCAGAACCTTTTACCAGCAAAAAAATTCTAGTTGGT,10,30,14,27,27,42,27,53,27,35,35,42,46,53,37.15,0.0
hek293t,8680,1,8,TCATATTAATATTTGAAGTTTTCAAGCTGTGGCAGCAAGCCTGCCTAGAAGAGGCTCTGTGCGGGTCTCTGCTTGCATTACAAAAAAATTCTAGTTGGT,TCATATTAATATTTGAAGTTTTCAAGCTTGTTGTCTGTGGCAGCAAGCCTGCCTAGAAGAGGCTCTGTGCGGGTCTCTGCTTGCATTACAAAAAAATTC,10,30,14,27,27,34,27,42,27,27,27,34,35,42,38.91,1.217913617
hek293t,8682,1,7,ATGAGTCCATGCAAACATATTCCTAATCTAGGGACCTGACCTGTTCACATTTTCAAGTGTGCTTTTAAAAAAATTCTAGTTGGTTTAACGCGTAACTAG,ATGAGTCCATGCAAACATATTCCTAATCTAGGGACGCTTTGCCTGACCTGTTCACATTTTCAAGTGTGCTTTTAAAAAAATTCTAGTTGGTTTAACGCG,10,30,14,27,27,50,27,57,27,35,35,50,42,57,22.49,1.803815807
hek293t,8682,1,7,TCTGGTCCATGCAAACATATTCCTAATCTAGGGACCTGACCTGTTCACATTTTCAAGTGTGCTTTTCTGTTAAAAAAATTCTAGTTGGTTTAACGCGTA,TCTGGTCCATGCAAACATATTCCTAATCTAGGGACGCTTTGCCTGACCTGTTCACATTTTCAAGTGTGCTTTTCTGTTAAAAAAATTCTAGTTGGTTTA,10,30,14,27,27,45,27,52,27,35,35,45,42,52,22.49,12.48323549
hek293t,8684,1,8,CTCTGGATTTGGAAATACCACATCACCTCAGGTAAAGAATGCATAAAAGCCCTTACATTTTGAATAAAGTAGAAATTAAAAAAATTCTAGTTGGTTTAA,CTCTGGATTTGGAAATACCACATCACCGGACGAGCTCAGGTAAAGAATGCATAAAAGCCCTTACATTTTGAATAAAGTAGAAATTAAAAAAATTCTAGT,10,30,14,27,27,38,27,46,27,28,28,38,36,46,48.3,42.61273604
hek293t,8686,1,14,GGGCAATTCTAAATTTAAAAAAGATCTAAAGGCTGAAGTAAACATAACATGAAAGGAGACAAAAATCAGTTTAAAAAAATTCTAGTTGGTTTAACGCGT,GGGCAATTCTAAATTTAAAAAAGATCTAAAGGCTCCAATACGTAAAGTGAAGTAAACATAACATGAAAGGAGACAAAAATCAGTTTAAAAAAATTCTAG,10,30,14,27,27,37,27,51,27,34,34,37,48,51,0.35,0.0
hek293t,8686,1,14,ACCCCATTCTAAATTTAAAAAAGATCTAAAGGCTGAAGTAAACATAACATGAAAGGAGACAAAAAAAAAAAATTCTAGTTGGTTTAACGCGTAACTAGA,ACCCCATTCTAAATTTAAAAAAGATCTAAAGGCTCCAATACGTAAAGTGAAGTAAACATAACATGAAAGGAGACAAAAAAAAAAAATTCTAGTTGGTTT,10,30,14,27,27,44,27,58,27,34,34,44,48,58,0.35,0.0
hek293t,8690,1,3,TGCCACCATAAAAAGTAGCATAGCATAGTTGGAAATTGGCACATTAGCCAACTAAAATCTGGATTCCCCCCCCAAAAAAATTCTAGTTGGTTTAACGCG,TGCCACCATAAAAAGTAGCATAGCATAGTTGTTCGAAATTGGCACATTAGCCAACTAAAATCTGGATTCCCCCCCCAAAAAAATTCTAGTTGGTTTAAC,10,30,14,27,27,47,27,50,27,32,32,47,35,50,25.02,80.89488909
hek293t,8692,1,15,GCGGATTCAACTAGAACAAGAGAAATATATGGCTGGAAGCCAGTCAGCAGCCAAACGTGTTAGATGGCTTCCAAAAAAATTCTAGTTGGTTTAACGCGT,GCGGATTCAACTAGAACAAGAGAAATATATGGGGAATGCCCGTGTGGCTGGAAGCCAGTCAGCAGCCAAACGTGTTAGATGGCTTCCAAAAAAATTCTA,10,30,14,27,27,36,27,51,27,33,33,36,48,51,39.35,0.458015267
hek293t,8693,1,8,CTCCACTAGACCCCGTCGCTAAAAGCTGAAGGAAGAGCTCAGTTAAAGTTAGACAACCTTTCTCTACAATAAAAAAAATTCTAGTTGGTTTAACGCGTA,CTCCACTAGACCCCGTCGCTAAAAGCTGAAGGAAGACATGTGCAGCTCAGTTAAAGTTAGACAACCTTTCTCTACAATAAAAAAAATTCTAGTTGGTTT,10,30,14,27,27,44,27,52,27,37,37,44,45,52,51.1,1.950791006
hek293t,8693,1,8,GAATGCTAGACCCCGTCGCTAAAAGCTGAAGGAAGAGCTCAGTTAAAGTTAGACAACCTTTCTCTACAATACTGAAAAAAAATTCTAGTTGGTTTAACG,GAATGCTAGACCCCGTCGCTAAAAGCTGAAGGAAGACATGTGCAGCTCAGTTAAAGTTAGACAACCTTTCTCTACAATACTGAAAAAAAATTCTAGTTG,10,30,14,27,27,40,27,48,27,37,37,40,45,48,51.1,0.0
hek293t,8695,1,15,GGATGCTTACAGCTGTTACTTGTTAGGACAGGACACCACTACTCACAGGTGGTCACAACCTGTCCAAAAAAATTCTAGTTGGTTTAACGCGTAACTAGA,GGATGCTTACAGCTGTTACTTGTTAGGACAGGACACCACCTTGACCATTGGCTTTACTCACAGGTGGTCACAACCTGTCCAAAAAAATTCTAGTTGGTT,10,30,14,27,27,43,27,58,27,40,40,43,55,58,35.83,0.0
hek293t,8696,1,6,CAGCTAGCACCAATATGCACATAAATCACTGGAGTGTCACAGTGGTAGATACCAAAAAGTCAAGGTTTGCCACAGAAAAAAATTCTAGTTGGTTTAACG,CAGCTAGCACCAATATGCACATAAATAACCAGCACTGGAGTGTCACAGTGGTAGATACCAAAAAGTCAAGGTTTGCCACAGAAAAAAATTCTAGTTGGT,10,30,14,27,27,42,27,48,27,27,27,42,33,48,42.71,15.54524094
hek293t,8698,1,3,GCAACGTTCATAGATCTCATTTATATTTGTGGTTATTGCTGCAACTTGTTTCTTGAACAGATTTTCTGTTTTAAACAGACAAAAAAATTCTAGTTGGTT,GCAACGTTCATAGATCTCATTTATATTTGTGGTTATACATGCTGCAACTTGTTTCTTGAACAGATTTTCTGTTTTAAACAGACAAAAAAATTCTAGTTG,10,30,14,27,27,40,27,43,27,37,37,40,40,43,10.94,0.332225914
hek293t,8698,1,3,CACGGGTTCATAGATCTCATTTATATTTGTGGTTATTGCTGCAACTTGTTTCTTGAACAGATTTTCTGTTTTAAAAAAAATTCTAGTTGGTTTAACGCG,CACGGGTTCATAGATCTCATTTATATTTGTGGTTATACATGCTGCAACTTGTTTCTTGAACAGATTTTCTGTTTTAAAAAAAATTCTAGTTGGTTTAAC,10,30,14,27,27,47,27,50,27,37,37,47,40,50,10.94,43.86612526
hek293t,8700,1,12,CCGTAAGACTTTGTGGGATGCTAATGTAGGGGATTGTTTTGCTAGTGTAATTAGAAATGCAATTCTAAAAAAATTCTAGTTGGTTTAACGCGTAACTAG,CCGTAAGACTTTGTGGGATGCTAATGTAGGGGATTGTATACGGGACGGCTTTGCTAGTGTAATTAGAAATGCAATTCTAAAAAAATTCTAGTTGGTTTA,10,30,14,27,27,45,27,57,27,38,38,45,50,57,56.94,0.161030596
hek293t,8700,1,12,TTCGGAGACTTTGTGGGATGCTAATGTAGGGGATTGTTTTGCTAGTGTAATTAGAAATGCAATTCTAGAAAAAAAAATTCTAGTTGGTTTAACGCGTAA,TTCGGAGACTTTGTGGGATGCTAATGTAGGGGATTGTATACGGGACGGCTTTGCTAGTGTAATTAGAAATGCAATTCTAGAAAAAAAAATTCTAGTTGG,10,30,14,27,27,41,27,53,27,38,38,41,50,53,56.94,0.0
hek293t,8702,1,12,CGAAGCACGAGACTAATTATGAAAATGTATGGACCATGATGCATTTTTTGTTGTTTTTGAACCTAAAAAAATTCTAGTTGGTTTAACGCGTAACTAGAT,CGAAGCACGAGACTAATTATGAAAATGTATGGACCATGATCATGCAGATCCTGCATTTTTTGTTGTTTTTGAACCTAAAAAAATTCTAGTTGGTTTAAC,10,30,14,27,27,47,27,59,27,40,40,47,52,59,33.45,0.0
hek293t,8703,1,4,TTTCTTGAAAGTGCAGATGTTTTTCATACAGGAAGTCTCTAATCCAAACATTCCCTCCTCTCCCCTCGCTGAAAAAAATTCTAGTTGGTTTAACGCGTA,TTTCTTGAAAGTGCAGATGTTTTTCATACAGGAAGTCTCTGACAAATCCAAACATTCCCTCCTCTCCCCTCGCTGAAAAAAATTCTAGTTGGTTTAACG,10,30,14,27,27,48,27,52,27,41,41,48,45,52,12.38,1.625104928
hek293t,20799,1,14,AAAGTTGGATCCAGCTCCCGAGAAAGCCAAGGAGCAAGGCTGGTTTCCCCTCGCATCCCCTCGCCCCCACAAAAAAATTCTAGTTGGTTTAACGCGTAA,AAAGTTGGATCCAGCTCCCGAGAAAGCCAAGGGAGGTTAGAGTTAGAGCAAGGCTGGTTTCCCCTCGCATCCCCTCGCCCCCACAAAAAAATTCTAGTT,10,30,14,27,27,39,27,53,27,32,32,39,46,53,71.15,2.591834453
hek293t,20799,1,14,GCTTATGGATCCAGCTCCCGAGAAAGCCAAGGAGCAAGGCTGGTTTCCCCTCGCATCCCCTCGCCCCAAAAAAATTCTAGTTGGTTTAACGCGTAACTA,GCTTATGGATCCAGCTCCCGAGAAAGCCAAGGGAGGTTAGAGTTAGAGCAAGGCTGGTTTCCCCTCGCATCCCCTCGCCCCAAAAAAATTCTAGTTGGT,10,30,14,27,27,42,27,56,27,32,32,42,46,56,71.15,5.147581424
hek293t,8706,1,12,CCATGTACTGGGCTTAACTCAGACAACGTTGGACCATTGTACAAAGCCCACCAGATGTTTCTCCTAGGTCTTGGCAAAAAAATTCTAGTTGGTTTAACG,CCATGTACTGGGCTTAACTCAGACAACGGTGCTTTGCATTTTGGACCATTGTACAAAGCCCACCAGATGTTTCTCCTAGGTCTTGGCAAAAAAATTCTA,10,30,14,27,27,36,27,48,27,29,29,36,41,48,68.12,2.058906684
hek293t,8706,1,12,TAGCCTACTGGGCTTAACTCAGACAACGTTGGACCATTGTACAAAGCCCACCAGATGTTTCTCCTAGAAAAAAATTCTAGTTGGTTTAACGCGTAACTA,TAGCCTACTGGGCTTAACTCAGACAACGGTGCTTTGCATTTTGGACCATTGTACAAAGCCCACCAGATGTTTCTCCTAGAAAAAAATTCTAGTTGGTTT,10,30,14,27,27,44,27,56,27,29,29,44,41,56,68.12,1.719858156
hek293t,8708,1,5,AGGCGACTTAAATGGGTGGGAGCTATGTGAGGGATCAGTTTTATGTAAAAAATAATCATAATCACCTTCAGTTTCTTAAAAAAATTCTAGTTGGTTTAA,AGGCGACTTAAATGGGTGGGAGCTATGTGAGGGCAAATATCAGTTTTATGTAAAAAATAATCATAATCACCTTCAGTTTCTTAAAAAAATTCTAGTTGG,10,30,14,27,27,41,27,46,27,34,34,41,39,46,58.71,11.85394813
hek293t,8708,1,5,CTTCTACTTAAATGGGTGGGAGCTATGTGAGGGATCAGTTTTATGTAAAAAATAATCATAATCACCTTCAGTTTAAAAAAATTCTAGTTGGTTTAACGC,CTTCTACTTAAATGGGTGGGAGCTATGTGAGGGCAAATATCAGTTTTATGTAAAAAATAATCATAATCACCTTCAGTTTAAAAAAATTCTAGTTGGTTT,10,30,14,27,27,44,27,49,27,34,34,44,39,49,58.71,17.19534301
hek293t,8710,1,13,GGAACCTAGAGTTCATCAGTGACGTGACCAGGACAGGTTCATGCTTGTAAACATGGTTCTGTCTGTCAAAAAAATTCTAGTTGGTTTAACGCGTAACTA,GGAACCTAGAGTTCATCAGTGACGTGACCAGGACAGGTTGTAGCGTAGACTACATGCTTGTAAACATGGTTCTGTCTGTCAAAAAAATTCTAGTTGGTT,10,30,14,27,27,43,27,56,27,40,40,43,53,56,37.37,0.707121798
hek293t,8711,1,2,CCCAACAGAGGGAACTGATACATGGCAACAGGCCACAGCACCACCCCTGGGCAGCTTGTGAGTGTCTCAGTAGGTGCCAAAGGAGAAAAAAAATTCTAG,CCCAACAGAGGGAACTGATACATGGCAACAGTAGCCACAGCACCACCCCTGGGCAGCTTGTGAGTGTCTCAGTAGGTGCCAAAGGAGAAAAAAAATTCT,10,30,14,27,27,35,27,37,27,32,32,35,34,37,51.22,16.69837763
hek293t,8711,1,2,CAGTACAGAGGGAACTGATACATGGCAACAGGCCACAGCACCACCCCTGGGCAGCTTGTGAGTGTCTCAGTAGGAAAAAAATTCTAGTTGGTTTAACGC,CAGTACAGAGGGAACTGATACATGGCAACAGTAGCCACAGCACCACCCCTGGGCAGCTTGTGAGTGTCTCAGTAGGAAAAAAATTCTAGTTGGTTTAAC,10,30,14,27,27,47,27,49,27,32,32,47,34,49,51.22,80.89024718
hek293t,8713,1,10,TTGGTGTATTTTTGATAGACAAAAATAAAAGGCTTCACTTACAGTTTCACCTCTTTGACCTGCATCCCCTGAAAAAAATTCTAGTTGGTTTAACGCGTA,TTGGTGTATTTTTGATAGACAAAAATAAAAGCTTCTGTTCTGCTTCACTTACAGTTTCACCTCTTTGACCTGCATCCCCTGAAAAAAATTCTAGTTGGT,10,30,14,27,27,42,27,52,27,32,32,42,42,52,-0.65,0.0
hek293t,8713,1,10,TTAAGGTATTTTTGATAGACAAAAATAAAAGGCTTCACTTACAGTTTCACCTCTTTGACCTGCATCCCCTGGAGGGCCAAAAAAATTCTAGTTGGTTTA,TTAAGGTATTTTTGATAGACAAAAATAAAAGCTTCTGTTCTGCTTCACTTACAGTTTCACCTCTTTGACCTGCATCCCCTGGAGGGCCAAAAAAATTCT,10,30,14,27,27,35,27,45,27,32,32,35,42,45,-0.65,0.0
hek293t,8717,1,12,GTCCTCAGTTCAGGTCTTGGCTTAAACACAGGAATAAGAAAAACAGGAATCACAAGTGTTGTACATTAAAAAAATTCTAGTTGGTTTAACGCGTAACTA,GTCCTCAGTTCAGGTCTTGGCTTAAACACAGGAATACAAGTACATGGCAGAAAAACAGGAATCACAAGTGTTGTACATTAAAAAAATTCTAGTTGGTTT,10,30,14,27,27,44,27,56,27,37,37,44,49,56,70.24,0.024922118
hek293t,8718,1,12,AGTGCGACGGCTCTAGAGTGACAATCCACTGGTCAGAGACTAGTTTTGGTTCTATCACAAGTCTAAAAAAATTCTAGTTGGTTTAACGCGTAACTAGAT,AGTGCGACGGCTCTAGAGTGACAATCCACTGGTCAGTTAAACACCATCAGACTAGTTTTGGTTCTATCACAAGTCTAAAAAAATTCTAGTTGGTTTAAC,10,30,14,27,27,47,27,59,27,37,37,47,49,59,64.2,1.009614946
hek293t,8719,1,11,TTAAGACAAAGATACAATGTCTAATTGCTAGGACTTCAAGACTCAGAGGAAGAGCATACAGAGAGAACGATGAAAAAAATTCTAGTTGGTTTAACGCGT,TTAAGACAAAGATACAATGTCTAATTGCTAGGAGACTAGTGTAACTTCAAGACTCAGAGGAAGAGCATACAGAGAGAACGATGAAAAAAATTCTAGTTG,10,30,14,27,27,40,27,51,27,33,33,40,44,51,43.05,1.612057782
hek293t,8719,1,11,TGCTGACAAAGATACAATGTCTAATTGCTAGGACTTCAAGACTCAGAGGAAGAGCATACAGAGAAAAAAAATTCTAGTTGGTTTAACGCGTAACTAGAT,TGCTGACAAAGATACAATGTCTAATTGCTAGGAGACTAGTGTAACTTCAAGACTCAGAGGAAGAGCATACAGAGAAAAAAAATTCTAGTTGGTTTAACG,10,30,14,27,27,48,27,59,27,33,33,48,44,59,43.05,0.368442552
hek293t,8721,1,8,CGGAGCACTGATTCCAGTGAGAACACGGATGGACTCGAACGCAGAACAGAATAAACTTAAGTAGAAACATAAAAAAATTCTAGTTGGTTTAACGCGTAA,CGGAGCACTGATTCCAGTGAGAACACGGATGGACTCGTCGGTGCCAACGCAGAACAGAATAAACTTAAGTAGAAACATAAAAAAATTCTAGTTGGTTTA,10,30,14,27,27,45,27,53,27,38,38,45,46,53,56.63,10.49115231
hek293t,8722,1,15,AAGCCTGCCAAACTTCAGTGAGCCCAACTCGGAGCACCTAGGGCAGAACAAACTGGTATGTTAAACTTGCAAAAAAATTCTAGTTGGTTTAACGCGTAA,AAGCCTGCCAAACTTCAGTGAGCCCAACTCGGAGCGCAGGGTTGTGACCCACCTAGGGCAGAACAAACTGGTATGTTAAACTTGCAAAAAAATTCTAGT,10,30,14,27,27,38,27,53,27,35,35,38,50,53,49.1,0.033944331
hek293t,8723,1,11,GGCGTAAATCTCAGATGTAGACAAAATTAAGGTACCACTGGATACATTCGAACAGAAAATAAACATAAAAAAATTCTAGTTGGTTTAACGCGTAACTAG,GGCGTAAATCTCAGATGTAGACAAAATTAAGGTACCACAAATTGGTGTCTGGATACATTCGAACAGAAAATAAACATAAAAAAATTCTAGTTGGTTTAA,10,30,14,27,27,46,27,57,27,39,39,46,50,57,20.58,0.151860289
hek293t,8724,1,12,CAACCGTGGAAAATGAGAATGCATGGTTGTGGGTTGCAAAGGCTGAATGAAGATTTAACTTGTGATTTCCTGAAAAAAATTCTAGTTGGTTTAACGCGT,CAACCGTGGAAAATGAGAATGCATGGTTGTGTGGTCCCCGGATGGTTGCAAAGGCTGAATGAAGATTTAACTTGTGATTTCCTGAAAAAAATTCTAGTT,10,30,14,27,27,39,27,51,27,32,32,39,44,51,46.52,2.28573042
hek293t,8726,1,14,CCAGACTAACTAGCATCTGCAGACTAAGCTGGGAAGCTATCCCATTGCTCCCATTTTGATCACTCAGTTTTGATAAAAAAATTCTAGTTGGTTTAACGC,CCAGACTAACTAGCATCTGCAGACTAATTACCAACCCATACGCTGGGAAGCTATCCCATTGCTCCCATTTTGATCACTCAGTTTTGATAAAAAAATTCT,10,30,14,27,27,35,27,49,27,28,28,35,42,49,27.71,9.76850377
hek293t,8726,1,14,TGCCTCTAACTAGCATCTGCAGACTAAGCTGGGAAGCTATCCCATTGCTCCCATTTTGATCACTCAGTTTTAAAAAAATTCTAGTTGGTTTAACGCGTA,TGCCTCTAACTAGCATCTGCAGACTAATTACCAACCCATACGCTGGGAAGCTATCCCATTGCTCCCATTTTGATCACTCAGTTTTAAAAAAATTCTAGT,10,30,14,27,27,38,27,52,27,28,28,38,42,52,27.71,39.27054357
hek293t,8728,1,11,AGCCATGTCATAGCCTTCCCCTGTTCCCCAGGACTGTTTCTTCTCAGTCTGTGCCAGCAGGCATTGTTGCTGTACAAAAAAATTCTAGTTGGTTTAACG,AGCCATGTCATAGCCTTCCCCTGTTCCCTACGGATCGCCCAGGACTGTTTCTTCTCAGTCTGTGCCAGCAGGCATTGTTGCTGTACAAAAAAATTCTAG,10,30,14,27,27,37,27,48,27,27,27,37,38,48,53.9,8.36711941
hek293t,8730,1,15,AGAGGAGTAACCGAACAGGCCATGAAGCTAGGAGTTTCTCGCTTTCCCCAAGACAAGACGTTCACCTAGACAGCCAAAAAAATTCTAGTTGGTTTAACG,AGAGGAGTAACCGAACAGGCCATGAAGCTTAAACCGCACGCGACAGGAGTTTCTCGCTTTCCCCAAGACAAGACGTTCACCTAGACAGCCAAAAAAATT,10,30,14,27,27,33,27,48,27,30,30,33,45,48,55.31,0.178797927
hek293t,8730,1,15,CAATTAGTAACCGAACAGGCCATGAAGCTAGGAGTTTCTCGCTTTCCCCAAGACAAGACGTTCACCTAAAAAAAATTCTAGTTGGTTTAACGCGTAACT,CAATTAGTAACCGAACAGGCCATGAAGCTTAAACCGCACGCGACAGGAGTTTCTCGCTTTCCCCAAGACAAGACGTTCACCTAAAAAAAATTCTAGTTG,10,30,14,27,27,40,27,55,27,30,30,40,45,55,55.31,63.64415965
hek293t,8734,1,4,TGGGCGTGTTAATTTTCTTGAGGTAGGGGAGGAGGGAGTAGCTTGAAATGCAGCTCTCACTGGTGGAAGCCTTTTCAAAAAAATTCTAGTTGGTTTAAC,TGGGCGTGTTAATTTTCTTGAGGTAGGGGAGGAGGTTCTGAGTAGCTTGAAATGCAGCTCTCACTGGTGGAAGCCTTTTCAAAAAAATTCTAGTTGGTT,10,30,14,27,27,43,27,47,27,36,36,43,40,47,25.78,60.42334201
hek293t,8734,1,4,CAAGCGTGTTAATTTTCTTGAGGTAGGGGAGGAGGGAGTAGCTTGAAATGCAGCTCTCACTGGTGGAAAAAAAAATTCTAGTTGGTTTAACGCGTAACT,CAAGCGTGTTAATTTTCTTGAGGTAGGGGAGGAGGTTCTGAGTAGCTTGAAATGCAGCTCTCACTGGTGGAAAAAAAAATTCTAGTTGGTTTAACGCGT,10,30,14,27,27,51,27,55,27,36,36,51,40,55,25.78,14.82306097
hek293t,8736,1,3,TCTATATTATGCTCTGTCATAGACTACAGGGGTTCAAGAGTAATCATCTTAATGTGGCTGCTTGCCAGCTCCCACAGAAAAAAAATTCTAGTTGGTTTA,TCTATATTATGCTCTGTCATAGACTACAGGGGTTCAAGGGAAGTAATCATCTTAATGTGGCTGCTTGCCAGCTCCCACAGAAAAAAAATTCTAGTTGGT,10,30,14,27,27,42,27,45,27,39,39,42,42,45,64.87,0.0
hek293t,8736,1,3,CCTCCATTATGCTCTGTCATAGACTACAGGGGTTCAAGAGTAATCATCTTAATGTGGCTGCTTGCCAAAAAAATTCTAGTTGGTTTAACGCGTAACTAG,CCTCCATTATGCTCTGTCATAGACTACAGGGGTTCAAGGGAAGTAATCATCTTAATGTGGCTGCTTGCCAAAAAAATTCTAGTTGGTTTAACGCGTAAC,10,30,14,27,27,54,27,57,27,39,39,54,42,57,64.87,22.73977014
hek293t,8738,1,2,ATACGTTACTAACAGAATTAACAATTCCTAGGAGTATGAAATTAATGTTAATTAATGTAAATTCCTCAATTCCTTATTACAAAAAAAAAATTCTAGTTG,ATACGTTACTAACAGAATTAACAATTCCTAGGAGAGTATGAAATTAATGTTAATTAATGTAAATTCCTCAATTCCTTATTACAAAAAAAAAATTCTAGT,10,30,14,27,27,38,27,40,27,35,35,38,37,40,36.68,0.359255447
hek293t,8738,1,2,GCGAGTTACTAACAGAATTAACAATTCCTAGGAGTATGAAATTAATGTTAATTAATGTAAATTCCTCAATTAAAAAAATTCTAGTTGGTTTAACGCGTA,GCGAGTTACTAACAGAATTAACAATTCCTAGGAGAGTATGAAATTAATGTTAATTAATGTAAATTCCTCAATTAAAAAAATTCTAGTTGGTTTAACGCG,10,30,14,27,27,50,27,52,27,35,35,50,37,52,36.68,1.88410093
hek293t,8740,1,12,GTTGCTCAGTAAGTATAGCAGTTCCCTGCTGGCTGCTAGAAACCGCTTGGAGAGGAGGGGAGTGTGACAGGTCTCAAAAAAATTCTAGTTGGTTTAACG,GTTGCTCAGTAAGTATAGCAGTTCCCTGCTGGGACCCGCGCTTTCTGCTAGAAACCGCTTGGAGAGGAGGGGAGTGTGACAGGTCTCAAAAAAATTCTA,10,30,14,27,27,36,27,48,27,33,33,36,45,48,61.44,0.108225108
hek293t,8741,1,15,GTTAAAGGTGTCCTTAAAAATGATAAAGCTGGTTTCAGTGGATCTCTCTTTTCAGTTCATAAACTTTATTGATTTTAAAAAAATTCTAGTTGGTTTAAC,GTTAAAGGTGTCCTTAAAAATGATAAAGGGAGTAGAGAGATTGCTGGTTTCAGTGGATCTCTCTTTTCAGTTCATAAACTTTATTGATTTTAAAAAAAT,10,30,14,27,27,32,27,47,27,29,29,32,44,47,26.48,0.0
hek293t,8741,1,15,GCTAAAGGTGTCCTTAAAAATGATAAAGCTGGTTTCAGTGGATCTCTCTTTTCAGTTCATAAACAAAAAAATTCTAGTTGGTTTAACGCGTAACTAGAT,GCTAAAGGTGTCCTTAAAAATGATAAAGGGAGTAGAGAGATTGCTGGTTTCAGTGGATCTCTCTTTTCAGTTCATAAACAAAAAAATTCTAGTTGGTTT,10,30,14,27,27,44,27,59,27,29,29,44,44,59,26.48,0.0
hek293t,8743,1,9,GTCACCCAGAATCAATATCCCACTGTGGTAGGTACTGCAGAAAGAAAGGAAGGAAGGAATGAGTTCTGAGTTTCACTAAAAAAATTCTAGTTGGTTTAA,GTCACCCAGAATCAATATCCCACTGTCAGCCCCGCGGTAGGTACTGCAGAAAGAAAGGAAGGAAGGAATGAGTTCTGAGTTTCACTAAAAAAATTCTAG,10,30,14,27,27,37,27,46,27,27,27,37,36,46,55.2,43.76106998
hek293t,8743,1,9,CTCCTCCAGAATCAATATCCCACTGTGGTAGGTACTGCAGAAAGAAAGGAAGGAAGGAATGAGTTCTGAGTTTCACTTCAGAAAAAAAAAATTCTAGTT,CTCCTCCAGAATCAATATCCCACTGTCAGCCCCGCGGTAGGTACTGCAGAAAGAAAGGAAGGAAGGAATGAGTTCTGAGTTTCACTTCAGAAAAAAAAA,10,30,14,27,27,30,27,39,27,27,27,30,36,39,55.2,0.0
hek293t,8745,1,10,AACGGAGGACAATGCAGCAAGTATAAGAATGGAAGATAAAGAAGCCTGTAGAAATAGCCATTCAGCTCAAAAAAATTCTAGTTGGTTTAACGCGTAACT,AACGGAGGACAATGCAGCAAGTATAAGAATCCCTCGAACTGGAAGATAAAGAAGCCTGTAGAAATAGCCATTCAGCTCAAAAAAATTCTAGTTGGTTTA,10,30,14,27,27,45,27,55,27,30,30,45,40,55,46.69,0.948565811
hek293t,8745,1,10,GATCGAGGACAATGCAGCAAGTATAAGAATGGAAGATAAAGAAGCCTGTAGAAATAGCCATTCAGCTCTTTCCAAAAAAATTCTAGTTGGTTTAACGCG,GATCGAGGACAATGCAGCAAGTATAAGAATCCCTCGAACTGGAAGATAAAGAAGCCTGTAGAAATAGCCATTCAGCTCTTTCCAAAAAAATTCTAGTTG,10,30,14,27,27,40,27,50,27,30,30,40,40,50,46.69,3.676249266
hek293t,8747,1,13,TCTTCGATTGGGGTTTCTTTTGAGTTTTATGGGATAAGCTTATCTCGTAAAGCTGAAATTTATTGTTAGGTAATCAAAAAAAATTCTAGTTGGTTTAAC,TCTTCGATTGGGGTTTCTTTTGAGTTATAACCTACCAGGTTATGGGATAAGCTTATCTCGTAAAGCTGAAATTTATTGTTAGGTAATCAAAAAAAATTC,10,30,14,27,27,34,27,47,27,27,27,34,40,47,-3.26,0.0
hek293t,8747,1,13,GGACTGATTGGGGTTTCTTTTGAGTTTTATGGGATAAGCTTATCTCGTAAAGCTGAAATTTATTGTTAGGTAAAAAAAAATTCTAGTTGGTTTAACGCG,GGACTGATTGGGGTTTCTTTTGAGTTATAACCTACCAGGTTATGGGATAAGCTTATCTCGTAAAGCTGAAATTTATTGTTAGGTAAAAAAAAATTCTAG,10,30,14,27,27,37,27,50,27,27,27,37,40,50,-3.26,0.086355786
hek293t,8749,1,2,TCAGCAGTCCTGACCAGAGTTAGGCAAAGAGGTCTCTCTCTGTCAATGCCATACATCCACCACTGCAGAGCTTGTGACAAAAAAAATTCTAGTTGGTTT,TCAGCAGTCCTGACCAGAGTTAGGCAAAGAGGTCTCTCTCTCTGTCAATGCCATACATCCACCACTGCAGAGCTTGTGACAAAAAAAATTCTAGTTGGT,10,30,14,27,27,42,27,44,27,35,35,42,37,44,60.41,0.0
hek293t,8749,1,2,GGTACAGTCCTGACCAGAGTTAGGCAAAGAGGTCTCTCTCTGTCAATGCCATACATCCACCACTGCAGAGCAAAAAAATTCTAGTTGGTTTAACGCGTA,GGTACAGTCCTGACCAGAGTTAGGCAAAGAGGTCTCTCTCTCTGTCAATGCCATACATCCACCACTGCAGAGCAAAAAAATTCTAGTTGGTTTAACGCG,10,30,14,27,27,50,27,52,27,35,35,50,37,52,60.41,78.93031804
hek293t,8751,1,14,GTACGCTATTAAATGCATCTGGATATGAGTGGCATAACTTTGATGGCATAACTCAGAGGCCCACATATTCTAGGAAAAAAATTCTAGTTGGTTTAACGC,GTACGCTATTAAATGCATCTGGATATGGGTCGGTCCGAACCAGTGGCATAACTTTGATGGCATAACTCAGAGGCCCACATATTCTAGGAAAAAAATTCT,10,30,14,27,27,35,27,49,27,28,28,35,42,49,59.55,3.485922237
hek293t,8753,1,8,GTTACTAGCATAGTTTTGGCTGTTCAAAAAGGATCCAAGCTATTAGCAAGTACATGTGTACTTTAACAAAGTATACAGTAAAGACAAAAAAATTCTAGT,GTTACTAGCATAGTTTTGGCTGTTCACATACATCAAAAGGATCCAAGCTATTAGCAAGTACATGTGTACTTTAACAAAGTATACAGTAAAGACAAAAAA,10,30,14,27,27,30,27,38,27,27,27,30,35,38,14.8,5.857139962
hek293t,8753,1,8,TTGTATAGCATAGTTTTGGCTGTTCAAAAAGGATCCAAGCTATTAGCAAGTACATGTGTACTTTAACAAAGTATACAGAAAAAAATTCTAGTTGGTTTA,TTGTATAGCATAGTTTTGGCTGTTCACATACATCAAAAGGATCCAAGCTATTAGCAAGTACATGTGTACTTTAACAAAGTATACAGAAAAAAATTCTAG,10,30,14,27,27,37,27,45,27,27,27,37,35,45,14.8,24.81830682
hek293t,8756,1,5,GCAACTGAGAGATCACACAAAGACATGCTTGGAGCCCTCTACAAGTTTACAAATTAATGACCATTTTGCTGGCAGAACTCTAAAAAAATTCTAGTTGGT,GCAACTGAGAGATCACACAAAGACATGCTTGGAACACAGCCCTCTACAAGTTTACAAATTAATGACCATTTTGCTGGCAGAACTCTAAAAAAATTCTAG,10,30,14,27,27,37,27,42,27,34,34,37,39,42,63.99,1.367654862
hek293t,8756,1,5,CCAAATGAGAGATCACACAAAGACATGCTTGGAGCCCTCTACAAGTTTACAAATTAATGACCATTTTGCAAAAAAATTCTAGTTGGTTTAACGCGTAAC,CCAAATGAGAGATCACACAAAGACATGCTTGGAACACAGCCCTCTACAAGTTTACAAATTAATGACCATTTTGCAAAAAAATTCTAGTTGGTTTAACGC,10,30,14,27,27,49,27,54,27,34,34,49,39,54,63.99,16.13196457
hek293t,8758,1,14,AAGCGAAAGCAAGTCAGGGTCTTGACCTTTGGGACCCTGCAAGTAATGGTTTCTGATTAAGCCAAGAAAAAAATTCTAGTTGGTTTAACGCGTAACTAG,AAGCGAAAGCAAGTCAGGGTCTTGACCTTTGGGGAATTTATCGGCGGACCCTGCAAGTAATGGTTTCTGATTAAGCCAAGAAAAAAATTCTAGTTGGTT,10,30,14,27,27,43,27,57,27,33,33,43,47,57,31.03,5.193282371
hek293t,8758,1,14,ACCATAAAGCAAGTCAGGGTCTTGACCTTTGGGACCCTGCAAGTAATGGTTTCTGATTAAGCCAAGCTGAAAAAAATTCTAGTTGGTTTAACGCGTAAC,ACCATAAAGCAAGTCAGGGTCTTGACCTTTGGGGAATTTATCGGCGGACCCTGCAAGTAATGGTTTCTGATTAAGCCAAGCTGAAAAAAATTCTAGTTG,10,30,14,27,27,40,27,54,27,33,33,40,47,54,31.03,0.784746935
hek293t,8760,1,3,CCTGTGAAGAGGGTGCTGCTTTCTGGTCACGGTCTAGATGCACTGATGCAGCAATAAGCACAACTTAATTGTTGAGCCGCTTACGAAAAAAATTCTAGT,CCTGTGAAGAGGGTGCTGCTTTCTGGTGCGCACGGTCTAGATGCACTGATGCAGCAATAAGCACAACTTAATTGTTGAGCCGCTTACGAAAAAAATTCT,10,30,14,27,27,35,27,38,27,28,28,35,31,38,38.93,90.80379183
hek293t,8760,1,3,CGACCGAAGAGGGTGCTGCTTTCTGGTCACGGTCTAGATGCACTGATGCAGCAATAAGCACAACTTAATTGTTGAGCCGCTTACGTATTAAAAAAATTC,CGACCGAAGAGGGTGCTGCTTTCTGGTGCGCACGGTCTAGATGCACTGATGCAGCAATAAGCACAACTTAATTGTTGAGCCGCTTACGTATTAAAAAAA,10,30,14,27,27,31,27,34,27,28,28,31,31,34,38.93,7.60090749
hek293t,8762,1,4,GGAACGCAAGGGAAGATGAACAGTGCAGGAGGTGGAGAAGAGGACCTGAGTGTAGTGGCTGCAGGAGAAGAAAAAAAATTCTAGTTGGTTTAACGCGTA,GGAACGCAAGGGAAGATGAACAGTGCAGGAGGACTCTGGAGAAGAGGACCTGAGTGTAGTGGCTGCAGGAGAAGAAAAAAAATTCTAGTTGGTTTAACG,10,30,14,27,27,48,27,52,27,33,33,48,37,52,52.72,83.69563301
hek293t,8762,1,4,ATTAAGCAAGGGAAGATGAACAGTGCAGGAGGTGGAGAAGAGGACCTGAGTGTAGTGGCTGCAGGAGAAGACCTGCTGCAAAAAAATTCTAGTTGGTTT,ATTAAGCAAGGGAAGATGAACAGTGCAGGAGGACTCTGGAGAAGAGGACCTGAGTGTAGTGGCTGCAGGAGAAGACCTGCTGCAAAAAAATTCTAGTTG,10,30,14,27,27,40,27,44,27,33,33,40,37,44,52.72,83.02392211
hek293t,8764,1,5,ACTCGCCCCCCCCTCTTCTTGTGCTGGCCAGGTGGTGGGCGTGTGTCCACTCCTCTTCCTTTCCTGATTCTGTGCTTCAAAAAAATTCTAGTTGGTTTA,ACTCGCCCCCCCCTCTTCTTGTGCTGGCCACCCGAGGTGGTGGGCGTGTGTCCACTCCTCTTCCTTTCCTGATTCTGTGCTTCAAAAAAATTCTAGTTG,10,30,14,27,27,40,27,45,27,30,30,40,35,45,17.09,13.24561217
hek293t,8767,1,3,TTTGGTGCTTCCTGGATGCACAGGTGCTCCGGGGCTTTCACTGGGCTCTGCCAGGGTCTTTACTGCCTCTCAGCAAAAAAATTCTAGTTGGTTTAACGC,TTTGGTGCTTCCTGGATGCACAGGTGCTCCGGGGCTGCTTTCACTGGGCTCTGCCAGGGTCTTTACTGCCTCTCAGCAAAAAAATTCTAGTTGGTTTAA,10,30,14,27,27,46,27,49,27,36,36,46,39,49,49.18,74.33419363
hek293t,8767,1,3,ACAACTGCTTCCTGGATGCACAGGTGCTCCGGGGCTTTCACTGGGCTCTGCCAGGGTCTTTACTGCCTCTCAGCTGACAATAAAAAAATTCTAGTTGGT,ACAACTGCTTCCTGGATGCACAGGTGCTCCGGGGCTGCTTTCACTGGGCTCTGCCAGGGTCTTTACTGCCTCTCAGCTGACAATAAAAAAATTCTAGTT,10,30,14,27,27,39,27,42,27,36,36,39,39,42,49.18,0.126023945
hek293t,8769,1,2,TGTCTCTATTTCAGTTTATCTGCAGTGTCTGGAATTCAAGGTATTGTCCTTCTTTTTGTGTTGCCAAAAAAATTCTAGTTGGTTTAACGCGTAACTAGA,TGTCTCTATTTCAGTTTATCTGCAGTGTCTGGAATTCAAGAAGTATTGTCCTTCTTTTTGTGTTGCCAAAAAAATTCTAGTTGGTTTAACGCGTAACTA,10,30,14,27,27,56,27,58,27,41,41,56,43,58,8.83,0.775297288
hek293t,8771,1,8,TTCGATTGTACTGTATATTTGACAAAACTTGGCTGCAGCTTACCCCCCCCAAAGAAGAGTACTGGGGCAAAAAAATTCTAGTTGGTTTAACGCGTAACT,TTCGATTGTACTGTATATTTGACAAAACTTGGCTGCAGCCTTCAACCTTACCCCCCCCAAAGAAGAGTACTGGGGCAAAAAAATTCTAGTTGGTTTAAC,10,30,14,27,27,47,27,55,27,40,40,47,48,55,22.65,0.562587904
hek293t,8773,1,4,CTTGGCTCTTCAGGCAAGGCAGCCCTGCGAGGTGCGGGTGCTTTTCTTGGTGCCGGAGAAGAGCAGAAATCTCAGAAAAAAATTCTAGTTGGTTTAACG,CTTGGCTCTTCAGGCAAGGCAGCCCTGCGAGGTGCGAAACGGTGCTTTTCTTGGTGCCGGAGAAGAGCAGAAATCTCAGAAAAAAATTCTAGTTGGTTT,10,30,14,27,27,44,27,48,27,37,37,44,41,48,61.99,26.90335341
hek293t,8773,1,4,GTAACCTCTTCAGGCAAGGCAGCCCTGCGAGGTGCGGGTGCTTTTCTTGGTGCCGGAGAAGAGCAGAAATCTCAGAGTGAAAAAAATTCTAGTTGGTTT,GTAACCTCTTCAGGCAAGGCAGCCCTGCGAGGTGCGAAACGGTGCTTTTCTTGGTGCCGGAGAAGAGCAGAAATCTCAGAGTGAAAAAAATTCTAGTTG,10,30,14,27,27,40,27,44,27,37,37,40,41,44,61.99,5.937999488
hek293t,8775,1,14,TGAGGTGGCTTCACTGGGCTTTGGTGTTTTGGCTGCCACAAGGCAGCGGTTGCAGGTGCTGGCGGAGCTGGGATTAAAAAAATTCTAGTTGGTTTAACG,TGAGGTGGCTTCACTGGGCTTTGGTGTTTTCGCTGTCTGCCCGGGGCTGCCACAAGGCAGCGGTTGCAGGTGCTGGCGGAGCTGGGATTAAAAAAATTC,10,30,14,27,27,34,27,48,27,31,31,34,45,48,9.92,0.8611461
hek293t,8776,1,10,AGTCAGAATTCCTTTCCCTAAAAATAAATTGGATATGTTCATTTATTCATTCCCAAGTTATATATTTAAAAAAAAAATTCTAGTTGGTTTAACGCGTAA,AGTCAGAATTCCTTTCCCTAAAAATAAATTGGATATGTTCGAACGGGGTCATTTATTCATTCCCAAGTTATATATTTAAAAAAAAAATTCTAGTTGGTT,10,30,14,27,27,43,27,53,27,40,40,43,50,53,1.9,0.0
hek293t,8778,1,3,AATCGAGTATGGCAGAGTCAGCTTCTCTGTGGAGACAGCACAATTGTAACTTTAACAAGAAAGAAAATATTTTACTGATAAACAGGAAAAAAAAATTCT,AATCGAGTATGGCAGAGTCAGCTTCTCTGGCGTGGAGACAGCACAATTGTAACTTTAACAAGAAAGAAAATATTTTACTGATAAACAGGAAAAAAAAAT,10,30,14,27,27,32,27,35,27,29,29,32,32,35,75.35,0.440951531
hek293t,8778,1,3,TAGAAAGTATGGCAGAGTCAGCTTCTCTGTGGAGACAGCACAATTGTAACTTTAACAAGAAAGAAAATATTTTACTGATAAAAAAAAATTCTAGTTGGT,TAGAAAGTATGGCAGAGTCAGCTTCTCTGGCGTGGAGACAGCACAATTGTAACTTTAACAAGAAAGAAAATATTTTACTGATAAAAAAAAATTCTAGTT,10,30,14,27,27,39,27,42,27,29,29,39,32,42,75.35,64.4022324
hek293t,8780,1,12,AGTTAGCATGCTTAATGAGAAACAGCTGGTGGCCAAGGAACTGAGCAACTTCTGTGCCCCAAATCGCTAAAAAAATTCTAGTTGGTTTAACGCGTAACT,AGTTAGCATGCTTAATGAGAAACAGCTGGTGGCCAAGGAATACTTCGGTAAACTGAGCAACTTCTGTGCCCCAAATCGCTAAAAAAATTCTAGTTGGTT,10,30,14,27,27,43,27,55,27,40,40,43,52,55,48.8,0.0
hek293t,8782,1,14,CTCAGCCCTGATATGAGGGGGAAGAAACGGGGATCTGAGGGATTCCCGCATTGAGGGATTTCCTAAAAAAAATTCTAGTTGGTTTAACGCGTAACTAGA,CTCAGCCCTGATATGAGGGGGAAGAAACGGGGAGATGCTTGGGGGGTTCTGAGGGATTCCCGCATTGAGGGATTTCCTAAAAAAAATTCTAGTTGGTTT,10,30,14,27,27,44,27,58,27,34,34,44,48,58,67.04,0.112612613
hek293t,8783,1,8,CCCTGGAACGTAGCAATTACTGGATAAATTGGGTTTTAGCTTCTCACCCATCAACTAAGATAGTGAGCAAAAAAAATTCTAGTTGGTTTAACGCGTAAC,CCCTGGAACGTAGCAATTACTGGATAAATTGGGTTCTAACTTTTTAGCTTCTCACCCATCAACTAAGATAGTGAGCAAAAAAAATTCTAGTTGGTTTAA,10,30,14,27,27,46,27,54,27,36,36,46,44,54,18.06,19.62610766
hek293t,8785,1,10,CCAGCATTTCAGATCCAGGTTTGCATCCACGGAGAATACAGTTATTCAAAGAAGGTCACTTTAGGATGCGCTGAAAAAAATTCTAGTTGGTTTAACGCG,CCAGCATTTCAGATCCAGGTTTGCATCCACAGTTACAAACGGAGAATACAGTTATTCAAAGAAGGTCACTTTAGGATGCGCTGAAAAAAATTCTAGTTG,10,30,14,27,27,40,27,50,27,30,30,40,40,50,47.96,15.12923616
hek293t,8785,1,10,CGCTCATTTCAGATCCAGGTTTGCATCCACGGAGAATACAGTTATTCAAAGAAGGTCACTTTAGGATGCGCTGGAGAAAAAAATTCTAGTTGGTTTAAC,CGCTCATTTCAGATCCAGGTTTGCATCCACAGTTACAAACGGAGAATACAGTTATTCAAAGAAGGTCACTTTAGGATGCGCTGGAGAAAAAAATTCTAG,10,30,14,27,27,37,27,47,27,30,30,37,40,47,47.96,0.511223287
hek293t,8787,1,8,GTGGTCTTCAGAAGATGCCCTCTTCAAAGAGGTTATCAGCAAGCTCCTACAGAACCTATCACACCACTTTCCCAACCCCACAAAAAAATTCTAGTTGGT,GTGGTCTTCAGAAGATGCCCTCTTCATTAACAGTAAGAGGTTATCAGCAAGCTCCTACAGAACCTATCACACCACTTTCCCAACCCCACAAAAAAATTC,10,30,14,27,27,34,27,42,27,27,27,34,35,42,59.18,10.6753263
hek293t,8787,1,8,CGACGCTTCAGAAGATGCCCTCTTCAAAGAGGTTATCAGCAAGCTCCTACAGAACCTATCACACCACTTTCCCAACCCCACCTAGAAAAAAATTCTAGT,CGACGCTTCAGAAGATGCCCTCTTCATTAACAGTAAGAGGTTATCAGCAAGCTCCTACAGAACCTATCACACCACTTTCCCAACCCCACCTAGAAAAAA,10,30,14,27,27,30,27,38,27,27,27,30,35,38,59.18,1.693181539
hek293t,8789,1,3,GCGGTATTAGTGGTTTTAAGAGAGTTTTATGGTTACTGTTTTACAATATAAATTGTGAAACAATGTGTGATCTTGCAGACATTAAAAAAATTCTAGTTG,GCGGTATTAGTGGTTTTAAGAGAGTTTTATGGTGGGTACTGTTTTACAATATAAATTGTGAAACAATGTGTGATCTTGCAGACATTAAAAAAATTCTAG,10,30,14,27,27,37,27,40,27,34,34,37,37,40,9.72,0.098765432
hek293t,8789,1,3,GAACGATTAGTGGTTTTAAGAGAGTTTTATGGTTACTGTTTTACAATATAAATTGTGAAACAATGTGTGATCTTGCAAAAAAATTCTAGTTGGTTTAAC,GAACGATTAGTGGTTTTAAGAGAGTTTTATGGTGGGTACTGTTTTACAATATAAATTGTGAAACAATGTGTGATCTTGCAAAAAAATTCTAGTTGGTTT,10,30,14,27,27,44,27,47,27,34,34,44,37,47,9.72,45.23986617
hek293t,8791,1,11,AGGGCGGAAAGCAAATGGATCAAACATGCAGGCAATCTATTACTGAAGAGCAGGACCGATTAGTCACAGGCAGAGTAAACAAAAAAATTCTAGTTGGTT,AGGGCGGAAAGCAAATGGATCAAACATGCACACGCGAAGCAGGCAATCTATTACTGAAGAGCAGGACCGATTAGTCACAGGCAGAGTAAACAAAAAAAT,10,30,14,27,27,32,27,43,27,29,29,32,40,43,49.4,5.974156651
hek293t,8791,1,11,ATCTAGGAAAGCAAATGGATCAAACATGCAGGCAATCTATTACTGAAGAGCAGGACCGATTAGTCACAGGCAGAAAAAAATTCTAGTTGGTTTAACGCG,ATCTAGGAAAGCAAATGGATCAAACATGCACACGCGAAGCAGGCAATCTATTACTGAAGAGCAGGACCGATTAGTCACAGGCAGAAAAAAATTCTAGTT,10,30,14,27,27,39,27,50,27,29,29,39,40,50,49.4,37.9145262
hek293t,8793,1,15,CAATCATAGAAACTTGTCTAAATGGAATAAGGAGTCTGATTTTAGACGCTCTTCTGCTCTATGGTAAAAAAATTCTAGTTGGTTTAACGCGTAACTAGA,CAATCATAGAAACTTGTCTAAATGGAATAAGGAGTCTGAACTGGATGCTGAAACTTTTAGACGCTCTTCTGCTCTATGGTAAAAAAATTCTAGTTGGTT,10,30,14,27,27,43,27,58,27,40,40,43,55,58,17.22,0.248015873
hek293t,8796,1,9,TGTTCTATATCATTTCATGTAAAGAAAAGTGGTAGTCTTACTTGGAATTTAATACACCTTCATAAAGTACTTAAAAAAATTCTAGTTGGTTTAACGCGT,TGTTCTATATCATTTCATGTAAAGAAAAGTGGTAGTCTGCTTAGTTATACTTGGAATTTAATACACCTTCATAAAGTACTTAAAAAAATTCTAGTTGGT,10,30,14,27,27,42,27,51,27,39,39,42,48,51,32.9,0.0
hek293t,8797,1,11,TGACTTGGATAAACCTTCTCAGCTCAACATGGATAAGATAACTAAGAATATTATCAGAGAGAAAGGCTAAAAAAATTCTAGTTGGTTTAACGCGTAACT,TGACTTGGATAAACCTTCTCAGCTCAACATGGAAGCCGAAGTCATAAGATAACTAAGAATATTATCAGAGAGAAAGGCTAAAAAAATTCTAGTTGGTTT,10,30,14,27,27,44,27,55,27,34,34,44,45,55,64.12,0.431252571
hek293t,8797,1,11,CTGGATGGATAAACCTTCTCAGCTCAACATGGATAAGATAACTAAGAATATTATCAGAGAGAAAGGCTGACACAGAAAAAAATTCTAGTTGGTTTAACG,CTGGATGGATAAACCTTCTCAGCTCAACATGGAAGCCGAAGTCATAAGATAACTAAGAATATTATCAGAGAGAAAGGCTGACACAGAAAAAAATTCTAG,10,30,14,27,27,37,27,48,27,34,34,37,45,48,64.12,0.0
hek293t,8800,1,10,GAGACTCACCATGTTATTACAGTTGTCCTAGGACCAGGTATTAACAGCTCTAGGAATTCAGCAAGATACATTAACAAAAAAATTCTAGTTGGTTTAACG,GAGACTCACCATGTTATTACAGTTGTCCTAGGACACGACCCCCGCAGGTATTAACAGCTCTAGGAATTCAGCAAGATACATTAACAAAAAAATTCTAGT,10,30,14,27,27,38,27,48,27,35,35,38,45,48,55.47,0.382262997
hek293t,8800,1,10,GTAACTCACCATGTTATTACAGTTGTCCTAGGACCAGGTATTAACAGCTCTAGGAATTCAGCAAGATACATAAAAAAATTCTAGTTGGTTTAACGCGTA,GTAACTCACCATGTTATTACAGTTGTCCTAGGACACGACCCCCGCAGGTATTAACAGCTCTAGGAATTCAGCAAGATACATAAAAAAATTCTAGTTGGT,10,30,14,27,27,42,27,52,27,35,35,42,45,52,55.47,0.37236681
hek293t,8802,1,9,CTTGATAAGGGCTTGATCCTGGTCGGTGCAGGTTATCCTTAGCTTGTTCAGACTGTTGTTCACACAGAAAAAAATTCTAGTTGGTTTAACGCGTAACTA,CTTGATAAGGGCTTGATCCTGGTCGGTGCAGCCCCCCCGTGTTATCCTTAGCTTGTTCAGACTGTTGTTCACACAGAAAAAAATTCTAGTTGGTTTAAC,10,30,14,27,27,47,27,56,27,32,32,47,41,56,51.95,28.33266897
hek293t,8802,1,9,ATATTTAAGGGCTTGATCCTGGTCGGTGCAGGTTATCCTTAGCTTGTTCAGACTGTTGTTCACACAGCAGCTTGCCAGGAAAAAAATTCTAGTTGGTTT,ATATTTAAGGGCTTGATCCTGGTCGGTGCAGCCCCCCCGTGTTATCCTTAGCTTGTTCAGACTGTTGTTCACACAGCAGCTTGCCAGGAAAAAAATTCT,10,30,14,27,27,35,27,44,27,32,32,35,41,44,51.95,0.694444444
hek293t,720,1,3,AGGTTTGTTACAGCCTTCCCAACCTCAAGTGGTACTTTACAGCTTGAATTCTGTCCCATCGACTGAGCCCAGCCAGAAAAAAATTCTAGTTGGTTTAAC,AGGTTTGTTACAGCCTTCCCAACCTCAAGTGGTACTTTACACGAGCTTGAATTCTGTCCCATCGACTGAGCCCAGCCAGAAAAAAATTCTAGTTGGTTT,10,30,14,27,27,44,27,47,27,41,41,44,44,47,50.78,0.0
hek293t,720,1,3,CTGTATGTTACAGCCTTCCCAACCTCAAGTGGTACTTTACAGCTTGAATTCTGTCCCATCGACTGAGCCCAGAAAAAAATTCTAGTTGGTTTAACGCGT,CTGTATGTTACAGCCTTCCCAACCTCAAGTGGTACTTTACACGAGCTTGAATTCTGTCCCATCGACTGAGCCCAGAAAAAAATTCTAGTTGGTTTAACG,10,30,14,27,27,48,27,51,27,41,41,48,44,51,50.78,70.7799883
hek293t,8806,1,8,ATGGAGTACTTTTCCTCATGCTTTTTGTAAGGGCATATTTATGAGGTGTCTGGAGGAATAATACTTTGTATAAAAAAATTCTAGTTGGTTTAACGCGTA,ATGGAGTACTTTTCCTCATGCTTTTTGTAAGGGCATATTTCACTTAGAATGAGGTGTCTGGAGGAATAATACTTTGTATAAAAAAATTCTAGTTGGTTT,10,30,14,27,27,44,27,52,27,41,41,44,49,52,6.55,0.0
hek293t,8806,1,8,GCGTCGTACTTTTCCTCATGCTTTTTGTAAGGGCATATTTATGAGGTGTCTGGAGGAATAATACAAAAAAATTCTAGTTGGTTTAACGCGTAACTAGAT,GCGTCGTACTTTTCCTCATGCTTTTTGTAAGGGCATATTTCACTTAGAATGAGGTGTCTGGAGGAATAATACAAAAAAATTCTAGTTGGTTTAACGCGT,10,30,14,27,27,51,27,59,27,41,41,51,49,59,6.55,0.096227868
hek293t,8808,1,12,AAATTAAGGGCATGGAGAGTAATGAGGCGAGGTTTTGTCAGTAGCTGTCAAATGCAGAAATAAATAACTTAAAAAAATTCTAGTTGGTTTAACGCGTAA,AAATTAAGGGCATGGAGAGTAATGAGGCGAACCCACGGTGTGGGTTTTGTCAGTAGCTGTCAAATGCAGAAATAAATAACTTAAAAAAATTCTAGTTGG,10,30,14,27,27,41,27,53,27,31,31,41,43,53,56.22,29.26763923
hek293t,8810,1,10,AACGTTAAATAATAATTTCTCCTTTCCAAAGGTGATGAGGCCTGTGGAAGCAATGCAGGGAGAAAAAAAAAATTCTAGTTGGTTTAACGCGTAACTAGA,AACGTTAAATAATAATTTCTCCTTTCCAAAGGTGATGAGGGTCCAGCAGTCCTGTGGAAGCAATGCAGGGAGAAAAAAAAAATTCTAGTTGGTTTAACG,10,30,14,27,27,48,27,58,27,41,41,48,51,58,13.93,0.799951702
hek293t,8812,1,7,TTAACGCACGCCAGATAGTGCTGCTGCCGAGGTCGCTGCGGTGCCGCGCAATAGTCCTGATGGAGTTCAAAAAAATTCTAGTTGGTTTAACGCGTAACT,TTAACGCACGCCAGATAGTGCTGCTGCCGAGGTCGCTGCGCGAACACGTGCCGCGCAATAGTCCTGATGGAGTTCAAAAAAATTCTAGTTGGTTTAACG,10,30,14,27,27,48,27,55,27,41,41,48,48,55,47.05,30.27827446
hek293t,8814,1,5,TAGGAGCTTACTTTATTTTGATGAAGTGAAGGTAAACAATGGCCTTACAGTGGTAAGGACCAGAGGACCTCCCCAAAAAAATTCTAGTTGGTTTAACGC,TAGGAGCTTACTTTATTTTGATGAAGTGAAGGTTCTCAAAACAATGGCCTTACAGTGGTAAGGACCAGAGGACCTCCCCAAAAAAATTCTAGTTGGTTT,10,30,14,27,27,44,27,49,27,34,34,44,39,49,17.13,2.261038533
hek293t,8818,1,10,CTTCCCAAACTTCAAATCAGAAAATGCACAGGAGAGAAGCTGCTTTTGAAAAATAATTAATATGCAAAAAAAATTCTAGTTGGTTTAACGCGTAACTAG,CTTCCCAAACTTCAAATCAGAAAATGCACAGGAGAGAAGACTTGCGGCGCTGCTTTTGAAAAATAATTAATATGCAAAAAAAATTCTAGTTGGTTTAAC,10,30,14,27,27,47,27,57,27,40,40,47,50,57,34.89,0.024224806
hek293t,8818,1,10,GCCATCAAACTTCAAATCAGAAAATGCACAGGAGAGAAGCTGCTTTTGAAAAATAATTAATATGCACTATAAAAAAATTCTAGTTGGTTTAACGCGTAA,GCCATCAAACTTCAAATCAGAAAATGCACAGGAGAGAAGACTTGCGGCGCTGCTTTTGAAAAATAATTAATATGCACTATAAAAAAATTCTAGTTGGTT,10,30,14,27,27,43,27,53,27,40,40,43,50,53,34.89,0.0
hek293t,8820,1,6,GATTGTAACAAAAAATGTTAATGGAAAAAAGGAAATGCCTGTAGATGACACTATAGTGAACACTTCCTATTTAAAAAAATTCTAGTTGGTTTAACGCGT,GATTGTAACAAAAAATGTTAATGGAAAAAAGGAAATGCAGAGTCCTGTAGATGACACTATAGTGAACACTTCCTATTTAAAAAAATTCTAGTTGGTTTA,10,30,14,27,27,45,27,51,27,38,38,45,44,51,-0.47,0.0
hek293t,8822,1,13,GTGTTTTTGCTGAAGAGCTGCACGAGCTCTGGAAATGTGTAAATAAGGCAATTTGGAGGTTTGTGAAAAAAAAATTCTAGTTGGTTTAACGCGTAACTA,GTGTTTTTGCTGAAGAGCTGCACGAGCTCTGGAGGCAATCTCATAAAATGTGTAAATAAGGCAATTTGGAGGTTTGTGAAAAAAAAATTCTAGTTGGTT,10,30,14,27,27,43,27,56,27,33,33,43,46,56,43.7,0.0
hek293t,16245,1,9,TCTTGAGGGGTCTACATATGACAACAGAGAGGCCCAGTTAACTGTAGCTTCCTAAGTCTAGAGTAAAACAGAAAAAAATTCTAGTTGGTTTAACGCGTA,TCTTGAGGGGTCTACATATGACAACAGAGAGGCCCAGTTTTTGAACTAAACTGTAGCTTCCTAAGTCTAGAGTAAAACAGAAAAAAATTCTAGTTGGTT,10,30,14,27,27,43,27,52,27,40,40,43,49,52,66.32,0.140562249
hek293t,16245,1,9,CGTAGAGGGGTCTACATATGACAACAGAGAGGCCCAGTTAACTGTAGCTTCCTAAGTCTAGAGTAAAAAAAAAATTCTAGTTGGTTTAACGCGTAACTA,CGTAGAGGGGTCTACATATGACAACAGAGAGGCCCAGTTTTTGAACTAAACTGTAGCTTCCTAAGTCTAGAGTAAAAAAAAAATTCTAGTTGGTTTAAC,10,30,14,27,27,47,27,56,27,40,40,47,49,56,66.32,1.677042904
hek293t,8825,1,14,ATGCTCATATTTTACAGCATTAGGATCTATGGAATATTTTGACAACTGCAACAGTTCAATGAAGTTGAAAAAAATTCTAGTTGGTTTAACGCGTAACTA,ATGCTCATATTTTACAGCATTAGGATCTATGAGACTGGGGGCGGGGAATATTTTGACAACTGCAACAGTTCAATGAAGTTGAAAAAAATTCTAGTTGGT,10,30,14,27,27,42,27,56,27,32,32,42,46,56,10.1,0.388726919
hek293t,8825,1,14,TTATTCATATTTTACAGCATTAGGATCTATGGAATATTTTGACAACTGCAACAGTTCAATGAAGTTGGTAATTTAAAAAAATTCTAGTTGGTTTAACGC,TTATTCATATTTTACAGCATTAGGATCTATGAGACTGGGGGCGGGGAATATTTTGACAACTGCAACAGTTCAATGAAGTTGGTAATTTAAAAAAATTCT,10,30,14,27,27,35,27,49,27,32,32,35,46,49,10.1,0.0
hek293t,8827,1,5,AGTTCTGCCTTTCCTCTAGAAGCTGTTTATGGTAATGCTAGGTGTCCAGTTGGAATGTGCATGGCGTTGTTGCCTGTAGCAGGCTGTTAAAAAAATTCT,AGTTCTGCCTTTCCTCTAGAAGCTGTTATCATTATGGTAATGCTAGGTGTCCAGTTGGAATGTGCATGGCGTTGTTGCCTGTAGCAGGCTGTTAAAAAA,10,30,14,27,27,30,27,35,27,27,27,30,32,35,12.23,0.0
hek293t,8827,1,5,ACTGATGCCTTTCCTCTAGAAGCTGTTTATGGTAATGCTAGGTGTCCAGTTGGAATGTGCATGGCGTTGTTGCCTGAAAAAAATTCTAGTTGGTTTAAC,ACTGATGCCTTTCCTCTAGAAGCTGTTATCATTATGGTAATGCTAGGTGTCCAGTTGGAATGTGCATGGCGTTGTTGCCTGAAAAAAATTCTAGTTGGT,10,30,14,27,27,42,27,47,27,27,27,42,32,47,12.23,11.05624085
hek293t,8829,1,15,ATCAGGTAACATTCTAAAAAACTTTTCAATGGATCTGTGACCCACTGATCTCTGCAGGCCAGCGCAAAAAAATTCTAGTTGGTTTAACGCGTAACTAGA,ATCAGGTAACATTCTAAAAAACTTTTCAATGGATCTTGCAGGGCGATAACTGTGACCCACTGATCTCTGCAGGCCAGCGCAAAAAAATTCTAGTTGGTT,10,30,14,27,27,43,27,58,27,36,36,43,51,58,15.15,0.057077626
hek293t,8832,1,13,GTAACAATTAAATTGCATTCAACAAAACAAGGAGTCAGATAAAATGCATTTAAAAAAGGTTTGAAAAATCAAAAAAATTCTAGTTGGTTTAACGCGTAA,GTAACAATTAAATTGCATTCAACAAAACAAGGTTGAGGCGTTGGAAGTCAGATAAAATGCATTTAAAAAAGGTTTGAAAAATCAAAAAAATTCTAGTTG,10,30,14,27,27,40,27,53,27,33,33,40,46,53,40.15,0.0
hek293t,8833,1,13,CTTTGATGTAACTGGGCTTCTTTCTAGGAAGGTGAAAAATTGTATGATTAGTGGAAGCATGTTTTGCAATTACGAAAAAAATTCTAGTTGGTTTAACGC,CTTTGATGTAACTGGGCTTCTTTCTAGGAAGGTGCGGTCTAATGTTGAAAAATTGTATGATTAGTGGAAGCATGTTTTGCAATTACGAAAAAAATTCTA,10,30,14,27,27,36,27,49,27,33,33,36,46,49,35.99,0.111113209
hek293t,8836,1,8,TTACGGGATGTCCACAGCCCGAAAAGCCATGGCCCCCGGCAGTCCCCCTGCTGAGATTTTAAGGCTGAAAAAAAATTCTAGTTGGTTTAACGCGTAACT,TTACGGGATGTCCACAGCCCGAAAAGCCATGGCCCCCGGAGGACGTCCAGTCCCCCTGCTGAGATTTTAAGGCTGAAAAAAAATTCTAGTTGGTTTAAC,10,30,14,27,27,47,27,55,27,40,40,47,48,55,62.09,3.782621757
hek293t,8836,1,8,CGTAGGGATGTCCACAGCCCGAAAAGCCATGGCCCCCGGCAGTCCCCCTGCTGAGATTTTAAGGCTGAGGACAAAAAAATTCTAGTTGGTTTAACGCGT,CGTAGGGATGTCCACAGCCCGAAAAGCCATGGCCCCCGGAGGACGTCCAGTCCCCCTGCTGAGATTTTAAGGCTGAGGACAAAAAAATTCTAGTTGGTT,10,30,14,27,27,43,27,51,27,40,40,43,48,51,62.09,0.718581136
hek293t,8840,1,12,CGGATACTGCAAAGAGGTGTGGCATAGAGTGGCACAGAGTGCTTTCATTTTACCTGAAATTTCTGTAAAAAAATTCTAGTTGGTTTAACGCGTAACTAG,CGGATACTGCAAAGAGGTGTGGCATAGAGTCATGTCTATCATGGCACAGAGTGCTTTCATTTTACCTGAAATTTCTGTAAAAAAATTCTAGTTGGTTTA,10,30,14,27,27,45,27,57,27,30,30,45,42,57,57.18,17.98997209
hek293t,8840,1,12,GGTACACTGCAAAGAGGTGTGGCATAGAGTGGCACAGAGTGCTTTCATTTTACCTGAAATTTCTGTAATCAAAACTCTAAAAAAATTCTAGTTGGTTTA,GGTACACTGCAAAGAGGTGTGGCATAGAGTCATGTCTATCATGGCACAGAGTGCTTTCATTTTACCTGAAATTTCTGTAATCAAAACTCTAAAAAAATT,10,30,14,27,27,33,27,45,27,30,30,33,42,45,57.18,0.0
hek293t,8842,1,7,GATGCAACAGAAAATAAACATGGTCTGCCAGGCAGAGAAAGACTATGATGAGAAGTATTTTCTTCAAAAAAATTCTAGTTGGTTTAACGCGTAACTAGA,GATGCAACAGAAAATAAACATGGTCTGCCAGGCAGAGAAACACGCACGACTATGATGAGAAGTATTTTCTTCAAAAAAATTCTAGTTGGTTTAACGCGT,10,30,14,27,27,51,27,58,27,41,41,51,48,58,46.96,0.74857812
hek293t,8842,1,7,TCCTCAACAGAAAATAAACATGGTCTGCCAGGCAGAGAAAGACTATGATGAGAAGTATTTTCTTCAGTTTACAAAAAAATTCTAGTTGGTTTAACGCGT,TCCTCAACAGAAAATAAACATGGTCTGCCAGGCAGAGAAACACGCACGACTATGATGAGAAGTATTTTCTTCAGTTTACAAAAAAATTCTAGTTGGTTT,10,30,14,27,27,44,27,51,27,41,41,44,48,51,46.96,0.0
hek293t,8844,1,3,GGTCCCTACGGTCATTTCGGTGAACAGTACGGCGCAAGAAGATTCTTTAATGTAGTATCTTGAAAAAAAAATTCTAGTTGGTTTAACGCGTAACTAGAT,GGTCCCTACGGTCATTTCGGTGAACAGTACGGCGCAAGAATTGGATTCTTTAATGTAGTATCTTGAAAAAAAAATTCTAGTTGGTTTAACGCGTAACTA,10,30,14,27,27,56,27,59,27,41,41,56,44,59,54.32,59.95016249
hek293t,8850,1,1,GCCCTAAAAATATGAAGAATTAAGGAAATTGGAATAATAATTGGGCAAACAATGAATCCAGTTAAACTTCTGTAGTTCAAAAAAATTCTAGTTGGTTTA,GCCCTAAAAATATGAAGAATTAAGGAAACTTGGAATAATAATTGGGCAAACAATGAATCCAGTTAAACTTCTGTAGTTCAAAAAAATTCTAGTTGGTTT,10,30,14,27,27,44,27,45,27,29,29,44,30,45,13.84,0.0
hek293t,8850,1,1,CATACAAAAATATGAAGAATTAAGGAAATTGGAATAATAATTGGGCAAACAATGAATCCAGTTAAACTTCTGTAGTTCCAAATAAAAAAATTCTAGTTG,CATACAAAAATATGAAGAATTAAGGAAACTTGGAATAATAATTGGGCAAACAATGAATCCAGTTAAACTTCTGTAGTTCCAAATAAAAAAATTCTAGTT,10,30,14,27,27,39,27,40,27,29,29,39,30,40,13.84,2.800387094
hek293t,8855,1,3,CATTTCTATACACATTGCAAACGGTCAGAAGGGAATGCCAGGGCATCTGCTCTGCAACTATTTCTTCATTGTTCAGTTAAAAAAATTCTAGTTGGTTTA,CATTTCTATACACATTGCAAACGGTCAGAAGGTTGGAATGCCAGGGCATCTGCTCTGCAACTATTTCTTCATTGTTCAGTTAAAAAAATTCTAGTTGGT,10,30,14,27,27,42,27,45,27,32,32,42,35,45,20.7,86.66784283
hek293t,8855,1,3,TTTAACTATACACATTGCAAACGGTCAGAAGGGAATGCCAGGGCATCTGCTCTGCAACTATTTCTTCATTGTTAAAAAAATTCTAGTTGGTTTAACGCG,TTTAACTATACACATTGCAAACGGTCAGAAGGTTGGAATGCCAGGGCATCTGCTCTGCAACTATTTCTTCATTGTTAAAAAAATTCTAGTTGGTTTAAC,10,30,14,27,27,47,27,50,27,32,32,47,35,50,20.7,80.30397788
hek293t,8857,1,6,ACGACTTACTTCACAGAACTGATGGTCCACGGAGCTCCGGTTTCCCTGAGGGTTTCTGCCTTGATGTTATCTAAAAAAAATTCTAGTTGGTTTAACGCG,ACGACTTACTTCACAGAACTGATGGTCCACGGAGCTCCGGCTCCCGTTTCCCTGAGGGTTTCTGCCTTGATGTTATCTAAAAAAAATTCTAGTTGGTTT,10,30,14,27,27,44,27,50,27,41,41,44,47,50,60.8,0.12539185
hek293t,8861,1,14,GCTTCCTCAAAGAAAAGCCGATATACATGTGGCGTGTATAACACCTACAAACTCCCTGCGCACCAAAAAAATTCTAGTTGGTTTAACGCGTAACTAGAT,GCTTCCTCAAAGAAAAGCCGATATACATGTGGCGTGTCGTGACCAGATGCAATAACACCTACAAACTCCCTGCGCACCAAAAAAATTCTAGTTGGTTTA,10,30,14,27,27,45,27,59,27,38,38,45,52,59,57.73,0.0
hek293t,8862,1,3,AGCTATGCATACATGAGGCAGCAAAATTAAGGTTCTCATGTTAACCTTATCCAATAGATAGTTTCCAAACTCTTGAGAAATAAAAAAATTCTAGTTGGT,AGCTATGCATACATGAGGCAGCAAAATTAAGACCGTTCTCATGTTAACCTTATCCAATAGATAGTTTCCAAACTCTTGAGAAATAAAAAAATTCTAGTT,10,30,14,27,27,39,27,42,27,32,32,39,35,42,27.48,15.17231428
hek293t,8862,1,3,TATAGTGCATACATGAGGCAGCAAAATTAAGGTTCTCATGTTAACCTTATCCAATAGATAGTTTCCAAACTCTTGAGAAAAAAAATTCTAGTTGGTTTA,TATAGTGCATACATGAGGCAGCAAAATTAAGACCGTTCTCATGTTAACCTTATCCAATAGATAGTTTCCAAACTCTTGAGAAAAAAAATTCTAGTTGGT,10,30,14,27,27,42,27,45,27,32,32,42,35,45,27.48,15.74794141
hek293t,8864,1,3,TACGCAGAATCACTGCTGAGTTAGTTTTGAGGAATAAATGGGCCAGAGAGCATTGACCAGATGGCTGTCCGGAGGTGTTGGGTGGATCTAAAAAAATTC,TACGCAGAATCACTGCTGAGTTAGTTTTTGTGAGGAATAAATGGGCCAGAGAGCATTGACCAGATGGCTGTCCGGAGGTGTTGGGTGGATCTAAAAAAA,10,30,14,27,27,31,27,34,27,28,28,31,31,34,39.55,0.0
hek293t,8864,1,3,ATTGGAGAATCACTGCTGAGTTAGTTTTGAGGAATAAATGGGCCAGAGAGCATTGACCAGATGGCTGTCCGGAGGTGTTGGGTGGAAAAAAATTCTAGT,ATTGGAGAATCACTGCTGAGTTAGTTTTTGTGAGGAATAAATGGGCCAGAGAGCATTGACCAGATGGCTGTCCGGAGGTGTTGGGTGGAAAAAAATTCT,10,30,14,27,27,35,27,38,27,28,28,35,31,38,39.55,14.10856454
hek293t,8866,1,10,GCAACTTGTTCTGTGTAAGCACACAGCTCTGGGCAGCCCTGGACTCAGCTGTCGGAGTCTCCAGCACCATACAGAGCTCCAAAAAAATTCTAGTTGGTT,GCAACTTGTTCTGTGTAAGCACACAGCTCCGCGCTGACGTGGGCAGCCCTGGACTCAGCTGTCGGAGTCTCCAGCACCATACAGAGCTCCAAAAAAATT,10,30,14,27,27,33,27,43,27,30,30,33,40,43,60.01,17.69350868
hek293t,8868,1,11,CGCGAGAGTAAGGGTCTCCAGGTTACTGAAGGCATAAAAATACAGACTTGAAGTCTATGTTAATAGGTAAAAAAATTCTAGTTGGTTTAACGCGTAACT,CGCGAGAGTAAGGGTCTCCAGGTTACTGCATAAAAGGGTAAGGCATAAAAATACAGACTTGAAGTCTATGTTAATAGGTAAAAAAATTCTAGTTGGTTT,10,30,14,27,27,44,27,55,27,29,29,44,40,55,59.77,0.635946559
hek293t,8868,1,11,AAGCTGAGTAAGGGTCTCCAGGTTACTGAAGGCATAAAAATACAGACTTGAAGTCTATGTTAATAGGTTAAAAGATACCAAAAAAAATTCTAGTTGGTT,AAGCTGAGTAAGGGTCTCCAGGTTACTGCATAAAAGGGTAAGGCATAAAAATACAGACTTGAAGTCTATGTTAATAGGTTAAAAGATACCAAAAAAAAT,10,30,14,27,27,32,27,43,27,29,29,32,40,43,59.77,0.0
hek293t,8873,1,7,CAAATACAGCACCTAAACAAGAGCAGGCAAGGAAACCTGTTTAAGGATTAAAGGAAAACCACGAATGAGACTTCCTAAAAAAATTCTAGTTGGTTTAAC,CAAATACAGCACCTAAACAAGAGCAGGCAAGGAAACAGTGTGACTGTTTAAGGATTAAAGGAAAACCACGAATGAGACTTCCTAAAAAAATTCTAGTTG,10,30,14,27,27,40,27,47,27,37,37,40,44,47,25.28,0.0
hek293t,8873,1,7,CACCAACAGCACCTAAACAAGAGCAGGCAAGGAAACCTGTTTAAGGATTAAAGGAAAACCACGAAAAAAAATTCTAGTTGGTTTAACGCGTAACTAGAT,CACCAACAGCACCTAAACAAGAGCAGGCAAGGAAACAGTGTGACTGTTTAAGGATTAAAGGAAAACCACGAAAAAAAATTCTAGTTGGTTTAACGCGTA,10,30,14,27,27,52,27,59,27,37,37,52,44,59,25.28,0.579199839
hek293t,8875,1,6,GGGTTCGGCTCTGCAGGCCCCAGGAGCGTCGGGTCGGGCTCGCCTGCGGTGCTCAGCGCCCGCTTTGTCATGCTTCCTTGCCTCCTCAAAAAAATTCTA,GGGTTCGGCTCTGCAGGCCCCAGGAGATAATACGTCGGGTCGGGCTCGCCTGCGGTGCTCAGCGCCCGCTTTGTCATGCTTCCTTGCCTCCTCAAAAAA,10,30,14,27,27,30,27,36,27,27,27,30,33,36,53.62,6.447987354
hek293t,8875,1,6,GTCCCCGGCTCTGCAGGCCCCAGGAGCGTCGGGTCGGGCTCGCCTGCGGTGCTCAGCGCCCGCTTTGTCATGCTTCCTTGCCTAAAAAAATTCTAGTTG,GTCCCCGGCTCTGCAGGCCCCAGGAGATAATACGTCGGGTCGGGCTCGCCTGCGGTGCTCAGCGCCCGCTTTGTCATGCTTCCTTGCCTAAAAAAATTC,10,30,14,27,27,34,27,40,27,27,27,34,33,40,53.62,68.56009706
hek293t,8877,1,12,GCTCGACAATTTTAAATGCAATACTCTTAAGGTTAGCTGTTTTTGAACAATTTGCTGACAGTTAGGAAAAAAAAATTCTAGTTGGTTTAACGCGTAACT,GCTCGACAATTTTAAATGCAATACTCTTAAGGTTACGGCTGCCTATTGCTGTTTTTGAACAATTTGCTGACAGTTAGGAAAAAAAAATTCTAGTTGGTT,10,30,14,27,27,43,27,55,27,36,36,43,48,55,3.65,0.0
hek293t,8878,1,5,ATGGGTCTCAACCAGCTAATATTGAGAAAAGGGTGGCTTTAAAAATTGCTAGAATTAAAATGAAACGTGCAAAAACAAAGAAAAAAATTCTAGTTGGTT,ATGGGTCTCAACCAGCTAATATTGAGAGCACGAAAGGGTGGCTTTAAAAATTGCTAGAATTAAAATGAAACGTGCAAAAACAAAGAAAAAAATTCTAGT,10,30,14,27,27,38,27,43,27,28,28,38,33,43,17.24,27.07091754
hek293t,8878,1,5,GCGGGTCTCAACCAGCTAATATTGAGAAAAGGGTGGCTTTAAAAATTGCTAGAATTAAAATGAAACGTGCAAAAACAAAGAACAAAGAAAAAAATTCTA,GCGGGTCTCAACCAGCTAATATTGAGAGCACGAAAGGGTGGCTTTAAAAATTGCTAGAATTAAAATGAAACGTGCAAAAACAAAGAACAAAGAAAAAAA,10,30,14,27,27,31,27,36,27,28,28,31,33,36,17.24,0.033333333
hek293t,17595,1,2,GGTCACAGGAAATTTGCCCAGATGCTGGAAGGCAATACAAGATATTTGACTCAACATTACCCCCCCCCTTGACTTTCAAAAAAAAATTCTAGTTGGTTT,GGTCACAGGAAATTTGCCCAGATGCTGGAAGGCAACATACAAGATATTTGACTCAACATTACCCCCCCCCTTGACTTTCAAAAAAAAATTCTAGTTGGT,10,30,14,27,27,42,27,44,27,35,35,42,37,44,63.2,85.24336855
hek293t,8884,1,9,CTAAGTTCTATAGACATGAGGAGGGACAGGGGATTTTCTTCTGTGAAACCTTTACTCCTCACAGAAAAAAATTCTAGTTGGTTTAACGCGTAACTAGAT,CTAAGTTCTATAGACATGAGGAGGGACAGGGGATGAAACCTCATTTCTTCTGTGAAACCTTTACTCCTCACAGAAAAAAATTCTAGTTGGTTTAACGCG,10,30,14,27,27,50,27,59,27,35,35,50,44,59,58.1,7.73291182
hek293t,8884,1,9,TGCCATTCTATAGACATGAGGAGGGACAGGGGATTTTCTTCTGTGAAACCTTTACTCCTCACAGACTGGAGAAAAAAAATTCTAGTTGGTTTAACGCGT,TGCCATTCTATAGACATGAGGAGGGACAGGGGATGAAACCTCATTTCTTCTGTGAAACCTTTACTCCTCACAGACTGGAGAAAAAAAATTCTAGTTGGT,10,30,14,27,27,42,27,51,27,35,35,42,44,51,58.1,3.610280889
hek293t,8886,1,6,TGCTGTTAGAAATGCCAAAAAGTCATGCAAGGAAGGAAAAAATGTTTTTCTTTTTTCATTTATTTGCATGAAATTCCTAAAAAAATTCTAGTTGGTTTA,TGCTGTTAGAAATGCCAAAAAGTCATGCAAGGAAGCTCCCGGAAAAAATGTTTTTCTTTTTTCATTTATTTGCATGAAATTCCTAAAAAAATTCTAGTT,10,30,14,27,27,39,27,45,27,36,36,39,42,45,67.83,0.0
hek293t,8886,1,6,ACTGATTAGAAATGCCAAAAAGTCATGCAAGGAAGGAAAAAATGTTTTTCTTTTTTCATTTATTTGCATGAAAAAAAATTCTAGTTGGTTTAACGCGTA,ACTGATTAGAAATGCCAAAAAGTCATGCAAGGAAGCTCCCGGAAAAAATGTTTTTCTTTTTTCATTTATTTGCATGAAAAAAAATTCTAGTTGGTTTAA,10,30,14,27,27,46,27,52,27,36,36,46,42,52,67.83,0.396064756
hek293t,8888,1,12,TGCTTAGCACCTTTGGAAAAGATTAATCTAGGGTGGTACCCCCCCAAAAACGTGTTCAGTAGAAAGCTTGGCTTAAAAAAATTCTAGTTGGTTTAACGC,TGCTTAGCACCTTTGGAAAAGATTAATCTAGGGACTTTGCAACTATGGTACCCCCCCAAAAACGTGTTCAGTAGAAAGCTTGGCTTAAAAAAATTCTAG,10,30,14,27,27,37,27,49,27,34,34,37,46,49,31.16,0.0
hek293t,8888,1,12,GACGAAGCACCTTTGGAAAAGATTAATCTAGGGTGGTACCCCCCCAAAAACGTGTTCAGTAGAAAGCAAAAAAATTCTAGTTGGTTTAACGCGTAACTA,GACGAAGCACCTTTGGAAAAGATTAATCTAGGGACTTTGCAACTATGGTACCCCCCCAAAAACGTGTTCAGTAGAAAGCAAAAAAATTCTAGTTGGTTT,10,30,14,27,27,44,27,56,27,34,34,44,46,56,31.16,0.275968836
hek293t,8890,1,1,TCATTTCAAAGTCTAAGTAGTGGTGACTTTGGTCTTGTTTTCAAGTGCAGCTTGTCAGTTCTGCAACCTTTTACTTCTCCGCAAAAAAATTCTAGTTGG,TCATTTCAAAGTCTAAGTAGTGGTGACTTCTGGTCTTGTTTTCAAGTGCAGCTTGTCAGTTCTGCAACCTTTTACTTCTCCGCAAAAAAATTCTAGTTG,10,30,14,27,27,40,27,41,27,30,30,40,31,41,42.69,75.62756449
hek293t,8890,1,1,GCGTTTCAAAGTCTAAGTAGTGGTGACTTTGGTCTTGTTTTCAAGTGCAGCTTGTCAGTTCTGCAACCTTTTACTTCAAAAAAATTCTAGTTGGTTTAA,GCGTTTCAAAGTCTAAGTAGTGGTGACTTCTGGTCTTGTTTTCAAGTGCAGCTTGTCAGTTCTGCAACCTTTTACTTCAAAAAAATTCTAGTTGGTTTA,10,30,14,27,27,45,27,46,27,30,30,45,31,46,42.69,77.05321469
hek293t,8892,1,6,AGGGCTCTTGGGAATACGGAACATCGATCTGGAAGGCATATCAAGGATAATCCAGTCTAGTTCCCTGGCAAAAAAAATTCTAGTTGGTTTAACGCGTAA,AGGGCTCTTGGGAATACGGAACATCGATCTGACATGCGAAGGCATATCAAGGATAATCCAGTCTAGTTCCCTGGCAAAAAAAATTCTAGTTGGTTTAAC,10,30,14,27,27,47,27,53,27,32,32,47,38,53,44.66,57.92324947
hek293t,851,1,12,GTTAACCTGTTATCAGATTACACCCATACAGGTGGTGGGCCCCCCCCAATTTCCTTGTCCATATTTCCCAGAAAAAAAATTCTAGTTGGTTTAACGCGT,GTTAACCTGTTATCAGATTACACCCATACAGATTTGCTCTCTTGTGGTGGGCCCCCCCCAATTTCCTTGTCCATATTTCCCAGAAAAAAAATTCTAGTT,10,30,14,27,27,39,27,51,27,32,32,39,44,51,36.61,9.972070324
hek293t,8897,1,2,CAGAGGGAGGATTTACTTCCGCCACGTTTTGGAAGTAGCTGAGAAGGGAGAAGGCGGCTGGGCTGGCAGAGAAAAAAATTCTAGTTGGTTTAACGCGTA,CAGAGGGAGGATTTACTTCCGCCACGTTTTGGAAACGTAGCTGAGAAGGGAGAAGGCGGCTGGGCTGGCAGAGAAAAAAATTCTAGTTGGTTTAACGCG,10,30,14,27,27,50,27,52,27,35,35,50,37,52,17.94,26.19142941
hek293t,8897,1,2,AAACAGGAGGATTTACTTCCGCCACGTTTTGGAAGTAGCTGAGAAGGGAGAAGGCGGCTGGGCTGGCAGAGGCAGCGTTAGGCAAAAAAATTCTAGTTG,AAACAGGAGGATTTACTTCCGCCACGTTTTGGAAACGTAGCTGAGAAGGGAGAAGGCGGCTGGGCTGGCAGAGGCAGCGTTAGGCAAAAAAATTCTAGT,10,30,14,27,27,38,27,40,27,35,35,38,37,40,17.94,34.49736441
hek293t,8899,1,12,GCCATAGTAGCTTGAAATGCAGCTCTCACTGGTGGAAGCCTTTTCCGGGTCCTGTGGTTGAATTCTCCTTTAAAAAAATTCTAGTTGGTTTAACGCGTA,GCCATAGTAGCTTGAAATGCAGCTCTCACTGGGTCTGACCGAGTTGGAAGCCTTTTCCGGGTCCTGTGGTTGAATTCTCCTTTAAAAAAATTCTAGTTG,10,30,14,27,27,40,27,52,27,33,33,40,45,52,45.01,2.147230949
hek293t,8899,1,12,TAATAAGTAGCTTGAAATGCAGCTCTCACTGGTGGAAGCCTTTTCCGGGTCCTGTGGTTGAATTCTCCTTTATGGAAAAAAATTCTAGTTGGTTTAACG,TAATAAGTAGCTTGAAATGCAGCTCTCACTGGGTCTGACCGAGTTGGAAGCCTTTTCCGGGTCCTGTGGTTGAATTCTCCTTTATGGAAAAAAATTCTA,10,30,14,27,27,36,27,48,27,33,33,36,45,48,45.01,0.130378096
hek293t,8901,1,9,TTTTGTTCACCTCATCCAGCTCGGGCTTCTGGCCCTCTCAAAGTGAGCACACCCCGATTGCACCTGACACTGAGAAAAAAATTCTAGTTGGTTTAACGC,TTTTGTTCACCTCATCCAGCTCGGGCTTCGGCTACGGATGGCCCTCTCAAAGTGAGCACACCCCGATTGCACCTGACACTGAGAAAAAAATTCTAGTTG,10,30,14,27,27,40,27,49,27,30,30,40,39,49,12.45,45.6407348
hek293t,8901,1,9,TCACATTCACCTCATCCAGCTCGGGCTTCTGGCCCTCTCAAAGTGAGCACACCCCGATTGCACCTGACACTGAGTTCACACAAAAAAATTCTAGTTGGT,TCACATTCACCTCATCCAGCTCGGGCTTCGGCTACGGATGGCCCTCTCAAAGTGAGCACACCCCGATTGCACCTGACACTGAGTTCACACAAAAAAATT,10,30,14,27,27,33,27,42,27,30,30,33,39,42,12.45,0.645594082
hek293t,8903,1,11,CACGGTAGGAAGGATCATACACAGCAGTGAGGTGCTTTCTTTAAATAGGTATTAGATACCTAGCTATAATTTGTGAAAAAAATTCTAGTTGGTTTAACG,CACGGTAGGAAGGATCATACACAGCAGTGAGGTCCCACCCTACTGCTTTCTTTAAATAGGTATTAGATACCTAGCTATAATTTGTGAAAAAAATTCTAG,10,30,14,27,27,37,27,48,27,34,34,37,45,48,71.31,0.0
hek293t,8904,1,14,TCGGATGGCCAGGATGCCGTTATCGTGGGTGGACTGGTTATTAGAGGCCTTTCTGAGTGTTGCCACTCCTTAAAAAAATTCTAGTTGGTTTAACGCGTA,TCGGATGGCCAGGATGCCGTTATCGTGGGTCTACCGAACGGCTAGGACTGGTTATTAGAGGCCTTTCTGAGTGTTGCCACTCCTTAAAAAAATTCTAGT,10,30,14,27,27,38,27,52,27,31,31,38,45,52,54.18,0.134637429
hek293t,8904,1,14,CCTGCTGGCCAGGATGCCGTTATCGTGGGTGGACTGGTTATTAGAGGCCTTTCTGAGTGTTGCCACTCCTTCCCTAAAAAAATTCTAGTTGGTTTAACG,CCTGCTGGCCAGGATGCCGTTATCGTGGGTCTACCGAACGGCTAGGACTGGTTATTAGAGGCCTTTCTGAGTGTTGCCACTCCTTCCCTAAAAAAATTC,10,30,14,27,27,34,27,48,27,31,31,34,45,48,54.18,0.0
hek293t,22650,1,11,GTAAATTACTGAGGGCAAGATTTAACTATTGGTGTAAGAACACAGGGACTCTTAATACTGGTGATAATGAAAAAAATTCTAGTTGGTTTAACGCGTAAC,GTAAATTACTGAGGGCAAGATTTAACTATTGGTGTAAGAATATCGAACTTACACAGGGACTCTTAATACTGGTGATAATGAAAAAAATTCTAGTTGGTT,10,30,14,27,27,43,27,54,27,40,40,43,51,54,28.81,0.0
hek293t,8907,1,9,GGGTATGGTTTAACAGGCAGGATTACTCAAGGCAGGAACAGAAATCAGCATTCTGTAGAAGCAGCTCTAAAAAAATTCTAGTTGGTTTAACGCGTAACT,GGGTATGGTTTAACAGGCAGGATTACTCAAGGCAGGAAAGTCTTATACAGAAATCAGCATTCTGTAGAAGCAGCTCTAAAAAAATTCTAGTTGGTTTAA,10,30,14,27,27,46,27,55,27,39,39,46,48,55,61.88,0.769287
hek293t,8907,1,9,GGGGTTGGTTTAACAGGCAGGATTACTCAAGGCAGGAACAGAAATCAGCATTCTGTAGAAGCAGCAAAAAAATTCTAGTTGGTTTAACGCGTAACTAGA,GGGGTTGGTTTAACAGGCAGGATTACTCAAGGCAGGAAAGTCTTATACAGAAATCAGCATTCTGTAGAAGCAGCAAAAAAATTCTAGTTGGTTTAACGC,10,30,14,27,27,49,27,58,27,39,39,49,48,58,61.88,0.583910128
hek293t,8909,1,3,GTTATTTGTTAAAAATCTGTCTTTTGTGGCGGCTAAGAGCTTCAGTTTTTAGCAGACTATAATTTAGAAAAAAATTCTAGTTGGTTTAACGCGTAACTA,GTTATTTGTTAAAAATCTGTCTTTTGTGGCGGCTAAGGGTAGCTTCAGTTTTTAGCAGACTATAATTTAGAAAAAAATTCTAGTTGGTTTAACGCGTAA,10,30,14,27,27,53,27,56,27,38,38,53,41,56,22.52,1.039485534
hek293t,8909,1,3,CTGCGTTGTTAAAAATCTGTCTTTTGTGGCGGCTAAGAGCTTCAGTTTTTAGCAGACTATAATTTAGAAGTTAAAAAAATTCTAGTTGGTTTAACGCGT,CTGCGTTGTTAAAAATCTGTCTTTTGTGGCGGCTAAGGGTAGCTTCAGTTTTTAGCAGACTATAATTTAGAAGTTAAAAAAATTCTAGTTGGTTTAACG,10,30,14,27,27,48,27,51,27,38,38,48,41,51,22.52,1.954183551
hek293t,8911,1,15,GGACCTCAGGGCTGAGGCCGGAGGGCGTGCGGTGGCGGCAGGCTCCGTGGCGCGACGTCCCCCGGCAAAAAAATTCTAGTTGGTTTAACGCGTAACTAG,GGACCTCAGGGCTGAGGCCGGAGGGCGTGCGGTGTGTAGGTTGGCGTTAGCGGCAGGCTCCGTGGCGCGACGTCCCCCGGCAAAAAAATTCTAGTTGGT,10,30,14,27,27,42,27,57,27,35,35,42,50,57,47.45,5.849309898
hek293t,8912,1,8,CATGACTGTCTAAAGCCGTTGAAAGGAGGAGGGTAACACGCAGGAAGCGAGAAGGCAGCGCAGACCAAAAAAAAAATTCTAGTTGGTTTAACGCGTAAC,CATGACTGTCTAAAGCCGTTGAAAGGAGGAGGGTAACAGATGTTAACGCAGGAAGCGAGAAGGCAGCGCAGACCAAAAAAAAAATTCTAGTTGGTTTAA,10,30,14,27,27,46,27,54,27,39,39,46,47,54,38.05,0.086839807
hek293t,8912,1,8,TTATGCTGTCTAAAGCCGTTGAAAGGAGGAGGGTAACACGCAGGAAGCGAGAAGGCAGCGCAGACCAAAGGGCAAAAAAATTCTAGTTGGTTTAACGCG,TTATGCTGTCTAAAGCCGTTGAAAGGAGGAGGGTAACAGATGTTAACGCAGGAAGCGAGAAGGCAGCGCAGACCAAAGGGCAAAAAAATTCTAGTTGGT,10,30,14,27,27,42,27,50,27,39,39,42,47,50,38.05,0.0
hek293t,8914,1,9,TAGAAGAATTGCTGTTGAAGGTGTGTTGATGGTCCAGGTGTATTAACCCCCCCCTTTCTATGACATTTTATGTATAAAAAAATTCTAGTTGGTTTAACG,TAGAAGAATTGCTGTTGAAGGTGTGTTGATGGTCCGAGGCTACTAGGTGTATTAACCCCCCCCTTTCTATGACATTTTATGTATAAAAAAATTCTAGTT,10,30,14,27,27,39,27,48,27,36,36,39,45,48,24.52,0.0
hek293t,8917,1,14,ACTTTATTCCATACCACTGCACAAACTTAAGGGGAATTGTATTTCCCATTGTAAGTAACTATTTTCCCTCCTATCAAAAAAATTCTAGTTGGTTTAACG,ACTTTATTCCATACCACTGCACAAACTTAACAGGAGCCACTACTGGGGAATTGTATTTCCCATTGTAAGTAACTATTTTCCCTCCTATCAAAAAAATTC,10,30,14,27,27,34,27,48,27,31,31,34,45,48,27.33,0.0
hek293t,8917,1,14,GCAATATTCCATACCACTGCACAAACTTAAGGGGAATTGTATTTCCCATTGTAAGTAACTATTTTCCCAAAAAAATTCTAGTTGGTTTAACGCGTAACT,GCAATATTCCATACCACTGCACAAACTTAACAGGAGCCACTACTGGGGAATTGTATTTCCCATTGTAAGTAACTATTTTCCCAAAAAAATTCTAGTTGG,10,30,14,27,27,41,27,55,27,31,31,41,45,55,27.33,13.93710842
hek293t,8921,1,4,AACCGATATCCTCTATAGAAATGGCCTGCAGGCATTAATTACACTCCGTACAAGACTTCCACCCATATCATGATAACCCGAAAAAAAATTCTAGTTGGT,AACCGATATCCTCTATAGAAATGGCCTGCAGGCAAAGATTAATTACACTCCGTACAAGACTTCCACCCATATCATGATAACCCGAAAAAAAATTCTAGT,10,30,14,27,27,38,27,42,27,35,35,38,39,42,37.15,6.161556293
hek293t,8921,1,4,ACATGATATCCTCTATAGAAATGGCCTGCAGGCATTAATTACACTCCGTACAAGACTTCCACCCATATCAAAAAAATTCTAGTTGGTTTAACGCGTAAC,ACATGATATCCTCTATAGAAATGGCCTGCAGGCAAAGATTAATTACACTCCGTACAAGACTTCCACCCATATCAAAAAAATTCTAGTTGGTTTAACGCG,10,30,14,27,27,50,27,54,27,35,35,50,39,54,37.15,40.50243615
hek293t,8923,1,6,TTTATCTAGTGATTATCTGTATGGGTCTGTGGCCAAAGCCCAAATTTAATTCTGTTTCCAGCACTGGAAAAAAATTCTAGTTGGTTTAACGCGTAACTA,TTTATCTAGTGATTATCTGTATGGGTCTGTGGCCATCTTCAAAGCCCAAATTTAATTCTGTTTCCAGCACTGGAAAAAAATTCTAGTTGGTTTAACGCG,10,30,14,27,27,50,27,56,27,35,35,50,41,56,41.44,28.30207199
hek293t,8923,1,6,CTCTTCTAGTGATTATCTGTATGGGTCTGTGGCCAAAGCCCAAATTTAATTCTGTTTCCAGCACTGGTTCCTAAAAAAATTCTAGTTGGTTTAACGCGT,CTCTTCTAGTGATTATCTGTATGGGTCTGTGGCCATCTTCAAAGCCCAAATTTAATTCTGTTTCCAGCACTGGTTCCTAAAAAAATTCTAGTTGGTTTA,10,30,14,27,27,45,27,51,27,35,35,45,41,51,41.44,46.19039476
hek293t,8925,1,12,CTTTATCTCATAAGTGGAATATAAATCAGTGGCAAATGTACCTATCCCCGTCTGTACAGTGCCAAAAAAAATTCTAGTTGGTTTAACGCGTAACTAGAT,CTTTATCTCATAAGTGGAATATAAATCAGTGGCAAATGTGCTGATAACGGAACCTATCCCCGTCTGTACAGTGCCAAAAAAAATTCTAGTTGGTTTAAC,10,30,14,27,27,47,27,59,27,40,40,47,52,59,62.6,0.0
hek293t,8925,1,12,CCAGATCTCATAAGTGGAATATAAATCAGTGGCAAATGTACCTATCCCCGTCTGTACAGTGCCAGCTGAAAAAAATTCTAGTTGGTTTAACGCGTAACT,CCAGATCTCATAAGTGGAATATAAATCAGTGGCAAATGTGCTGATAACGGAACCTATCCCCGTCTGTACAGTGCCAGCTGAAAAAAATTCTAGTTGGTT,10,30,14,27,27,43,27,55,27,40,40,43,52,55,62.6,0.0
hek293t,8927,1,8,TCTCTGCCGCTGTTGCACTCTCTGTCCGGTGGATGGAACCTACTGAGGGTCATCAAAATTTTCAGGAAAACAGAAGTTTTAAGGAAAAAAATTCTAGTT,TCTCTGCCGCTGTTGCACTCTCTGTCCAACGTTTAGGTGGATGGAACCTACTGAGGGTCATCAAAATTTTCAGGAAAACAGAAGTTTTAAGGAAAAAAA,10,30,14,27,27,31,27,39,27,28,28,31,36,39,61.73,0.896768949
hek293t,8929,1,10,CTAGGAACAGTCCAATCCCGTGTAGACTGAGGATAATAGAATAAGGCAGGAGGGAAAAGAATCAAAGAAAACAAAAAAATTCTAGTTGGTTTAACGCGT,CTAGGAACAGTCCAATCCCGTGTAGACTGATTAATGGGGCGGATAATAGAATAAGGCAGGAGGGAAAAGAATCAAAGAAAACAAAAAAATTCTAGTTGG,10,30,14,27,27,41,27,51,27,31,31,41,41,51,75.05,2.236234889
hek293t,8929,1,10,ACTCGAACAGTCCAATCCCGTGTAGACTGAGGATAATAGAATAAGGCAGGAGGGAAAAGAATCAAAGAAAACAAGAAAAAAATTCTAGTTGGTTTAACG,ACTCGAACAGTCCAATCCCGTGTAGACTGATTAATGGGGCGGATAATAGAATAAGGCAGGAGGGAAAAGAATCAAAGAAAACAAGAAAAAAATTCTAGT,10,30,14,27,27,38,27,48,27,31,31,38,41,48,75.05,1.405336041
hek293t,8931,1,10,GCGCTACAAGATTGTACAGTTATATAGCTTGGACTGCACTAAAATCTAGCACAGAGTTTAGTGGTGGATATAATAGAAAAAAATTCTAGTTGGTTTAAC,GCGCTACAAGATTGTACAGTTATATAGCTAGAGCTGCGTTGGACTGCACTAAAATCTAGCACAGAGTTTAGTGGTGGATATAATAGAAAAAAATTCTAG,10,30,14,27,27,37,27,47,27,30,30,37,40,47,39.8,1.200683358
hek293t,8931,1,10,GGATGACAAGATTGTACAGTTATATAGCTTGGACTGCACTAAAATCTAGCACAGAGTTTAGTGGTGGAAAAAAAATTCTAGTTGGTTTAACGCGTAACT,GGATGACAAGATTGTACAGTTATATAGCTAGAGCTGCGTTGGACTGCACTAAAATCTAGCACAGAGTTTAGTGGTGGAAAAAAAATTCTAGTTGGTTTA,10,30,14,27,27,45,27,55,27,30,30,45,40,55,39.8,1.801485616
hek293t,8933,1,3,GCATTTATAGGGAGAACATCCTGACAACAAGGAACTTCACAGAGATGTATGCCTTATATTCTACAGAGAGAAAGTTTATTTATAAAAAGGAAAAAAATT,GCATTTATAGGGAGAACATCCTGACACCTACAAGGAACTTCACAGAGATGTATGCCTTATATTCTACAGAGAGAAAGTTTATTTATAAAAAGGAAAAAA,10,30,14,27,27,30,27,33,27,27,27,30,30,33,52.47,0.997046235
hek293t,8935,1,8,AATGGTATTTATTCATCTATAAAATATGGAGGGGCCAGGAATTGAGCATTTTGCTGAATCATGCACTCAAAAAAAATTCTAGTTGGTTTAACGCGTAAC,AATGGTATTTATTCATCTATAAAATATGGAGAGCTAACGGGGCCAGGAATTGAGCATTTTGCTGAATCATGCACTCAAAAAAAATTCTAGTTGGTTTAA,10,30,14,27,27,46,27,54,27,31,31,46,39,54,31.54,0.0
hek293t,8935,1,8,AAGGATATTTATTCATCTATAAAATATGGAGGGGCCAGGAATTGAGCATTTTGCTGAATCATGCACTCATTTTCAAAAAAATTCTAGTTGGTTTAACGC,AAGGATATTTATTCATCTATAAAATATGGAGAGCTAACGGGGCCAGGAATTGAGCATTTTGCTGAATCATGCACTCATTTTCAAAAAAATTCTAGTTGG,10,30,14,27,27,41,27,49,27,31,31,41,39,49,31.54,0.0
hek293t,8940,1,3,ACTTCTCCTGCTTAGAAGGAGAGAGATGGAGGCGAAAAGAAAACAAGGAGTTAGCTTCATGGCCTTTCCAACTAAATAAGAAAAAAATTCTAGTTGGTT,ACTTCTCCTGCTTAGAAGGAGAGAGATGGAGGCGAAGAGAAGAAAACAAGGAGTTAGCTTCATGGCCTTTCCAACTAAATAAGAAAAAAATTCTAGTTG,10,30,14,27,27,40,27,43,27,37,37,40,40,43,59.76,4.293218911
hek293t,8940,1,3,AGAAATCCTGCTTAGAAGGAGAGAGATGGAGGCGAAAAGAAAACAAGGAGTTAGCTTCATGGCCTTTCAAAAAAATTCTAGTTGGTTTAACGCGTAACT,AGAAATCCTGCTTAGAAGGAGAGAGATGGAGGCGAAGAGAAGAAAACAAGGAGTTAGCTTCATGGCCTTTCAAAAAAATTCTAGTTGGTTTAACGCGTA,10,30,14,27,27,52,27,55,27,37,37,52,40,55,59.76,4.164916665
hek293t,8942,1,1,CTCAAAATTCAGATATGCTAGTTGAGTCATGGTATTTTGATGTTTAGATTTAAGTATCTAGGATGTTAAAAATAAAAAAATTCTAGTTGGTTTAACGCG,CTCAAAATTCAGATATGCTAGTTGAGTCATGGTATTTTAGATGTTTAGATTTAAGTATCTAGGATGTTAAAAATAAAAAAATTCTAGTTGGTTTAACGC,10,30,14,27,27,49,27,50,27,39,39,49,40,50,50.97,42.28354772
hek293t,8942,1,1,ACGGCAATTCAGATATGCTAGTTGAGTCATGGTATTTTGATGTTTAGATTTAAGTATCTAGGATGTTAAAAATAAAAGTGAAAAAAATTCTAGTTGGTT,ACGGCAATTCAGATATGCTAGTTGAGTCATGGTATTTTAGATGTTTAGATTTAAGTATCTAGGATGTTAAAAATAAAAGTGAAAAAAATTCTAGTTGGT,10,30,14,27,27,42,27,43,27,39,39,42,40,43,50.97,30.45306229
hek293t,8948,1,4,ACCTCCTAAGCTGCTATATTAAAATATCATGGAGACAGTTTCCCTCTCCTGTCTTGTTCTCTCAGTTCTAAGGAAAGGCTCATCTAAACAAAAAAATTC,ACCTCCTAAGCTGCTATATTAAAATAGATGTCATGGAGACAGTTTCCCTCTCCTGTCTTGTTCTCTCAGTTCTAAGGAAAGGCTCATCTAAACAAAAAA,10,30,14,27,27,30,27,34,27,27,27,30,31,34,27.55,0.0
hek293t,8951,1,11,AGCGCTGTATTTGGAATATTTTACATATTTGGGTTTTATTACTGGTACTGTTGTTTCCTACTGCCTTTTAAGCAAAAAAATTCTAGTTGGTTTAACGCG,AGCGCTGTATTTGGAATATTTTACATATTTGAGACACCCGTTGGTTTTATTACTGGTACTGTTGTTTCCTACTGCCTTTTAAGCAAAAAAATTCTAGTT,10,30,14,27,27,39,27,50,27,32,32,39,43,50,-0.35,0.0
hek293t,8953,1,1,GATTGGATCTCCAGGAACACCCTATGCAGAGGAGAAGTCACTATTAGAATGAAAGCATTATAGTTATGGAAATTAGACATAAACTTTTTCAAAAAAAAT,GATTGGATCTCCAGGAACACCCTATGCAAGAGGAGAAGTCACTATTAGAATGAAAGCATTATAGTTATGGAAATTAGACATAAACTTTTTCAAAAAAAA,10,30,14,27,27,31,27,32,27,28,28,31,29,32,70.69,3.317668259
hek293t,8953,1,1,TGCTTGATCTCCAGGAACACCCTATGCAGAGGAGAAGTCACTATTAGAATGAAAGCATTATAGTTATGGAAATTAGACATAAACAAAAAAATTCTAGTT,TGCTTGATCTCCAGGAACACCCTATGCAAGAGGAGAAGTCACTATTAGAATGAAAGCATTATAGTTATGGAAATTAGACATAAACAAAAAAATTCTAGT,10,30,14,27,27,38,27,39,27,28,28,38,29,39,70.69,7.703794204
hek293t,8957,1,2,TCCTACTCCTTTGTCAAATGCAGAGTCAAAGGATGTCTGTTTATCTGATACCCCCCACAGCAGACACTGCTTATCAGCAGGTTTTGGAAGAAAAAAATT,TCCTACTCCTTTGTCAAATGCAGAGTCTTAAAGGATGTCTGTTTATCTGATACCCCCCACAGCAGACACTGCTTATCAGCAGGTTTTGGAAGAAAAAAA,10,30,14,27,27,31,27,33,27,28,28,31,30,33,29.12,0.0
hek293t,8958,1,11,CGGGGTAGAAAATCGACTGATGTTATGATAGGACTTGGAAATGGAAATATATTTTTAAAAAGCTTTTGCATCTTAAAAAAATTCTAGTTGGTTTAACGC,CGGGGTAGAAAATCGACTGATGTTATGTGGCCCCTCACATAGGACTTGGAAATGGAAATATATTTTTAAAAAGCTTTTGCATCTTAAAAAAATTCTAGT,10,30,14,27,27,38,27,49,27,28,28,38,39,49,50.44,8.692028428
hek293t,8958,1,11,GTTTATAGAAAATCGACTGATGTTATGATAGGACTTGGAAATGGAAATATATTTTTAAAAAGCTTTTGCATCTTTAAATATAAAAAAATTCTAGTTGGT,GTTTATAGAAAATCGACTGATGTTATGTGGCCCCTCACATAGGACTTGGAAATGGAAATATATTTTTAAAAAGCTTTTGCATCTTTAAATATAAAAAAA,10,30,14,27,27,31,27,42,27,28,28,31,39,42,50.44,0.294117647
hek293t,8960,1,4,CGTTTTCCCTATTTCGTGGCTGATGGAAAAGGGTATATGCAACCACTTCTTTCCAGATACTGCTGCAATGAGAAAAAAAAATTCTAGTTGGTTTAACGC,CGTTTTCCCTATTTCGTGGCTGATGGAAAAGGGTATTAATATGCAACCACTTCTTTCCAGATACTGCTGCAATGAGAAAAAAAAATTCTAGTTGGTTTA,10,30,14,27,27,45,27,49,27,35,35,45,39,49,21.67,17.50502343
hek293t,8962,1,9,CGTTTGAATTTCAATTCTGCTGACAAATAAGGGAATTTGGGGAGACAACTAATGTTTTCAAGTGTTTAAAAAAAAAATTCTAGTTGGTTTAACGCGTAA,CGTTTGAATTTCAATTCTGCTGACAAATAGCACCCCAAAGGGAATTTGGGGAGACAACTAATGTTTTCAAGTGTTTAAAAAAAAAATTCTAGTTGGTTT,10,30,14,27,27,44,27,53,27,29,29,44,38,53,1.78,1.323032318
hek293t,8962,1,9,GGGTAGAATTTCAATTCTGCTGACAAATAAGGGAATTTGGGGAGACAACTAATGTTTTCAAGTGTTTAAAAACTGACCAAAAAAATTCTAGTTGGTTTA,GGGTAGAATTTCAATTCTGCTGACAAATAGCACCCCAAAGGGAATTTGGGGAGACAACTAATGTTTTCAAGTGTTTAAAAACTGACCAAAAAAATTCTA,10,30,14,27,27,36,27,45,27,29,29,36,38,45,1.78,0.0
hek293t,8964,1,11,CATTCAGAAAAACATTTTAAAACCTGTAAAGGTTTTGCAAAAATTATTTGTCTGGGAGTTGCCCTATTTCAAAAAAATTCTAGTTGGTTTAACGCGTAA,CATTCAGAAAAACATTTTAAAACCTGTAAAGGATTGGAATATGTTTTGCAAAAATTATTTGTCTGGGAGTTGCCCTATTTCAAAAAAATTCTAGTTGGT,10,30,14,27,27,42,27,53,27,32,32,42,43,53,-3.81,0.056785917
hek293t,8966,1,4,GCCGATCTCATATTGCAGCAAATTTTAGTAGGAGCAAAATGCCATATGGTTTCTTTTATGAGTAATTGGAAATAAAAAATTGTAAAAAAATTCTAGTTG,GCCGATCTCATATTGCAGCAAATTTTAGTAGGATAGAGCAAAATGCCATATGGTTTCTTTTATGAGTAATTGGAAATAAAAAATTGTAAAAAAATTCTA,10,30,14,27,27,36,27,40,27,33,33,36,37,40,10.09,0.352733686
hek293t,8968,1,11,CTGTGCTGCTTTTGTGTGATGTGAGGATGTGGAGGTTGTAATTTTACCATAGTATCTTTGGCTTCCCTCTTAAAAAAATTCTAGTTGGTTTAACGCGTA,CTGTGCTGCTTTTGTGTGATGTGAGGATGTGGAGGTTGTACTTATTACGTAATTTTACCATAGTATCTTTGGCTTCCCTCTTAAAAAAATTCTAGTTGG,10,30,14,27,27,41,27,52,27,38,38,41,49,52,36.56,0.0
hek293t,8968,1,11,GCTGTCTGCTTTTGTGTGATGTGAGGATGTGGAGGTTGTAATTTTACCATAGTATCTTTGGCTTCCCAAAAAAATTCTAGTTGGTTTAACGCGTAACTA,GCTGTCTGCTTTTGTGTGATGTGAGGATGTGGAGGTTGTACTTATTACGTAATTTTACCATAGTATCTTTGGCTTCCCAAAAAAATTCTAGTTGGTTTA,10,30,14,27,27,45,27,56,27,38,38,45,49,56,36.56,0.0
hek293t,8970,1,9,CAGGGTACAGTGAATTCAAAAATAGCTCATGGTATTGCTTTCAAATTTTAAAGGAAAAAATATCCAAGAAATTCCTCAAAAAAATTCTAGTTGGTTTAA,CAGGGTACAGTGAATTCAAAAATAGCTCGGCTACATCATGGTATTGCTTTCAAATTTTAAAGGAAAAAATATCCAAGAAATTCCTCAAAAAAATTCTAG,10,30,14,27,27,37,27,46,27,27,27,37,36,46,45.22,1.660390481
hek293t,8970,1,9,CTATCTACAGTGAATTCAAAAATAGCTCATGGTATTGCTTTCAAATTTTAAAGGAAAAAATATCCAAGAAATTCCTCCTGAAAAAAATTCTAGTTGGTT,CTATCTACAGTGAATTCAAAAATAGCTCGGCTACATCATGGTATTGCTTTCAAATTTTAAAGGAAAAAATATCCAAGAAATTCCTCCTGAAAAAAATTC,10,30,14,27,27,34,27,43,27,27,27,34,36,43,45.22,0.0
hek293t,8972,1,7,CAGAGAGAATACTCTAATGTTTGCAGGATAGGCAATTGTACATTTACGCTTACACTTAAGATACCTATGTAGAAAAAAAATTCTAGTTGGTTTAACGCG,CAGAGAGAATACTCTAATGTTTGCAGGATAGGCGTGACGCAATTGTACATTTACGCTTACACTTAAGATACCTATGTAGAAAAAAAATTCTAGTTGGTT,10,30,14,27,27,43,27,50,27,33,33,43,40,50,20.2,6.725853335
hek293t,8972,1,7,TTGTGAGAATACTCTAATGTTTGCAGGATAGGCAATTGTACATTTACGCTTACACTTAAGATACCTATGTAGAAGAAAAAAAATTCTAGTTGGTTTAAC,TTGTGAGAATACTCTAATGTTTGCAGGATAGGCGTGACGCAATTGTACATTTACGCTTACACTTAAGATACCTATGTAGAAGAAAAAAAATTCTAGTTG,10,30,14,27,27,40,27,47,27,33,33,40,40,47,20.2,0.655613559
hek293t,8974,1,4,TTTTGTTTCTGCCAGTGAAAGAGAGCATAAGGGGAAGTATAAATGTGTAACGCAAGGTTTAGAGTCCTCTCATGTCTGGGAGAAAAAAAATTCTAGTTG,TTTTGTTTCTGCCAGTGAAAGAGAGCATGTACAAGGGGAAGTATAAATGTGTAACGCAAGGTTTAGAGTCCTCTCATGTCTGGGAGAAAAAAAATTCTA,10,30,14,27,27,36,27,40,27,29,29,36,33,40,29.66,74.02040899
hek293t,8978,1,8,GAAGCACCTTTTCTTTTCCTTGTGGTCTTTGGGTTTTGTCTTGCAAGAAAGTTTAAGTATCCTGATTTAAGTAGTTAAAAAAAATTCTAGTTGGTTTAA,GAAGCACCTTTTCTTTTCCTTGTGGTCTGTATTCTTTTGGGTTTTGTCTTGCAAGAAAGTTTAAGTATCCTGATTTAAGTAGTTAAAAAAAATTCTAGT,10,30,14,27,27,38,27,46,27,28,28,38,36,46,-2.39,0.917047184
hek293t,8978,1,8,CCGGTACCTTTTCTTTTCCTTGTGGTCTTTGGGTTTTGTCTTGCAAGAAAGTTTAAGTATCCTGATTTAAGTAGTTATAGAAAAAAATTCTAGTTGGTT,CCGGTACCTTTTCTTTTCCTTGTGGTCTGTATTCTTTTGGGTTTTGTCTTGCAAGAAAGTTTAAGTATCCTGATTTAAGTAGTTATAGAAAAAAATTCT,10,30,14,27,27,35,27,43,27,28,28,35,36,43,-2.39,0.0
hek293t,8980,1,12,TTGGAAGAAAGAGGAGCTTCTGGAAGTCCTGGACCAAAAGGGGATAAGGTAACAACTCCCCTACAAAAAAAATTCTAGTTGGTTTAACGCGTAACTAGA,TTGGAAGAAAGAGGAGCTTCTGGAAGTCCTGGACCAAAAGCTGGCCCGCGAGGGGATAAGGTAACAACTCCCCTACAAAAAAAATTCTAGTTGGTTTAA,10,30,14,27,27,46,27,58,27,39,39,46,51,58,57.67,0.057372347
hek293t,8981,1,6,GCACGCCAGTGCCGTGTGCGGTAGGAACAAGGATACTGTTGAAAGTCTTTTGTGTAAATGGGACGCGATGGGCTGTAAAAAAAATTCTAGTTGGTTTAA,GCACGCCAGTGCCGTGTGCGGTAGGAACAAGGATACTATTTGTGTTGAAAGTCTTTTGTGTAAATGGGACGCGATGGGCTGTAAAAAAAATTCTAGTTG,10,30,14,27,27,40,27,46,27,37,37,40,43,46,65.0,0.119127783
hek293t,8985,1,3,CCCGAATGGTTGAGACCAGTCTGGGTTCCCGGTGTAGATTTCAGGCTGTGATATGGGGGCAGGGGGAACCTTTCAAAAAAATTCTAGTTGGTTTAACGC,CCCGAATGGTTGAGACCAGTCTGGGTTCCCGGTGTAGAGATTTTCAGGCTGTGATATGGGGGCAGGGGGAACCTTTCAAAAAAATTCTAGTTGGTTTAA,10,30,14,27,27,46,27,49,27,39,39,46,42,49,36.1,38.9178512
hek293t,8985,1,3,CGCAAATGGTTGAGACCAGTCTGGGTTCCCGGTGTAGATTTCAGGCTGTGATATGGGGGCAGGGGGAACCTTTCAGAGAAAAAAATTCTAGTTGGTTTA,CGCAAATGGTTGAGACCAGTCTGGGTTCCCGGTGTAGAGATTTTCAGGCTGTGATATGGGGGCAGGGGGAACCTTTCAGAGAAAAAAATTCTAGTTGGT,10,30,14,27,27,42,27,45,27,39,39,42,42,45,36.1,0.471111466
hek293t,8987,1,1,TCCCGGCCTCTTTGACTCCATGAATACTTCGGCCTCTATAACATCCCCGTCAAATGAGTTCTTAAATTAACAAAAAAATTCTAGTTGGTTTAACGCGTA,TCCCGGCCTCTTTGACTCCATGAATACTTCGGCCTACTATAACATCCCCGTCAAATGAGTTCTTAAATTAACAAAAAAATTCTAGTTGGTTTAACGCGT,10,30,14,27,27,51,27,52,27,36,36,51,37,52,22.4,41.72871573
hek293t,8989,1,14,CATTCTTTTAGAGCATTGGTAGTTAGAGCAGGACACAGAGTACGTATCTTTATCTACGTTAAAAAATAAAAAAATTCTAGTTGGTTTAACGCGTAACTA,CATTCTTTTAGAGCATTGGTAGTTAGGGCGTGCGTACGAAAGCAGGACACAGAGTACGTATCTTTATCTACGTTAAAAAATAAAAAAATTCTAGTTGGT,10,30,14,27,27,42,27,56,27,27,27,42,41,56,49.0,17.10111282
hek293t,8989,1,14,AGCTGTTTTAGAGCATTGGTAGTTAGAGCAGGACACAGAGTACGTATCTTTATCTACGTTAAAAAATAACAATGACACTAAAAAAATTCTAGTTGGTTT,AGCTGTTTTAGAGCATTGGTAGTTAGGGCGTGCGTACGAAAGCAGGACACAGAGTACGTATCTTTATCTACGTTAAAAAATAACAATGACACTAAAAAA,10,30,14,27,27,30,27,44,27,27,27,30,41,44,49.0,0.86771251
hek293t,8991,1,6,GGATTATAAATGCAATCTGTTGCTGTTTCTGGTTTTCATTTCTAAATCACTTTAAAGAACTCTCTCCCTAAAGTTAACTTTCTAAAAAAATTCTAGTTG,GGATTATAAATGCAATCTGTTGCTGTTTCTAAATCAGGTTTTCATTTCTAAATCACTTTAAAGAACTCTCTCCCTAAAGTTAACTTTCTAAAAAAATTC,10,30,14,27,27,34,27,40,27,31,31,34,37,40,5.21,0.164203612
hek293t,8991,1,6,GCCTGATAAATGCAATCTGTTGCTGTTTCTGGTTTTCATTTCTAAATCACTTTAAAGAACTCTCTCCCTAAAGTTAACTAAAAAAATTCTAGTTGGTTT,GCCTGATAAATGCAATCTGTTGCTGTTTCTAAATCAGGTTTTCATTTCTAAATCACTTTAAAGAACTCTCTCCCTAAAGTTAACTAAAAAAATTCTAGT,10,30,14,27,27,38,27,44,27,31,31,38,37,44,5.21,12.23424205
hek293t,8993,1,9,TTGCCCAGCAATTCTTTCACTTACTATCTTGGTACACCTTTTTCCTGTGGAATTAGCTTTCGAAAGAAAAAAATTCTAGTTGGTTTAACGCGTAACTAG,TTGCCCAGCAATTCTTTCACTTACTATCTTGGTACACCGACTAACTCTTTTTCCTGTGGAATTAGCTTTCGAAAGAAAAAAATTCTAGTTGGTTTAACG,10,30,14,27,27,48,27,57,27,38,38,48,47,57,13.1,1.018780411
hek293t,8994,1,15,CGAATGCAAAGGGAACAGACTGTAGAAAGTGGCAGGGCTTGCATGCTCTTTAGCTATTTTAAAAGGTATCTCCAAAAAAATTCTAGTTGGTTTAACGCG,CGAATGCAAAGGGAACAGACTGTAGAAAGTGCTATTATCATCGTCAGCAGGGCTTGCATGCTCTTTAGCTATTTTAAAAGGTATCTCCAAAAAAATTCT,10,30,14,27,27,35,27,50,27,32,32,35,47,50,70.98,0.587741394
hek293t,8995,1,2,TAAGTATGGGGGGAGAGTAGCATGTAAATTGGTGTAACAATTGGATATGGGGTGCAGTTCTGATCTCCCCAAAAAAATTCTAGTTGGTTTAACGCGTAA,TAAGTATGGGGGGAGAGTAGCATGTAAATTGGTGTAGAACAATTGGATATGGGGTGCAGTTCTGATCTCCCCAAAAAAATTCTAGTTGGTTTAACGCGT,10,30,14,27,27,51,27,53,27,36,36,51,38,53,32.68,60.03633305
hek293t,8997,1,2,GCAGAATGCAGTTAAAATTCCTCAGCAGCAGGTAATCGTTCTGCATTATAAAATAGCGTTGTAACATAAGCGATGTATGAAGAAAAACCAAAAAAATTC,GCAGAATGCAGTTAAAATTCCTCAGCAGGACAGGTAATCGTTCTGCATTATAAAATAGCGTTGTAACATAAGCGATGTATGAAGAAAAACCAAAAAAAT,10,30,14,27,27,32,27,34,27,29,29,32,31,34,27.98,1.088048423
hek293t,8997,1,2,GACGTATGCAGTTAAAATTCCTCAGCAGCAGGTAATCGTTCTGCATTATAAAATAGCGTTGTAACATAAGCGATGTATGAAGAAAAAAAAAATTCTAGT,GACGTATGCAGTTAAAATTCCTCAGCAGGACAGGTAATCGTTCTGCATTATAAAATAGCGTTGTAACATAAGCGATGTATGAAGAAAAAAAAAATTCTA,10,30,14,27,27,36,27,38,27,29,29,36,31,38,27.98,27.55336077
hek293t,8999,1,1,TTACCCAGTGTTCCAGAGTTTCTGCAGTCCGGGAAAAATAGCAACTGGGAGACTGAACAGGAGTAATGTCTAGAGTGAAAAAAATTCTAGTTGGTTTAA,TTACCCAGTGTTCCAGAGTTTCTGCAGTCCGGGAAAAAATAGCAACTGGGAGACTGAACAGGAGTAATGTCTAGAGTGAAAAAAATTCTAGTTGGTTTA,10,30,14,27,27,45,27,46,27,38,38,45,39,46,37.06,25.71150917
hek293t,23537,1,9,CAAGCGCAAAATGTATCTACAGGGGCTCTTGGGCCATTCGTCTGCAACTCCTACAGGAGGGTGAGCAAAAAAATTCTAGTTGGTTTAACGCGTAACTAG,CAAGCGCAAAATGTATCTACAGGGGCTCTTGGACGTTCAAGGCCATTCGTCTGCAACTCCTACAGGAGGGTGAGCAAAAAAATTCTAGTTGGTTTAACG,10,30,14,27,27,48,27,57,27,33,33,48,42,57,37.22,30.52486825
hek293t,23537,1,9,AGACTGCAAAATGTATCTACAGGGGCTCTTGGGCCATTCGTCTGCAACTCCTACAGGAGGGTGAGCCTGGGCAAAAAAAAATTCTAGTTGGTTTAACGC,AGACTGCAAAATGTATCTACAGGGGCTCTTGGACGTTCAAGGCCATTCGTCTGCAACTCCTACAGGAGGGTGAGCCTGGGCAAAAAAAAATTCTAGTTG,10,30,14,27,27,40,27,49,27,33,33,40,42,49,37.22,22.11369579
hek293t,9003,1,12,CTTGAATGTATAATTTATCTGTTCAATAAAGGGTGGTTATTCCCATAGTGACCTACATGATTTTAATAAAGGAAAAAAATTCTAGTTGGTTTAACGCGT,CTTGAATGTATAATTTATCTGTTCAATAAGCTGCCTCACCAAGGGTGGTTATTCCCATAGTGACCTACATGATTTTAATAAAGGAAAAAAATTCTAGTT,10,30,14,27,27,39,27,51,27,29,29,39,41,51,4.98,5.437807713
hek293t,9003,1,12,GGGTAATGTATAATTTATCTGTTCAATAAAGGGTGGTTATTCCCATAGTGACCTACATGATTTTAATAAAGGGTAAAAAAAATTCTAGTTGGTTTAACG,GGGTAATGTATAATTTATCTGTTCAATAAGCTGCCTCACCAAGGGTGGTTATTCCCATAGTGACCTACATGATTTTAATAAAGGGTAAAAAAAATTCTA,10,30,14,27,27,36,27,48,27,29,29,36,41,48,4.98,1.943538861
hek293t,9005,1,6,CTATAGGGATGTTATAAATTGAACAGTTTAGGCTTTCTTAGGCATTTATTCTAGTAAAGAACATGGAAACATAAGTCTGCTAACAAAAAAAATTCTAGT,CTATAGGGATGTTATAAATTGAACAGTTAACAGATAGGCTTTCTTAGGCATTTATTCTAGTAAAGAACATGGAAACATAAGTCTGCTAACAAAAAAAAT,10,30,14,27,27,32,27,38,27,29,29,32,35,38,4.59,0.215518202
hek293t,9005,1,6,GCGGCGGGATGTTATAAATTGAACAGTTTAGGCTTTCTTAGGCATTTATTCTAGTAAAGAACATGGAAACATAAGTCTGCTAAAAAAATTCTAGTTGGT,GCGGCGGGATGTTATAAATTGAACAGTTAACAGATAGGCTTTCTTAGGCATTTATTCTAGTAAAGAACATGGAAACATAAGTCTGCTAAAAAAATTCTA,10,30,14,27,27,36,27,42,27,29,29,36,35,42,4.59,2.662868952
hek293t,9008,1,9,TGTATCCAAGCAAGGTTCTGCTACCAGTGGGGAGACATAGACTGCTTCTATGAGTTAAAAGAGCATTTAAAAAAATTCTAGTTGGTTTAACGCGTAACT,TGTATCCAAGCAAGGTTCTGCTACCAGTGGGTTAAGAAAGGAGACATAGACTGCTTCTATGAGTTAAAAGAGCATTTAAAAAAATTCTAGTTGGTTTAA,10,30,14,27,27,46,27,55,27,31,31,46,40,55,64.4,40.17007447
hek293t,9008,1,9,TGGCGCCAAGCAAGGTTCTGCTACCAGTGGGGAGACATAGACTGCTTCTATGAGTTAAAAGAGCATTTGCTGTTACAAAAAAATTCTAGTTGGTTTAAC,TGGCGCCAAGCAAGGTTCTGCTACCAGTGGGTTAAGAAAGGAGACATAGACTGCTTCTATGAGTTAAAAGAGCATTTGCTGTTACAAAAAAATTCTAGT,10,30,14,27,27,38,27,47,27,31,31,38,40,47,64.4,3.30392698
hek293t,6546,1,8,CCCCAGCTCCATTGTCACAGACACAAATCTGGCATGGTGCTGGCTTCCAAATATCCCTGTTCAGGTACATCTGGCCATTCTGAGTAAAAAAATTCTAGT,CCCCAGCTCCATTGTCACAGACACAACCACTGCGATCTGGCATGGTGCTGGCTTCCAAATATCCCTGTTCAGGTACATCTGGCCATTCTGAGTAAAAAA,10,30,14,27,27,30,27,38,27,27,27,30,35,38,26.63,0.694663554
hek293t,6546,1,8,TCTACGCTCCATTGTCACAGACACAAATCTGGCATGGTGCTGGCTTCCAAATATCCCTGTTCAGGTACATCTGGCCATTCTAAAAAAATTCTAGTTGGT,TCTACGCTCCATTGTCACAGACACAACCACTGCGATCTGGCATGGTGCTGGCTTCCAAATATCCCTGTTCAGGTACATCTGGCCATTCTAAAAAAATTC,10,30,14,27,27,34,27,42,27,27,27,34,35,42,26.63,8.667678045
hek293t,9012,1,14,GCCGACTTTTGCCTCTTAATATAACCCAGCGGCTCAGGAGGCTCGAGGCGTTTGCTGCCTGCCACCCAAAAAAATTCTAGTTGGTTTAACGCGTAACTA,GCCGACTTTTGCCTCTTAATATAACCCAGCGGCTCAGGTGAGGACCTTCGCAAGGCTCGAGGCGTTTGCTGCCTGCCACCCAAAAAAATTCTAGTTGGT,10,30,14,27,27,42,27,56,27,39,39,42,53,56,57.38,0.0
hek293t,18901,1,7,CTAGGTATGAAGAGAACTAAAAAGTGAGGAGGAGAAGCTCAGAAAAATTGAGTTCACCTCGCGCACACTGAAAAAAATTCTAGTTGGTTTAACGCGTAA,CTAGGTATGAAGAGAACTAAAAAGTGAGGAGTTTAAGGGAGAAGCTCAGAAAAATTGAGTTCACCTCGCGCACACTGAAAAAAATTCTAGTTGGTTTAA,10,30,14,27,27,46,27,53,27,31,31,46,38,53,37.23,0.108315863
hek293t,18901,1,7,CCAACTATGAAGAGAACTAAAAAGTGAGGAGGAGAAGCTCAGAAAAATTGAGTTCACCTCGCGCACACTGTAAATTGGAAAAAAATTCTAGTTGGTTTA,CCAACTATGAAGAGAACTAAAAAGTGAGGAGTTTAAGGGAGAAGCTCAGAAAAATTGAGTTCACCTCGCGCACACTGTAAATTGGAAAAAAATTCTAGT,10,30,14,27,27,38,27,45,27,31,31,38,38,45,37.23,0.0
hek293t,9015,1,7,ATTTCGAAACTCCAGGCAAAAATCGTCACTGGCCCAGCAGCACGCTAGACTCCCCAAGACAAAGCCCAAAAAAATTCTAGTTGGTTTAACGCGTAACTA,ATTTCGAAACTCCAGGCAAAAATCGTCACTGGCCCAGCCGCACACAGCACGCTAGACTCCCCAAGACAAAGCCCAAAAAAATTCTAGTTGGTTTAACGC,10,30,14,27,27,49,27,56,27,39,39,49,46,56,36.16,0.0
hek293t,9016,1,10,TTCTCGCACGCAGTTCAGCTAATGCTGCTTGGTTTTGATCCTGAAAAACAAGAAAACCTGTACAAAAAAAATTCTAGTTGGTTTAACGCGTAACTAGAT,TTCTCGCACGCAGTTCAGCTAATGCTGCTTGGTTTTGACTTTTGGTCTTCCTGAAAAACAAGAAAACCTGTACAAAAAAAATTCTAGTTGGTTTAACGC,10,30,14,27,27,49,27,59,27,39,39,49,49,59,52.66,0.224519442
hek293t,9017,1,1,ACGAGAGAACAATGTTTGGAAAGACCGTAAGGCATTGGAGTATCATTTTTTGCCTGTGTAAACTTTCAAACAAAAAAATTCTAGTTGGTTTAACGCGTA,ACGAGAGAACAATGTTTGGAAAGACCGTAAGGCATTGGAGTTATCATTTTTTGCCTGTGTAAACTTTCAAACAAAAAAATTCTAGTTGGTTTAACGCGT,10,30,14,27,27,51,27,52,27,41,41,51,42,52,27.8,67.55867041
hek293t,9019,1,12,AGTTATAAGGCCTATAAATAAAAAGTCTCAGGCAACACGTTCAATACCAGTGGAAAAGCCGCTTTATGGGATGTCATGACAAAAAAAATTCTAGTTGGT,AGTTATAAGGCCTATAAATAAAAAGTCCGAACTAAGCACTCAGGCAACACGTTCAATACCAGTGGAAAAGCCGCTTTATGGGATGTCATGACAAAAAAA,10,30,14,27,27,30,27,42,27,27,27,30,39,42,20.46,0.0
hek293t,9019,1,12,ATTGCTAAGGCCTATAAATAAAAAGTCTCAGGCAACACGTTCAATACCAGTGGAAAAGCCGCTTTATGGGATGTAAAAAAATTCTAGTTGGTTTAACGC,ATTGCTAAGGCCTATAAATAAAAAGTCCGAACTAAGCACTCAGGCAACACGTTCAATACCAGTGGAAAAGCCGCTTTATGGGATGTAAAAAAATTCTAG,10,30,14,27,27,37,27,49,27,27,27,37,39,49,20.46,0.0
hek293t,9021,1,5,AAGTATAAAGGGAAGCATAAGTGAAAATAAGGGAGGATAAACTTTAAGAAATATAGAGAAATGTTTGGTGTGGAAAAAAATTCTAGTTGGTTTAACGCG,AAGTATAAAGGGAAGCATAAGTGAAAATAAGGGAGGATGATATAAACTTTAAGAAATATAGAGAAATGTTTGGTGTGGAAAAAAATTCTAGTTGGTTTA,10,30,14,27,27,45,27,50,27,38,38,45,43,50,32.59,0.0
hek293t,9021,1,5,GTGGGTAAAGGGAAGCATAAGTGAAAATAAGGGAGGATAAACTTTAAGAAATATAGAGAAATGTTTGGTGTGGTCAAAAAAAAATTCTAGTTGGTTTAA,GTGGGTAAAGGGAAGCATAAGTGAAAATAAGGGAGGATGATATAAACTTTAAGAAATATAGAGAAATGTTTGGTGTGGTCAAAAAAAAATTCTAGTTGG,10,30,14,27,27,41,27,46,27,38,38,41,43,46,32.59,0.0
hek293t,9023,1,15,ACATAGGAGAGTTCTCTCCACAAAAACACAGGGGAGGAGAATGTTTCCTTCCCAACATAAAGAGTAAAAAAAATTCTAGTTGGTTTAACGCGTAACTAG,ACATAGGAGAGTTCTCTCCACAAAAACACAGAACATATGTGATTTAGGGAGGAGAATGTTTCCTTCCCAACATAAAGAGTAAAAAAAATTCTAGTTGGT,10,30,14,27,27,42,27,57,27,32,32,42,47,57,59.73,0.897279369
hek293t,9024,1,11,ATTTGTTCTAGCTGTTATAGGCTGAAAGTTGGATTAACTGATTTCTTCTGTCAGCCCTTGAGCCCTGTACACCAGACTGAAAAAAATTCTAGTTGGTTT,ATTTGTTCTAGCTGTTATAGGCTGAAAGTCAAGTGACACATGGATTAACTGATTTCTTCTGTCAGCCCTTGAGCCCTGTACACCAGACTGAAAAAAATT,10,30,14,27,27,33,27,44,27,30,30,33,41,44,33.13,0.644116589
hek293t,9024,1,11,TCTATTTCTAGCTGTTATAGGCTGAAAGTTGGATTAACTGATTTCTTCTGTCAGCCCTTGAGCCCTGAAAAAAATTCTAGTTGGTTTAACGCGTAACTA,TCTATTTCTAGCTGTTATAGGCTGAAAGTCAAGTGACACATGGATTAACTGATTTCTTCTGTCAGCCCTTGAGCCCTGAAAAAAATTCTAGTTGGTTTA,10,30,14,27,27,45,27,56,27,30,30,45,41,56,33.13,13.67438796
hek293t,9026,1,2,GTGTCAGAAGAAAATGCTGTGAGGATACTTGGCCTTGTGGGCAGGTCAAAGAAACCACTGTGCTGCTAGCATTTTCCTTTTACTTGTAAAAAAATTCTA,GTGTCAGAAGAAAATGCTGTGAGGATACTTACGGCCTTGTGGGCAGGTCAAAGAAACCACTGTGCTGCTAGCATTTTCCTTTTACTTGTAAAAAAATTC,10,30,14,27,27,34,27,36,27,31,31,34,33,36,16.65,5.530838128
hek293t,9026,1,2,ACGGGAGAAGAAAATGCTGTGAGGATACTTGGCCTTGTGGGCAGGTCAAAGAAACCACTGTGCTGCTAGCATTTTAAAAAAATTCTAGTTGGTTTAACG,ACGGGAGAAGAAAATGCTGTGAGGATACTTACGGCCTTGTGGGCAGGTCAAAGAAACCACTGTGCTGCTAGCATTTTAAAAAAATTCTAGTTGGTTTAA,10,30,14,27,27,46,27,48,27,31,31,46,33,48,16.65,84.25265108
hek293t,9028,1,8,CTGCTCTGAGCAAGTCAGGTTGCTTTTACTGGCACAGAGGTAGGCGCGCACATGCACACGTACACAGAACTAAAAAAATTCTAGTTGGTTTAACGCGTA,CTGCTCTGAGCAAGTCAGGTTGCTTTTACCGCAACTCTGGCACAGAGGTAGGCGCGCACATGCACACGTACACAGAACTAAAAAAATTCTAGTTGGTTT,10,30,14,27,27,44,27,52,27,29,29,44,37,52,9.04,14.35860966
hek293t,9028,1,8,CATTACTGAGCAAGTCAGGTTGCTTTTACTGGCACAGAGGTAGGCGCGCACATGCACACGTACACAGAACTTTTAAAAAAAAATTCTAGTTGGTTTAAC,CATTACTGAGCAAGTCAGGTTGCTTTTACCGCAACTCTGGCACAGAGGTAGGCGCGCACATGCACACGTACACAGAACTTTTAAAAAAAAATTCTAGTT,10,30,14,27,27,39,27,47,27,29,29,39,37,47,9.04,5.173672213
hek293t,9034,1,15,TGAAGATCTTTACATTACAAAGAAAATAATGGCCTAGCCCCCCCTTGGAAAAGTATTCACAAAGCAAAAAAATTCTAGTTGGTTTAACGCGTAACTAGA,TGAAGATCTTTACATTACAAAGAAAATAATCCGTACAGTAGAAATGGCCTAGCCCCCCCTTGGAAAAGTATTCACAAAGCAAAAAAATTCTAGTTGGTT,10,30,14,27,27,43,27,58,27,28,28,43,43,58,14.21,0.0
hek293t,9034,1,15,CCCGAATCTTTACATTACAAAGAAAATAATGGCCTAGCCCCCCCTTGGAAAAGTATTCACAAAGCACCAGGATAAAAAAATTCTAGTTGGTTTAACGCG,CCCGAATCTTTACATTACAAAGAAAATAATCCGTACAGTAGAAATGGCCTAGCCCCCCCTTGGAAAAGTATTCACAAAGCACCAGGATAAAAAAATTCT,10,30,14,27,27,35,27,50,27,28,28,35,43,50,14.21,0.0
hek293t,9038,1,9,CACTAAAGGGAAGCGTTCTGCCAGAGAACAGGCACCTCCGCGAGGCTCTCCGCAGGCTCGGCGAGCGGCAGGAAAAAAAAATTCTAGTTGGTTTAACGC,CACTAAAGGGAAGCGTTCTGCCAGAGAACGTCGCGACTAGGCACCTCCGCGAGGCTCTCCGCAGGCTCGGCGAGCGGCAGGAAAAAAAAATTCTAGTTG,10,30,14,27,27,40,27,49,27,30,30,40,39,49,59.6,44.07101107
hek293t,9040,1,2,TCAATACTATGGGTGTTCAAAGATGGTCCTGGTTAATAGTCTTAGATTTCTTGAAGTCCATGCTTGAAATTCCCCCAAGCTGGAAAAAAATTCTAGTTG,TCAATACTATGGGTGTTCAAAGATGGTCCTGGTTGGAATAGTCTTAGATTTCTTGAAGTCCATGCTTGAAATTCCCCCAAGCTGGAAAAAAATTCTAGT,10,30,14,27,27,38,27,40,27,35,35,38,37,40,54.67,0.284237726
hek293t,9042,1,6,CGTTCGAGCTGCAGGGTGCTGTAACTCAGTGGCCAGGCCACAGCAGCTTACGCAGAACAAAGCGGGGCACCCTAAAAAAAATTCTAGTTGGTTTAACGC,CGTTCGAGCTGCAGGGTGCTGTAACTCATTAAAAGTGGCCAGGCCACAGCAGCTTACGCAGAACAAAGCGGGGCACCCTAAAAAAAATTCTAGTTGGTT,10,30,14,27,27,43,27,49,27,28,28,43,34,49,67.17,68.86923312
hek293t,9042,1,6,TACAAGAGCTGCAGGGTGCTGTAACTCAGTGGCCAGGCCACAGCAGCTTACGCAGAACAAAGCGGGGCACCCTAACCTGCCAAAAAAAATTCTAGTTGG,TACAAGAGCTGCAGGGTGCTGTAACTCATTAAAAGTGGCCAGGCCACAGCAGCTTACGCAGAACAAAGCGGGGCACCCTAACCTGCCAAAAAAAATTCT,10,30,14,27,27,35,27,41,27,28,28,35,34,41,67.17,8.396072399
hek293t,9045,1,6,TGTGGGGGAACTTACTTGCCTTGATAGCTAGGTATTTTGAATGACAGGAAATCTCCTTCTTTCATGCCTGTCTTCGTCACAAAAAAATTCTAGTTGGTT,TGTGGGGGAACTTACTTGCCTTGATAGCTTGGGGAAGGTATTTTGAATGACAGGAAATCTCCTTCTTTCATGCCTGTCTTCGTCACAAAAAAATTCTAG,10,30,14,27,27,37,27,43,27,30,30,37,36,43,32.74,2.943924592
hek293t,9047,1,11,TTCAGATATGATTGCTTGAAACAGAAATCAGGAGCAGAATTTCTTCAGGTAAGTCTTCAGCTTCAGAAAAAAATTCTAGTTGGTTTAACGCGTAACTAG,TTCAGATATGATTGCTTGAAACAGAAATCAGGAGCAGAGCCGGATTAACATTTCTTCAGGTAAGTCTTCAGCTTCAGAAAAAAATTCTAGTTGGTTTAA,10,30,14,27,27,46,27,57,27,39,39,46,50,57,36.76,0.0
hek293t,9048,1,2,GGTCTGATGCGTTTTTGACAGTAATTATGAGGTTGAAAAGAATTTCCATTGGATGCTGTCTGGCTGAGTTGCTGCTCAAAAAAATTCTAGTTGGTTTAA,GGTCTGATGCGTTTTTGACAGTAATTATGAGGTTGAACAAAGAATTTCCATTGGATGCTGTCTGGCTGAGTTGCTGCTCAAAAAAATTCTAGTTGGTTT,10,30,14,27,27,44,27,46,27,37,37,44,39,46,29.95,10.04073135
hek293t,9048,1,2,ATTCTGATGCGTTTTTGACAGTAATTATGAGGTTGAAAAGAATTTCCATTGGATGCTGTCTGGCTGAGTAAAAAAATTCTAGTTGGTTTAACGCGTAAC,ATTCTGATGCGTTTTTGACAGTAATTATGAGGTTGAACAAAGAATTTCCATTGGATGCTGTCTGGCTGAGTAAAAAAATTCTAGTTGGTTTAACGCGTA,10,30,14,27,27,52,27,54,27,37,37,52,39,54,29.95,4.043099212
hek293t,9050,1,7,CTACGTTTGAATTCAGAACACAAGCACACAGGGAAGTGGCGACCATAATCTTCCTCTTTACCCTCTTATGTCAAAAAAATTCTAGTTGGTTTAACGCGT,CTACGTTTGAATTCAGAACACAAGCACACAGGGAAGTGGCTCCTCCCGACCATAATCTTCCTCTTTACCCTCTTATGTCAAAAAAATTCTAGTTGGTTT,10,30,14,27,27,44,27,51,27,41,41,44,48,51,52.08,1.875901876
hek293t,9051,1,5,TTAAGTAATACTGTGTACCAGGTGAGGCAAGGGGGGAAGCACAGTAGTATGGGGAGCAGGGTGCAGATAGAGTGAAAAAAAATTCTAGTTGGTTTAACG,TTAAGTAATACTGTGTACCAGGTGAGGCAAGGGGGGAAGGTCCCCACAGTAGTATGGGGAGCAGGGTGCAGATAGAGTGAAAAAAAATTCTAGTTGGTT,10,30,14,27,27,43,27,48,27,40,40,43,45,48,57.63,0.690111177
hek293t,9051,1,5,CTGCATAATACTGTGTACCAGGTGAGGCAAGGGGGGAAGCACAGTAGTATGGGGAGCAGGGTGCAGATAGAAAAAAAATTCTAGTTGGTTTAACGCGTA,CTGCATAATACTGTGTACCAGGTGAGGCAAGGGGGGAAGGTCCCCACAGTAGTATGGGGAGCAGGGTGCAGATAGAAAAAAAATTCTAGTTGGTTTAAC,10,30,14,27,27,47,27,52,27,40,40,47,45,52,57.63,41.85719981
hek293t,9053,1,5,AGGGACCCCGTGAAATTAGGACACAGTTCAGGGACAAAATGTCTTGTCTAGGGTAGGAGAAGGACAAGGAAGCACGAGAAATCAAAAAAATTCTAGTTG,AGGGACCCCGTGAAATTAGGACACAGTCATACTCAGGGACAAAATGTCTTGTCTAGGGTAGGAGAAGGACAAGGAAGCACGAGAAATCAAAAAAATTCT,10,30,14,27,27,35,27,40,27,28,28,35,33,40,35.17,42.22645008
hek293t,9057,1,4,CCCATCTGGGACAGATGTGTTAGCCAAAGTGGGAAATAAAAGCTGAAAAGGAGAAAGGAGGCCTGCCAGAGTTCAAAAAAAATTCTAGTTGGTTTAACG,CCCATCTGGGACAGATGTGTTAGCCAAAGTGGGAAAGGTTTAAAAGCTGAAAAGGAGAAAGGAGGCCTGCCAGAGTTCAAAAAAAATTCTAGTTGGTTT,10,30,14,27,27,44,27,48,27,37,37,44,41,48,37.48,8.796663314
hek293t,9058,1,10,TTATAACCTCAAAGTCCAGGGATATGGAAAGGAATAAATTGTTTTGAGGATCCTTTTTGAAATAATGCACGGTTCAAAAAAAATTCTAGTTGGTTTAAC,TTATAACCTCAAAGTCCAGGGATATGTGTATCAGGGGAAAGGAATAAATTGTTTTGAGGATCCTTTTTGAAATAATGCACGGTTCAAAAAAAATTCTAG,10,30,14,27,27,37,27,47,27,27,27,37,37,47,42.01,0.238759878
hek293t,9058,1,10,TAGCAACCTCAAAGTCCAGGGATATGGAAAGGAATAAATTGTTTTGAGGATCCTTTTTGAAATAATGCACGAAAAAAATTCTAGTTGGTTTAACGCGTA,TAGCAACCTCAAAGTCCAGGGATATGTGTATCAGGGGAAAGGAATAAATTGTTTTGAGGATCCTTTTTGAAATAATGCACGAAAAAAATTCTAGTTGGT,10,30,14,27,27,42,27,52,27,27,27,42,37,52,42.01,0.0
hek293t,9061,1,2,CCCTAATTTATAGCAATTCTTGAAATGGGAGGGGCCTCCCTTTAATTTCTGTACTTTAAATCCTGTTTTTAATAAAAAAATTCTAGTTGGTTTAACGCG,CCCTAATTTATAGCAATTCTTGAAATGGGAGGGGCCTCCCCCTTTAATTTCTGTACTTTAAATCCTGTTTTTAATAAAAAAATTCTAGTTGGTTTAACG,10,30,14,27,27,48,27,50,27,41,41,48,43,50,51.42,55.21809357
hek293t,9063,1,13,ACTAGAGAGCTCAGGACACACAGTGTGCTTGGAGACAGGGTCAAACACCCGGAGTTTCTCTGCTGATCAAAAAAATTCTAGTTGGTTTAACGCGTAACT,ACTAGAGAGCTCAGGACACACAGTGTGCTTGGAGACAGGCTTAAATATATTGGTCAAACACCCGGAGTTTCTCTGCTGATCAAAAAAATTCTAGTTGGT,10,30,14,27,27,42,27,55,27,39,39,42,52,55,51.3,0.0
hek293t,9064,1,6,AGCGAGTGGTCCTCTTCCCAGGCTACCGCAGGGCCTCGGTGTCTCCTGGGCACTTACAGTTTTGGTGCTTGTTTAACCCCAGAAAAAAATTCTAGTTGG,AGCGAGTGGTCCTCTTCCCAGGCTACCGCAGAGGGAAGGCCTCGGTGTCTCCTGGGCACTTACAGTTTTGGTGCTTGTTTAACCCCAGAAAAAAATTCT,10,30,14,27,27,35,27,41,27,32,32,35,38,41,47.56,0.650099612
hek293t,9066,1,3,CAGACGGACAAGATGGGCAACAGTGTTAAAGGGATTCACTTTTGCCACGTAAGCAGCTTTGCCTTCATCATTAAAAAAATTCTAGTTGGTTTAACGCGT,CAGACGGACAAGATGGGCAACAGTGTTAAAGGATCGATTCACTTTTGCCACGTAAGCAGCTTTGCCTTCATCATTAAAAAAATTCTAGTTGGTTTAACG,10,30,14,27,27,48,27,51,27,33,33,48,36,51,17.08,73.05800009
hek293t,9066,1,3,ACCACGGACAAGATGGGCAACAGTGTTAAAGGGATTCACTTTTGCCACGTAAGCAGCTTTGCCTTCATCATTCTTTTTCTAAAAAAATTCTAGTTGGTT,ACCACGGACAAGATGGGCAACAGTGTTAAAGGATCGATTCACTTTTGCCACGTAAGCAGCTTTGCCTTCATCATTCTTTTTCTAAAAAAATTCTAGTTG,10,30,14,27,27,40,27,43,27,33,33,40,36,43,17.08,70.79790132
hek293t,9068,1,7,ACATTACTCTGTTCCTCAGTTATACTGTGGGGAGAAAGCAATGCTCACCAAACAAGGCTGACAAGTTCAAAAAAATTCTAGTTGGTTTAACGCGTAACT,ACATTACTCTGTTCCTCAGTTATACTGTGGGGAGAAATAGTACTGCAATGCTCACCAAACAAGGCTGACAAGTTCAAAAAAATTCTAGTTGGTTTAACG,10,30,14,27,27,48,27,55,27,38,38,48,45,55,68.15,14.09268727
hek293t,9069,1,3,GCCGATGGCTCAGATGTGTGAACAAATTGTGGCCTTGATGTTCCAACATGGGTGTGTGAAGGAGCCTCTGACCTTCTCTGAAAAAAATTCTAGTTGGTT,GCCGATGGCTCAGATGTGTGAACAAATTGTGGCCTTCCGGATGTTCCAACATGGGTGTGTGAAGGAGCCTCTGACCTTCTCTGAAAAAAATTCTAGTTG,10,30,14,27,27,40,27,43,27,37,37,40,40,43,47.62,0.608272506
hek293t,9069,1,3,AAGTGTGGCTCAGATGTGTGAACAAATTGTGGCCTTGATGTTCCAACATGGGTGTGTGAAGGAGCCTCTGACCTTCAAAAAAATTCTAGTTGGTTTAAC,AAGTGTGGCTCAGATGTGTGAACAAATTGTGGCCTTCCGGATGTTCCAACATGGGTGTGTGAAGGAGCCTCTGACCTTCAAAAAAATTCTAGTTGGTTT,10,30,14,27,27,44,27,47,27,37,37,44,40,47,47.62,37.25722024
hek293t,9073,1,1,ACCGAAATTAGGGTCACTAAGAAAAAGCCTGGAAAAATGTGTCACTTACTGTACTGTTAAGAGCTAACAGTGGAATTTTATAAAAAAATTCTAGTTGGT,ACCGAAATTAGGGTCACTAAGAAAAAGCCTGGAAAAATTGTGTCACTTACTGTACTGTTAAGAGCTAACAGTGGAATTTTATAAAAAAATTCTAGTTGG,10,30,14,27,27,41,27,42,27,38,38,41,39,42,48.71,0.0
hek293t,9073,1,1,GTCGGAATTAGGGTCACTAAGAAAAAGCCTGGAAAAATGTGTCACTTACTGTACTGTTAAGAGCTAACAGTGGAATTAAAAAAATTCTAGTTGGTTTAA,GTCGGAATTAGGGTCACTAAGAAAAAGCCTGGAAAAATTGTGTCACTTACTGTACTGTTAAGAGCTAACAGTGGAATTAAAAAAATTCTAGTTGGTTTA,10,30,14,27,27,45,27,46,27,38,38,45,39,46,48.71,0.0
hek293t,9075,1,6,CGTCCTTACAGCATAGACTTGTCCTGCACTGGCCTTGTGATTCATGTAACAGGCTCCCTCCTCTTCTGATGAAAATCTCAGGTAAAAAAATTCTAGTTG,CGTCCTTACAGCATAGACTTGTCCTGTACGTCCACTGGCCTTGTGATTCATGTAACAGGCTCCCTCCTCTTCTGATGAAAATCTCAGGTAAAAAAATTC,10,30,14,27,27,34,27,40,27,27,27,34,33,40,36.32,26.35305384
hek293t,9075,1,6,TACGATTACAGCATAGACTTGTCCTGCACTGGCCTTGTGATTCATGTAACAGGCTCCCTCCTCTTCTGATGAAAATCTCAGGTACAGAAAAAAATTCTA,TACGATTACAGCATAGACTTGTCCTGTACGTCCACTGGCCTTGTGATTCATGTAACAGGCTCCCTCCTCTTCTGATGAAAATCTCAGGTACAGAAAAAA,10,30,14,27,27,30,27,36,27,27,27,30,33,36,36.32,0.809719627
hek293t,9077,1,1,CCCCCTCAATAATGAGGTGCCTGCAAGAAAGGAATATTGCGATTCCCCCATCAGTTAAGGACAGAGGCCCTGGAAGTGCTAAAAAAATTCTAGTTGGTT,CCCCCTCAATAATGAGGTGCCTGCAACGAAAGGAATATTGCGATTCCCCCATCAGTTAAGGACAGAGGCCCTGGAAGTGCTAAAAAAATTCTAGTTGGT,10,30,14,27,27,42,27,43,27,27,27,42,28,43,32.03,6.732809633
hek293t,9077,1,1,CAGGGTCAATAATGAGGTGCCTGCAAGAAAGGAATATTGCGATTCCCCCATCAGTTAAGGACAGAGGCCCTGGAAGTGCTGATTGATAAAAAAAATTCT,CAGGGTCAATAATGAGGTGCCTGCAACGAAAGGAATATTGCGATTCCCCCATCAGTTAAGGACAGAGGCCCTGGAAGTGCTGATTGATAAAAAAAATTC,10,30,14,27,27,34,27,35,27,27,27,34,28,35,32.03,29.08620293
hek293t,9079,1,9,AGGGCGCTTGTGTCAGGTAAGGGTGGATGTGGGATGAAGGGTGGGGGGTGGTGAAGGGCTTAGTAGTAAAAAAATTCTAGTTGGTTTAACGCGTAACTA,AGGGCGCTTGTGTCAGGTAAGGGTGGATGTGGAAGCGCAGGGATGAAGGGTGGGGGGTGGTGAAGGGCTTAGTAGTAAAAAAATTCTAGTTGGTTTAAC,10,30,14,27,27,47,27,56,27,32,32,47,41,56,43.47,2.299946572
hek293t,9079,1,9,GCCAGGCTTGTGTCAGGTAAGGGTGGATGTGGGATGAAGGGTGGGGGGTGGTGAAGGGCTTAGTAGTGAAATGCTTAAAAAAAAAATTCTAGTTGGTTT,GCCAGGCTTGTGTCAGGTAAGGGTGGATGTGGAAGCGCAGGGATGAAGGGTGGGGGGTGGTGAAGGGCTTAGTAGTGAAATGCTTAAAAAAAAAATTCT,10,30,14,27,27,35,27,44,27,32,32,35,41,44,43.47,0.101626016
hek293t,9081,1,4,CGCATTTTCTCCAATATCTGTGAAGTAGATGGCAACCAAGGGGAGCCAGAATTTGGAGTATCTCCTTTTCTGAGGTCCTTTTTAAAAAAATTCTAGTTG,CGCATTTTCTCCAATATCTGTGAAGTAGCAGAATGGCAACCAAGGGGAGCCAGAATTTGGAGTATCTCCTTTTCTGAGGTCCTTTTTAAAAAAATTCTA,10,30,14,27,27,36,27,40,27,29,29,36,33,40,26.21,53.39830128
hek293t,9081,1,4,AAGCGTTTCTCCAATATCTGTGAAGTAGATGGCAACCAAGGGGAGCCAGAATTTGGAGTATCTCCTTTTCTGAGGTCCTTTTTCATGAAAAAAATTCTA,AAGCGTTTCTCCAATATCTGTGAAGTAGCAGAATGGCAACCAAGGGGAGCCAGAATTTGGAGTATCTCCTTTTCTGAGGTCCTTTTTCATGAAAAAAAT,10,30,14,27,27,32,27,36,27,29,29,32,33,36,26.21,6.419243119
hek293t,9083,1,7,ATCTCGCTTTTATTTATTTATTTAAGTGAAGGTAACTTAAAAGTGCCCAAATTACATTATAATTAAACACATAACCAACCAAAAAAATTCTAGTTGGTT,ATCTCGCTTTTATTTATTTATTTAAGTGAAGGTCCGCTGTAACTTAAAAGTGCCCAAATTACATTATAATTAAACACATAACCAACCAAAAAAATTCTA,10,30,14,27,27,36,27,43,27,33,33,36,40,43,0.16,0.0
hek293t,9083,1,7,CAGGTGCTTTTATTTATTTATTTAAGTGAAGGTAACTTAAAAGTGCCCAAATTACATTATAATTAAACACATAACCAAAAAAATTCTAGTTGGTTTAAC,CAGGTGCTTTTATTTATTTATTTAAGTGAAGGTCCGCTGTAACTTAAAAGTGCCCAAATTACATTATAATTAAACACATAACCAAAAAAATTCTAGTTG,10,30,14,27,27,40,27,47,27,33,33,40,40,47,0.16,0.0
hek293t,9085,1,5,GAGGCCTGCACTGAATTCCATAAACCACAAGGAGTAGTAAAGCAGTTCACAACTGAAGCTTGTAAAGTTCTCAAAAAAAATTCTAGTTGGTTTAACGCG,GAGGCCTGCACTGAATTCCATAAACCACAAGGAGCCGATTAGTAAAGCAGTTCACAACTGAAGCTTGTAAAGTTCTCAAAAAAAATTCTAGTTGGTTTA,10,30,14,27,27,45,27,50,27,35,35,45,40,50,58.31,11.6025748
hek293t,9085,1,5,CCAATCTGCACTGAATTCCATAAACCACAAGGAGTAGTAAAGCAGTTCACAACTGAAGCTTGTAAAGTTCTCAATACCACAAAAAAATTCTAGTTGGTT,CCAATCTGCACTGAATTCCATAAACCACAAGGAGCCGATTAGTAAAGCAGTTCACAACTGAAGCTTGTAAAGTTCTCAATACCACAAAAAAATTCTAGT,10,30,14,27,27,38,27,43,27,35,35,38,40,43,58.31,0.623843405
hek293t,9087,1,15,TGAGCCATGATTTCACAAAGCCTAAAATAAGGAAGATCAAAATGGCTGATGTGACTTTCCAGGGAAAAAAATTCTAGTTGGTTTAACGCGTAACTAGAT,TGAGCCATGATTTCACAAAGCCTAAAATAAGGAATTGCCGGCCGCACAAGATCAAAATGGCTGATGTGACTTTCCAGGGAAAAAAATTCTAGTTGGTTT,10,30,14,27,27,44,27,59,27,34,34,44,49,59,36.84,0.053763441
hek293t,9088,1,9,TCTCTCTGAACACCAGGCTGCTTTTCTCATGGCTAAGGCAGGGGAAAGAAATGAAGATGAGAGAGAGTAAAGTGGGAGAAAAAAAAAATTCTAGTTGGT,TCTCTCTGAACACCAGGCTGCTTTTCTCACTGTTACTGTGGCTAAGGCAGGGGAAAGAAATGAAGATGAGAGAGAGTAAAGTGGGAGAAAAAAAAAATT,10,30,14,27,27,33,27,42,27,30,30,33,39,42,31.5,0.66887646
hek293t,9088,1,9,CATTACTGAACACCAGGCTGCTTTTCTCATGGCTAAGGCAGGGGAAAGAAATGAAGATGAGAGAGAGTAAAGTGAAAAAAATTCTAGTTGGTTTAACGC,CATTACTGAACACCAGGCTGCTTTTCTCACTGTTACTGTGGCTAAGGCAGGGGAAAGAAATGAAGATGAGAGAGAGTAAAGTGAAAAAAATTCTAGTTG,10,30,14,27,27,40,27,49,27,30,30,40,39,49,31.5,20.29497449
hek293t,18103,1,1,ACTGGTGTTGGTTCTTTTTAGTAGTGTTATGGAAAAAAGTATATGAAAACTGCGAGAAATTACGCTTTTTAGAAGAAAAAAATTCTAGTTGGTTTAACG,ACTGGTGTTGGTTCTTTTTAGTAGTGTTATGGGAAAAAAGTATATGAAAACTGCGAGAAATTACGCTTTTTAGAAGAAAAAAATTCTAGTTGGTTTAAC,10,30,14,27,27,47,27,48,27,32,32,47,33,48,8.98,0.776482292
hek293t,9092,1,6,GCGTCTTGTAATAGGTTTACACCTAACATAGGTTGTCCTATTTGAAACTTCAATTTTAAAAGCTTTTTAAAATGAAAAAAATTCTAGTTGGTTTAACGC,GCGTCTTGTAATAGGTTTACACCTAACATAGGTTGGAGACTTCCTATTTGAAACTTCAATTTTAAAAGCTTTTTAAAATGAAAAAAATTCTAGTTGGTT,10,30,14,27,27,43,27,49,27,36,36,43,42,49,63.22,3.133702478
hek293t,9092,1,6,ACGTATTGTAATAGGTTTACACCTAACATAGGTTGTCCTATTTGAAACTTCAATTTTAAAAGCTTTAAAAAAATTCTAGTTGGTTTAACGCGTAACTAG,ACGTATTGTAATAGGTTTACACCTAACATAGGTTGGAGACTTCCTATTTGAAACTTCAATTTTAAAAGCTTTAAAAAAATTCTAGTTGGTTTAACGCGT,10,30,14,27,27,51,27,57,27,36,36,51,42,57,63.22,13.31913999
hek293t,9094,1,1,CAAGATGTATAATGTAGGCTGGCTCTGCATGGCCATATTGTAGCATGTTAGCATTTTGGAAAATAGTTACTGCAAGTCTAAAAAAATTCTAGTTGGTTT,CAAGATGTATAATGTAGGCTGGCTCTGACATGGCCATATTGTAGCATGTTAGCATTTTGGAAAATAGTTACTGCAAGTCTAAAAAAATTCTAGTTGGTT,10,30,14,27,27,43,27,44,27,28,28,43,29,44,64.44,78.49132283
hek293t,9094,1,1,GCCGGTGTATAATGTAGGCTGGCTCTGCATGGCCATATTGTAGCATGTTAGCATTTTGGAAAATAGTTACTGCAAGTCTGTTTAAAAAAAATTCTAGTT,GCCGGTGTATAATGTAGGCTGGCTCTGACATGGCCATATTGTAGCATGTTAGCATTTTGGAAAATAGTTACTGCAAGTCTGTTTAAAAAAAATTCTAGT,10,30,14,27,27,38,27,39,27,28,28,38,29,39,64.44,75.7535168
hek293t,9096,1,12,GTAATCTCCCTTCTCGGCCTGGCCGGGGAAGGCTGCTCTCTGCCAGCAGCATTTCCCTCCCTCTGCCTGCTTTCACAGACAAAAAAATTCTAGTTGGTT,GTAATCTCCCTTCTCGGCCTGGCCGGGCGTCCTCCTAAAGAAGGCTGCTCTCTGCCAGCAGCATTTCCCTCCCTCTGCCTGCTTTCACAGACAAAAAAA,10,30,14,27,27,31,27,43,27,28,28,31,40,43,32.72,0.0
hek293t,9098,1,15,AGACCAGAAGCCTTGCCTTTATGGACACACGGAGCGGCAAGACCAGCTTATCTTGCATTAGCTCAAAAAAATTCTAGTTGGTTTAACGCGTAACTAGAT,AGACCAGAAGCCTTGCCTTTATGGACACACGGAGCGTATCTCAATAGGAGCGCAAGACCAGCTTATCTTGCATTAGCTCAAAAAAATTCTAGTTGGTTT,10,30,14,27,27,44,27,59,27,37,37,44,52,59,42.26,0.999871576
hek293t,9099,1,3,ATGGGTTTGTACAACCCTGCTCTAGCAAGGGGCTTAAGTCAGTTTGAAAAATGTAATTTCAACAGCAGTAGAACAAGTTGCTAAAAAAATTCTAGTTGG,ATGGGTTTGTACAACCCTGCTCTAGCAGGCAGGGGCTTAAGTCAGTTTGAAAAATGTAATTTCAACAGCAGTAGAACAAGTTGCTAAAAAAATTCTAGT,10,30,14,27,27,38,27,41,27,28,28,38,31,41,62.99,21.5937263
hek293t,9099,1,3,AGAGCTTTGTACAACCCTGCTCTAGCAAGGGGCTTAAGTCAGTTTGAAAAATGTAATTTCAACAGCAGTAGAACAAGAAAAAAATTCTAGTTGGTTTAA,AGAGCTTTGTACAACCCTGCTCTAGCAGGCAGGGGCTTAAGTCAGTTTGAAAAATGTAATTTCAACAGCAGTAGAACAAGAAAAAAATTCTAGTTGGTT,10,30,14,27,27,43,27,46,27,28,28,43,31,46,62.99,9.052097996
hek293t,12928,1,8,TGGCCAGATTAAAATAGTAAATACTAATCTGGCACGGGTTCTTGAGACACTCTACAAATAGATTCCTTCAAAAAAAATTCTAGTTGGTTTAACGCGTAA,TGGCCAGATTAAAATAGTAAATACTAATCTGGCACGGATTAGTTAGTTCTTGAGACACTCTACAAATAGATTCCTTCAAAAAAAATTCTAGTTGGTTTA,10,30,14,27,27,45,27,53,27,38,38,45,46,53,9.71,0.0
hek293t,12928,1,8,CGCTGAGATTAAAATAGTAAATACTAATCTGGCACGGGTTCTTGAGACACTCTACAAATAGATTCCTTCAACTGAAAAAAATTCTAGTTGGTTTAACGC,CGCTGAGATTAAAATAGTAAATACTAATCTGGCACGGATTAGTTAGTTCTTGAGACACTCTACAAATAGATTCCTTCAACTGAAAAAAATTCTAGTTGG,10,30,14,27,27,41,27,49,27,38,38,41,46,49,9.71,0.0
hek293t,9103,1,14,AGGTTGCCTAGAAAGAAAATAGTGCTGCCTGGGATGGCCAATTCAGCTGCTGGAGCACACATCCACATTTAAGAAAAAAATTCTAGTTGGTTTAACGCG,AGGTTGCCTAGAAAGAAAATAGTGCTGCCCGTAGTCCGCACACTGGGATGGCCAATTCAGCTGCTGGAGCACACATCCACATTTAAGAAAAAAATTCTA,10,30,14,27,27,36,27,50,27,29,29,36,43,50,52.43,0.47366375
hek293t,9103,1,14,TTTAAGCCTAGAAAGAAAATAGTGCTGCCTGGGATGGCCAATTCAGCTGCTGGAGCACACATCCACATTTAAGATTAAAAAAAATTCTAGTTGGTTTAA,TTTAAGCCTAGAAAGAAAATAGTGCTGCCCGTAGTCCGCACACTGGGATGGCCAATTCAGCTGCTGGAGCACACATCCACATTTAAGATTAAAAAAAAT,10,30,14,27,27,32,27,46,27,29,29,32,43,46,52.43,0.0
hek293t,9105,1,4,TAACGCCTTAAGCATCAAGGAAAGGACCCTGGAGCTATTTTGCTGGAAAGTTTACTTTCCACATTTTAGCAAAAAAATTCTAGTTGGTTTAACGCGTAA,TAACGCCTTAAGCATCAAGGAAAGGACCCTGGAGCTAGCTATTTTGCTGGAAAGTTTACTTTCCACATTTTAGCAAAAAAATTCTAGTTGGTTTAACGC,10,30,14,27,27,49,27,53,27,34,34,49,38,53,53.11,21.59134899
hek293t,9107,1,12,TACTACCCCCCCCCAGACTGACATTCTGAAGGTACCCACAACATTTATAACAGATAGTTCTGTATTTCCCTACTAGCAAAAAAATTCTAGTTGGTTTAA,TACTACCCCCCCCCAGACTGACATTCATGTTTACTGAATGAAGGTACCCACAACATTTATAACAGATAGTTCTGTATTTCCCTACTAGCAAAAAAATTC,10,30,14,27,27,34,27,46,27,27,27,34,39,46,45.8,11.9621918
hek293t,9107,1,12,ATTGGCCCCCCCCCAGACTGACATTCTGAAGGTACCCACAACATTTATAACAGATAGTTCTGTATTTCCAAAAAAATTCTAGTTGGTTTAACGCGTAAC,ATTGGCCCCCCCCCAGACTGACATTCATGTTTACTGAATGAAGGTACCCACAACATTTATAACAGATAGTTCTGTATTTCCAAAAAAATTCTAGTTGGT,10,30,14,27,27,42,27,54,27,27,27,42,39,54,45.8,15.13335786
hek293t,9111,1,7,GTATCTTAGTACAGACCAACACTGACATCTGGTGCCAGCAAAACCATTTTACATTGGGGCAAAGATTCAAAAAAAAATTCTAGTTGGTTTAACGCGTAA,GTATCTTAGTACAGACCAACACTGACATCTGGTGCCAGATCCAATCAAAACCATTTTACATTGGGGCAAAGATTCAAAAAAAAATTCTAGTTGGTTTAA,10,30,14,27,27,46,27,53,27,39,39,46,46,53,45.26,1.516142643
hek293t,9111,1,7,TCTTATTAGTACAGACCAACACTGACATCTGGTGCCAGCAAAACCATTTTACATTGGGGCAAAGATTAAAAAAATTCTAGTTGGTTTAACGCGTAACTA,TCTTATTAGTACAGACCAACACTGACATCTGGTGCCAGATCCAATCAAAACCATTTTACATTGGGGCAAAGATTAAAAAAATTCTAGTTGGTTTAACGC,10,30,14,27,27,49,27,56,27,39,39,49,46,56,45.26,0.570588849
hek293t,9113,1,12,CCCTTTTTATACTCTGAAAAAATGGTGTGGGGCCCTCGCGTGCCACTGAGAAGAGCATAAGAGACCCCCCCCGAACAAAAAAAAAAATTCTAGTTGGTT,CCCTTTTTATACTCTGAAAAAATGGTGGAACCGAGCCAGTGGGGCCCTCGCGTGCCACTGAGAAGAGCATAAGAGACCCCCCCCGAACAAAAAAAAAAA,10,30,14,27,27,31,27,43,27,28,28,31,40,43,48.64,0.0
hek293t,9115,1,8,TACTTTCTGCCATATATTTTGGTAGACTAAGGTAAGGAAGATAAATAACTCTAAACTGTGTGCAACCTAGTTGAAGAAAAAAATTCTAGTTGGTTTAAC,TACTTTCTGCCATATATTTTGGTAGACTAAGTTTTAGTCGTAAGGAAGATAAATAACTCTAAACTGTGTGCAACCTAGTTGAAGAAAAAAATTCTAGTT,10,30,14,27,27,39,27,47,27,32,32,39,40,47,21.22,0.0
hek293t,9115,1,8,CCTTTTCTGCCATATATTTTGGTAGACTAAGGTAAGGAAGATAAATAACTCTAAACTGTGTGCAACCTAAAAAAATTCTAGTTGGTTTAACGCGTAACT,CCTTTTCTGCCATATATTTTGGTAGACTAAGTTTTAGTCGTAAGGAAGATAAATAACTCTAAACTGTGTGCAACCTAAAAAAATTCTAGTTGGTTTAAC,10,30,14,27,27,47,27,55,27,32,32,47,40,55,21.22,0.915217364
hek293t,9117,1,8,TGAAGAACTCCAGAGAAATTGGATTTAGAAGGTTGGTATTAAAGAACAAAATACACAAGTACAAACTGATGAAAAAAATTCTAGTTGGTTTAACGCGTA,TGAAGAACTCCAGAGAAATTGGATTTAGAAGGTTGGCACGCGAATATTAAAGAACAAAATACACAAGTACAAACTGATGAAAAAAATTCTAGTTGGTTT,10,30,14,27,27,44,27,52,27,37,37,44,45,52,23.7,0.214472006
hek293t,9118,1,7,CTCTTAGTAACTTCCATAGTATAAAAATCAGGACTTCTTTTATGCATTAAGAATGGAAAGAGGATAGAAAACAGAAAAAAATTCTAGTTGGTTTAACGC,CTCTTAGTAACTTCCATAGTATAAAAATCAGGACCGTCGGCTTCTTTTATGCATTAAGAATGGAAAGAGGATAGAAAACAGAAAAAAATTCTAGTTGGT,10,30,14,27,27,42,27,49,27,35,35,42,42,49,26.42,0.0
hek293t,9123,1,7,GTTTGAAAACCCCCCCCAAGAAAAAGAAATGGATTCATTCTCACCATTTTTCCTACCTACATTATGTATAAAAAAAATTCTAGTTGGTTTAACGCGTAA,GTTTGAAAACCCCCCCCAAGAAAAAGAAATGGATTCATGACGATGTCTCACCATTTTTCCTACCTACATTATGTATAAAAAAAATTCTAGTTGGTTTAA,10,30,14,27,27,46,27,53,27,39,39,46,46,53,28.01,0.0
hek293t,9124,1,13,GTGTTTTTATGTACATGTAGCTGAAAAAATGGTTTCCACCGTCAGTTCCAGGCGGCTGGGGAAGCCCCACTCTAAAAAAAATTCTAGTTGGTTTAACGC,GTGTTTTTATGTACATGTAGCTGAAAAAATAAGGAATGCAAATGGTTTCCACCGTCAGTTCCAGGCGGCTGGGGAAGCCCCACTCTAAAAAAAATTCTA,10,30,14,27,27,36,27,49,27,29,29,36,42,49,22.87,0.0
hek293t,9124,1,13,ATGACTTTATGTACATGTAGCTGAAAAAATGGTTTCCACCGTCAGTTCCAGGCGGCTGGGGAAGCCCCACTCTACAGCAAAAAAATTCTAGTTGGTTTA,ATGACTTTATGTACATGTAGCTGAAAAAATAAGGAATGCAAATGGTTTCCACCGTCAGTTCCAGGCGGCTGGGGAAGCCCCACTCTACAGCAAAAAAAT,10,30,14,27,27,32,27,45,27,29,29,32,42,45,22.87,0.0
hek293t,9126,1,10,CTGTAGTAACGTTATCTCTCGGTTTGTACCGGATGTCATGAAAGAGCACGCTATTCCTTTGTTCATCACAAAAAAATTCTAGTTGGTTTAACGCGTAAC,CTGTAGTAACGTTATCTCTCGGTTTGTATTCTCGCGGTCCGGATGTCATGAAAGAGCACGCTATTCCTTTGTTCATCACAAAAAAATTCTAGTTGGTTT,10,30,14,27,27,44,27,54,27,29,29,44,39,54,21.97,27.42599989
hek293t,9128,1,15,CGCAGAATGACAGAGTTCTGGAGAACTGAAGGAGAGCTTTAAGAACTTATCTCTCAATGGAATAATATGCAAAAAAATTCTAGTTGGTTTAACGCGTAA,CGCAGAATGACAGAGTTCTGGAGAACTGAAGGCCGACCTGGGCATGGAGAGCTTTAAGAACTTATCTCTCAATGGAATAATATGCAAAAAAATTCTAGT,10,30,14,27,27,38,27,53,27,31,31,38,46,53,56.66,1.117960986
hek293t,9128,1,15,GACTCAATGACAGAGTTCTGGAGAACTGAAGGAGAGCTTTAAGAACTTATCTCTCAATGGAATAATATGCTATTAAAAAAATTCTAGTTGGTTTAACGC,GACTCAATGACAGAGTTCTGGAGAACTGAAGGCCGACCTGGGCATGGAGAGCTTTAAGAACTTATCTCTCAATGGAATAATATGCTATTAAAAAAATTC,10,30,14,27,27,34,27,49,27,31,31,34,46,49,56.66,4.66928769
hek293t,9130,1,1,TCCACAATATGCTGCTTGTAGAACCAAATAGGAGGGAGAAAGATCTTGAAGACAAATTAGGGATTGGCAGTTATTCAAAAAAATTCTAGTTGGTTTAAC,TCCACAATATGCTGCTTGTAGAACCAAATAGGAGGTGAGAAAGATCTTGAAGACAAATTAGGGATTGGCAGTTATTCAAAAAAATTCTAGTTGGTTTAA,10,30,14,27,27,46,27,47,27,36,36,46,37,47,10.93,5.290114587
hek293t,9130,1,1,GACCCAATATGCTGCTTGTAGAACCAAATAGGAGGGAGAAAGATCTTGAAGACAAATTAGGGATTGGCAGTTATTCGAAAGACAAAAAAATTCTAGTTG,GACCCAATATGCTGCTTGTAGAACCAAATAGGAGGTGAGAAAGATCTTGAAGACAAATTAGGGATTGGCAGTTATTCGAAAGACAAAAAAATTCTAGTT,10,30,14,27,27,39,27,40,27,36,36,39,37,40,10.93,0.0
hek293t,9132,1,2,CCCAGATTACAATTGAAAGCGAATATGAAAGGCAAAACTGTCACCGAGTTTTGACTGCAAGCAAAGAAATGGAAAGGTTAGCAAAAAAATTCTAGTTGG,CCCAGATTACAATTGAAAGCGAATATGAAAGGCAATCAACTGTCACCGAGTTTTGACTGCAAGCAAAGAAATGGAAAGGTTAGCAAAAAAATTCTAGTT,10,30,14,27,27,39,27,41,27,36,36,39,38,41,30.04,0.0
hek293t,9132,1,2,TCATCATTACAATTGAAAGCGAATATGAAAGGCAAAACTGTCACCGAGTTTTGACTGCAAGCAAAGAAATGGAAAAAAAAAATTCTAGTTGGTTTAACG,TCATCATTACAATTGAAAGCGAATATGAAAGGCAATCAACTGTCACCGAGTTTTGACTGCAAGCAAAGAAATGGAAAAAAAAAATTCTAGTTGGTTTAA,10,30,14,27,27,46,27,48,27,36,36,46,38,48,30.04,6.430845253
hek293t,9134,1,1,AGATGAGAGGCAGAGTTGCAGTAGTTTACAGGAGCATGAGGCCATCAGGAGCTCTGTCATGCTGTTTCCAGTGCTCAGCTGTAAAAAAATTCTAGTTGG,AGATGAGAGGCAGAGTTGCAGTAGTTTACAGGAGCACTGAGGCCATCAGGAGCTCTGTCATGCTGTTTCCAGTGCTCAGCTGTAAAAAAATTCTAGTTG,10,30,14,27,27,40,27,41,27,37,37,40,38,41,19.58,23.54435523
hek293t,9134,1,1,GCGACAGAGGCAGAGTTGCAGTAGTTTACAGGAGCATGAGGCCATCAGGAGCTCTGTCATGCTGTTTCCAGTGCTAAAAAAATTCTAGTTGGTTTAACG,GCGACAGAGGCAGAGTTGCAGTAGTTTACAGGAGCACTGAGGCCATCAGGAGCTCTGTCATGCTGTTTCCAGTGCTAAAAAAATTCTAGTTGGTTTAAC,10,30,14,27,27,47,27,48,27,37,37,47,38,48,19.58,71.71306978
hek293t,9138,1,10,CTTGGCAGCTGTGCACAAACAAATAGAAGGGGCCTGTTAATGCTGCGTGCTGGCACAAGCCATATTTGGGAGATAGAAAAAAAAATTCTAGTTGGTTTA,CTTGGCAGCTGTGCACAAACAAATAGATTGAGTGCTAAGGGGCCTGTTAATGCTGCGTGCTGGCACAAGCCATATTTGGGAGATAGAAAAAAAAATTCT,10,30,14,27,27,35,27,45,27,28,28,35,38,45,51.92,1.432742188
hek293t,9140,1,7,AGGCCCCCGAGAAGCCGTGTTACTCTTACAGGGCAAGGCCTTTACATCTGGAGGAAAGATAGCTTCTGCTAGGGAGGTGACAAAAAAATTCTAGTTGGT,AGGCCCCCGAGAAGCCGTGTTACTCTTAGATGACACAGGGCAAGGCCTTTACATCTGGAGGAAAGATAGCTTCTGCTAGGGAGGTGACAAAAAAATTCT,10,30,14,27,27,35,27,42,27,28,28,35,35,42,14.94,28.62083569
hek293t,9140,1,7,GCAATCCCGAGAAGCCGTGTTACTCTTACAGGGCAAGGCCTTTACATCTGGAGGAAAGATAGCTTCTGCTAGGGAGGTAAAAAAATTCTAGTTGGTTTA,GCAATCCCGAGAAGCCGTGTTACTCTTAGATGACACAGGGCAAGGCCTTTACATCTGGAGGAAAGATAGCTTCTGCTAGGGAGGTAAAAAAATTCTAGT,10,30,14,27,27,38,27,45,27,28,28,38,35,45,14.94,70.93220715
hek293t,9142,1,11,GAGGGCTGCAAGCACCTCTGGGGAGGGGATGGGCCACTGAGAGGGCCTCCCTGAGGGCCGGTGGGCAGGAGATAAAAAAATTCTAGTTGGTTTAACGCG,GAGGGCTGCAAGCACCTCTGGGGAGGGGGGCGGTCAGTAATGGGCCACTGAGAGGGCCTCCCTGAGGGCCGGTGGGCAGGAGATAAAAAAATTCTAGTT,10,30,14,27,27,39,27,50,27,29,29,39,40,50,30.19,27.57520734
hek293t,9142,1,11,GGCACCTGCAAGCACCTCTGGGGAGGGGATGGGCCACTGAGAGGGCCTCCCTGAGGGCCGGTGGGCAGGAGATGGAAAAAAAATTCTAGTTGGTTTAAC,GGCACCTGCAAGCACCTCTGGGGAGGGGGGCGGTCAGTAATGGGCCACTGAGAGGGCCTCCCTGAGGGCCGGTGGGCAGGAGATGGAAAAAAAATTCTA,10,30,14,27,27,36,27,47,27,29,29,36,40,47,30.19,26.38696015
hek293t,18621,1,4,CCATTTATAGACAGATTCATTTAATGAGCAGGGTCTGACAAAGCAGAAGAAAGCCATCATCACAGGTTATAGGATGAAAAAAATTCTAGTTGGTTTAAC,CCATTTATAGACAGATTCATTTAATGAGCAGGTCGTGTCTGACAAAGCAGAAGAAAGCCATCATCACAGGTTATAGGATGAAAAAAATTCTAGTTGGTT,10,30,14,27,27,43,27,47,27,33,33,43,37,47,9.43,69.11366851
hek293t,18621,1,4,GGCTTTATAGACAGATTCATTTAATGAGCAGGGTCTGACAAAGCAGAAGAAAGCCATCATCACAGGTTATAGGATGTAGTTTTAAAAAAATTCTAGTTG,GGCTTTATAGACAGATTCATTTAATGAGCAGGTCGTGTCTGACAAAGCAGAAGAAAGCCATCATCACAGGTTATAGGATGTAGTTTTAAAAAAATTCTA,10,30,14,27,27,36,27,40,27,33,33,36,37,40,9.43,0.055648303
hek293t,9146,1,9,GCAGGCCAAACATGGTGGGATGGAGACCTCGGGTACCAAGGTCCTACAGGCTTTGTGGAGATACGTGGTAAAAAAATTCTAGTTGGTTTAACGCGTAAC,GCAGGCCAAACATGGTGGGATGGAGACCTCGGGTACACAAATCACCAAGGTCCTACAGGCTTTGTGGAGATACGTGGTAAAAAAATTCTAGTTGGTTTA,10,30,14,27,27,45,27,54,27,35,35,45,44,54,56.48,9.5101846
hek293t,9146,1,9,GGTGACCAAACATGGTGGGATGGAGACCTCGGGTACCAAGGTCCTACAGGCTTTGTGGAGATACGTGGTGGAGGGCAAAAAAATTCTAGTTGGTTTAAC,GGTGACCAAACATGGTGGGATGGAGACCTCGGGTACACAAATCACCAAGGTCCTACAGGCTTTGTGGAGATACGTGGTGGAGGGCAAAAAAATTCTAGT,10,30,14,27,27,38,27,47,27,35,35,38,44,47,56.48,0.0
hek293t,9148,1,8,GGACTGGGCAGGAGCCTAAATATGGAGCGAGGCATCACTTCAGACTGGTTGTTTCTGAAAATCCTAAAAAAATTCTAGTTGGTTTAACGCGTAACTAGA,GGACTGGGCAGGAGCCTAAATATGGAGCGAGGCATCCAATGATCACTTCAGACTGGTTGTTTCTGAAAATCCTAAAAAAATTCTAGTTGGTTTAACGCG,10,30,14,27,27,50,27,58,27,35,35,50,43,58,58.09,3.716662388
hek293t,9148,1,8,TGCTTGGGCAGGAGCCTAAATATGGAGCGAGGCATCACTTCAGACTGGTTGTTTCTGAAAATCCTGGCCCAAAAAAATTCTAGTTGGTTTAACGCGTAA,TGCTTGGGCAGGAGCCTAAATATGGAGCGAGGCATCCAATGATCACTTCAGACTGGTTGTTTCTGAAAATCCTGGCCCAAAAAAATTCTAGTTGGTTTA,10,30,14,27,27,45,27,53,27,35,35,45,43,53,58.09,4.994061948
hek293t,9150,1,3,GGTTCACAAGAGATTGTACAGATATGAGATGGTCATACTATATTTCTAAGGAATTGGAAGTGCATGAACTGAGAGAGAAAAAAATTCTAGTTGGTTTAA,GGTTCACAAGAGATTGTACAGATATGATCGGATGGTCATACTATATTTCTAAGGAATTGGAAGTGCATGAACTGAGAGAGAAAAAAATTCTAGTTGGTT,10,30,14,27,27,43,27,46,27,28,28,43,31,46,67.3,76.27654399
hek293t,5899,1,3,CTTACCCTTCCTAGCCTGCCTCCTAATTGAGGAGGTAAGCCATGAGGTAGAATTCTGTTTCCAGGGCTTTTGTGAAAAAAATTCTAGTTGGTTTAACGC,CTTACCCTTCCTAGCCTGCCTCCTAATTGAGGAGGTAAAATGCCATGAGGTAGAATTCTGTTTCCAGGGCTTTTGTGAAAAAAATTCTAGTTGGTTTAA,10,30,14,27,27,46,27,49,27,39,39,46,42,49,59.17,2.001338552
hek293t,5899,1,3,CCTGCCCTTCCTAGCCTGCCTCCTAATTGAGGAGGTAAGCCATGAGGTAGAATTCTGTTTCCAGGGAAAAAAATTCTAGTTGGTTTAACGCGTAACTAG,CCTGCCCTTCCTAGCCTGCCTCCTAATTGAGGAGGTAAAATGCCATGAGGTAGAATTCTGTTTCCAGGGAAAAAAATTCTAGTTGGTTTAACGCGTAAC,10,30,14,27,27,54,27,57,27,39,39,54,42,57,59.17,13.37546374
hek293t,9154,1,12,TGTCCAACTCAGATGCTTTCTTTCATGGGGGGAGAAGGCACAGCTATGAATTAAAAACTCCTGCATAAAAAAAATTCTAGTTGGTTTAACGCGTAACTA,TGTCCAACTCAGATGCTTTCTTTCATGGGGGGAGAAGGCAAATACTTGCCTCCAGCTATGAATTAAAAACTCCTGCATAAAAAAAATTCTAGTTGGTTT,10,30,14,27,27,44,27,56,27,41,41,44,53,56,53.5,0.0
hek293t,5273,1,2,ACCATACCACCACAGGCAGAGATGTGGAAAGGCTGGAAAACCTTTGTTTTGCTCAGAAAAATGTAATTTCACTGAAGTAAAAAAATTCTAGTTGGTTTA,ACCATACCACCACAGGCAGAGATGTGGAAAGGCGCTGGAAAACCTTTGTTTTGCTCAGAAAAATGTAATTTCACTGAAGTAAAAAAATTCTAGTTGGTT,10,30,14,27,27,43,27,45,27,33,33,43,35,45,59.32,80.30773155
hek293t,5273,1,2,TGTGTACCACCACAGGCAGAGATGTGGAAAGGCTGGAAAACCTTTGTTTTGCTCAGAAAAATGTAATTTCACTGAAGTCTCAAAAAAATTCTAGTTGGT,TGTGTACCACCACAGGCAGAGATGTGGAAAGGCGCTGGAAAACCTTTGTTTTGCTCAGAAAAATGTAATTTCACTGAAGTCTCAAAAAAATTCTAGTTG,10,30,14,27,27,40,27,42,27,33,33,40,35,42,59.32,77.22261217
hek293t,9157,1,7,TGCTCAACCTTTAAAAATGAAGGAAACTCAGGTTAATAAAACCAATTGCAGTGAGTTGGGACTTTCAAATTATTGTGTCAAAAAAAATTCTAGTTGGTT,TGCTCAACCTTTAAAAATGAAGGAAACTCAGGCTGGATTTTAATAAAACCAATTGCAGTGAGTTGGGACTTTCAAATTATTGTGTCAAAAAAAATTCTA,10,30,14,27,27,36,27,43,27,33,33,36,40,43,25.56,0.0
hek293t,9157,1,7,GTCCCAACCTTTAAAAATGAAGGAAACTCAGGTTAATAAAACCAATTGCAGTGAGTTGGGACTTTCAAATTATAAAAAAATTCTAGTTGGTTTAACGCG,GTCCCAACCTTTAAAAATGAAGGAAACTCAGGCTGGATTTTAATAAAACCAATTGCAGTGAGTTGGGACTTTCAAATTATAAAAAAATTCTAGTTGGTT,10,30,14,27,27,43,27,50,27,33,33,43,40,50,25.56,0.0145624
hek293t,9159,1,11,TTGTCAGCAGCAGAGTGTGTATTTAAGCTAGGCTAGCAGCCCAGCTTTACCACAGCAGCAAAACGAGCAAAAAAAAATTCTAGTTGGTTTAACGCGTAA,TTGTCAGCAGCAGAGTGTGTATTTAAGCTAGGCTAGCAGCAAAGCTCTAGCCCAGCTTTACCACAGCAGCAAAACGAGCAAAAAAAAATTCTAGTTGGT,10,30,14,27,27,42,27,53,27,39,39,42,50,53,33.44,0.0
hek293t,9163,1,9,AGCGTTGCATAAAATCCATTTTGAATATGTGGTACCTGCTCCACCTGCATTGCCTTTCATGGAGGACTTCTAAAAAAATTCTAGTTGGTTTAACGCGTA,AGCGTTGCATAAAATCCATTTTGAATATGTGGTACCTGCTCTTCGCTATCCACCTGCATTGCCTTTCATGGAGGACTTCTAAAAAAATTCTAGTTGGTT,10,30,14,27,27,43,27,52,27,40,40,43,49,52,9.85,0.0
hek293t,9163,1,9,TTCGTTGCATAAAATCCATTTTGAATATGTGGTACCTGCTCCACCTGCATTGCCTTTCATGGAGAAAAAAATTCTAGTTGGTTTAACGCGTAACTAGAT,TTCGTTGCATAAAATCCATTTTGAATATGTGGTACCTGCTCTTCGCTATCCACCTGCATTGCCTTTCATGGAGAAAAAAATTCTAGTTGGTTTAACGCG,10,30,14,27,27,50,27,59,27,40,40,50,49,59,9.85,0.048169557
hek293t,9165,1,4,CTCAGTGAAAAGTCTTGTGCAAAAATGACAGGTCAAACAGGGAAATGAAATAGATGTTGCTTTTGTCTGCCAATGTGAAATAAAAAAATTCTAGTTGGT,CTCAGTGAAAAGTCTTGTGCAAAAATGACACACGGGTCAAACAGGGAAATGAAATAGATGTTGCTTTTGTCTGCCAATGTGAAATAAAAAAATTCTAGT,10,30,14,27,27,38,27,42,27,31,31,38,35,42,40.64,0.223839044
hek293t,9165,1,4,ATTGCTGAAAAGTCTTGTGCAAAAATGACAGGTCAAACAGGGAAATGAAATAGATGTTGCTTTTGTCTGCCAATGTGAAATAGGTAAAAAAATTCTAGT,ATTGCTGAAAAGTCTTGTGCAAAAATGACACACGGGTCAAACAGGGAAATGAAATAGATGTTGCTTTTGTCTGCCAATGTGAAATAGGTAAAAAAATTC,10,30,14,27,27,34,27,38,27,31,31,34,35,38,40.64,0.0
hek293t,9167,1,8,AAGGCGCTACAGTGCAGTTTTTAATTCTGTGGCCAACAGCTTCTTAAATGCATGAAGAGAAGCTGGTTTTATAAAAAAATTCTAGTTGGTTTAACGCGT,AAGGCGCTACAGTGCAGTTTTTAATTCTGTGGCCAACAGGGCGTTAACTTCTTAAATGCATGAAGAGAAGCTGGTTTTATAAAAAAATTCTAGTTGGTT,10,30,14,27,27,43,27,51,27,40,40,43,48,51,9.41,0.742668856
hek293t,9167,1,8,ACGCAGCTACAGTGCAGTTTTTAATTCTGTGGCCAACAGCTTCTTAAATGCATGAAGAGAAGCTGGTTAAAAAAATTCTAGTTGGTTTAACGCGTAACT,ACGCAGCTACAGTGCAGTTTTTAATTCTGTGGCCAACAGGGCGTTAACTTCTTAAATGCATGAAGAGAAGCTGGTTAAAAAAATTCTAGTTGGTTTAAC,10,30,14,27,27,47,27,55,27,40,40,47,48,55,9.41,0.0
hek293t,9169,1,12,CCCGCCCCCCCCGAGTTATACCACAGACAAGGGACTGCAAAATAACAGACTGTGGCAATGCAGAATAAAAAAATTCTAGTTGGTTTAACGCGTAACTAG,CCCGCCCCCCCCGAGTTATACCACAGACAAGGGACTGGATACGTAATTCCAAAATAACAGACTGTGGCAATGCAGAATAAAAAAATTCTAGTTGGTTTA,10,30,14,27,27,45,27,57,27,38,38,45,50,57,56.94,0.0
hek293t,9170,1,4,AAGGGTTTGCCCAGGCTCATGTTCCAGGCAGGTCCATTTTGTGTCTGAAGGAACGTGCTTTATAAGACTGTAACCTAAAAAAAATTCTAGTTGGTTTAA,AAGGGTTTGCCCAGGCTCATGTTCCAGGCAGAACCGTCCATTTTGTGTCTGAAGGAACGTGCTTTATAAGACTGTAACCTAAAAAAAATTCTAGTTGGT,10,30,14,27,27,42,27,46,27,32,32,42,36,46,36.37,68.04950752
hek293t,9170,1,4,TTTCCTTTGCCCAGGCTCATGTTCCAGGCAGGTCCATTTTGTGTCTGAAGGAACGTGCTTTATAAGACTGTAACCTATCTAAAAAAATTCTAGTTGGTT,TTTCCTTTGCCCAGGCTCATGTTCCAGGCAGAACCGTCCATTTTGTGTCTGAAGGAACGTGCTTTATAAGACTGTAACCTATCTAAAAAAATTCTAGTT,10,30,14,27,27,39,27,43,27,32,32,39,36,43,36.37,75.37195182
hek293t,9172,1,13,ATAATCAATACTGGCAAGCATCTACACTTTGGATAAAATGTACTCGCACTGTTCATCCTCTAACAAAAAAATTCTAGTTGGTTTAACGCGTAACTAGAT,ATAATCAATACTGGCAAGCATCTACACTTTAGTACTAGACACCGGATAAAATGTACTCGCACTGTTCATCCTCTAACAAAAAAATTCTAGTTGGTTTAA,10,30,14,27,27,46,27,59,27,31,31,46,44,59,50.22,4.895260366
hek293t,9175,1,6,GCCGTTGTCTTTAATAACTGATGGAATTGTGGGGTTTGTGTTTGTTTTTGATGACTGTCAGCTCCTACCACTATTCTCTTAGAAAAAAAATTCTAGTTG,GCCGTTGTCTTTAATAACTGATGGAATTGTTAATGCGGGGTTTGTGTTTGTTTTTGATGACTGTCAGCTCCTACCACTATTCTCTTAGAAAAAAAATTC,10,30,14,27,27,34,27,40,27,31,31,34,37,40,17.59,0.0
hek293t,9177,1,9,TTCCTTAACAGAATATGTGAACCCACCGTAGGAATATACAAAGACTGTGCTTGCATGTACTTACCAAGGGCTCAAAGAAAAAAATTCTAGTTGGTTTAA,TTCCTTAACAGAATATGTGAACCCACCGTAGCCCACTCAGGAATATACAAAGACTGTGCTTGCATGTACTTACCAAGGGCTCAAAGAAAAAAATTCTAG,10,30,14,27,27,37,27,46,27,30,30,37,39,46,60.41,3.983913057
hek293t,9177,1,9,CCCCTTAACAGAATATGTGAACCCACCGTAGGAATATACAAAGACTGTGCTTGCATGTACTTACCAAGGGCTCAAAGAATAAAAAAAATTCTAGTTGGT,CCCCTTAACAGAATATGTGAACCCACCGTAGCCCACTCAGGAATATACAAAGACTGTGCTTGCATGTACTTACCAAGGGCTCAAAGAATAAAAAAAATT,10,30,14,27,27,33,27,42,27,30,30,33,39,42,60.41,1.285226964
hek293t,9179,1,8,TTATAAGCACGGAGCTGGTACAGTAGAGATGGTGTTTTCTACGTTGCCGACCTCACACCCGCATCTTTTCAATGTAAAAAAATTCTAGTTGGTTTAACG,TTATAAGCACGGAGCTGGTACAGTAGAGATGGAGTCCCATTGTTTTCTACGTTGCCGACCTCACACCCGCATCTTTTCAATGTAAAAAAATTCTAGTTG,10,30,14,27,27,40,27,48,27,33,33,40,41,48,57.08,0.376647834
hek293t,9179,1,8,GACATAGCACGGAGCTGGTACAGTAGAGATGGTGTTTTCTACGTTGCCGACCTCACACCCGCATCTTAAAAAAATTCTAGTTGGTTTAACGCGTAACTA,GACATAGCACGGAGCTGGTACAGTAGAGATGGAGTCCCATTGTTTTCTACGTTGCCGACCTCACACCCGCATCTTAAAAAAATTCTAGTTGGTTTAACG,10,30,14,27,27,48,27,56,27,33,33,48,41,56,57.08,5.231519434
hek293t,3743,1,10,CTCGTCAGAATATACAATAGTGCCACTGTTGGTAAACAACTAAAAATAATTCAGACATTTAGTCCAAAAAAATTCTAGTTGGTTTAACGCGTAACTAGA,CTCGTCAGAATATACAATAGTGCCACTGTTGGTGTCGATGACTAAACAACTAAAAATAATTCAGACATTTAGTCCAAAAAAATTCTAGTTGGTTTAACG,10,30,14,27,27,48,27,58,27,33,33,48,43,58,61.1,0.425010841
hek293t,3743,1,10,CTAATCAGAATATACAATAGTGCCACTGTTGGTAAACAACTAAAAATAATTCAGACATTTAGTCCTCTCAACAGAATAAAAAAATTCTAGTTGGTTTAA,CTAATCAGAATATACAATAGTGCCACTGTTGGTGTCGATGACTAAACAACTAAAAATAATTCAGACATTTAGTCCTCTCAACAGAATAAAAAAATTCTA,10,30,14,27,27,36,27,46,27,33,33,36,43,46,61.1,25.24697138
hek293t,9183,1,6,CGGTTAAATCAAAACCGATTGTGTATACAAGGATGTATTTGTGTCTGATATCCATTGCAATTTGGCCCATTTAATTTAAAAAAATTCTAGTTGGTTTAA,CGGTTAAATCAAAACCGATTGTGTATACAGGACACAGGATGTATTTGTGTCTGATATCCATTGCAATTTGGCCCATTTAATTTAAAAAAATTCTAGTTG,10,30,14,27,27,40,27,46,27,30,30,40,36,46,19.11,13.55615478
hek293t,9183,1,6,AAGAAAAATCAAAACCGATTGTGTATACAAGGATGTATTTGTGTCTGATATCCATTGCAATTTGGCCCATTTAAAAAAATTCTAGTTGGTTTAACGCGT,AAGAAAAATCAAAACCGATTGTGTATACAGGACACAGGATGTATTTGTGTCTGATATCCATTGCAATTTGGCCCATTTAAAAAAATTCTAGTTGGTTTA,10,30,14,27,27,45,27,51,27,30,30,45,36,51,19.11,11.8636299
hek293t,9185,1,4,GGTTATTCACAAAACACACAGATATTCTAAGGGTCCTTCCCCATAGCTGAAGACTAGATTGTTTTATTTGTTTGAAAAAAAATTCTAGTTGGTTTAACG,GGTTATTCACAAAACACACAGATATTCTGACGAAGGGTCCTTCCCCATAGCTGAAGACTAGATTGTTTTATTTGTTTGAAAAAAAATTCTAGTTGGTTT,10,30,14,27,27,44,27,48,27,29,29,44,33,48,12.03,24.02653044
hek293t,9187,1,11,AAAGGGAAATATTCTTCCAGGGGGAATTCTGGCACTTTCACTACTCTAAGTTCATTATTATTTAGTGTTGTATCACAAAAAAAATTCTAGTTGGTTTAA,AAAGGGAAATATTCTTCCAGGGGGAATTTAAAGCGGTATCTGGCACTTTCACTACTCTAAGTTCATTATTATTTAGTGTTGTATCACAAAAAAAATTCT,10,30,14,27,27,35,27,46,27,28,28,35,39,46,9.74,0.411522634
hek293t,9187,1,11,TGGCGGAAATATTCTTCCAGGGGGAATTCTGGCACTTTCACTACTCTAAGTTCATTATTATTTAGTGTTAAAAAAATTCTAGTTGGTTTAACGCGTAAC,TGGCGGAAATATTCTTCCAGGGGGAATTTAAAGCGGTATCTGGCACTTTCACTACTCTAAGTTCATTATTATTTAGTGTTAAAAAAATTCTAGTTGGTT,10,30,14,27,27,43,27,54,27,28,28,43,39,54,9.74,31.58836416
hek293t,9189,1,1,GAGAAAGAAATCAATTAATTTAATGTCTGTGGACATTAATGTAATTGTAATTAATGATGGCTTTAATTTAACTGTTTAGATGTGACAATATAAAAAAAT,GAGAAAGAAATCAATTAATTTAATGTCCTGTGGACATTAATGTAATTGTAATTAATGATGGCTTTAATTTAACTGTTTAGATGTGACAATATAAAAAAA,10,30,14,27,27,31,27,32,27,28,28,31,29,32,11.95,0.0
hek293t,9189,1,1,ATCCTAGAAATCAATTAATTTAATGTCTGTGGACATTAATGTAATTGTAATTAATGATGGCTTTAATTTAACTGTTTAGAAAAAAATTCTAGTTGGTTT,ATCCTAGAAATCAATTAATTTAATGTCCTGTGGACATTAATGTAATTGTAATTAATGATGGCTTTAATTTAACTGTTTAGAAAAAAATTCTAGTTGGTT,10,30,14,27,27,43,27,44,27,28,28,43,29,44,11.95,0.0
hek293t,9191,1,4,CTAGGACATGAGATATTTTTCTGAGGGTTTGGCTTTGGATACTGATCTCAGCAATATTTGGGAAACTGTTGAGAAAGAAAAAAATTCTAGTTGGTTTAA,CTAGGACATGAGATATTTTTCTGAGGGTTTGGCTTACGTTGGATACTGATCTCAGCAATATTTGGGAAACTGTTGAGAAAGAAAAAAATTCTAGTTGGT,10,30,14,27,27,42,27,46,27,35,35,42,39,46,9.23,44.45962827
hek293t,9193,1,3,TGGGCATATTGAGAAGCCTACTTTCTTAAAGGTTTTTAAGTAAGCAGAGGCAAAAGTGTATATCAGAGAACAGATTTTGTGAAAAAAATTCTAGTTGGT,TGGGCATATTGAGAAGCCTACTTTCTTAAAGCAAGTTTTTAAGTAAGCAGAGGCAAAAGTGTATATCAGAGAACAGATTTTGTGAAAAAAATTCTAGTT,10,30,14,27,27,39,27,42,27,32,32,39,35,42,10.07,62.72665621
hek293t,9193,1,3,GCTTGATATTGAGAAGCCTACTTTCTTAAAGGTTTTTAAGTAAGCAGAGGCAAAAGTGTATATCAGAGAACAGATTTTGTGTACAAAAAAAATTCTAGT,GCTTGATATTGAGAAGCCTACTTTCTTAAAGCAAGTTTTTAAGTAAGCAGAGGCAAAAGTGTATATCAGAGAACAGATTTTGTGTACAAAAAAAATTCT,10,30,14,27,27,35,27,38,27,32,32,35,35,38,10.07,0.0
hek293t,2709,1,11,GGCCAGCCAATACTGAAATTGTATAACGGAGGCATTAGTCCTCATTAATATGGCTTGTTTCTCCTAAAAAAAAAATTCTAGTTGGTTTAACGCGTAACT,GGCCAGCCAATACTGAAATTGTATAACGGAGGCGGTAGATCACTATTAGTCCTCATTAATATGGCTTGTTTCTCCTAAAAAAAAAATTCTAGTTGGTTT,10,30,14,27,27,44,27,55,27,34,34,44,45,55,72.52,1.387685501
hek293t,2709,1,11,TTCTAGCCAATACTGAAATTGTATAACGGAGGCATTAGTCCTCATTAATATGGCTTGTTTCTCCTAAAGTAACTGAAAAAAATTCTAGTTGGTTTAACG,TTCTAGCCAATACTGAAATTGTATAACGGAGGCGGTAGATCACTATTAGTCCTCATTAATATGGCTTGTTTCTCCTAAAGTAACTGAAAAAAATTCTAG,10,30,14,27,27,37,27,48,27,34,34,37,45,48,72.52,0.543109301
hek293t,9197,1,1,GTAACTTCACTAGTCACACTTTTTCCTTGAGGAAGACAACTTTATTGTTTGGTCAGGAATTACTCATTCAGTATCCCCCCAAAAAAATTCTAGTTGGTT,GTAACTTCACTAGTCACACTTTTTCCATTGAGGAAGACAACTTTATTGTTTGGTCAGGAATTACTCATTCAGTATCCCCCCAAAAAAATTCTAGTTGGT,10,30,14,27,27,42,27,43,27,27,27,42,28,43,14.44,35.91853314
hek293t,9199,1,15,TTGTGAAATCTACTCCTCTCCCTGAAATGAGGATAACTGCCACTAGTAACATCAAACTGATGATAAGCAAATAGGAAAAAAATTCTAGTTGGTTTAACG,TTGTGAAATCTACTCCTCTCCCTGAAATGGCTTAAGACTTATCTAGGATAACTGCCACTAGTAACATCAAACTGATGATAAGCAAATAGGAAAAAAATT,10,30,14,27,27,33,27,48,27,30,30,33,45,48,67.69,0.0
hek293t,9199,1,15,ATTACAAATCTACTCCTCTCCCTGAAATGAGGATAACTGCCACTAGTAACATCAAACTGATGATAAGCAAAAAAAAAATTCTAGTTGGTTTAACGCGTA,ATTACAAATCTACTCCTCTCCCTGAAATGGCTTAAGACTTATCTAGGATAACTGCCACTAGTAACATCAAACTGATGATAAGCAAAAAAAAAATTCTAG,10,30,14,27,27,37,27,52,27,30,30,37,45,52,67.69,0.0
hek293t,9203,1,2,TCGGCCCCAGCCACTGAGGGGACATGGAAAGGCTGCTGTACTGCACGGACAAGCCACTTTGTACTGATTTCTGGCAAAAAAAAAATTCTAGTTGGTTTA,TCGGCCCCAGCCACTGAGGGGACATGGAAAGGCTGCTGTTTACTGCACGGACAAGCCACTTTGTACTGATTTCTGGCAAAAAAAAAATTCTAGTTGGTT,10,30,14,27,27,43,27,45,27,40,40,43,42,45,52.0,43.91641812
hek293t,9203,1,2,CTGGACCCAGCCACTGAGGGGACATGGAAAGGCTGCTGTACTGCACGGACAAGCCACTTTGTACTGATTTCAAAAAAATTCTAGTTGGTTTAACGCGTA,CTGGACCCAGCCACTGAGGGGACATGGAAAGGCTGCTGTTTACTGCACGGACAAGCCACTTTGTACTGATTTCAAAAAAATTCTAGTTGGTTTAACGCG,10,30,14,27,27,50,27,52,27,40,40,50,42,52,52.0,61.57604926
hek293t,9205,1,14,TCTAACGTTTTGTTACAAGTACGACAGAAAGGACCTGTGGATTCATTTCAGCTTGAGTTATAGCTAAAAAAAATTCTAGTTGGTTTAACGCGTAACTAG,TCTAACGTTTTGTTACAAGTACGACAGAAAGGACCGGTAGGTATGCCGATGTGGATTCATTTCAGCTTGAGTTATAGCTAAAAAAAATTCTAGTTGGTT,10,30,14,27,27,43,27,57,27,36,36,43,50,57,33.41,0.129032258
hek293t,9205,1,14,TCCTACGTTTTGTTACAAGTACGACAGAAAGGACCTGTGGATTCATTTCAGCTTGAGTTATAGCTACACGAAAAAAATTCTAGTTGGTTTAACGCGTAA,TCCTACGTTTTGTTACAAGTACGACAGAAAGGACCGGTAGGTATGCCGATGTGGATTCATTTCAGCTTGAGTTATAGCTACACGAAAAAAATTCTAGTT,10,30,14,27,27,39,27,53,27,36,36,39,50,53,33.41,0.0
hek293t,9209,1,8,GTCGGCAGAAGCGCAGAGAGGGTGCTTTTTGGCTACATGCTTTGCAGATGTGAACATAAATCTCCTTTAACAAAAAAAATTCTAGTTGGTTTAACGCGT,GTCGGCAGAAGCGCAGAGAGGGTGCTTTTTGGACAAAGTACTACATGCTTTGCAGATGTGAACATAAATCTCCTTTAACAAAAAAAATTCTAGTTGGTT,10,30,14,27,27,43,27,51,27,33,33,43,41,51,8.05,2.476618935
hek293t,9211,1,11,GTATGTGTGCAAGTGCTCAAAAAGCAGAATGGTAAGTGCTCTGGGAAGTGTCAAACCACCAGGAAAAAAAATTCTAGTTGGTTTAACGCGTAACTAGAT,GTATGTGTGCAAGTGCTCAAAAAGCAGAATGGGACGACGGAACTAAGTGCTCTGGGAAGTGTCAAACCACCAGGAAAAAAAATTCTAGTTGGTTTAACG,10,30,14,27,27,48,27,59,27,33,33,48,44,59,36.09,0.264291575
hek293t,9211,1,11,TTTTCTGTGCAAGTGCTCAAAAAGCAGAATGGTAAGTGCTCTGGGAAGTGTCAAACCACCAGGAGGGTTTTTAAAAAAATTCTAGTTGGTTTAACGCGT,TTTTCTGTGCAAGTGCTCAAAAAGCAGAATGGGACGACGGAACTAAGTGCTCTGGGAAGTGTCAAACCACCAGGAGGGTTTTTAAAAAAATTCTAGTTG,10,30,14,27,27,40,27,51,27,33,33,40,44,51,36.09,0.0
hek293t,9213,1,3,CTGTCGCGTGAACTCCGTATGTGGTTGGTTGGTATCGCATGTAAAGCTTAGCCAGAGCACGCTTGGTTAGGTCCAACACAAAAAAATTCTAGTTGGTTT,CTGTCGCGTGAACTCCGTATGTGGTTGGTTGGTATCGTCCCATGTAAAGCTTAGCCAGAGCACGCTTGGTTAGGTCCAACACAAAAAAATTCTAGTTGG,10,30,14,27,27,41,27,44,27,38,38,41,41,44,57.76,7.427216287
hek293t,9213,1,3,TGATGGCGTGAACTCCGTATGTGGTTGGTTGGTATCGCATGTAAAGCTTAGCCAGAGCACGCTTGGTAAAAAAATTCTAGTTGGTTTAACGCGTAACTA,TGATGGCGTGAACTCCGTATGTGGTTGGTTGGTATCGTCCCATGTAAAGCTTAGCCAGAGCACGCTTGGTAAAAAAATTCTAGTTGGTTTAACGCGTAA,10,30,14,27,27,53,27,56,27,38,38,53,41,56,57.76,76.48076366
hek293t,9215,1,10,ACACTAGCTTCATGTTCCCTTTAAAAGAAAGGGAATTAACAATCTTAGCAATGCATGATCATCTGACTCCCCTATAAAAAAATTCTAGTTGGTTTAACG,ACACTAGCTTCATGTTCCCTTTAAAAGTTCGCAGGCAAAAGGGAATTAACAATCTTAGCAATGCATGATCATCTGACTCCCCTATAAAAAAATTCTAGT,10,30,14,27,27,38,27,48,27,28,28,38,38,48,16.54,0.0
hek293t,9215,1,10,GGAGGAGCTTCATGTTCCCTTTAAAAGAAAGGGAATTAACAATCTTAGCAATGCATGATCATCTGACTCCAAAAAAATTCTAGTTGGTTTAACGCGTAA,GGAGGAGCTTCATGTTCCCTTTAAAAGTTCGCAGGCAAAAGGGAATTAACAATCTTAGCAATGCATGATCATCTGACTCCAAAAAAATTCTAGTTGGTT,10,30,14,27,27,43,27,53,27,28,28,43,38,53,16.54,0.0
hek293t,20128,1,1,GTCTTATATTGAAGAAAATCTGAAATGCCTGGATCTACTTCAAACTCTGAGCCAAACTGAGATCCTAAAAAAGGATTGGAAAAAAAATTCTAGTTGGTT,GTCTTATATTGAAGAAAATCTGAAATGCCTGGATCTACGTTCAAACTCTGAGCCAAACTGAGATCCTAAAAAAGGATTGGAAAAAAAATTCTAGTTGGT,10,30,14,27,27,42,27,43,27,39,39,42,40,43,33.17,0.0
hek293t,20128,1,1,GCTGAATATTGAAGAAAATCTGAAATGCCTGGATCTACTTCAAACTCTGAGCCAAACTGAGATCCTAAAAAAGAAAAAAATTCTAGTTGGTTTAACGCG,GCTGAATATTGAAGAAAATCTGAAATGCCTGGATCTACGTTCAAACTCTGAGCCAAACTGAGATCCTAAAAAAGAAAAAAATTCTAGTTGGTTTAACGC,10,30,14,27,27,49,27,50,27,39,39,49,40,50,33.17,2.092046556
hek293t,12449,1,10,AACGATGCTAAGCCGCACCAGGGTGACTGCGGCCGGGGAAGCGGCCAGGGTGGGCAGCAGGGACGAGGGAGGCGAGAAAAAAATTCTAGTTGGTTTAAC,AACGATGCTAAGCCGCACCAGGGTGACTGCGGCCAACGTGCCCCGGGGAAGCGGCCAGGGTGGGCAGCAGGGACGAGGGAGGCGAGAAAAAAATTCTAG,10,30,14,27,27,37,27,47,27,34,34,37,44,47,72.59,0.913242009
hek293t,9223,1,10,AGTGTTGAAACTGAGATAACAAAAGAAGTTGGTTCAAATATATAATTCAAATGATCAGTATAATCAGGAAAAAAAATTCTAGTTGGTTTAACGCGTAAC,AGTGTTGAAACTGAGATAACAAAAGAAGCATCACCATTTTGGTTCAAATATATAATTCAAATGATCAGTATAATCAGGAAAAAAAATTCTAGTTGGTTT,10,30,14,27,27,44,27,54,27,29,29,44,39,54,51.23,0.048221788
hek293t,9223,1,10,TTGAGTGAAACTGAGATAACAAAAGAAGTTGGTTCAAATATATAATTCAAATGATCAGTATAATCAGGACAAATAAAAAAATTCTAGTTGGTTTAACGC,TTGAGTGAAACTGAGATAACAAAAGAAGCATCACCATTTTGGTTCAAATATATAATTCAAATGATCAGTATAATCAGGACAAATAAAAAAATTCTAGTT,10,30,14,27,27,39,27,49,27,29,29,39,39,49,51.23,0.053373007
hek293t,9225,1,9,GATATAGATCAGTTAATTCCAGATCCTTTTGGTTTTTATAGAAAACTGGCAAATGAAGTAAATATAAAACAAAAAAATTCTAGTTGGTTTAACGCGTAA,GATATAGATCAGTTAATTCCAGATCCTTTCGCACAATTTGGTTTTTATAGAAAACTGGCAAATGAAGTAAATATAAAACAAAAAAATTCTAGTTGGTTT,10,30,14,27,27,44,27,53,27,29,29,44,38,53,9.17,3.097644843
hek293t,9227,1,7,CATTCTCCCCGGTGGTCCCATGAAATATCAGGGAGTTTGAGATATACAGTGAATGCAGAACTGAATAAAAAAATTCTAGTTGGTTTAACGCGTAACTAG,CATTCTCCCCGGTGGTCCCATGAAATATCAGGGACTAATAAGTTTGAGATATACAGTGAATGCAGAACTGAATAAAAAAATTCTAGTTGGTTTAACGCG,10,30,14,27,27,50,27,57,27,35,35,50,42,57,17.12,1.197782109
hek293t,9227,1,7,CCTTCTCCCCGGTGGTCCCATGAAATATCAGGGAGTTTGAGATATACAGTGAATGCAGAACTGAATCACAAAAAAAAATTCTAGTTGGTTTAACGCGTA,CCTTCTCCCCGGTGGTCCCATGAAATATCAGGGACTAATAAGTTTGAGATATACAGTGAATGCAGAACTGAATCACAAAAAAAAATTCTAGTTGGTTTA,10,30,14,27,27,45,27,52,27,35,35,45,42,52,17.12,0.637604119
hek293t,9229,1,4,CCAAAGCAGTGCAGTCAGAAGTGAGACAAAGGAAAAATGTAAAACGCAATAAAAAATCAGCTACTGAGAAGAAAAAAATTCTAGTTGGTTTAACGCGTA,CCAAAGCAGTGCAGTCAGAAGTGAGACAAAGGAAAAACTTTTGTAAAACGCAATAAAAAATCAGCTACTGAGAAGAAAAAAATTCTAGTTGGTTTAACG,10,30,14,27,27,48,27,52,27,38,38,48,42,52,51.01,1.639472214
hek293t,9229,1,4,ACAACGCAGTGCAGTCAGAAGTGAGACAAAGGAAAAATGTAAAACGCAATAAAAAATCAGCTACTGAGAAGTTATCTGAAAAAAATTCTAGTTGGTTTA,ACAACGCAGTGCAGTCAGAAGTGAGACAAAGGAAAAACTTTTGTAAAACGCAATAAAAAATCAGCTACTGAGAAGTTATCTGAAAAAAATTCTAGTTGG,10,30,14,27,27,41,27,45,27,38,38,41,42,45,51.01,0.0
hek293t,9231,1,12,GTCATTGGTCAAACACATTACTAGGCTCAAGGGTAAAGTGGTGAAAATGGATGAAGATTTCCATGTTTGTCAAAAAAATTCTAGTTGGTTTAACGCGTA,GTCATTGGTCAAACACATTACTAGGCTCAGCGGGGAAGGCAAGGGTAAAGTGGTGAAAATGGATGAAGATTTCCATGTTTGTCAAAAAAATTCTAGTTG,10,30,14,27,27,40,27,52,27,30,30,40,42,52,41.09,2.833536166
hek293t,9231,1,12,AGGCGTGGTCAAACACATTACTAGGCTCAAGGGTAAAGTGGTGAAAATGGATGAAGATTTCCATGTAAAAAAATTCTAGTTGGTTTAACGCGTAACTAG,AGGCGTGGTCAAACACATTACTAGGCTCAGCGGGGAAGGCAAGGGTAAAGTGGTGAAAATGGATGAAGATTTCCATGTAAAAAAATTCTAGTTGGTTTA,10,30,14,27,27,45,27,57,27,30,30,45,42,57,41.09,2.726546712
hek293t,9233,1,11,AATTTAACAATCCCATCCACAGCAATCAGGGGATTTCTTGTTATATATCTCTGACCAGTAAATCCAGCTTGAGGTAGTAGAAAAAAATTCTAGTTGGTT,AATTTAACAATCCCATCCACAGCAATCATAGAGGAGGAAGGGGATTTCTTGTTATATATCTCTGACCAGTAAATCCAGCTTGAGGTAGTAGAAAAAAAT,10,30,14,27,27,32,27,43,27,29,29,32,40,43,70.4,0.641461528
hek293t,9233,1,11,CGCCTAACAATCCCATCCACAGCAATCAGGGGATTTCTTGTTATATATCTCTGACCAGTAAATCCAGCTTGAGAAAAAAATTCTAGTTGGTTTAACGCG,CGCCTAACAATCCCATCCACAGCAATCATAGAGGAGGAAGGGGATTTCTTGTTATATATCTCTGACCAGTAAATCCAGCTTGAGAAAAAAATTCTAGTT,10,30,14,27,27,39,27,50,27,29,29,39,40,50,70.4,62.82271928
hek293t,9235,1,7,TTTGAAATAATTAGAAACCCTAAATATCAAGGAGATAAGCAGTCCAAGATTTTCACTAACAAGCAAAAAAAATTCTAGTTGGTTTAACGCGTAACTAGA,TTTGAAATAATTAGAAACCCTAAATATCAAGGAGAGTAAGCGTAAGCAGTCCAAGATTTTCACTAACAAGCAAAAAAAATTCTAGTTGGTTTAACGCGT,10,30,14,27,27,51,27,58,27,36,36,51,43,58,26.01,2.083278221
hek293t,9235,1,7,ACTGTAATAATTAGAAACCCTAAATATCAAGGAGATAAGCAGTCCAAGATTTTCACTAACAAGCAGCAATAAAAAAATTCTAGTTGGTTTAACGCGTAA,ACTGTAATAATTAGAAACCCTAAATATCAAGGAGAGTAAGCGTAAGCAGTCCAAGATTTTCACTAACAAGCAGCAATAAAAAAATTCTAGTTGGTTTAA,10,30,14,27,27,46,27,53,27,36,36,46,43,53,26.01,6.158501337
hek293t,9237,1,2,TATCGACTAATGATTCCTAAGACATACAATGGTTCTAAGGAAAATTAAAGCACCCAAAGCAAAACTAACTCCTGACCCCCCAAAAAAATTCTAGTTGGT,TATCGACTAATGATTCCTAAGACATACAATGGTTCTGGAAGGAAAATTAAAGCACCCAAAGCAAAACTAACTCCTGACCCCCCAAAAAAATTCTAGTTG,10,30,14,27,27,40,27,42,27,37,37,40,39,42,56.14,0.0
hek293t,9237,1,2,TAGCCACTAATGATTCCTAAGACATACAATGGTTCTAAGGAAAATTAAAGCACCCAAAGCAAAACTAACTCCTGACCAAAAAAATTCTAGTTGGTTTAA,TAGCCACTAATGATTCCTAAGACATACAATGGTTCTGGAAGGAAAATTAAAGCACCCAAAGCAAAACTAACTCCTGACCAAAAAAATTCTAGTTGGTTT,10,30,14,27,27,44,27,46,27,37,37,44,39,46,56.14,19.76151086
hek293t,9239,1,15,AGAAAATGTCCTGGAATATTTCAGAGCTGAGGGCGGTTTTGGCAATGCCCTGTTACTACAAGAGAGTCAAAAAAAAATTCTAGTTGGTTTAACGCGTAA,AGAAAATGTCCTGGAATATTTCAGAGCTGAACGACGGTGGTCCTCGGGCGGTTTTGGCAATGCCCTGTTACTACAAGAGAGTCAAAAAAAAATTCTAGT,10,30,14,27,27,38,27,53,27,31,31,38,46,53,43.43,0.069968114
hek293t,9239,1,15,GCGTAATGTCCTGGAATATTTCAGAGCTGAGGGCGGTTTTGGCAATGCCCTGTTACTACAAGAGAGTCAAAACGAAAAAAATTCTAGTTGGTTTAACGC,GCGTAATGTCCTGGAATATTTCAGAGCTGAACGACGGTGGTCCTCGGGCGGTTTTGGCAATGCCCTGTTACTACAAGAGAGTCAAAACGAAAAAAATTC,10,30,14,27,27,34,27,49,27,31,31,34,46,49,43.43,0.524020574
hek293t,9243,1,9,GGCCAGCTTGTATTAAATCAAGTGTAGCAAGGAAGGTGTTCCAAATAATATAACTTTGTAATAGCAACGAAAAAAATTCTAGTTGGTTTAACGCGTAAC,GGCCAGCTTGTATTAAATCAAGTGTAGCAGGAGTACGTAGGAAGGTGTTCCAAATAATATAACTTTGTAATAGCAACGAAAAAAATTCTAGTTGGTTTA,10,30,14,27,27,45,27,54,27,30,30,45,39,54,57.66,2.490536224
hek293t,9243,1,9,TACTGGCTTGTATTAAATCAAGTGTAGCAAGGAAGGTGTTCCAAATAATATAACTTTGTAATAGCAACGTTGGGGTCAAAAAAATTCTAGTTGGTTTAA,TACTGGCTTGTATTAAATCAAGTGTAGCAGGAGTACGTAGGAAGGTGTTCCAAATAATATAACTTTGTAATAGCAACGTTGGGGTCAAAAAAATTCTAG,10,30,14,27,27,37,27,46,27,30,30,37,39,46,57.66,0.166720005
hek293t,9247,1,4,TTCCGGATCTCCTGTCCTCTGTTCTGGAAAGGGTACATTTTCCTCATGAGTTTTGAGATCTCAAAATGGCAAAAAAATTCTAGTTGGTTTAACGCGTAA,TTCCGGATCTCCTGTCCTCTGTTCTGGAAAGGGTACATACCTTTTCCTCATGAGTTTTGAGATCTCAAAATGGCAAAAAAATTCTAGTTGGTTTAACGC,10,30,14,27,27,49,27,53,27,39,39,49,43,53,21.42,4.688884345
hek293t,9247,1,4,CCTCAGATCTCCTGTCCTCTGTTCTGGAAAGGGTACATTTTCCTCATGAGTTTTGAGATCTCAAAATGGCAATAAAAAAATTCTAGTTGGTTTAACGCG,CCTCAGATCTCCTGTCCTCTGTTCTGGAAAGGGTACATACCTTTTCCTCATGAGTTTTGAGATCTCAAAATGGCAATAAAAAAATTCTAGTTGGTTTAA,10,30,14,27,27,46,27,50,27,39,39,46,43,50,21.42,2.438075729
hek293t,9249,1,10,GGGATCTAAACACTACATGTCCTATTAAGAGGTATGTTATGTGAGAAAATACCCCCCCCCCAGATCTGTCATCTGTGGAAAAAAATTCTAGTTGGTTTA,GGGATCTAAACACTACATGTCCTATTAAGAGAGTCCGACTCGTATGTTATGTGAGAAAATACCCCCCCCCCAGATCTGTCATCTGTGGAAAAAAATTCT,10,30,14,27,27,35,27,45,27,32,32,35,42,45,60.26,7.805821962
hek293t,9253,1,4,ACTCCAGATCAACCACAGTACTCCAGCTCAGGTGTTCCTGGTGCTGTCTGAAACACCTGATACCTGTTGTTCATAAAAAAATTCTAGTTGGTTTAACGC,ACTCCAGATCAACCACAGTACTCCAGCTCAGGTGTTCACAACTGGTGCTGTCTGAAACACCTGATACCTGTTGTTCATAAAAAAATTCTAGTTGGTTTA,10,30,14,27,27,45,27,49,27,38,38,45,42,49,53.96,65.85874506
hek293t,9253,1,4,TCCGAAGATCAACCACAGTACTCCAGCTCAGGTGTTCCTGGTGCTGTCTGAAACACCTGATACCTGTTGTTCATGGAAAAAAAAATTCTAGTTGGTTTA,TCCGAAGATCAACCACAGTACTCCAGCTCAGGTGTTCACAACTGGTGCTGTCTGAAACACCTGATACCTGTTGTTCATGGAAAAAAAAATTCTAGTTGG,10,30,14,27,27,41,27,45,27,38,38,41,42,45,53.96,0.111111111
hek293t,9255,1,8,GCGTTAGAGCCTGCTGCCACCAGGGAGGATGGCAGGTATTGGCACGCGGCCTGAAGCTCGTGCCTGGCAAAAAAAAATTCTAGTTGGTTTAACGCGTAA,GCGTTAGAGCCTGCTGCCACCAGGGAGGATGGCAGGTCGGTATGTATTGGCACGCGGCCTGAAGCTCGTGCCTGGCAAAAAAAAATTCTAGTTGGTTTA,10,30,14,27,27,45,27,53,27,38,38,45,46,53,47.94,0.506728309
hek293t,9255,1,8,GCAAGAGAGCCTGCTGCCACCAGGGAGGATGGCAGGTATTGGCACGCGGCCTGAAGCTCGTGCCTGGCAAATCCAAAAAAATTCTAGTTGGTTTAACGC,GCAAGAGAGCCTGCTGCCACCAGGGAGGATGGCAGGTCGGTATGTATTGGCACGCGGCCTGAAGCTCGTGCCTGGCAAATCCAAAAAAATTCTAGTTGG,10,30,14,27,27,41,27,49,27,38,38,41,46,49,47.94,0.0
hek293t,9257,1,9,TCCCGTGTTCTCCATGAGGTAACTCACCTTGGTGAGAAGCTAACGCATATGAACAGAGTCCAATCTCCAACCGTCTAAAAAAATTCTAGTTGGTTTAAC,TCCCGTGTTCTCCATGAGGTAACTCACCTTGTCCTTTCGGGTGAGAAGCTAACGCATATGAACAGAGTCCAATCTCCAACCGTCTAAAAAAATTCTAGT,10,30,14,27,27,38,27,47,27,31,31,38,40,47,48.94,0.076982294
hek293t,9257,1,9,TTATATGTTCTCCATGAGGTAACTCACCTTGGTGAGAAGCTAACGCATATGAACAGAGTCCAATCTCCAACCGAAAAAAATTCTAGTTGGTTTAACGCG,TTATATGTTCTCCATGAGGTAACTCACCTTGTCCTTTCGGGTGAGAAGCTAACGCATATGAACAGAGTCCAATCTCCAACCGAAAAAAATTCTAGTTGG,10,30,14,27,27,41,27,50,27,31,31,41,40,50,48.94,1.923486861
hek293t,9259,1,7,ATTCCAGAAAGCAAAGAATTTGCTCTTATTGGTGAATTCATGCCCCTCAAATTTCTCCTAATGCCATTGAATGTTGTATGTTTAAAAAAATTCTAGTTG,ATTCCAGAAAGCAAAGAATTTGCTCTTATTAACCCGTGGTGAATTCATGCCCCTCAAATTTCTCCTAATGCCATTGAATGTTGTATGTTTAAAAAAATT,10,30,14,27,27,33,27,40,27,30,30,33,37,40,6.17,0.0
hek293t,9259,1,7,ACAGGAGAAAGCAAAGAATTTGCTCTTATTGGTGAATTCATGCCCCTCAAATTTCTCCTAATGCCATTGAAAAAAAAATTCTAGTTGGTTTAACGCGTA,ACAGGAGAAAGCAAAGAATTTGCTCTTATTAACCCGTGGTGAATTCATGCCCCTCAAATTTCTCCTAATGCCATTGAAAAAAAAATTCTAGTTGGTTTA,10,30,14,27,27,45,27,52,27,30,30,45,37,52,6.17,13.355686
hek293t,9261,1,6,TTCGTGAAATAGGTGGCAGCGTTGATCTAAGGCAAGAAGCATAAATGATGGAGCCTGTATGAAATGAAAAAGAAAAAAAATTCTAGTTGGTTTAACGCG,TTCGTGAAATAGGTGGCAGCGTTGATCTAAGGCAAGCTCGCAAAGCATAAATGATGGAGCCTGTATGAAATGAAAAAGAAAAAAAATTCTAGTTGGTTT,10,30,14,27,27,44,27,50,27,37,37,44,43,50,51.68,2.08295305
hek293t,9261,1,6,AACCCGAAATAGGTGGCAGCGTTGATCTAAGGCAAGAAGCATAAATGATGGAGCCTGTATGAAATGAAAAAGAAAATAAAAAAATTCTAGTTGGTTTAA,AACCCGAAATAGGTGGCAGCGTTGATCTAAGGCAAGCTCGCAAAGCATAAATGATGGAGCCTGTATGAAATGAAAAAGAAAATAAAAAAATTCTAGTTG,10,30,14,27,27,40,27,46,27,37,37,40,43,46,51.68,0.0
hek293t,9263,1,6,GTCTTCCCCCAAGGCTCCCCAAAGCTGCTTGGCACTAGAGAGAATTGACGTAAGTTACGTTCCTAATGTGTGCTACGTATAGGAAAAAAATTCTAGTTG,GTCTTCCCCCAAGGCTCCCCAAAGCTCCTACCGCTTGGCACTAGAGAGAATTGACGTAAGTTACGTTCCTAATGTGTGCTACGTATAGGAAAAAAATTC,10,30,14,27,27,34,27,40,27,27,27,34,33,40,49.03,44.85962125
hek293t,9263,1,6,GTACTCCCCCAAGGCTCCCCAAAGCTGCTTGGCACTAGAGAGAATTGACGTAAGTTACGTTCCTAATGTGTGCTACGTATAGGTCAGAAAAAAATTCTA,GTACTCCCCCAAGGCTCCCCAAAGCTCCTACCGCTTGGCACTAGAGAGAATTGACGTAAGTTACGTTCCTAATGTGTGCTACGTATAGGTCAGAAAAAA,10,30,14,27,27,30,27,36,27,27,27,30,33,36,49.03,7.098765432
hek293t,9265,1,3,AACCTGCTGTCATTTTAGAGGGTGACTTCTGGAGTTTATTATTTAGCAATAACTACTGTTCATCCATACAAATGTTAAAAAAATTCTAGTTGGTTTAAC,AACCTGCTGTCATTTTAGAGGGTGACTTCTGGAAATGTTTATTATTTAGCAATAACTACTGTTCATCCATACAAATGTTAAAAAAATTCTAGTTGGTTT,10,30,14,27,27,44,27,47,27,34,34,44,37,47,16.53,79.78892424
hek293t,9265,1,3,ACACGGCTGTCATTTTAGAGGGTGACTTCTGGAGTTTATTATTTAGCAATAACTACTGTTCATCCATACAAATGTTGGCAAAAAAATTCTAGTTGGTTT,ACACGGCTGTCATTTTAGAGGGTGACTTCTGGAAATGTTTATTATTTAGCAATAACTACTGTTCATCCATACAAATGTTGGCAAAAAAATTCTAGTTGG,10,30,14,27,27,41,27,44,27,34,34,41,37,44,16.53,70.07152237
hek293t,9267,1,13,ACCGCTGAGATAGGAGAGAAAGAGCAAGGTGGTTTGTATCTAGCTTGTAATGAGTCTTTCCCCACGTAAAAAAAATTCTAGTTGGTTTAACGCGTAACT,ACCGCTGAGATAGGAGAGAAAGAGCATATGCAGCCTCCTAGGTGGTTTGTATCTAGCTTGTAATGAGTCTTTCCCCACGTAAAAAAAATTCTAGTTGGT,10,30,14,27,27,42,27,55,27,27,27,42,40,55,73.53,40.13956681
hek293t,9267,1,13,GATTCTGAGATAGGAGAGAAAGAGCAAGGTGGTTTGTATCTAGCTTGTAATGAGTCTTTCCCCACGTATATCTCTTAAAAAAATTCTAGTTGGTTTAAC,GATTCTGAGATAGGAGAGAAAGAGCATATGCAGCCTCCTAGGTGGTTTGTATCTAGCTTGTAATGAGTCTTTCCCCACGTATATCTCTTAAAAAAATTC,10,30,14,27,27,34,27,47,27,27,27,34,40,47,73.53,9.194114909
hek293t,16668,1,8,CGAGACTGCAACAAGATTGCTCAACTAGCTGGATATTAAAAGTGAGGCACAGAAGGGATCTTCCTTGAAGTAAAAAAAAATTCTAGTTGGTTTAACGCG,CGAGACTGCAACAAGATTGCTCAACTAGCTGGATATTACGCGCGCTAAAGTGAGGCACAGAAGGGATCTTCCTTGAAGTAAAAAAAAATTCTAGTTGGT,10,30,14,27,27,42,27,50,27,39,39,42,47,50,12.71,0.0
hek293t,16668,1,8,GGATGCTGCAACAAGATTGCTCAACTAGCTGGATATTAAAAGTGAGGCACAGAAGGGATCTTCCTTGAAAAAAAAATTCTAGTTGGTTTAACGCGTAAC,GGATGCTGCAACAAGATTGCTCAACTAGCTGGATATTACGCGCGCTAAAGTGAGGCACAGAAGGGATCTTCCTTGAAAAAAAAATTCTAGTTGGTTTAA,10,30,14,27,27,46,27,54,27,39,39,46,47,54,12.71,0.677702978
hek293t,9276,1,1,TGGTCTGGTCTCCATGTAAGCAGCTAGAGTGGCTACAGCCCCCTCTGAACGGAGGGGAAGGGAGGATGCTCAGAGACTTTAAAAAAATTCTAGTTGGTT,TGGTCTGGTCTCCATGTAAGCAGCTAGAGTGGCTACAGGCCCCCTCTGAACGGAGGGGAAGGGAGGATGCTCAGAGACTTTAAAAAAATTCTAGTTGGT,10,30,14,27,27,42,27,43,27,39,39,42,40,43,47.34,68.8690861
hek293t,9276,1,1,AGCAATGGTCTCCATGTAAGCAGCTAGAGTGGCTACAGCCCCCTCTGAACGGAGGGGAAGGGAGGATGAAAAAAATTCTAGTTGGTTTAACGCGTAACT,AGCAATGGTCTCCATGTAAGCAGCTAGAGTGGCTACAGGCCCCCTCTGAACGGAGGGGAAGGGAGGATGAAAAAAATTCTAGTTGGTTTAACGCGTAAC,10,30,14,27,27,54,27,55,27,39,39,54,40,55,47.34,64.63417651
hek293t,9278,1,13,CATAAGGGAGCCGGAGAGAGCGGGCAAAACGGGGCAGCTTCTCTGCACTTAGGTGTCTGGTTTACTTCATCAAAAAAATTCTAGTTGGTTTAACGCGTA,CATAAGGGAGCCGGAGAGAGCGGGCAAACCCTGGGCGTGAAACGGGGCAGCTTCTCTGCACTTAGGTGTCTGGTTTACTTCATCAAAAAAATTCTAGTT,10,30,14,27,27,39,27,52,27,29,29,39,42,52,28.19,51.52184233
hek293t,9280,1,5,AAATCTTACTATTCTACTGAGTAAAAATCAGGCACCTTTAAGAACAAGGTAATGAAATGAGCAAGAAGCCGTGATAACGAAAAAAATTCTAGTTGGTTT,AAATCTTACTATTCTACTGAGTAAAAATCAGACCGGGCACCTTTAAGAACAAGGTAATGAAATGAGCAAGAAGCCGTGATAACGAAAAAAATTCTAGTT,10,30,14,27,27,39,27,44,27,32,32,39,37,44,33.12,0.695913779
hek293t,9280,1,5,GTGCTTTACTATTCTACTGAGTAAAAATCAGGCACCTTTAAGAACAAGGTAATGAAATGAGCAAGAAGCCGTGATAACGTATCAAAAAAATTCTAGTTG,GTGCTTTACTATTCTACTGAGTAAAAATCAGACCGGGCACCTTTAAGAACAAGGTAATGAAATGAGCAAGAAGCCGTGATAACGTATCAAAAAAATTCT,10,30,14,27,27,35,27,40,27,32,32,35,37,40,33.12,0.0
hek293t,9282,1,8,CCTCAGCCTACCAACAGCAGAACTATATCTGGCATGAAAAGTTGTTTAAGTTGGCGGGATTTTTACTATTGATTTCAAAAAAAATTCTAGTTGGTTTAA,CCTCAGCCTACCAACAGCAGAACTATATCTAGGCGTTGGGCATGAAAAGTTGTTTAAGTTGGCGGGATTTTTACTATTGATTTCAAAAAAAATTCTAGT,10,30,14,27,27,38,27,46,27,31,31,38,39,46,24.94,1.703688578
hek293t,1699,1,8,CACGTATAAAAGAGTATGTGACTTAAAAATGGTGAAATAGTGATCAGAGGCATCCAACATTTTGGTATGAAAAAAATTCTAGTTGGTTTAACGCGTAAC,CACGTATAAAAGAGTATGTGACTTAAAAATTACTGAGTGGTGAAATAGTGATCAGAGGCATCCAACATTTTGGTATGAAAAAAATTCTAGTTGGTTTAA,10,30,14,27,27,46,27,54,27,31,31,46,39,54,22.24,0.270576235
hek293t,1699,1,8,CGCTTATAAAAGAGTATGTGACTTAAAAATGGTGAAATAGTGATCAGAGGCATCCAACATTTTGGTATGAGCTTAAAAAAATTCTAGTTGGTTTAACGC,CGCTTATAAAAGAGTATGTGACTTAAAAATTACTGAGTGGTGAAATAGTGATCAGAGGCATCCAACATTTTGGTATGAGCTTAAAAAAATTCTAGTTGG,10,30,14,27,27,41,27,49,27,31,31,41,39,49,22.24,0.033134526
hek293t,9286,1,10,GTCTTTAACCTACCTGGAGTCCTTCTCATAGGTGTAGCACAGAGCCATCTTACTCTGAACCCCATTGCACCATATGACACCAAAAAAAATTCTAGTTGG,GTCTTTAACCTACCTGGAGTCCTTCTCCGCACTGGACATAGGTGTAGCACAGAGCCATCTTACTCTGAACCCCATTGCACCATATGACACCAAAAAAAA,10,30,14,27,27,31,27,41,27,28,28,31,38,41,40.92,0.362976407
hek293t,9286,1,10,CTCACTAACCTACCTGGAGTCCTTCTCATAGGTGTAGCACAGAGCCATCTTACTCTGAACCCCATTGCACAAAAAAATTCTAGTTGGTTTAACGCGTAA,CTCACTAACCTACCTGGAGTCCTTCTCCGCACTGGACATAGGTGTAGCACAGAGCCATCTTACTCTGAACCCCATTGCACAAAAAAATTCTAGTTGGTT,10,30,14,27,27,43,27,53,27,28,28,43,38,53,40.92,34.69709166
hek293t,9289,1,10,CGCTCCTTGGACCATGAACAAGCAAAACTAGGTTCTAAGATACACAAGTGATCATAGAAGTGGACTAAAAAAATTCTAGTTGGTTTAACGCGTAACTAG,CGCTCCTTGGACCATGAACAAGCAAAACTAGCTTCCTGTTCGTTCTAAGATACACAAGTGATCATAGAAGTGGACTAAAAAAATTCTAGTTGGTTTAAC,10,30,14,27,27,47,27,57,27,32,32,47,42,57,52.17,0.658987088
hek293t,9289,1,10,CTCAACTTGGACCATGAACAAGCAAAACTAGGTTCTAAGATACACAAGTGATCATAGAAGTGGACTGTTTCTTAAAAAAAATTCTAGTTGGTTTAACGC,CTCAACTTGGACCATGAACAAGCAAAACTAGCTTCCTGTTCGTTCTAAGATACACAAGTGATCATAGAAGTGGACTGTTTCTTAAAAAAAATTCTAGTT,10,30,14,27,27,39,27,49,27,32,32,39,42,49,52.17,1.346124635
hek293t,9293,1,13,CTCTACAATGATCCAGGTGCAAGCTTCACAGGAGCACAGGGTTAGGGGAGAAGGCGGTGGCAGCAGGTCAGAAGGAAAGAAAAAAATTCTAGTTGGTTT,CTCTACAATGATCCAGGTGCAAGCTTCAAAATCTTCGGGAACAGGAGCACAGGGTTAGGGGAGAAGGCGGTGGCAGCAGGTCAGAAGGAAAGAAAAAAA,10,30,14,27,27,31,27,44,27,28,28,31,41,44,33.76,0.208046274
hek293t,9293,1,13,CGGCTCAATGATCCAGGTGCAAGCTTCACAGGAGCACAGGGTTAGGGGAGAAGGCGGTGGCAGCAGGTCAGAAAAAAAATTCTAGTTGGTTTAACGCGT,CGGCTCAATGATCCAGGTGCAAGCTTCAAAATCTTCGGGAACAGGAGCACAGGGTTAGGGGAGAAGGCGGTGGCAGCAGGTCAGAAAAAAAATTCTAGT,10,30,14,27,27,38,27,51,27,28,28,38,41,51,33.76,4.592053771
hek293t,3572,1,13,AATGGAAAGTTCTAATGCATGGCACTGTCAGGGATCTTCTCTCCCTCACACATCTTCTGTACTGTTTCAAAAAAAATTCTAGTTGGTTTAACGCGTAAC,AATGGAAAGTTCTAATGCATGGCACTGTCAGGGATCTTCGGGCAAACATGTCTCTCCCTCACACATCTTCTGTACTGTTTCAAAAAAAATTCTAGTTGG,10,30,14,27,27,41,27,54,27,38,38,41,51,54,18.92,0.0
hek293t,9296,1,2,ACTCCTGAAAACAATAGCCATCACGGTACTGGACTTTGTGGGATCCAAGAAAGGCCATTACAGCTAGAAAAAAATTCTAGTTGGTTTAACGCGTAACTA,ACTCCTGAAAACAATAGCCATCACGGTACTGGACTTTGTGTGGGATCCAAGAAAGGCCATTACAGCTAGAAAAAAATTCTAGTTGGTTTAACGCGTAAC,10,30,14,27,27,54,27,56,27,39,39,54,41,56,27.18,77.34677832
hek293t,9296,1,2,AACGTTGAAAACAATAGCCATCACGGTACTGGACTTTGTGGGATCCAAGAAAGGCCATTACAGCTAGCTCAGCTGAAAAAAATTCTAGTTGGTTTAACG,AACGTTGAAAACAATAGCCATCACGGTACTGGACTTTGTGTGGGATCCAAGAAAGGCCATTACAGCTAGCTCAGCTGAAAAAAATTCTAGTTGGTTTAA,10,30,14,27,27,46,27,48,27,39,39,46,41,48,27.18,69.45107423
hek293t,9298,1,10,CTCGCAGCACTGCCACAGACACCTCCGTATGGTATTTGCACTGCCATCCATGTTGCAGCGTAGGTTATGAAAAAAAATTCTAGTTGGTTTAACGCGTAA,CTCGCAGCACTGCCACAGACACCTCCGGAACTATTAGTATGGTATTTGCACTGCCATCCATGTTGCAGCGTAGGTTATGAAAAAAAATTCTAGTTGGTT,10,30,14,27,27,43,27,53,27,28,28,43,38,53,60.47,15.50620903
hek293t,9302,1,1,TTTTCTAGTGATATAAATTAAATTGATCTTGGAAAATGCTGGAATGAAAGTTACCGTGTTTTGCATCCAGTTACAGAAAAAAAAATTCTAGTTGGTTTA,TTTTCTAGTGATATAAATTAAATTGATCTTGGAAAAATGCTGGAATGAAAGTTACCGTGTTTTGCATCCAGTTACAGAAAAAAAAATTCTAGTTGGTTT,10,30,14,27,27,44,27,45,27,37,37,44,38,45,3.08,0.0
hek293t,9306,1,5,GACCATAAACAGGACCTCTGCAAAAAACCTGGAGTTGAGTGCCAGGCAGTTTCAACCATTACAAGGACAAGTAAAAAAATTCTAGTTGGTTTAACGCGT,GACCATAAACAGGACCTCTGCAAAAAACCTGGAGTTGACTACAGTGCCAGGCAGTTTCAACCATTACAAGGACAAGTAAAAAAATTCTAGTTGGTTTAA,10,30,14,27,27,46,27,51,27,39,39,46,44,51,52.91,3.287441294
hek293t,9306,1,5,GCGAGTAAACAGGACCTCTGCAAAAAACCTGGAGTTGAGTGCCAGGCAGTTTCAACCATTACAAGGACAAAAAAAATTCTAGTTGGTTTAACGCGTAAC,GCGAGTAAACAGGACCTCTGCAAAAAACCTGGAGTTGACTACAGTGCCAGGCAGTTTCAACCATTACAAGGACAAAAAAAATTCTAGTTGGTTTAACGC,10,30,14,27,27,49,27,54,27,39,39,49,44,54,52.91,1.763873962
hek293t,9308,1,1,CCGTATTTCCCCTCTTCACACAAAAAGTCAGGTTTTATTCTGGTTCGTTTCGATTTGTGCCTGAAGAGGAGGCATTAAGTGAAAAAAAATTCTAGTTGG,CCGTATTTCCCCTCTTCACACAAAAAGTCAAGGTTTTATTCTGGTTCGTTTCGATTTGTGCCTGAAGAGGAGGCATTAAGTGAAAAAAAATTCTAGTTG,10,30,14,27,27,40,27,41,27,30,30,40,31,41,19.32,0.070028011
hek293t,9311,1,8,CTGCCGGCAACAACCATACGCTAATGCACAGGGACCAGCACCTCCAGTCAAGGTCCTGCTGACCTAGGAAAAAAATTCTAGTTGGTTTAACGCGTAACT,CTGCCGGCAACAACCATACGCTAATGCACAGGGACCAGCGTCCCTAAACCTCCAGTCAAGGTCCTGCTGACCTAGGAAAAAAATTCTAGTTGGTTTAAC,10,30,14,27,27,47,27,55,27,40,40,47,48,55,61.8,4.748012982
hek293t,9312,1,13,TCCGCGTCTTGTACAATTCAGACACAATCTGGTGTGTTGCAATGCAAAATAAAACCATATAGTAACTAAAAAAATTCTAGTTGGTTTAACGCGTAACTA,TCCGCGTCTTGTACAATTCAGACACAATCTGGTGTGTTGTAGCTCCTACGGACAATGCAAAATAAAACCATATAGTAACTAAAAAAATTCTAGTTGGTT,10,30,14,27,27,43,27,56,27,40,40,43,53,56,21.55,0.0
hek293t,9313,1,3,GTCGCGAAAAATTAGCTCCGTGCCTTGCATGGAGCTCTTGGGCTGTGTGTAATTCTACTGCCACTTTCTTCTGAGAATTCAAAAAAAAATTCTAGTTGG,GTCGCGAAAAATTAGCTCCGTGCCTTGTTACATGGAGCTCTTGGGCTGTGTGTAATTCTACTGCCACTTTCTTCTGAGAATTCAAAAAAAAATTCTAGT,10,30,14,27,27,38,27,41,27,28,28,38,31,41,48.42,51.26465774
hek293t,9313,1,3,CACAAGAAAAATTAGCTCCGTGCCTTGCATGGAGCTCTTGGGCTGTGTGTAATTCTACTGCCACTTTCTTCTGAGAATTCAATTTACTTAAAAAAATTC,CACAAGAAAAATTAGCTCCGTGCCTTGTTACATGGAGCTCTTGGGCTGTGTGTAATTCTACTGCCACTTTCTTCTGAGAATTCAATTTACTTAAAAAAA,10,30,14,27,27,31,27,34,27,28,28,31,31,34,48.42,2.825127669
hek293t,19996,1,10,TATTCGAGCAGCTTAGAGAAAATTAAAAATGGGAAGCAGGATATAAAAGGTACAAAGACAGAAGCTAAAAAAAAAATTCTAGTTGGTTTAACGCGTAAC,TATTCGAGCAGCTTAGAGAAAATTAAAAATGGGAAGAGCGTTTACTCAGGATATAAAAGGTACAAAGACAGAAGCTAAAAAAAAAATTCTAGTTGGTTT,10,30,14,27,27,44,27,54,27,37,37,44,47,54,2.32,0.0
hek293t,19996,1,10,ATTATGAGCAGCTTAGAGAAAATTAAAAATGGGAAGCAGGATATAAAAGGTACAAAGACAGAAGCTAAAAAAATTCTAGTTGGTTTAACGCGTAACTAG,ATTATGAGCAGCTTAGAGAAAATTAAAAATGGGAAGAGCGTTTACTCAGGATATAAAAGGTACAAAGACAGAAGCTAAAAAAATTCTAGTTGGTTTAAC,10,30,14,27,27,47,27,57,27,37,37,47,47,57,2.32,0.0
hek293t,8255,1,2,CGCTTGTTTGTTGCAGCAGAGCAGAGATCTGGTAAAGGGCTTGTCTGTCATCCTTGTCACTGCTACACTTAAGGATGGAGAGTGTGAAAAAAATTCTAG,CGCTTGTTTGTTGCAGCAGAGCAGAGATCTCTGGTAAAGGGCTTGTCTGTCATCCTTGTCACTGCTACACTTAAGGATGGAGAGTGTGAAAAAAATTCT,10,30,14,27,27,35,27,37,27,28,28,35,30,37,51.06,23.74422921
hek293t,9319,1,7,CATCGGATTTCTGGGGAGAGTCCTTCTTATGGTAAGTCACTTAAATGCACACAGCAGAAGAAGCCCCCCCTTTTATAAAAAAATTCTAGTTGGTTTAAC,CATCGGATTTCTGGGGAGAGTCCTTCTTATGGGGTGTGGTAAGTCACTTAAATGCACACAGCAGAAGAAGCCCCCCCTTTTATAAAAAAATTCTAGTTG,10,30,14,27,27,40,27,47,27,33,33,40,40,47,23.97,4.287393075
hek293t,9319,1,7,GGCAAGATTTCTGGGGAGAGTCCTTCTTATGGTAAGTCACTTAAATGCACACAGCAGAAGAAGCCCCCAAAAAAATTCTAGTTGGTTTAACGCGTAACT,GGCAAGATTTCTGGGGAGAGTCCTTCTTATGGGGTGTGGTAAGTCACTTAAATGCACACAGCAGAAGAAGCCCCCAAAAAAATTCTAGTTGGTTTAACG,10,30,14,27,27,48,27,55,27,33,33,48,40,55,23.97,0.873202792
hek293t,9321,1,4,GCAAATCCCCTTTGTGCACACTTTGAGGTTGGTAATGGGTTCTATAGTCCATCCTTTCAGAACCATTCTTGGAGCATCATTTAAAAAAATTCTAGTTGG,GCAAATCCCCTTTGTGCACACTTTGAGGTTGGTACTCAATGGGTTCTATAGTCCATCCTTTCAGAACCATTCTTGGAGCATCATTTAAAAAAATTCTAG,10,30,14,27,27,37,27,41,27,34,34,37,38,41,19.7,0.150285543
hek293t,9321,1,4,CCAATTCCCCTTTGTGCACACTTTGAGGTTGGTAATGGGTTCTATAGTCCATCCTTTCAGAACCATTCTTGGAGCATCAAAAAAATTCTAGTTGGTTTA,CCAATTCCCCTTTGTGCACACTTTGAGGTTGGTACTCAATGGGTTCTATAGTCCATCCTTTCAGAACCATTCTTGGAGCATCAAAAAAATTCTAGTTGG,10,30,14,27,27,41,27,45,27,34,34,41,38,45,19.7,43.8279759
hek293t,9323,1,4,AGCCGTGCAAATTAAAGACAGATAACCAGAGGAAAAACTTGCAGAAAGGTACAAGATAAGTTACCAGATGATATAAACTAAAAAAATTCTAGTTGGTTT,AGCCGTGCAAATTAAAGACAGATAACCAGAGGAAAATGGCACTTGCAGAAAGGTACAAGATAAGTTACCAGATGATATAAACTAAAAAAATTCTAGTTG,10,30,14,27,27,40,27,44,27,37,37,40,41,44,63.8,0.0
hek293t,9323,1,4,TGCAATGCAAATTAAAGACAGATAACCAGAGGAAAAACTTGCAGAAAGGTACAAGATAAGTTACCAGAAAAAAATTCTAGTTGGTTTAACGCGTAACTA,TGCAATGCAAATTAAAGACAGATAACCAGAGGAAAATGGCACTTGCAGAAAGGTACAAGATAAGTTACCAGAAAAAAATTCTAGTTGGTTTAACGCGTA,10,30,14,27,27,52,27,56,27,37,37,52,41,56,63.8,1.635141194
hek293t,9327,1,14,GCTAACCGTGTTTCAACCCTCAGTTATTTTGGCACAACAAGACGGTGAGTAATTCAAGCTTCTTATGATTTAATGCAAAAAAATTCTAGTTGGTTTAAC,GCTAACCGTGTTTCAACCCTCAGTTATTTCAGTGATATGGCTGTGGCACAACAAGACGGTGAGTAATTCAAGCTTCTTATGATTTAATGCAAAAAAATT,10,30,14,27,27,33,27,47,27,30,30,33,44,47,9.53,0.0
hek293t,9327,1,14,ATATACCGTGTTTCAACCCTCAGTTATTTTGGCACAACAAGACGGTGAGTAATTCAAGCTTCTTAAAAAAATTCTAGTTGGTTTAACGCGTAACTAGAT,ATATACCGTGTTTCAACCCTCAGTTATTTCAGTGATATGGCTGTGGCACAACAAGACGGTGAGTAATTCAAGCTTCTTAAAAAAATTCTAGTTGGTTTA,10,30,14,27,27,45,27,59,27,30,30,45,44,59,9.53,3.403058929
hek293t,9331,1,15,GGTCCCTGAAAGCCTAAGGGAAAGCTCACTGGGGAGAGCTGGGTCATGAGAAGACAGAGATTTTGTGAAAAAAATTCTAGTTGGTTTAACGCGTAACTA,GGTCCCTGAAAGCCTAAGGGAAAGCTCACTGGGTATCGGGGTAGCTTCGAGAGCTGGGTCATGAGAAGACAGAGATTTTGTGAAAAAAATTCTAGTTGG,10,30,14,27,27,41,27,56,27,34,34,41,49,56,30.59,1.037550992
hek293t,9332,1,10,GCGTCCCATAATTGATGGAAGCCCACAGAAGGTTTTGGAGCCTTCGGTAATTGTTAGAAGAGACCTTGTCTAAAAAAATTCTAGTTGGTTTAACGCGTA,GCGTCCCATAATTGATGGAAGCCCACGACTTTACTCAGAAGGTTTTGGAGCCTTCGGTAATTGTTAGAAGAGACCTTGTCTAAAAAAATTCTAGTTGGT,10,30,14,27,27,42,27,52,27,27,27,42,37,52,41.52,40.69042476
hek293t,9334,1,4,GGCTCATTTGCCAAAAAACGTTTGGAAAATGGCTGTGCATTTAACAACACGTGCATTGGCTACTGCTCCAGTACTTAGGGGAAAAAAAATTCTAGTTGG,GGCTCATTTGCCAAAAAACGTTTGGAAAACGGGTGGCTGTGCATTTAACAACACGTGCATTGGCTACTGCTCCAGTACTTAGGGGAAAAAAAATTCTAG,10,30,14,27,27,37,27,41,27,30,30,37,34,41,8.17,0.558462723
hek293t,9336,1,12,GACAGTCTTTGTTAATGAGTAGGCTGTAGTGGTAAAACCGTGCAAGTTTCCTCCAAGTTAACTATATTCAAAAAAATTCTAGTTGGTTTAACGCGTAAC,GACAGTCTTTGTTAATGAGTAGGCTGTAGTGGTACCTGCCCAGTCCAAACCGTGCAAGTTTCCTCCAAGTTAACTATATTCAAAAAAATTCTAGTTGGT,10,30,14,27,27,42,27,54,27,35,35,42,47,54,38.22,18.42688217
hek293t,9337,1,7,CGCAGTAGAAATTAAGAATTACATTTCCCTGGACAAAAGTTTAATGGAATTTAACTATGGTTTTATCATAGACTAAAAAAATTCTAGTTGGTTTAACGC,CGCAGTAGAAATTAAGAATTACATTTAGCGGATCCCTGGACAAAAGTTTAATGGAATTTAACTATGGTTTTATCATAGACTAAAAAAATTCTAGTTGGT,10,30,14,27,27,42,27,49,27,27,27,42,34,49,48.95,0.2002002
hek293t,9337,1,7,CTCGCTAGAAATTAAGAATTACATTTCCCTGGACAAAAGTTTAATGGAATTTAACTATGGTTTTATCATAGACTCATGCAAAAAAATTCTAGTTGGTTT,CTCGCTAGAAATTAAGAATTACATTTAGCGGATCCCTGGACAAAAGTTTAATGGAATTTAACTATGGTTTTATCATAGACTCATGCAAAAAAATTCTAG,10,30,14,27,27,37,27,44,27,27,27,37,34,44,48.95,1.819371563
hek293t,9340,1,11,AGGAAATGGTGCGGGGAGTAAGGAAAGGATGGGGATGCTACAGAGGGAGCTTTCTGGCACTCATCAGATTTCCTCTTCAAAAAAAAATTCTAGTTGGTT,AGGAAATGGTGCGGGGAGTAAGGAAAGGGCGCATTTTGTATGGGGATGCTACAGAGGGAGCTTTCTGGCACTCATCAGATTTCCTCTTCAAAAAAAAAT,10,30,14,27,27,32,27,43,27,29,29,32,40,43,52.18,0.0
hek293t,9340,1,11,TCTCGATGGTGCGGGGAGTAAGGAAAGGATGGGGATGCTACAGAGGGAGCTTTCTGGCACTCATCAGATTTCCAAAAAAATTCTAGTTGGTTTAACGCG,TCTCGATGGTGCGGGGAGTAAGGAAAGGGCGCATTTTGTATGGGGATGCTACAGAGGGAGCTTTCTGGCACTCATCAGATTTCCAAAAAAATTCTAGTT,10,30,14,27,27,39,27,50,27,29,29,39,40,50,52.18,12.01217699
hek293t,9342,1,6,TAGCTATGTAGGGGCAGACAGTGAGGGAATGGACAAGATAGAGTTAAGGAGCCAAAAGCCTTGGGAGGAATAAATAGCAGAAAAAAATTCTAGTTGGTT,TAGCTATGTAGGGGCAGACAGTGAGGGAAGATATTTGGACAAGATAGAGTTAAGGAGCCAAAAGCCTTGGGAGGAATAAATAGCAGAAAAAAATTCTAG,10,30,14,27,27,37,27,43,27,30,30,37,36,43,56.3,12.61115652
hek293t,9342,1,6,CAATAATGTAGGGGCAGACAGTGAGGGAATGGACAAGATAGAGTTAAGGAGCCAAAAGCCTTGGGAGGAATAAAAAAAATTCTAGTTGGTTTAACGCGT,CAATAATGTAGGGGCAGACAGTGAGGGAAGATATTTGGACAAGATAGAGTTAAGGAGCCAAAAGCCTTGGGAGGAATAAAAAAAATTCTAGTTGGTTTA,10,30,14,27,27,45,27,51,27,30,30,45,36,51,56.3,3.182674793
hek293t,9345,1,13,GAATAAAAATTGCAAAAGCAGAGGGAGGGAGGCTCATATTTGAATGCCAAGGAGCTTGTATTGGTGGCCCGGGAAAAAAAAATTCTAGTTGGTTTAACG,GAATAAAAATTGCAAAAGCAGAGGGAGCACGGCTTAAGAGGGAGGCTCATATTTGAATGCCAAGGAGCTTGTATTGGTGGCCCGGGAAAAAAAAATTCT,10,30,14,27,27,35,27,48,27,28,28,35,41,48,36.45,0.0
hek293t,9347,1,13,TCATGACCCTGAACTGGGGAAGTCCATATTGGCATGGATGTGGTGAGAAATGGCTCCTTAGCCCTGTGAAAAAAATTCTAGTTGGTTTAACGCGTAACT,TCATGACCCTGAACTGGGGAAGTCCATATTGGCATGGACAATGTGAGGAGCTGTGGTGAGAAATGGCTCCTTAGCCCTGTGAAAAAAATTCTAGTTGGT,10,30,14,27,27,42,27,55,27,39,39,42,52,55,27.42,0.0
hek293t,9348,1,14,GTCCTAACACTTATGCAAATAATTAGACCAGGTATCAAGACACGGCAACTATGGACACGACTCACACAAAAAAAATTCTAGTTGGTTTAACGCGTAACT,GTCCTAACACTTATGCAAATAATTAGACCAGGTATCACCCATTACCTAGCTAGACACGGCAACTATGGACACGACTCACACAAAAAAAATTCTAGTTGG,10,30,14,27,27,41,27,55,27,38,38,41,52,55,41.05,0.0
hek293t,9349,1,15,GGGACATGTAGGAACCTTTGCCTTGCAGGTGGGAAAGCCTGATACTTAAGCATGCTCTGTTGAGAAGTTAAAAAAATTCTAGTTGGTTTAACGCGTAAC,GGGACATGTAGGAACCTTTGCCTTGCAGTAAGCGCTGCTCAAGGTGGGAAAGCCTGATACTTAAGCATGCTCTGTTGAGAAGTTAAAAAAATTCTAGTT,10,30,14,27,27,39,27,54,27,29,29,39,44,54,32.8,67.46465707
hek293t,9349,1,15,TCTCCATGTAGGAACCTTTGCCTTGCAGGTGGGAAAGCCTGATACTTAAGCATGCTCTGTTGAGAAAAAAATTCTAGTTGGTTTAACGCGTAACTAGAT,TCTCCATGTAGGAACCTTTGCCTTGCAGTAAGCGCTGCTCAAGGTGGGAAAGCCTGATACTTAAGCATGCTCTGTTGAGAAAAAAATTCTAGTTGGTTT,10,30,14,27,27,44,27,59,27,29,29,44,44,59,32.8,64.89749297
hek293t,9353,1,9,TTAGAAATCATTGTTTTCCTTACCTCCTAAGGCCTTGGCTTTGCAGTCAGAGTGAGTGACACCAGAACCACTGTGAAAAAAAAATTCTAGTTGGTTTAA,TTAGAAATCATTGTTTTCCTTACCTCCTAGCTGTGCGGAGGCCTTGGCTTTGCAGTCAGAGTGAGTGACACCAGAACCACTGTGAAAAAAAAATTCTAG,10,30,14,27,27,37,27,46,27,30,30,37,39,46,14.42,15.90929706
hek293t,9353,1,9,CGTCAAATCATTGTTTTCCTTACCTCCTAAGGCCTTGGCTTTGCAGTCAGAGTGAGTGACACCAGAACCAAAAAAATTCTAGTTGGTTTAACGCGTAAC,CGTCAAATCATTGTTTTCCTTACCTCCTAGCTGTGCGGAGGCCTTGGCTTTGCAGTCAGAGTGAGTGACACCAGAACCAAAAAAATTCTAGTTGGTTTA,10,30,14,27,27,45,27,54,27,30,30,45,39,54,14.42,11.51295995
hek293t,9355,1,6,CAGAGCTTGTGGAAGTGTGGGTTTTTAATAGGTATGTTGATCTGCTCTTACTTCCGTCTATGGCTTTCTAGGATTCTGCATAAAAAAATTCTAGTTGGT,CAGAGCTTGTGGAAGTGTGGGTTTTTAATAGGACAATATATGTTGATCTGCTCTTACTTCCGTCTATGGCTTTCTAGGATTCTGCATAAAAAAATTCTA,10,30,14,27,27,36,27,42,27,33,33,36,39,42,13.19,0.42920394
hek293t,8312,1,13,CTTGATACCAGTTAGGTTTACGTTGCTCCTGGGAGGCGATTCTGTTATGCTCACCGTTAATACAGCTACGAAAAAAATTCTAGTTGGTTTAACGCGTAA,CTTGATACCAGTTAGGTTTACGTTGCTCCGGGGGTTAAAACTTGGGAGGCGATTCTGTTATGCTCACCGTTAATACAGCTACGAAAAAAATTCTAGTTG,10,30,14,27,27,40,27,53,27,30,30,40,43,53,48.36,0.486546149
hek293t,9359,1,2,ATACTCATGTTACAGAGTCAGAAACTTTCTGGGTGTATGGTTGGATTTGAAAAATGCTCCTGCTCTTGTACGTTAAAAAAATTCTAGTTGGTTTAACGC,ATACTCATGTTACAGAGTCAGAAACTTTCTGCTGGTGTATGGTTGGATTTGAAAAATGCTCCTGCTCTTGTACGTTAAAAAAATTCTAGTTGGTTTAAC,10,30,14,27,27,47,27,49,27,32,32,47,34,49,6.8,65.94321104
hek293t,9361,1,5,ATGGTGTAAGAGTTCTTGTGTTACAAAGCTGGGACATTTGGAAATCAAATATCATCAAAGCTGCATTAGAAGCATACTCAGTAGAAAAAAATTCTAGTT,ATGGTGTAAGAGTTCTTGTGTTACAAATGCAAGCTGGGACATTTGGAAATCAAATATCATCAAAGCTGCATTAGAAGCATACTCAGTAGAAAAAAATTC,10,30,14,27,27,34,27,39,27,27,27,34,32,39,34.16,72.23013828
hek293t,9361,1,5,TAAGGGTAAGAGTTCTTGTGTTACAAAGCTGGGACATTTGGAAATCAAATATCATCAAAGCTGCATTAGAAGCATAAAAAAAATTCTAGTTGGTTTAAC,TAAGGGTAAGAGTTCTTGTGTTACAAATGCAAGCTGGGACATTTGGAAATCAAATATCATCAAAGCTGCATTAGAAGCATAAAAAAAATTCTAGTTGGT,10,30,14,27,27,42,27,47,27,27,27,42,32,47,34.16,67.48192642
hek293t,9364,1,11,AGCGCCCTAAGCAGAACAAGAACAGAAGTAGGAATAGAAGTAAAACCTGACTGAGCCAAGTGGCTGTGTGCCCCAAAAAAATTCTAGTTGGTTTAACGC,AGCGCCCTAAGCAGAACAAGAACAGAAAGTTCGGCCCAGTAGGAATAGAAGTAAAACCTGACTGAGCCAAGTGGCTGTGTGCCCCAAAAAAATTCTAGT,10,30,14,27,27,38,27,49,27,28,28,38,39,49,45.81,3.143329563
hek293t,9364,1,11,AGTCCCCTAAGCAGAACAAGAACAGAAGTAGGAATAGAAGTAAAACCTGACTGAGCCAAGTGGCTGTGTGCCCCCCCAAAAAAATTCTAGTTGGTTTAA,AGTCCCCTAAGCAGAACAAGAACAGAAAGTTCGGCCCAGTAGGAATAGAAGTAAAACCTGACTGAGCCAAGTGGCTGTGTGCCCCCCCAAAAAAATTCT,10,30,14,27,27,35,27,46,27,28,28,35,39,46,45.81,1.339145715
hek293t,9367,1,6,AACTGTACAGTTCTTGTTAGAAAGCCAGAAGGTACACTATAAAGGGCTTATATTCAAACACTTTAAAGTAAAAAAATTCTAGTTGGTTTAACGCGTAAC,AACTGTACAGTTCTTGTTAGAAAGCCAGAAGGTACACTATGAGATAAAAGGGCTTATATTCAAACACTTTAAAGTAAAAAAATTCTAGTTGGTTTAACG,10,30,14,27,27,48,27,54,27,41,41,48,47,54,48.94,1.215245924
hek293t,9368,1,10,TGTATATACAGTGAGAAATCAGAGCACTATGGAGGATGTGAAAAGTCTTGAAGACATGGAGAATGTTTTAAAAAAAATTCTAGTTGGTTTAACGCGTAA,TGTATATACAGTGAGAAATCAGAGCACTATGGATAAGTTCATAGGATGTGAAAAGTCTTGAAGACATGGAGAATGTTTTAAAAAAAATTCTAGTTGGTT,10,30,14,27,27,43,27,53,27,33,33,43,43,53,71.79,3.695055295
hek293t,9368,1,10,TAAAGATACAGTGAGAAATCAGAGCACTATGGAGGATGTGAAAAGTCTTGAAGACATGGAGAATGAAAAAAATTCTAGTTGGTTTAACGCGTAACTAGA,TAAAGATACAGTGAGAAATCAGAGCACTATGGATAAGTTCATAGGATGTGAAAAGTCTTGAAGACATGGAGAATGAAAAAAATTCTAGTTGGTTTAACG,10,30,14,27,27,48,27,58,27,33,33,48,43,58,71.79,6.888643906
hek293t,9372,1,14,AAGCGCAAGGTTTAGAGTCCTCTCATGTCTGGGAGAATCTCATTTTTTATTCAATGTCACTGAGTGACTATTAAAAAAATTCTAGTTGGTTTAACGCGT,AAGCGCAAGGTTTAGAGTCCTCTCATGTCTGCAAGTCTGCCAGTGGGAGAATCTCATTTTTTATTCAATGTCACTGAGTGACTATTAAAAAAATTCTAG,10,30,14,27,27,37,27,51,27,30,30,37,44,51,47.22,1.779593452
hek293t,9374,1,11,GGTAGATAAATAGAACAATTCCATTGATTCGGCCACATTAATTCTTGAAAGCATCCTGTAAATCATCAGTCCTTTGGTCATAAAAAAAATTCTAGTTGG,GGTAGATAAATAGAACAATTCCATTGGCTGTCTTACTATTCGGCCACATTAATTCTTGAAAGCATCCTGTAAATCATCAGTCCTTTGGTCATAAAAAAA,10,30,14,27,27,30,27,41,27,27,27,30,38,41,33.68,1.05336979
hek293t,9374,1,11,CAGACATAAATAGAACAATTCCATTGATTCGGCCACATTAATTCTTGAAAGCATCCTGTAAATCATCAGTCCTTTGGTAAAAAAATTCTAGTTGGTTTA,CAGACATAAATAGAACAATTCCATTGGCTGTCTTACTATTCGGCCACATTAATTCTTGAAAGCATCCTGTAAATCATCAGTCCTTTGGTAAAAAAATTC,10,30,14,27,27,34,27,45,27,27,27,34,38,45,33.68,6.169294208
hek293t,9376,1,12,CCTGTAGTGAATATAGGACAGTGATCATTTGGTGACAAACAGCTTCAGAAGAACGGTTAGATTGTGAAAAAAAAATTCTAGTTGGTTTAACGCGTAACT,CCTGTAGTGAATATAGGACAGTGATCATTTGGGGTGGAGTGTCTTGACAAACAGCTTCAGAAGAACGGTTAGATTGTGAAAAAAAAATTCTAGTTGGTT,10,30,14,27,27,43,27,55,27,33,33,43,45,55,20.67,5.708580626
hek293t,9377,1,12,CCGGCTTCTTCTGACTCACTGCCACCGTGAGGAACAGAAGACATAAGAATGCTCATCTCCAAAAGGGCACAAGTTTAAAAAAATTCTAGTTGGTTTAAC,CCGGCTTCTTCTGACTCACTGCCACCGTGAGTATTATTCTGGAGAACAGAAGACATAAGAATGCTCATCTCCAAAAGGGCACAAGTTTAAAAAAATTCT,10,30,14,27,27,35,27,47,27,32,32,35,44,47,64.48,0.255918106
hek293t,9377,1,12,GGCAATTCTTCTGACTCACTGCCACCGTGAGGAACAGAAGACATAAGAATGCTCATCTCCAAAAGGGCACAAAAAAAAATTCTAGTTGGTTTAACGCGT,GGCAATTCTTCTGACTCACTGCCACCGTGAGTATTATTCTGGAGAACAGAAGACATAAGAATGCTCATCTCCAAAAGGGCACAAAAAAAAATTCTAGTT,10,30,14,27,27,39,27,51,27,32,32,39,44,51,64.48,0.243664717
hek293t,996,1,4,GGACCCTTCCTCAGCACATGGAGCGGCTCTGGCCACCTTGGGGCCTGGGCCTGTTTGGTGAGGGCCCTTTGGGAAAAAAATTCTAGTTGGTTTAACGCG,GGACCCTTCCTCAGCACATGGAGCGGCTCTGGCCACGGGCCTTGGGGCCTGGGCCTGTTTGGTGAGGGCCCTTTGGGAAAAAAATTCTAGTTGGTTTAA,10,30,14,27,27,46,27,50,27,36,36,46,40,50,34.34,27.7433418
hek293t,9381,1,14,GAGAGTCAGATTCTTGATGCAACTGATGAAGGTAGATCTACTTTGCCAGGTCTAAAAGGTTTGGAAAAAAATTCTAGTTGGTTTAACGCGTAACTAGAT,GAGAGTCAGATTCTTGATGCAACTGATGAAGGTATATCGATTATAGAGGATCTACTTTGCCAGGTCTAAAAGGTTTGGAAAAAAATTCTAGTTGGTTTA,10,30,14,27,27,45,27,59,27,35,35,45,49,59,39.78,9.132996633
hek293t,9382,1,15,CCTTGTGCCTGGAGATCTGTGCATTTCGGCGGTGAGTCCATTTCTCATTCTTGGAAGGTCATGAGGAGCCAAAGCACTAAAAAAATTCTAGTTGGTTTA,CCTTGTGCCTGGAGATCTGTGCATTTAATGCTAACTGAGGGCGGCGGTGAGTCCATTTCTCATTCTTGGAAGGTCATGAGGAGCCAAAGCACTAAAAAA,10,30,14,27,27,30,27,45,27,27,27,30,42,45,48.27,0.0
hek293t,9384,1,10,GACCCAAGTTTTTGTGATCCTCTGATTTAAGGATAACAAGTGCAGTCAAAAAATGTGACTTCTAATCCCATGTTTTCACAAAAAAATTCTAGTTGGTTT,GACCCAAGTTTTTGTGATCCTCTGATAGCGAGGGTTTTAAGGATAACAAGTGCAGTCAAAAAATGTGACTTCTAATCCCATGTTTTCACAAAAAAATTC,10,30,14,27,27,34,27,44,27,27,27,34,37,44,2.68,0.054914882
hek293t,9384,1,10,GATTCAAGTTTTTGTGATCCTCTGATTTAAGGATAACAAGTGCAGTCAAAAAATGTGACTTCTAATCCCATGTTTTAAAAAAATTCTAGTTGGTTTAAC,GATTCAAGTTTTTGTGATCCTCTGATAGCGAGGGTTTTAAGGATAACAAGTGCAGTCAAAAAATGTGACTTCTAATCCCATGTTTTAAAAAAATTCTAG,10,30,14,27,27,37,27,47,27,27,27,37,37,47,2.68,0.428526577
hek293t,9386,1,10,GTCTATGGACCATTGGTTTAGCACAGTATTGGTTTCTTACGTCCTTATGACTTGAACTGCATGGACTAAATAAAAAAATTCTAGTTGGTTTAACGCGTA,GTCTATGGACCATTGGTTTAGCACAGTATTGGTTAGCAATACGCTCTTACGTCCTTATGACTTGAACTGCATGGACTAAATAAAAAAATTCTAGTTGGT,10,30,14,27,27,42,27,52,27,35,35,42,45,52,26.2,3.353235311
hek293t,9388,1,3,GAACATGCAGTAGTCCATGATTCATTTGCTGGCAGAGAAAAAATCTTTTGCTGAAATACTAAGCAGGTTATAAAACATCAAAAAAAATTCTAGTTGGTT,GAACATGCAGTAGTCCATGATTCATTTGCTGGCAGATGTGAAAAAATCTTTTGCTGAAATACTAAGCAGGTTATAAAACATCAAAAAAAATTCTAGTTG,10,30,14,27,27,40,27,43,27,37,37,40,40,43,35.23,4.190974206
hek293t,9389,1,7,CCGGAGATATGGAGAAAGTTTTAGTGGTCTGGATAGAAGATCAAACCAGTCTCAACATTCCCTTAAGCAAAAAAATTCTAGTTGGTTTAACGCGTAACT,CCGGAGATATGGAGAAAGTTTTAGTGGTCTGGATAGAAGAATTGCCTTCAAACCAGTCTCAACATTCCCTTAAGCAAAAAAATTCTAGTTGGTTTAACG,10,30,14,27,27,48,27,55,27,41,41,48,48,55,11.13,0.0
hek293t,9390,1,2,TAAAAAATATAATCAGCACTGACTCCGAAAGGCAAATAAATTCTGTTTCCCTCCCAAAGTAGACAGAAAAAAATTCTAGTTGGTTTAACGCGTAACTAG,TAAAAAATATAATCAGCACTGACTCCGAAAGGCAAATAAGCATTCTGTTTCCCTCCCAAAGTAGACAGAAAAAAATTCTAGTTGGTTTAACGCGTAACT,10,30,14,27,27,55,27,57,27,40,40,55,42,57,29.46,72.47290019
hek293t,3610,1,2,AACACTCTTGGTCCCCCCCAGGAAAGATAAGGAAGGAATTGACACCCATCACTTTACTACAAGAACTCTTCCCAGCAGTATGTCAAAAAAATTCTAGTT,AACACTCTTGGTCCCCCCCAGGAAAGTCATAAGGAAGGAATTGACACCCATCACTTTACTACAAGAACTCTTCCCAGCAGTATGTCAAAAAAATTCTAG,10,30,14,27,27,37,27,39,27,27,27,37,29,39,51.57,19.46347253
hek293t,9394,1,13,AGCGATGTAATGCAAATGATGACAACATCTGGTCAAATTAAAACTATTGACAAACTAGATTTTCAACATTAAAAAAATTCTAGTTGGTTTAACGCGTAA,AGCGATGTAATGCAAATGATGACAACATCTGGCAGTTCGAGTCAGTCAAATTAAAACTATTGACAAACTAGATTTTCAACATTAAAAAAATTCTAGTTG,10,30,14,27,27,40,27,53,27,33,33,40,46,53,22.33,0.510855683
hek293t,9396,1,2,TATGTCCACTTGTCACATGCGTTAATTAATGGGGAGTGCGGGGTTTTGGGAAGCTTACTTAAAGTTGCTCTGTTAAAAAAAAATTCTAGTTGGTTTAAC,TATGTCCACTTGTCACATGCGTTAATTAATGTGGGGAGTGCGGGGTTTTGGGAAGCTTACTTAAAGTTGCTCTGTTAAAAAAAAATTCTAGTTGGTTTA,10,30,14,27,27,45,27,47,27,30,30,45,32,47,6.44,4.642780225
hek293t,9396,1,2,AGTTGCCACTTGTCACATGCGTTAATTAATGGGGAGTGCGGGGTTTTGGGAAGCTTACTTAAAGTTGCTCTGTTAAGCAGGATTCACTAAAAAAATTCT,AGTTGCCACTTGTCACATGCGTTAATTAATGTGGGGAGTGCGGGGTTTTGGGAAGCTTACTTAAAGTTGCTCTGTTAAGCAGGATTCACTAAAAAAATT,10,30,14,27,27,33,27,35,27,30,30,33,32,35,6.44,0.0
hek293t,9398,1,14,AGGCTGAAACTAAGCTTTCTAACTTCTTTAGGGCTTCTGAAGTTTTCTCAGGAGGATAAATAAGGTACGTGAAAAAAATTCTAGTTGGTTTAACGCGTA,AGGCTGAAACTAAGCTTTCTAACTTCTTTAGAGTCCGTTTCGTCGGGCTTCTGAAGTTTTCTCAGGAGGATAAATAAGGTACGTGAAAAAAATTCTAGT,10,30,14,27,27,38,27,52,27,31,31,38,45,52,1.8,0.0
hek293t,9398,1,14,GGGGAGAAACTAAGCTTTCTAACTTCTTTAGGGCTTCTGAAGTTTTCTCAGGAGGATAAATAAGGTACAAAAAAATTCTAGTTGGTTTAACGCGTAACT,GGGGAGAAACTAAGCTTTCTAACTTCTTTAGAGTCCGTTTCGTCGGGCTTCTGAAGTTTTCTCAGGAGGATAAATAAGGTACAAAAAAATTCTAGTTGG,10,30,14,27,27,41,27,55,27,31,31,41,45,55,1.8,0.030525031
hek293t,9401,1,15,CTGTAATCAGGTGCTCACGATCTGCGGTACGGCATTCACTGACTCGCTGTCAGGGAAGCAATAGTATCCAAAAAAATTCTAGTTGGTTTAACGCGTAAC,CTGTAATCAGGTGCTCACGATCTGCGGTACGAATATATCCCATTGAGCATTCACTGACTCGCTGTCAGGGAAGCAATAGTATCCAAAAAAATTCTAGTT,10,30,14,27,27,39,27,54,27,32,32,39,47,54,63.83,3.95367984
hek293t,9401,1,15,GTCTCATCAGGTGCTCACGATCTGCGGTACGGCATTCACTGACTCGCTGTCAGGGAAGCAATAGTATCCTTGCAAAAAAATTCTAGTTGGTTTAACGCG,GTCTCATCAGGTGCTCACGATCTGCGGTACGAATATATCCCATTGAGCATTCACTGACTCGCTGTCAGGGAAGCAATAGTATCCTTGCAAAAAAATTCT,10,30,14,27,27,35,27,50,27,32,32,35,47,50,63.83,0.738916256
hek293t,17703,1,9,CTTTGTGCTACACCTGTCATCTGGATGGTAGGTACAAAGGAAGCAGTTATATTAAAGGTACTTGCAGGCAGAGAAAAAAAATTCTAGTTGGTTTAACGC,CTTTGTGCTACACCTGTCATCTGGATGGTAGGAGATTCCGCTACAAAGGAAGCAGTTATATTAAAGGTACTTGCAGGCAGAGAAAAAAAATTCTAGTTG,10,30,14,27,27,40,27,49,27,33,33,40,42,49,69.17,38.15169843
hek293t,17703,1,9,GGGCCTGCTACACCTGTCATCTGGATGGTAGGTACAAAGGAAGCAGTTATATTAAAGGTACTTGCAGGCAGAAAAAAATTCTAGTTGGTTTAACGCGTA,GGGCCTGCTACACCTGTCATCTGGATGGTAGGAGATTCCGCTACAAAGGAAGCAGTTATATTAAAGGTACTTGCAGGCAGAAAAAAATTCTAGTTGGTT,10,30,14,27,27,43,27,52,27,33,33,43,42,52,69.17,66.77388613
hek293t,9405,1,9,ATTGAAACTAAAAACATTCTTGCTCTCCGTGGGCCAGTGGTGTGTCAGCATCTCCTTTCTGCTGAACAAAAAAATTCTAGTTGGTTTAACGCGTAACTA,ATTGAAACTAAAAACATTCTTGCTCTCCGTGGTGCCTACTGGCCAGTGGTGTGTCAGCATCTCCTTTCTGCTGAACAAAAAAATTCTAGTTGGTTTAAC,10,30,14,27,27,47,27,56,27,32,32,47,41,56,32.64,22.42449923
hek293t,9405,1,9,ACAACAACTAAAAACATTCTTGCTCTCCGTGGGCCAGTGGTGTGTCAGCATCTCCTTTCTGCTGAACAGAGGAGTAAAAAAATTCTAGTTGGTTTAACG,ACAACAACTAAAAACATTCTTGCTCTCCGTGGTGCCTACTGGCCAGTGGTGTGTCAGCATCTCCTTTCTGCTGAACAGAGGAGTAAAAAAATTCTAGTT,10,30,14,27,27,39,27,48,27,32,32,39,41,48,32.64,16.55374517
hek293t,9407,1,14,CGCTCCCTGAGCAAGGCTGGCAGTTATCTAGGTTTTCTGCAGACATTAACAACTTGGATTCATAGCTAAAAAAATTCTAGTTGGTTTAACGCGTAACTA,CGCTCCCTGAGCAAGGCTGGCAGTTATCTAGGTTGAGGCATATTTGGATTCTGCAGACATTAACAACTTGGATTCATAGCTAAAAAAATTCTAGTTGGT,10,30,14,27,27,42,27,56,27,35,35,42,49,56,18.12,0.224089636
hek293t,9407,1,14,TGGGTCCTGAGCAAGGCTGGCAGTTATCTAGGTTTTCTGCAGACATTAACAACTTGGATTCATAGCTGAAAAAAAAAATTCTAGTTGGTTTAACGCGTA,TGGGTCCTGAGCAAGGCTGGCAGTTATCTAGGTTGAGGCATATTTGGATTCTGCAGACATTAACAACTTGGATTCATAGCTGAAAAAAAAAATTCTAGT,10,30,14,27,27,38,27,52,27,35,35,38,49,52,18.12,0.0
hek293t,894,1,6,ATGCCAGGAATTTAAAAGATTGCTGGGAATGGGACTCTGGCCAGTAAGCCCCCCCGGCTTAAAGACTAAAAAAAATTCTAGTTGGTTTAACGCGTAACT,ATGCCAGGAATTTAAAAGATTGCTGGGAATGGGACTCTGTAATAGGCCAGTAAGCCCCCCCGGCTTAAAGACTAAAAAAAATTCTAGTTGGTTTAACGC,10,30,14,27,27,49,27,55,27,39,39,49,45,55,2.89,0.375472358
hek293t,19899,1,2,TTGTTTGAAGGAAACGGGCAGTGCTTGTGGGGCACGTTCCAGTCCCACGTTTCCAGTGTGGCCTCATCCGCCTAAAAAAATTCTAGTTGGTTTAACGCG,TTGTTTGAAGGAAACGGGCAGTGCTTGTGGGGCACGTTCTCCAGTCCCACGTTTCCAGTGTGGCCTCATCCGCCTAAAAAAATTCTAGTTGGTTTAACG,10,30,14,27,27,48,27,50,27,38,38,48,40,50,61.65,77.99280749
hek293t,19899,1,2,CGGGTTGAAGGAAACGGGCAGTGCTTGTGGGGCACGTTCCAGTCCCACGTTTCCAGTGTGGCCTCATCAAAAAAATTCTAGTTGGTTTAACGCGTAACT,CGGGTTGAAGGAAACGGGCAGTGCTTGTGGGGCACGTTCTCCAGTCCCACGTTTCCAGTGTGGCCTCATCAAAAAAATTCTAGTTGGTTTAACGCGTAA,10,30,14,27,27,53,27,55,27,38,38,53,40,55,61.65,71.0406743
hek293t,9412,1,13,AATCGAATTCTGCAGCATTTTAATTATCTTGGTTCTATGAATTTTTGCTAAAGTGAGGAAGAACTGACAGTATTAGAAGAAAAAAATTCTAGTTGGTTT,AATCGAATTCTGCAGCATTTTAATTATCGGGGGATATGTTCTTGGTTCTATGAATTTTTGCTAAAGTGAGGAAGAACTGACAGTATTAGAAGAAAAAAA,10,30,14,27,27,31,27,44,27,28,28,31,41,44,1.5,0.0
hek293t,9412,1,13,AACATAATTCTGCAGCATTTTAATTATCTTGGTTCTATGAATTTTTGCTAAAGTGAGGAAGAACTGACAGTAAAAAAAATTCTAGTTGGTTTAACGCGT,AACATAATTCTGCAGCATTTTAATTATCGGGGGATATGTTCTTGGTTCTATGAATTTTTGCTAAAGTGAGGAAGAACTGACAGTAAAAAAAATTCTAGT,10,30,14,27,27,38,27,51,27,28,28,38,41,51,1.5,0.066934404
hek293t,5633,1,2,CCGCCACTCTGCTGAATCTGAGTGGGTTCAGGAATCTCCTGGGACTGGCCATACCGGGGAGTAGGGTCCAGAATCACAAAAAAATTCTAGTTGGTTTAA,CCGCCACTCTGCTGAATCTGAGTGGGTTAGCAGGAATCTCCTGGGACTGGCCATACCGGGGAGTAGGGTCCAGAATCACAAAAAAATTCTAGTTGGTTT,10,30,14,27,27,44,27,46,27,29,29,44,31,46,18.23,69.29437
hek293t,5633,1,2,AGGCGACTCTGCTGAATCTGAGTGGGTTCAGGAATCTCCTGGGACTGGCCATACCGGGGAGTAGGGTCCAGAATCACCTGAGTGCTGGCAAAAAAATTC,AGGCGACTCTGCTGAATCTGAGTGGGTTAGCAGGAATCTCCTGGGACTGGCCATACCGGGGAGTAGGGTCCAGAATCACCTGAGTGCTGGCAAAAAAAT,10,30,14,27,27,32,27,34,27,29,29,32,31,34,18.23,0.477897252
hek293t,9416,1,4,GATCACCACTCTTGTCCAAGGAAGCAAAGAGGTCTGGAGTAGGCAGGTGGTTCCTGGTAATCGCACACGTAAAAAAATTCTAGTTGGTTTAACGCGTAA,GATCACCACTCTTGTCCAAGGAAGCAAAGAGGTAGACCTGGAGTAGGCAGGTGGTTCCTGGTAATCGCACACGTAAAAAAATTCTAGTTGGTTTAACGC,10,30,14,27,27,49,27,53,27,34,34,49,38,53,69.75,62.32997038
hek293t,9416,1,4,CCAAACCACTCTTGTCCAAGGAAGCAAAGAGGTCTGGAGTAGGCAGGTGGTTCCTGGTAATCGCACACGTGTCCCACTTGGTAAAAAAATTCTAGTTGG,CCAAACCACTCTTGTCCAAGGAAGCAAAGAGGTAGACCTGGAGTAGGCAGGTGGTTCCTGGTAATCGCACACGTGTCCCACTTGGTAAAAAAATTCTAG,10,30,14,27,27,37,27,41,27,34,34,37,38,41,69.75,0.220022002
hek293t,9418,1,7,GAGTGCCATTTCTGTTTATTTCCAGGAGCTGGTTGTTCATTTTTGAGGAAGGGATTTTGTTTTGCTTTTAAAGTAAAAAAATTCTAGTTGGTTTAACGC,GAGTGCCATTTCTGTTTATTTCCAGGAGCTGGTTTAAGCCAGTTCATTTTTGAGGAAGGGATTTTGTTTTGCTTTTAAAGTAAAAAAATTCTAGTTGGT,10,30,14,27,27,42,27,49,27,35,35,42,42,49,5.17,0.135226504
hek293t,9420,1,9,ACTCCGTCACATGCAAATCACTCCATATGAGGCATCAGGATGTCAAAAAAGAGCATTTAATCACCCTAAAAAAAATTCTAGTTGGTTTAACGCGTAACT,ACTCCGTCACATGCAAATCACTCCATATGAGGCATTGGAAGAGACAGGATGTCAAAAAAGAGCATTTAATCACCCTAAAAAAAATTCTAGTTGGTTTAA,10,30,14,27,27,46,27,55,27,36,36,46,45,55,61.55,2.812029495
hek293t,9422,1,7,TTAATTTGTTTCTGATTTACCTAATTTAAAGGTCACTAAGCAAGCAACATGTGCTGATGATCACAAAACTCTAAAAAAATTCTAGTTGGTTTAACGCGT,TTAATTTGTTTCTGATTTACCTAATTTATGAGAACAAGGTCACTAAGCAAGCAACATGTGCTGATGATCACAAAACTCTAAAAAAATTCTAGTTGGTTT,10,30,14,27,27,44,27,51,27,29,29,44,36,51,1.29,0.445930881
hek293t,9422,1,7,CCAGCTTGTTTCTGATTTACCTAATTTAAAGGTCACTAAGCAAGCAACATGTGCTGATGATCACAAAACTCTGTGTTTTGGCCAAAAAAAATTCTAGTT,CCAGCTTGTTTCTGATTTACCTAATTTATGAGAACAAGGTCACTAAGCAAGCAACATGTGCTGATGATCACAAAACTCTGTGTTTTGGCCAAAAAAAAT,10,30,14,27,27,32,27,39,27,29,29,32,36,39,1.29,0.0
hek293t,20882,1,5,AACACGTACACTGCCTTTGCAAATGCACAAGGAACTCCTGGGACACGTGAAGGTAAAGCACGCACTGTGTCCCGTAAAAAAATTCTAGTTGGTTTAACG,AACACGTACACTGCCTTTGCAAATGCAACGATCAAGGAACTCCTGGGACACGTGAAGGTAAAGCACGCACTGTGTCCCGTAAAAAAATTCTAGTTGGTT,10,30,14,27,27,43,27,48,27,28,28,43,33,48,50.64,37.95267351
hek293t,20882,1,5,GTTACGTACACTGCCTTTGCAAATGCACAAGGAACTCCTGGGACACGTGAAGGTAAAGCACGCACTGTGTCCCGTCCTCCAAAAAAATTCTAGTTGGTT,GTTACGTACACTGCCTTTGCAAATGCAACGATCAAGGAACTCCTGGGACACGTGAAGGTAAAGCACGCACTGTGTCCCGTCCTCCAAAAAAATTCTAGT,10,30,14,27,27,38,27,43,27,28,28,38,33,43,50.64,66.49881574
hek293t,9428,1,3,CCATTCGAGTCTTTGCTAGCGTGTAGCCAAGGACTTTACTGACTTTAACTGCAGGTAAAATACTCTTTAGTCAGAGAAAAAAATTCTAGTTGGTTTAAC,CCATTCGAGTCTTTGCTAGCGTGTAGCCAAGGACTTTACTCTTGACTTTAACTGCAGGTAAAATACTCTTTAGTCAGAGAAAAAAATTCTAGTTGGTTT,10,30,14,27,27,44,27,47,27,41,41,44,44,47,33.9,0.634920635
hek293t,9428,1,3,GGGCGCGAGTCTTTGCTAGCGTGTAGCCAAGGACTTTACTGACTTTAACTGCAGGTAAAATACTAAAAAAATTCTAGTTGGTTTAACGCGTAACTAGAT,GGGCGCGAGTCTTTGCTAGCGTGTAGCCAAGGACTTTACTCTTGACTTTAACTGCAGGTAAAATACTAAAAAAATTCTAGTTGGTTTAACGCGTAACTA,10,30,14,27,27,56,27,59,27,41,41,56,44,59,33.9,12.48616914
hek293t,20721,1,12,GCTCCAGCTTTATGCTGTGTTATTCTATTTGGTGAAAATTAAATACAATTTCCATCCTTGCGGATAAAAAAATTCTAGTTGGTTTAACGCGTAACTAGA,GCTCCAGCTTTATGCTGTGTTATTCTATTTAGCCCACTGTCAGGTGAAAATTAAATACAATTTCCATCCTTGCGGATAAAAAAATTCTAGTTGGTTTAA,10,30,14,27,27,46,27,58,27,31,31,46,43,58,6.7,0.0
hek293t,20721,1,12,CGGGCAGCTTTATGCTGTGTTATTCTATTTGGTGAAAATTAAATACAATTTCCATCCTTGCGGATTACAGGACGAAAAAAAAAATTCTAGTTGGTTTAA,CGGGCAGCTTTATGCTGTGTTATTCTATTTAGCCCACTGTCAGGTGAAAATTAAATACAATTTCCATCCTTGCGGATTACAGGACGAAAAAAAAAATTC,10,30,14,27,27,34,27,46,27,31,31,34,43,46,6.7,0.0
hek293t,9432,1,1,CTAGATAAATAATACCATGGCTGACAGGGTGGATTAATGTTCTCTGAAAAGTGAAAATCAAGAATTATATGCAGCCATAAAAAAATTCTAGTTGGTTTA,CTAGATAAATAATACCATGGCTGACAGGGTGGAATTAATGTTCTCTGAAAAGTGAAAATCAAGAATTATATGCAGCCATAAAAAAATTCTAGTTGGTTT,10,30,14,27,27,44,27,45,27,34,34,44,35,45,53.02,79.37752046
hek293t,9432,1,1,ATCCGTAAATAATACCATGGCTGACAGGGTGGATTAATGTTCTCTGAAAAGTGAAAATCAAGAATTATATGCAAAAAAAATTCTAGTTGGTTTAACGCG,ATCCGTAAATAATACCATGGCTGACAGGGTGGAATTAATGTTCTCTGAAAAGTGAAAATCAAGAATTATATGCAAAAAAAATTCTAGTTGGTTTAACGC,10,30,14,27,27,49,27,50,27,34,34,49,35,50,53.02,76.96018695
hek293t,9434,1,13,CCACAATCGGACACAGGTGAGCATCCCCCTGGCCAAGAATATTTGCAAAGCCCCCCCGCGACACAAAAAAAAATTCTAGTTGGTTTAACGCGTAACTAG,CCACAATCGGACACAGGTGAGCATCCCCCTGGCCAACACACCTAAGGCTGAATATTTGCAAAGCCCCCCCGCGACACAAAAAAAAATTCTAGTTGGTTT,10,30,14,27,27,44,27,57,27,37,37,44,50,57,63.71,0.0
hek293t,9434,1,13,TGTATATCGGACACAGGTGAGCATCCCCCTGGCCAAGAATATTTGCAAAGCCCCCCCGCGACACAAAGCAAAAAAAATTCTAGTTGGTTTAACGCGTAA,TGTATATCGGACACAGGTGAGCATCCCCCTGGCCAACACACCTAAGGCTGAATATTTGCAAAGCCCCCCCGCGACACAAAGCAAAAAAAATTCTAGTTG,10,30,14,27,27,40,27,53,27,37,37,40,50,53,63.71,2.563348021
hek293t,9436,1,3,GGGGGTGCATGAATACACAGTGCTTAGCATGGATCTGCTTAAAAAATGGTGCGGGGAGTAAGGAAAGGATGGGGATGCTAAAAAAATTCTAGTTGGTTT,GGGGGTGCATGAATACACAGTGCTTAGCATGGAACTTCTGCTTAAAAAATGGTGCGGGGAGTAAGGAAAGGATGGGGATGCTAAAAAAATTCTAGTTGG,10,30,14,27,27,41,27,44,27,34,34,41,37,44,60.74,66.8197371
hek293t,9436,1,3,AGAAGTGCATGAATACACAGTGCTTAGCATGGATCTGCTTAAAAAATGGTGCGGGGAGTAAGGAAAGGATGGGGATAAAAAAATTCTAGTTGGTTTAAC,AGAAGTGCATGAATACACAGTGCTTAGCATGGAACTTCTGCTTAAAAAATGGTGCGGGGAGTAAGGAAAGGATGGGGATAAAAAAATTCTAGTTGGTTT,10,30,14,27,27,44,27,47,27,34,34,44,37,47,60.74,82.89659982
hek293t,19187,1,5,GGGGTGGCTTTTGTTCTGTGTTACAGATGAGGCTAAGATTTAGTTTAATATGCTAACTCATGTTAGACAACAAACTTTTTAAAAAAATTCTAGTTGGTT,GGGGTGGCTTTTGTTCTGTGTTACAGACATTCTGAGGCTAAGATTTAGTTTAATATGCTAACTCATGTTAGACAACAAACTTTTTAAAAAAATTCTAGT,10,30,14,27,27,38,27,43,27,28,28,38,33,43,42.2,75.55060338
hek293t,19187,1,5,CACACGGCTTTTGTTCTGTGTTACAGATGAGGCTAAGATTTAGTTTAATATGCTAACTCATGTTAGACAACAAACTTTTTCTTAAAAAAATTCTAGTTG,CACACGGCTTTTGTTCTGTGTTACAGACATTCTGAGGCTAAGATTTAGTTTAATATGCTAACTCATGTTAGACAACAAACTTTTTCTTAAAAAAATTCT,10,30,14,27,27,35,27,40,27,28,28,35,33,40,42.2,71.61481963
hek293t,19865,1,5,AAGCTTTTTTGTAGCTGTTGCTAAAGGCTAGGCTTAGCCACAATAACTTTGCTAAAGGTCACCAGAAAGTTCTGGTTCAGAAAAAAATTCTAGTTGGTT,AAGCTTTTTTGTAGCTGTTGCTAAAGGGAAGTCTAGGCTTAGCCACAATAACTTTGCTAAAGGTCACCAGAAAGTTCTGGTTCAGAAAAAAATTCTAGT,10,30,14,27,27,38,27,43,27,28,28,38,33,43,43.44,30.65876376
hek293t,9442,1,14,GTCGAGTATCAGGCTTTAATTATTTGTATTGGGGTGTTTGTACCTGAAGAGCCTTTGATATTTGTGCCTAAAAAAATTCTAGTTGGTTTAACGCGTAAC,GTCGAGTATCAGGCTTTAATTATTTGTATTGGGGTGGAGATCATGTACTCTTTGTACCTGAAGAGCCTTTGATATTTGTGCCTAAAAAAATTCTAGTTG,10,30,14,27,27,40,27,54,27,37,37,40,51,54,0.21,0.0
hek293t,9443,1,8,TTACAGCATTTTCCCTACCGCTCCTGCTACGGCGATGCCGAGCGGTCGGGGCCGGGGTCAGAGCAAAAAAATTCTAGTTGGTTTAACGCGTAACTAGAT,TTACAGCATTTTCCCTACCGCTCCTGCTACGGCGATGCCGTTCAACCAAGCGGTCGGGGCCGGGGTCAGAGCAAAAAAATTCTAGTTGGTTTAACGCGT,10,30,14,27,27,51,27,59,27,41,41,51,49,59,51.19,10.79662727
hek293t,9443,1,8,CACGTGCATTTTCCCTACCGCTCCTGCTACGGCGATGCCGAGCGGTCGGGGCCGGGGTCAGAGCTCGGTGGAAAAAAATTCTAGTTGGTTTAACGCGTA,CACGTGCATTTTCCCTACCGCTCCTGCTACGGCGATGCCGTTCAACCAAGCGGTCGGGGCCGGGGTCAGAGCTCGGTGGAAAAAAATTCTAGTTGGTTT,10,30,14,27,27,44,27,52,27,41,41,44,49,52,51.19,0.0
hek293t,9445,1,10,GCGTTGTTTCTGGGAATGTTCCAGGTACGAGGATGTGTCCATCAGAATGAAATGGTTTGTGATCTATCAGTTGCGGTAAAAAAATTCTAGTTGGTTTAA,GCGTTGTTTCTGGGAATGTTCCAGGTACCCTACTGAGCGAGGATGTGTCCATCAGAATGAAATGGTTTGTGATCTATCAGTTGCGGTAAAAAAATTCTA,10,30,14,27,27,36,27,46,27,29,29,36,39,46,66.57,21.63988999
hek293t,9447,1,11,AAGCCAAAGCCAAGCCATCATTAACAATCTGGTTTTGTTCCTTCCTTATGAGGGAATAGCGTATACCCTCACAAAAAAAATTCTAGTTGGTTTAACGCG,AAGCCAAAGCCAAGCCATCATTAACAATCTGTACACTAAAGCGTTTTGTTCCTTCCTTATGAGGGAATAGCGTATACCCTCACAAAAAAAATTCTAGTT,10,30,14,27,27,39,27,50,27,32,32,39,43,50,12.21,0.999265553
hek293t,9447,1,11,AACGTAAAGCCAAGCCATCATTAACAATCTGGTTTTGTTCCTTCCTTATGAGGGAATAGCGTATACCCTCACATTCGAAAAAAATTCTAGTTGGTTTAA,AACGTAAAGCCAAGCCATCATTAACAATCTGTACACTAAAGCGTTTTGTTCCTTCCTTATGAGGGAATAGCGTATACCCTCACATTCGAAAAAAATTCT,10,30,14,27,27,35,27,46,27,32,32,35,43,46,12.21,0.0
hek293t,3917,1,11,GCGATCTTATAATTGAAATACGCATTTAAAGGTACAATTTTTCACTTGCAAGTTGGTGAATCTAAAAAAAATTCTAGTTGGTTTAACGCGTAACTAGAT,GCGATCTTATAATTGAAATACGCATTTAAAGGTCTGAGGAACATACAATTTTTCACTTGCAAGTTGGTGAATCTAAAAAAAATTCTAGTTGGTTTAACG,10,30,14,27,27,48,27,59,27,33,33,48,44,59,5.39,2.885110931
hek293t,9451,1,8,CACCAAAGTCACGGTTTGGTGCGGTGCTGAGGCTCCTCCGCTGTTAAATAATGTTGGGGTAATAGAGTAGAATTGTCTGAAAAAAAATTCTAGTTGGTT,CACCAAAGTCACGGTTTGGTGCGGTGCCCCGAGGTTGAGGCTCCTCCGCTGTTAAATAATGTTGGGGTAATAGAGTAGAATTGTCTGAAAAAAAATTCT,10,30,14,27,27,35,27,43,27,28,28,35,36,43,30.56,13.74072369
hek293t,9453,1,4,CCGACGACAGATGTCTTCCCTCCTACCTTTGGGCTAACACCTGTGTCTTTGTGGTGAATTTGATCAGAGCATAAAAAAATTCTAGTTGGTTTAACGCGT,CCGACGACAGATGTCTTCCCTCCTACCTTTGTCGCGGCTAACACCTGTGTCTTTGTGGTGAATTTGATCAGAGCATAAAAAAATTCTAGTTGGTTTAAC,10,30,14,27,27,47,27,51,27,32,32,47,36,51,35.52,85.58276919
hek293t,9454,1,5,CTATATCAGGCCTTACATCTGGCTTTTTGTGGTTGCTCTTATTGACCCAATGCCTGGTGCTGTAGCTGGTGGGCTTAAAAAAATTCTAGTTGGTTTAAC,CTATATCAGGCCTTACATCTGGCTTTCCCCGTTGTGGTTGCTCTTATTGACCCAATGCCTGGTGCTGTAGCTGGTGGGCTTAAAAAAATTCTAGTTGGT,10,30,14,27,27,42,27,47,27,27,27,42,32,47,20.28,17.50670809
hek293t,9454,1,5,CGGCATCAGGCCTTACATCTGGCTTTTTGTGGTTGCTCTTATTGACCCAATGCCTGGTGCTGTAGCTGGTGGGCTTGGGGCAAAAAAATTCTAGTTGGT,CGGCATCAGGCCTTACATCTGGCTTTCCCCGTTGTGGTTGCTCTTATTGACCCAATGCCTGGTGCTGTAGCTGGTGGGCTTGGGGCAAAAAAATTCTAG,10,30,14,27,27,37,27,42,27,27,27,37,32,42,20.28,16.32408315
hek293t,9456,1,2,CAAAACCAGGCACCAGGAAGTGGACAAGGAGGGGACTGGTTTTTAATTTTCTCCCTCTTACAGTTTCAAAAAAAATTCTAGTTGGTTTAACGCGTAACT,CAAAACCAGGCACCAGGAAGTGGACAAGGAGGGGACTCCGGTTTTTAATTTTCTCCCTCTTACAGTTTCAAAAAAAATTCTAGTTGGTTTAACGCGTAA,10,30,14,27,27,53,27,55,27,38,38,53,40,55,70.87,68.53285153
hek293t,9459,1,3,TCTACTTCTGATAGGTACAAATGTATGGTAGGTATGTGTATAAAATGCTGTCTGTCAGTCTCTGAACATGTAAGAAAAAAATTCTAGTTGGTTTAACGC,TCTACTTCTGATAGGTACAAATGTATGGTAGGTATTCCGTGTATAAAATGCTGTCTGTCAGTCTCTGAACATGTAAGAAAAAAATTCTAGTTGGTTTAA,10,30,14,27,27,46,27,49,27,36,36,46,39,49,68.86,24.08722604
hek293t,9461,1,10,GATACTTGTTTTGTGCATGCGAATTACAGTGGTCTTTGATGTTCATGAGCAGGTTTAAAACGTGGCTTCTTTGCAAAAAAATTCTAGTTGGTTTAACGC,GATACTTGTTTTGTGCATGCGAATTACAGTGTTTAGACGCGGTCTTTGATGTTCATGAGCAGGTTTAAAACGTGGCTTCTTTGCAAAAAAATTCTAGTT,10,30,14,27,27,39,27,49,27,32,32,39,42,49,38.09,2.285863715
hek293t,9461,1,10,GCCGCTTGTTTTGTGCATGCGAATTACAGTGGTCTTTGATGTTCATGAGCAGGTTTAAAACGTGGCAAAAAAATTCTAGTTGGTTTAACGCGTAACTAG,GCCGCTTGTTTTGTGCATGCGAATTACAGTGTTTAGACGCGGTCTTTGATGTTCATGAGCAGGTTTAAAACGTGGCAAAAAAATTCTAGTTGGTTTAAC,10,30,14,27,27,47,27,57,27,32,32,47,42,57,38.09,9.249957298
hek293t,9465,1,12,TGCCATACCCAAAGACTGAATTAACAGGTTGGCTTCTGAAATTCAGTTAAGTATCCCTTAGGTGATTGTCTAAAAAAAATTCTAGTTGGTTTAACGCGT,TGCCATACCCAAAGACTGAATTAACAGGTTGGCTTGAGGCCTACAGCCTGAAATTCAGTTAAGTATCCCTTAGGTGATTGTCTAAAAAAAATTCTAGTT,10,30,14,27,27,39,27,51,27,36,36,39,48,51,42.99,0.0
hek293t,9466,1,5,CAGACGAGGTATGAATGAGATGGCAAATGAGGTGCTCCTTTTCAGCATGCAGATCTTCCTGGCCTCTGGAAGTGTAGCTGACCTAAAAAAATTCTAGTT,CAGACGAGGTATGAATGAGATGGCAACTTGTATGAGGTGCTCCTTTTCAGCATGCAGATCTTCCTGGCCTCTGGAAGTGTAGCTGACCTAAAAAAATTC,10,30,14,27,27,34,27,39,27,27,27,34,32,39,68.13,86.61565554
hek293t,9466,1,5,ATGGGGAGGTATGAATGAGATGGCAAATGAGGTGCTCCTTTTCAGCATGCAGATCTTCCTGGCCTCTGGAAGTGTAGCTGAAAAAAAATTCTAGTTGGT,ATGGGGAGGTATGAATGAGATGGCAACTTGTATGAGGTGCTCCTTTTCAGCATGCAGATCTTCCTGGCCTCTGGAAGTGTAGCTGAAAAAAAATTCTAG,10,30,14,27,27,37,27,42,27,27,27,37,32,42,68.13,80.5004847
hek293t,9469,1,6,CATAGGCAAGTATTAAAATGCATGAGAACTGGAATTGCTTCCTTTCAAATACTCTGAGGAGTTTCTTTCAAATTTCCAAATGAAAAAAAATTCTAGTTG,CATAGGCAAGTATTAAAATGCATGAGAACTACATCGGGAATTGCTTCCTTTCAAATACTCTGAGGAGTTTCTTTCAAATTTCCAAATGAAAAAAAATTC,10,30,14,27,27,34,27,40,27,31,31,34,37,40,19.46,0.0
hek293t,9471,1,8,GGGCTGTTATTCAGAGTTTGGAAGCAAGATGGAAGCGATTATTTCCCGAAAAAATCGCTAAGCTGGCAAAAAAATTCTAGTTGGTTTAACGCGTAACTA,GGGCTGTTATTCAGAGTTTGGAAGCAAGATGGAAGCGCAGTCGTCATTATTTCCCGAAAAAATCGCTAAGCTGGCAAAAAAATTCTAGTTGGTTTAACG,10,30,14,27,27,48,27,56,27,38,38,48,46,56,31.27,9.12822916
hek293t,3640,1,14,AGCTGGGGAAAATGGTGTCATCACCAGCTTGGACTGAAAGAAAGACGATGTGAGCCTGAACTGTTGCTCAAAAAAATTCTAGTTGGTTTAACGCGTAAC,AGCTGGGGAAAATGGTGTCATCACCAGCTTGGACTGCACGGACAACAGTAAAAGAAAGACGATGTGAGCCTGAACTGTTGCTCAAAAAAATTCTAGTTG,10,30,14,27,27,40,27,54,27,37,37,40,51,54,51.29,1.36079026
hek293t,9473,1,8,AACTCGTGGAGAAAGAGTCTGCACAGGAGAGGCTTTATGGGAGCTTCACACTGAACTACAATGCAAAAAAATTCTAGTTGGTTTAACGCGTAACTAGAT,AACTCGTGGAGAAAGAGTCTGCACAGGAGAGGCTTTATGGCAAAGCCCGAGCTTCACACTGAACTACAATGCAAAAAAATTCTAGTTGGTTTAACGCGT,10,30,14,27,27,51,27,59,27,41,41,51,49,59,57.25,4.915550437
hek293t,9474,1,4,TCCCCAAAGTCCCCTTCAGACCTCCAACAAGGAGGTTTTATCCAATTTGGGAAAACAGGAGCAATACGTGGAAAAAAATTCTAGTTGGTTTAACGCGTA,TCCCCAAAGTCCCCTTCAGACCTCCAACAAGGAGGTTAGTGTTATCCAATTTGGGAAAACAGGAGCAATACGTGGAAAAAAATTCTAGTTGGTTTAACG,10,30,14,27,27,48,27,52,27,38,38,48,42,52,64.64,4.333308828
hek293t,9476,1,1,AGATGTGCTCCCAGCTCTGCTTGCCGATGTGGGGCTTCTTGGGGCTCGACAGGCAGCGGGAGACCCTGCCTCTCGGGAAAAAAATTCTAGTTGGTTTAA,AGATGTGCTCCCAGCTCTGCTTGCCGATGATGGGGCTTCTTGGGGCTCGACAGGCAGCGGGAGACCCTGCCTCTCGGGAAAAAAATTCTAGTTGGTTTA,10,30,14,27,27,45,27,46,27,30,30,45,31,46,35.47,48.17076308
hek293t,9476,1,1,ACGAATGCTCCCAGCTCTGCTTGCCGATGTGGGGCTTCTTGGGGCTCGACAGGCAGCGGGAGACCCTGCCTCTCGGGGCTGCCCGAAAAAAATTCTAGT,ACGAATGCTCCCAGCTCTGCTTGCCGATGATGGGGCTTCTTGGGGCTCGACAGGCAGCGGGAGACCCTGCCTCTCGGGGCTGCCCGAAAAAAATTCTAG,10,30,14,27,27,37,27,38,27,30,30,37,31,38,35.47,52.64054916
hek293t,19905,1,1,GGATGACGCAATTGGTTTTTGACCCATTTTGGAATTCTGTTGGGTGACTGCAGAGCTGCTGGTATGCACTTGCTTTATTTTGATAAAAAAAATTCTAGT,GGATGACGCAATTGGTTTTTGACCCATTTTGGAAATTCTGTTGGGTGACTGCAGAGCTGCTGGTATGCACTTGCTTTATTTTGATAAAAAAAATTCTAG,10,30,14,27,27,37,27,38,27,34,34,37,35,38,0.39,1.379410236
hek293t,19905,1,1,CCCATACGCAATTGGTTTTTGACCCATTTTGGAATTCTGTTGGGTGACTGCAGAGCTGCTGGTATGCACTTGCTTTATAAAAAAATTCTAGTTGGTTTA,CCCATACGCAATTGGTTTTTGACCCATTTTGGAAATTCTGTTGGGTGACTGCAGAGCTGCTGGTATGCACTTGCTTTATAAAAAAATTCTAGTTGGTTT,10,30,14,27,27,44,27,45,27,34,34,44,35,45,0.39,70.21173145
hek293t,9483,1,11,TATGAGGAATTTATTTTTATTTTAGGTGTAGGAAAGTTCAGTTTTTATTATTCCAACTGCTTAACTTGGGTGCAAGTAAAAAAAATTCTAGTTGGTTTA,TATGAGGAATTTATTTTTATTTTAGGAGGTCCGCCCATGTAGGAAAGTTCAGTTTTTATTATTCCAACTGCTTAACTTGGGTGCAAGTAAAAAAAATTC,10,30,14,27,27,34,27,45,27,27,27,34,38,45,-2.09,0.0
hek293t,9485,1,3,ATAACCTGATTCAGACCAGCTCCCTATGGAGGGCAGAAGGCTGAACGCCTGGGCTCTGGGCTCAGCTACGGATGTCATGTACGCTATAAAAAAATTCTA,ATAACCTGATTCAGACCAGCTCCCTATGGTTTAGGGCAGAAGGCTGAACGCCTGGGCTCTGGGCTCAGCTACGGATGTCATGTACGCTATAAAAAAATT,10,30,14,27,27,33,27,36,27,30,30,33,33,36,61.69,8.843385504
hek293t,9485,1,3,ACCATCTGATTCAGACCAGCTCCCTATGGAGGGCAGAAGGCTGAACGCCTGGGCTCTGGGCTCAGCTACGGATGTCATGTAAAAAAATTCTAGTTGGTT,ACCATCTGATTCAGACCAGCTCCCTATGGTTTAGGGCAGAAGGCTGAACGCCTGGGCTCTGGGCTCAGCTACGGATGTCATGTAAAAAAATTCTAGTTG,10,30,14,27,27,40,27,43,27,30,30,40,33,43,61.69,45.74328218
hek293t,9489,1,11,GGATGTTTGCTCACAGCTAGATACCAATTAGGCAGTCCCCGGACGCTGAAATGCCAACTAACTGTCAAGAAAAAAATTCTAGTTGGTTTAACGCGTAAC,GGATGTTTGCTCACAGCTAGATACCAATTAGGCAGTAACTCATGAATCCCCGGACGCTGAAATGCCAACTAACTGTCAAGAAAAAAATTCTAGTTGGTT,10,30,14,27,27,43,27,54,27,36,36,43,47,54,26.65,0.489427625
hek293t,9490,1,3,TGTGGAGACTGCCTAATCATGAAGTTAAAAGGGAGTCCAAGTGGACTGTTAAAGCTTGGCTAATATATAAAAAAAATTCTAGTTGGTTTAACGCGTAAC,TGTGGAGACTGCCTAATCATGAAGTTAAAAGGGAGTCCAATAAGTGGACTGTTAAAGCTTGGCTAATATATAAAAAAAATTCTAGTTGGTTTAACGCGT,10,30,14,27,27,51,27,54,27,41,41,51,44,54,6.25,0.81300813
hek293t,9494,1,14,TCACACATGCTGCAGAGCCTGGTGCCAGCTGGTGAGGGCCTACAGGAGTTTGATGGCCACCGTGACTTTCAAAAAAATTCTAGTTGGTTTAACGCGTAA,TCACACATGCTGCAGAGCCTGGTGCCAGCTGGTGAATTTAGACTATATTGGGCCTACAGGAGTTTGATGGCCACCGTGACTTTCAAAAAAATTCTAGTT,10,30,14,27,27,39,27,53,27,36,36,39,50,53,29.88,0.0
hek293t,9495,1,13,CTGCGATCACTTTTGTGTAGAAAGAAATTAGGAAGTTTGACACCAAATGGTGCCACTCAATGTCTTTGTAAAAAAAAATTCTAGTTGGTTTAACGCGTA,CTGCGATCACTTTTGTGTAGAAAGAAATATGCGGTATACGATAGGAAGTTTGACACCAAATGGTGCCACTCAATGTCTTTGTAAAAAAAAATTCTAGTT,10,30,14,27,27,39,27,52,27,29,29,39,42,52,21.84,0.580721634
hek293t,9495,1,13,ACGCAATCACTTTTGTGTAGAAAGAAATTAGGAAGTTTGACACCAAATGGTGCCACTCAATGTCTTTGTAAACAAAAAAAATTCTAGTTGGTTTAACGC,ACGCAATCACTTTTGTGTAGAAAGAAATATGCGGTATACGATAGGAAGTTTGACACCAAATGGTGCCACTCAATGTCTTTGTAAACAAAAAAAATTCTA,10,30,14,27,27,36,27,49,27,29,29,36,42,49,21.84,0.027166531
hek293t,9497,1,10,AGACCAATGTACAGCTTAACTTCTGTCAAAGGCATCTAAGAAAGAAAACAATTATGTATTCCTGAGTACTCAGCATAAAAAAAATTCTAGTTGGTTTAA,AGACCAATGTACAGCTTAACTTCTGTCAAACAGGAACTAAGGCATCTAAGAAAGAAAACAATTATGTATTCCTGAGTACTCAGCATAAAAAAAATTCTA,10,30,14,27,27,36,27,46,27,29,29,36,39,46,40.16,0.086879301
hek293t,9497,1,10,GTTTTAATGTACAGCTTAACTTCTGTCAAAGGCATCTAAGAAAGAAAACAATTATGTATTCCTGAGTACTCAGCAAAAAAATTCTAGTTGGTTTAACGC,GTTTTAATGTACAGCTTAACTTCTGTCAAACAGGAACTAAGGCATCTAAGAAAGAAAACAATTATGTATTCCTGAGTACTCAGCAAAAAAATTCTAGTT,10,30,14,27,27,39,27,49,27,29,29,39,39,49,40.16,1.133330923
hek293t,9501,1,2,GTGAAACTTCACAAAATGTGTGTGTGATGGGGTAAAGATTTCTGATCTTATGAATATGCAATACACCTTTTGTGTTTAAGAAAAAAAATTCTAGTTGGT,GTGAAACTTCACAAAATGTGTGTGTGATGGGGTAAAATGATTTCTGATCTTATGAATATGCAATACACCTTTTGTGTTTAAGAAAAAAAATTCTAGTTG,10,30,14,27,27,40,27,42,27,37,37,40,39,42,24.03,0.0
hek293t,9501,1,2,CATTAACTTCACAAAATGTGTGTGTGATGGGGTAAAGATTTCTGATCTTATGAATATGCAATACACCTTTTGTGAAAAAAATTCTAGTTGGTTTAACGC,CATTAACTTCACAAAATGTGTGTGTGATGGGGTAAAATGATTTCTGATCTTATGAATATGCAATACACCTTTTGTGAAAAAAATTCTAGTTGGTTTAAC,10,30,14,27,27,47,27,49,27,37,37,47,39,49,24.03,6.52491523
hek293t,9503,1,1,AGGACTAGAACAGTTGTAAGCCAATGCAAAGGATTAGAAAACTATGTATCATCTGTAAAATTACTTGTGAAAACTTATCAACAAAAAAATTCTAGTTGG,AGGACTAGAACAGTTGTAAGCCAATGCAAAAGGATTAGAAAACTATGTATCATCTGTAAAATTACTTGTGAAAACTTATCAACAAAAAAATTCTAGTTG,10,30,14,27,27,40,27,41,27,30,30,40,31,41,61.2,2.140129171
hek293t,9503,1,1,AAGGCTAGAACAGTTGTAAGCCAATGCAAAGGATTAGAAAACTATGTATCATCTGTAAAATTACTTGTGAAAACTTATCAACCCCAATTAAAAAAATTC,AAGGCTAGAACAGTTGTAAGCCAATGCAAAAGGATTAGAAAACTATGTATCATCTGTAAAATTACTTGTGAAAACTTATCAACCCCAATTAAAAAAATT,10,30,14,27,27,33,27,34,27,30,30,33,31,34,61.2,0.331046106
hek293t,9505,1,4,AATTTTAATAGAATTGTTCACAGTCTTCCTGGAAAGAACTAAATCCTGTTTGTGTCTTTCTTTTTTCCCCTAAAAAAATTCTAGTTGGTTTAACGCGTA,AATTTTAATAGAATTGTTCACAGTCTTCCTGGAAAGAAGTAACTAAATCCTGTTTGTGTCTTTCTTTTTTCCCCTAAAAAAATTCTAGTTGGTTTAACG,10,30,14,27,27,48,27,52,27,38,38,48,42,52,11.1,59.38489823
hek293t,9505,1,4,GTTCGTAATAGAATTGTTCACAGTCTTCCTGGAAAGAACTAAATCCTGTTTGTGTCTTTCTTTTTTCCCCTCACAAAAAAATTCTAGTTGGTTTAACGC,GTTCGTAATAGAATTGTTCACAGTCTTCCTGGAAAGAAGTAACTAAATCCTGTTTGTGTCTTTCTTTTTTCCCCTCACAAAAAAATTCTAGTTGGTTTA,10,30,14,27,27,45,27,49,27,38,38,45,42,49,11.1,5.209279987
hek293t,9507,1,1,TCGCACCCCAGTTGGCTTATGTAAACAGCTGGACGGTTGTGTTTAGAGCTCATTTTGGGGGAGGTTTTTTGGCAAAAGTATTTAAAAAAATTCTAGTTG,TCGCACCCCAGTTGGCTTATGTAAACAGCTGCGACGGTTGTGTTTAGAGCTCATTTTGGGGGAGGTTTTTTGGCAAAAGTATTTAAAAAAATTCTAGTT,10,30,14,27,27,39,27,40,27,32,32,39,33,40,40.32,62.89007602
hek293t,9507,1,1,TAGTCCCCCAGTTGGCTTATGTAAACAGCTGGACGGTTGTGTTTAGAGCTCATTTTGGGGGAGGTTTTTTGGCAAAAGTATTTTCAGAAAAAAATTCTA,TAGTCCCCCAGTTGGCTTATGTAAACAGCTGCGACGGTTGTGTTTAGAGCTCATTTTGGGGGAGGTTTTTTGGCAAAAGTATTTTCAGAAAAAAATTCT,10,30,14,27,27,35,27,36,27,32,32,35,33,36,40.32,28.87277149
hek293t,9509,1,6,AAACTAAAACTCCAAGGTTTTATTTGGTATGGGTGGGCACCTTATTTTTGCATAAAACTAACGCATTCAAAAGTGTAAGAAAAAAATTCTAGTTGGTTT,AAACTAAAACTCCAAGGTTTTATTTGGAAGGGGTATGGGTGGGCACCTTATTTTTGCATAAAACTAACGCATTCAAAAGTGTAAGAAAAAAATTCTAGT,10,30,14,27,27,38,27,44,27,28,28,38,34,44,6.71,0.569656448
hek293t,9511,1,2,GCTTTCCCTATGTCTCCCGTGCTGCATCCCGGCCACAGAAATCACATGAGGCCCTGCAGCTGCTGAGCCTGAGGGAAGACAATGCAAAAAAATTCTAGT,GCTTTCCCTATGTCTCCCGTGCTGCATCGTCCGGCCACAGAAATCACATGAGGCCCTGCAGCTGCTGAGCCTGAGGGAAGACAATGCAAAAAAATTCTA,10,30,14,27,27,36,27,38,27,29,29,36,31,38,53.34,79.18104569
hek293t,9511,1,2,AGCAGCCCTATGTCTCCCGTGCTGCATCCCGGCCACAGAAATCACATGAGGCCCTGCAGCTGCTGAGCCTGAGGGAAGACAAAAAAAAATTCTAGTTGG,AGCAGCCCTATGTCTCCCGTGCTGCATCGTCCGGCCACAGAAATCACATGAGGCCCTGCAGCTGCTGAGCCTGAGGGAAGACAAAAAAAAATTCTAGTT,10,30,14,27,27,39,27,41,27,29,29,39,31,41,53.34,86.8449349
hek293t,9513,1,3,TTATATTAAACAGTGTTCTACTTACAGAACGGATCTGCTAAATGTGAACAGCTCTTTGCCGTAGACCAGAACTAAACAAAAAAATTCTAGTTGGTTTAA,TTATATTAAACAGTGTTCTACTTACAGAACGGATCTGCTAATAAATGTGAACAGCTCTTTGCCGTAGACCAGAACTAAACAAAAAAATTCTAGTTGGTT,10,30,14,27,27,43,27,46,27,40,40,43,43,46,55.07,0.0
hek293t,9517,1,6,CGTTTCCCAGGACTTGCAGATTTTTCAGCTGGCACGCAGGCAGTACCTTAAACAAGCTCTCGTCCAAAACTCCAAAAAAATTCTAGTTGGTTTAACGCG,CGTTTCCCAGGACTTGCAGATTTTTCAGCTGGCACGGAAGCACAGGCAGTACCTTAAACAAGCTCTCGTCCAAAACTCCAAAAAAATTCTAGTTGGTTT,10,30,14,27,27,44,27,50,27,37,37,44,43,50,8.73,8.394423637
hek293t,9517,1,6,TTTAGCCCAGGACTTGCAGATTTTTCAGCTGGCACGCAGGCAGTACCTTAAACAAGCTCTCGTCCAAAACAAAAAAATTCTAGTTGGTTTAACGCGTAA,TTTAGCCCAGGACTTGCAGATTTTTCAGCTGGCACGGAAGCACAGGCAGTACCTTAAACAAGCTCTCGTCCAAAACAAAAAAATTCTAGTTGGTTTAAC,10,30,14,27,27,47,27,53,27,37,37,47,43,53,8.73,26.84819814
hek293t,9519,1,9,ATTGGATCACAGAAAATAATATGCAGTTTTGGGCTATGCATAGGGGACTTCCCCTTCCCTGCACAAAAAAATTCTAGTTGGTTTAACGCGTAACTAGAT,ATTGGATCACAGAAAATAATATGCAGTTTTGGGCTATGCGGAAGGATAATAGGGGACTTCCCCTTCCCTGCACAAAAAAATTCTAGTTGGTTTAACGCG,10,30,14,27,27,50,27,59,27,40,40,50,49,59,4.37,0.058072009
hek293t,9520,1,3,TAGTGATTGTGAACTAGTAAGAGGTCGCCTGGAAATTCAGCAGGATGAGATGAACATGAAACGGAAAACTCTATGGACGTTCAAAAAAAATTCTAGTTG,TAGTGATTGTGAACTAGTAAGAGGTCGCCGGATGGAAATTCAGCAGGATGAGATGAACATGAAACGGAAAACTCTATGGACGTTCAAAAAAAATTCTAG,10,30,14,27,27,37,27,40,27,30,30,37,33,40,40.45,3.746895194
hek293t,9520,1,3,AGCTCATTGTGAACTAGTAAGAGGTCGCCTGGAAATTCAGCAGGATGAGATGAACATGAAACGGAAAACTCTATGGACGTAAAAAAATTCTAGTTGGTT,AGCTCATTGTGAACTAGTAAGAGGTCGCCGGATGGAAATTCAGCAGGATGAGATGAACATGAAACGGAAAACTCTATGGACGTAAAAAAATTCTAGTTG,10,30,14,27,27,40,27,43,27,30,30,40,33,43,40.45,47.5231005
hek293t,9522,1,11,AAAGAGACCCTAACTTTGCCTCCCCAGCGGGGCTGCCAGCAGAGGTGAATCATGAGGTGCGTACAGATAAAAAAATTCTAGTTGGTTTAACGCGTAACT,AAAGAGACCCTAACTTTGCCTCCCCAGCGGGGCTGCCAGCTATAGCGATTCAGAGGTGAATCATGAGGTGCGTACAGATAAAAAAATTCTAGTTGGTTT,10,30,14,27,27,44,27,55,27,41,41,44,52,55,58.0,0.0
hek293t,9523,1,14,CATTCCTGCCCAGAGGCAGGCTGCATGCCCGGCTCAGTGGCTGCCCTCAGAAGATACCAGCAATACCAGGCAGCTGCAAAAAAAATTCTAGTTGGTTTA,CATTCCTGCCCAGAGGCAGGCTGCATGATAACGAGGACTGTCCCGGCTCAGTGGCTGCCCTCAGAAGATACCAGCAATACCAGGCAGCTGCAAAAAAAA,10,30,14,27,27,31,27,45,27,28,28,31,42,45,46.51,0.209230439
hek293t,9523,1,14,CATGTCTGCCCAGAGGCAGGCTGCATGCCCGGCTCAGTGGCTGCCCTCAGAAGATACCAGCAATACCAGGCAGCAAAAAAATTCTAGTTGGTTTAACGC,CATGTCTGCCCAGAGGCAGGCTGCATGATAACGAGGACTGTCCCGGCTCAGTGGCTGCCCTCAGAAGATACCAGCAATACCAGGCAGCAAAAAAATTCT,10,30,14,27,27,35,27,49,27,28,28,35,42,49,46.51,12.26608187
hek293t,9525,1,9,TTATCCTGCATTTTCTACATCCATGGTAATGGGCCTTCTGCCGTCTTCAAGCGTTAAGTGTTCGCGAAAAAAATTCTAGTTGGTTTAACGCGTAACTAG,TTATCCTGCATTTTCTACATCCATGGTAATGGGCCTTCTGGTTTACTTGCCGTCTTCAAGCGTTAAGTGTTCGCGAAAAAAATTCTAGTTGGTTTAACG,10,30,14,27,27,48,27,57,27,41,41,48,50,57,13.69,4.877624298
hek293t,9529,1,15,TCAGGCAATTAAAATGTCTGCATGTTGGCTGGGTGTGTGATGTCTGCCCACGTATGGGGCCAGTGTGTATTAAAAAAATTCTAGTTGGTTTAACGCGTA,TCAGGCAATTAAAATGTCTGCATGTTACCCTGCCATGGTTCGGCTGGGTGTGTGATGTCTGCCCACGTATGGGGCCAGTGTGTATTAAAAAAATTCTAG,10,30,14,27,27,37,27,52,27,27,27,37,42,52,15.62,1.554490751
hek293t,9531,1,15,CGCGGCCACTCGAAACTAATGAAAATTAAAGGCTGTTTTTGTAGGGAAATAGAGTTCTACTTCGTATGCGAAGTTAAAAAAAAAATTCTAGTTGGTTTA,CGCGGCCACTCGAAACTAATGAAAATTAACACAGCCCGACGTAAAGGCTGTTTTTGTAGGGAAATAGAGTTCTACTTCGTATGCGAAGTTAAAAAAAAA,10,30,14,27,27,30,27,45,27,27,27,30,42,45,4.0,0.0
hek293t,9531,1,15,GGACACCACTCGAAACTAATGAAAATTAAAGGCTGTTTTTGTAGGGAAATAGAGTTCTACTTCGTATGCGAAGTAAAAAAATTCTAGTTGGTTTAACGC,GGACACCACTCGAAACTAATGAAAATTAACACAGCCCGACGTAAAGGCTGTTTTTGTAGGGAAATAGAGTTCTACTTCGTATGCGAAGTAAAAAAATTC,10,30,14,27,27,34,27,49,27,27,27,34,42,49,4.0,0.0
hek293t,9534,1,10,AGTGGTGTAAGAATAGAAAATAGACTTTCTGGGACAGATTTAAAAAACAATCCTCTGGTGGATAATGAGAAAATAAAAAAAATTCTAGTTGGTTTAACG,AGTGGTGTAAGAATAGAAAATAGACTTATATTGGAAGTCTGGGACAGATTTAAAAAACAATCCTCTGGTGGATAATGAGAAAATAAAAAAAATTCTAGT,10,30,14,27,27,38,27,48,27,28,28,38,38,48,1.55,0.268427294
hek293t,9534,1,10,GTAGATGTAAGAATAGAAAATAGACTTTCTGGGACAGATTTAAAAAACAATCCTCTGGTGGATAATGAGAAAATAGAAAAAAAAATTCTAGTTGGTTTA,GTAGATGTAAGAATAGAAAATAGACTTATATTGGAAGTCTGGGACAGATTTAAAAAACAATCCTCTGGTGGATAATGAGAAAATAGAAAAAAAAATTCT,10,30,14,27,27,35,27,45,27,28,28,35,38,45,1.55,0.070472163
hek293t,9536,1,13,AAAGTCTTCTCTGTTGACTTAGCAATTGCAGGTGTGCTTACATTGGCTACAGACTGACCCTGCTGAAAAAAAATTCTAGTTGGTTTAACGCGTAACTAG,AAAGTCTTCTCTGTTGACTTAGCAATTGCAGGTGTGCTTAGCACCACCGACTTCATTGGCTACAGACTGACCCTGCTGAAAAAAAATTCTAGTTGGTTT,10,30,14,27,27,44,27,57,27,41,41,44,54,57,39.17,0.023752969
hek293t,9537,1,5,CCACGGTATTAAAATGTGCTCTGCCACTTTGGGTGTTTCCTAGGGCTGTCTGTGTACTTTTACAACATTGTCAGGAATAAAAAAATTCTAGTTGGTTTA,CCACGGTATTAAAATGTGCTCTGCCACTTTGGGTGTTACTGTTCCTAGGGCTGTCTGTGTACTTTTACAACATTGTCAGGAATAAAAAAATTCTAGTTG,10,30,14,27,27,40,27,45,27,37,37,40,42,45,15.2,0.0
hek293t,9537,1,5,ATTATGTATTAAAATGTGCTCTGCCACTTTGGGTGTTTCCTAGGGCTGTCTGTGTACTTTTACAACAAAAAAATTCTAGTTGGTTTAACGCGTAACTAG,ATTATGTATTAAAATGTGCTCTGCCACTTTGGGTGTTACTGTTCCTAGGGCTGTCTGTGTACTTTTACAACAAAAAAATTCTAGTTGGTTTAACGCGTA,10,30,14,27,27,52,27,57,27,37,37,52,42,57,15.2,34.39225212
hek293t,9539,1,15,CGAGACCAAGATGATAACATGAGTGTATCCGGCTTTCGTAGAGTATCATTAAATACAGCATCAGAAGTCCGGCTAAAAAAAATTCTAGTTGGTTTAACG,CGAGACCAAGATGATAACATGAGTGTATCGCGTTAGATGTGTCTCGGCTTTCGTAGAGTATCATTAAATACAGCATCAGAAGTCCGGCTAAAAAAAATT,10,30,14,27,27,33,27,48,27,30,30,33,45,48,28.9,0.0
hek293t,9540,1,14,GGGCTGCTAGATACTGTCATATTTCAGAATGGAGAGTTTCGTTTTGAATGGTTCCTTAGTATTTTGAATATTAAAAAAATTCTAGTTGGTTTAACGCGT,GGGCTGCTAGATACTGTCATATTTCAGAATGGAAAGATCTAGGCTCCGAGTTTCGTTTTGAATGGTTCCTTAGTATTTTGAATATTAAAAAAATTCTAG,10,30,14,27,27,37,27,51,27,34,34,37,48,51,29.39,0.0
hek293t,1212,1,9,GACTCAAGAAATGGAAAAAAGCTTTGGTGGGGGGTGTTGACTACTCAATAATAAAACAAGGTTTTGATATAAAAAAAATTCTAGTTGGTTTAACGCGTA,GACTCAAGAAATGGAAAAAAGCTTTGGTGGGGGGTGTTGTCCTCGATGACTACTCAATAATAAAACAAGGTTTTGATATAAAAAAAATTCTAGTTGGTT,10,30,14,27,27,43,27,52,27,40,40,43,49,52,52.57,0.0
hek293t,9544,1,14,GGAACGTCCTTTAAAAACAGAAAATTACGGGGTATTTGAAAGCACAGAATGAGAAAATAAAGAGCTAAAAAAAATTCTAGTTGGTTTAACGCGTAACTA,GGAACGTCCTTTAAAAACAGAAAATTACGGGGTATTTGTGGACGATAGGATTAAAGCACAGAATGAGAAAATAAAGAGCTAAAAAAAATTCTAGTTGGT,10,30,14,27,27,42,27,56,27,39,39,42,53,56,32.15,0.0
hek293t,9545,1,14,CTGTAGTTGCAGAACTACAATCCTTAATCTGGGGCAGTTAGTGACAGCTGCTAGATTTGTGCTAATTTTAAAAAAAAAATTCTAGTTGGTTTAACGCGT,CTGTAGTTGCAGAACTACAATCCTTAGTTCGTGATCTTGCATCTGGGGCAGTTAGTGACAGCTGCTAGATTTGTGCTAATTTTAAAAAAAAAATTCTAG,10,30,14,27,27,37,27,51,27,27,27,37,41,51,20.03,4.998259473
hek293t,9545,1,14,TATCGGTTGCAGAACTACAATCCTTAATCTGGGGCAGTTAGTGACAGCTGCTAGATTTGTGCTAATTTTAAAAACAAAAAAATTCTAGTTGGTTTAACG,TATCGGTTGCAGAACTACAATCCTTAGTTCGTGATCTTGCATCTGGGGCAGTTAGTGACAGCTGCTAGATTTGTGCTAATTTTAAAAACAAAAAAATTC,10,30,14,27,27,34,27,48,27,27,27,34,41,48,20.03,12.62738892
hek293t,9547,1,15,ACAACAGGCTAGATGAATGCTCCCAGCCATGGGTAAAACCCACCTGAGAGTTGGACCTTTGCAGACAAATCTAAAAAAAATTCTAGTTGGTTTAACGCG,ACAACAGGCTAGATGAATGCTCCCAGCCATGCCTGGGAGTGCCTGTGGTAAAACCCACCTGAGAGTTGGACCTTTGCAGACAAATCTAAAAAAAATTCT,10,30,14,27,27,35,27,50,27,32,32,35,47,50,51.24,0.0
hek293t,9548,1,7,AAGGACATCTACATCCAGCAGGTTGACTATGGGAACAGTCACTGAATCGACTCTTAGCAGTCATCTGAATTTAAAAAAATTCTAGTTGGTTTAACGCGT,AAGGACATCTACATCCAGCAGGTTGACTATGGGGGCACAAAACAGTCACTGAATCGACTCTTAGCAGTCATCTGAATTTAAAAAAATTCTAGTTGGTTT,10,30,14,27,27,44,27,51,27,34,34,44,41,51,53.75,1.908831391
hek293t,9550,1,13,GACTCAGTAGCTTACGTCCTATTTCCCAAAGGCTAAAAATTAGAGTTATCTGAAACTGCCATATCACAAAACTGAAAAAAATTCTAGTTGGTTTAACGC,GACTCAGTAGCTTACGTCCTATTTCCCAAAGGAAGCAGTTGGCCACTAAAAATTAGAGTTATCTGAAACTGCCATATCACAAAACTGAAAAAAATTCTA,10,30,14,27,27,36,27,49,27,33,33,36,46,49,36.27,0.0
hek293t,9551,1,6,GCCTGACTGCTTCCTTTTTGTCCCCCAGAAGGGAATTTTCTTTCTTTTAGACAGGCTGGTAGAAAATGTAAAAAAATTCTAGTTGGTTTAACGCGTAAC,GCCTGACTGCTTCCTTTTTGTCCCCCAGAAGGGAATTTTCAGTCGCTTTCTTTTAGACAGGCTGGTAGAAAATGTAAAAAAATTCTAGTTGGTTTAACG,10,30,14,27,27,48,27,54,27,41,41,48,47,54,11.2,0.221162274
hek293t,9553,1,15,CCATGACAGTTAAGCTAATCTTAGTTCAGAGGAATATGCACAATGGAATAAGAAGCCTTGTAATAAAAAAATTCTAGTTGGTTTAACGCGTAACTAGAT,CCATGACAGTTAAGCTAATCTTAGTTCAGAGGAATACCAAAGTTCGGTCAATGCACAATGGAATAAGAAGCCTTGTAATAAAAAAATTCTAGTTGGTTT,10,30,14,27,27,44,27,59,27,37,37,44,52,59,47.78,0.311484816
hek293t,9554,1,10,TAGCCACTCTTCTAGGAACGGAGAGAAGGAGGGGAAATCTGGGACAGGTAGGGAGATTTAACAAGTATCAACCTCTTGAACTGAAAAAAATTCTAGTTG,TAGCCACTCTTCTAGGAACGGAGAGAAAAAAGCAGTAGGAGGGGAAATCTGGGACAGGTAGGGAGATTTAACAAGTATCAACCTCTTGAACTGAAAAAA,10,30,14,27,27,30,27,40,27,27,27,30,37,40,57.92,0.0
hek293t,9554,1,10,ATCCAACTCTTCTAGGAACGGAGAGAAGGAGGGGAAATCTGGGACAGGTAGGGAGATTTAACAAGTATCAACCTCTAAAAAAATTCTAGTTGGTTTAAC,ATCCAACTCTTCTAGGAACGGAGAGAAAAAAGCAGTAGGAGGGGAAATCTGGGACAGGTAGGGAGATTTAACAAGTATCAACCTCTAAAAAAATTCTAG,10,30,14,27,27,37,27,47,27,27,27,37,37,47,57.92,4.512952905
hek293t,5524,1,12,GTCAGAGCACTTTCAGTCTACTTGACTGAAGGAGGGCTCTCTTTCAGTCAGACTTGTAACTGCATGTTCGGTCATAAAAAAATTCTAGTTGGTTTAACG,GTCAGAGCACTTTCAGTCTACTTGACTGAAGGACGAAGCGCAATAGGGCTCTCTTTCAGTCAGACTTGTAACTGCATGTTCGGTCATAAAAAAATTCTA,10,30,14,27,27,36,27,48,27,33,33,36,45,48,42.51,0.0
hek293t,5524,1,12,TCCGCAGCACTTTCAGTCTACTTGACTGAAGGAGGGCTCTCTTTCAGTCAGACTTGTAACTGCATGTTAAAAAAATTCTAGTTGGTTTAACGCGTAACT,TCCGCAGCACTTTCAGTCTACTTGACTGAAGGACGAAGCGCAATAGGGCTCTCTTTCAGTCAGACTTGTAACTGCATGTTAAAAAAATTCTAGTTGGTT,10,30,14,27,27,43,27,55,27,33,33,43,45,55,42.51,2.834113735
hek293t,9558,1,3,AGACAAAGCTCTTCCATTCATACCTTTTAAGGACTCTAACAGATAACCTCTGATAAATCTGTATCTGTTTAAGATAAAAAAATTCTAGTTGGTTTAACG,AGACAAAGCTCTTCCATTCATACCTTTTAAGGACTCTGATAACAGATAACCTCTGATAAATCTGTATCTGTTTAAGATAAAAAAATTCTAGTTGGTTTA,10,30,14,27,27,45,27,48,27,38,38,45,41,48,7.36,0.329665603
hek293t,9558,1,3,AGCACAAGCTCTTCCATTCATACCTTTTAAGGACTCTAACAGATAACCTCTGATAAATCTGTATCTGTTTAAAAAAAAATTCTAGTTGGTTTAACGCGT,AGCACAAGCTCTTCCATTCATACCTTTTAAGGACTCTGATAACAGATAACCTCTGATAAATCTGTATCTGTTTAAAAAAAAATTCTAGTTGGTTTAACG,10,30,14,27,27,48,27,51,27,38,38,48,41,51,7.36,0.449785954
hek293t,9560,1,13,CCCACATGTGCTTAAACATATGTTGGGGCAGGTTTGGATTGGCTGGCCTCAAAAAATTAACTATAATAAAAAAATTCTAGTTGGTTTAACGCGTAACTA,CCCACATGTGCTTAAACATATGTTGGGGCAGGTTTGGATAACTCTCTTTCGCTGGCTGGCCTCAAAAAATTAACTATAATAAAAAAATTCTAGTTGGTT,10,30,14,27,27,43,27,56,27,40,40,43,53,56,29.47,0.110011001
hek293t,9561,1,2,CGATTTTACCCTTAGTCAGCAAAGTTGAAAGGCCACTACTGACCATGCCAATCCACAAAGACAAATGAGTTACAGGAATGAATAAAAAAATTCTAGTTG,CGATTTTACCCTTAGTCAGCAAAGTTGAAAGGCCTAACTACTGACCATGCCAATCCACAAAGACAAATGAGTTACAGGAATGAATAAAAAAATTCTAGT,10,30,14,27,27,38,27,40,27,35,35,38,37,40,32.72,0.110926234
hek293t,9561,1,2,ACTGGTTACCCTTAGTCAGCAAAGTTGAAAGGCCACTACTGACCATGCCAATCCACAAAGACAAATGAGTTACAGGAATAAAAAAATTCTAGTTGGTTT,ACTGGTTACCCTTAGTCAGCAAAGTTGAAAGGCCTAACTACTGACCATGCCAATCCACAAAGACAAATGAGTTACAGGAATAAAAAAATTCTAGTTGGT,10,30,14,27,27,42,27,44,27,35,35,42,37,44,32.72,21.00184948
hek293t,17839,1,4,ATATTGTAGGCGACATCTTATTAATGGTCTGGGGAAGACAGACATTTATTTTTATTCAATTCAGACACATTTGTAAAAAAAATTCTAGTTGGTTTAACG,ATATTGTAGGCGACATCTTATTAATGGTCTGGGCTAAGAAGACAGACATTTATTTTTATTCAATTCAGACACATTTGTAAAAAAAATTCTAGTTGGTTT,10,30,14,27,27,44,27,48,27,34,34,44,38,48,21.85,17.04204017
hek293t,17839,1,4,TTTCGGTAGGCGACATCTTATTAATGGTCTGGGGAAGACAGACATTTATTTTTATTCAATTCAGACACATAAAAAAATTCTAGTTGGTTTAACGCGTAA,TTTCGGTAGGCGACATCTTATTAATGGTCTGGGCTAAGAAGACAGACATTTATTTTTATTCAATTCAGACACATAAAAAAATTCTAGTTGGTTTAACGC,10,30,14,27,27,49,27,53,27,34,34,49,38,53,21.85,12.37215141
hek293t,9565,1,8,ACGAATTATTTTTAGCTCTTAATAACTACAGGAGTTTGATTTCATCATTTTAAAGGTGAGGAGAAGTGTTGGAAAAAAAAAAAATTCTAGTTGGTTTAA,ACGAATTATTTTTAGCTCTTAATAACTACAGGAGGATAACGCTTTGATTTCATCATTTTAAAGGTGAGGAGAAGTGTTGGAAAAAAAAAAAATTCTAGT,10,30,14,27,27,38,27,46,27,35,35,38,43,46,2.8,0.0
hek293t,9565,1,8,GTGCATTATTTTTAGCTCTTAATAACTACAGGAGTTTGATTTCATCATTTTAAAGGTGAGGAGAAGTGTTAAAAAAATTCTAGTTGGTTTAACGCGTAA,GTGCATTATTTTTAGCTCTTAATAACTACAGGAGGATAACGCTTTGATTTCATCATTTTAAAGGTGAGGAGAAGTGTTAAAAAAATTCTAGTTGGTTTA,10,30,14,27,27,45,27,53,27,35,35,45,43,53,2.8,0.310077519
hek293t,9569,1,10,CCTCAAAGAAAACTCATTAAAATGTGTTCTGGTCATTATTGTCCCACAACTCTTTGCAAGAACTGTCTTACAGAAAAAAAAATTCTAGTTGGTTTAACG,CCTCAAAGAAAACTCATTAAAATGTGTTCTCGGTACTGCAGGTCATTATTGTCCCACAACTCTTTGCAAGAACTGTCTTACAGAAAAAAAAATTCTAGT,10,30,14,27,27,38,27,48,27,31,31,38,41,48,15.98,0.0
hek293t,9569,1,10,GCAGTAAGAAAACTCATTAAAATGTGTTCTGGTCATTATTGTCCCACAACTCTTTGCAAGAACTGTCAAAAAAATTCTAGTTGGTTTAACGCGTAACTA,GCAGTAAGAAAACTCATTAAAATGTGTTCTCGGTACTGCAGGTCATTATTGTCCCACAACTCTTTGCAAGAACTGTCAAAAAAATTCTAGTTGGTTTAA,10,30,14,27,27,46,27,56,27,31,31,46,41,56,15.98,0.946936936
hek293t,9571,1,11,TTTATCTCACTGCGGGACGGGTGGCGGCGAGGGGGAAGAGCCTGCTCTCCTCCTTGCGCTTTACAGCCTGAAAAAAATTCTAGTTGGTTTAACGCGTAA,TTTATCTCACTGCGGGACGGGTGGCGGCGAGGGGAACTCATTCAAGAAGAGCCTGCTCTCCTCCTTGCGCTTTACAGCCTGAAAAAAATTCTAGTTGGT,10,30,14,27,27,42,27,53,27,35,35,42,46,53,22.79,0.694180927
hek293t,9571,1,11,CTGTCCTCACTGCGGGACGGGTGGCGGCGAGGGGGAAGAGCCTGCTCTCCTCCTTGCGCTTTACAGCCTGGGGGAAAAAAATTCTAGTTGGTTTAACGC,CTGTCCTCACTGCGGGACGGGTGGCGGCGAGGGGAACTCATTCAAGAAGAGCCTGCTCTCCTCCTTGCGCTTTACAGCCTGGGGGAAAAAAATTCTAGT,10,30,14,27,27,38,27,49,27,35,35,38,46,49,22.79,0.0
hek293t,9573,1,1,TTATACTTTCCTTTCCACTGAGTCTCACCAGGGTTAAGATTTAAGAAAATTGCTTCCTGAAGGAGTGCAAGCACAGGGAATGCAAAAAAAAAATTCTAG,TTATACTTTCCTTTCCACTGAGTCTCACCAGGCGTTAAGATTTAAGAAAATTGCTTCCTGAAGGAGTGCAAGCACAGGGAATGCAAAAAAAAAATTCTA,10,30,14,27,27,36,27,37,27,33,33,36,34,37,40.22,2.845409194
hek293t,9573,1,1,AACTACTTTCCTTTCCACTGAGTCTCACCAGGGTTAAGATTTAAGAAAATTGCTTCCTGAAGGAGTGCAAGCACAGGGAAAAAAAATTCTAGTTGGTTT,AACTACTTTCCTTTCCACTGAGTCTCACCAGGCGTTAAGATTTAAGAAAATTGCTTCCTGAAGGAGTGCAAGCACAGGGAAAAAAAATTCTAGTTGGTT,10,30,14,27,27,43,27,44,27,33,33,43,34,44,40.22,87.41726343
hek293t,9577,1,4,ATCGGACTGAACATCCTTGAGCTAACAGGAGGCTCCTTTCCTTTTGAACAAGTGTCTCCACAGTGGTGTTGAACATGCATGAAAAAAATTCTAGTTGGT,ATCGGACTGAACATCCTTGAGCTAACAGGAGGCTCATGCCTTTCCTTTTGAACAAGTGTCTCCACAGTGGTGTTGAACATGCATGAAAAAAATTCTAGT,10,30,14,27,27,38,27,42,27,35,35,38,39,42,60.47,4.78115543
hek293t,9579,1,8,TCGGGCAGGAACTTGTGTCCATGAGCAAGGGGTGCAAGAGGAGAGTGGGATCTGTGAACTGTTGCTTCAGCAAAAAAATTCTAGTTGGTTTAACGCGTA,TCGGGCAGGAACTTGTGTCCATGAGCAAGGGGTGCAGTTGCACTAGAGGAGAGTGGGATCTGTGAACTGTTGCTTCAGCAAAAAAATTCTAGTTGGTTT,10,30,14,27,27,44,27,52,27,37,37,44,45,52,57.02,9.481383497
hek293t,9579,1,8,TGCTCCAGGAACTTGTGTCCATGAGCAAGGGGTGCAAGAGGAGAGTGGGATCTGTGAACTGTTGCTTCAAAAAAATTCTAGTTGGTTTAACGCGTAACT,TGCTCCAGGAACTTGTGTCCATGAGCAAGGGGTGCAGTTGCACTAGAGGAGAGTGGGATCTGTGAACTGTTGCTTCAAAAAAATTCTAGTTGGTTTAAC,10,30,14,27,27,47,27,55,27,37,37,47,45,55,57.02,57.99190493
hek293t,9581,1,6,GTGCACTGCAATGTCCACAGAAGTTCAAATGGCCCTCAGCAAAATCGGGAGGAATTAAATGGTAATGGTGTCCTTTCAAAAAAAATTCTAGTTGGTTTA,GTGCACTGCAATGTCCACAGAAGTTCAAATGGCCCCCTACGTCAGCAAAATCGGGAGGAATTAAATGGTAATGGTGTCCTTTCAAAAAAAATTCTAGTT,10,30,14,27,27,39,27,45,27,36,36,39,42,45,30.31,0.438763924
hek293t,9581,1,6,GTTGGCTGCAATGTCCACAGAAGTTCAAATGGCCCTCAGCAAAATCGGGAGGAATTAAATGGTAATGGTGTAAAAAAATTCTAGTTGGTTTAACGCGTA,GTTGGCTGCAATGTCCACAGAAGTTCAAATGGCCCCCTACGTCAGCAAAATCGGGAGGAATTAAATGGTAATGGTGTAAAAAAATTCTAGTTGGTTTAA,10,30,14,27,27,46,27,52,27,36,36,46,42,52,30.31,3.553424178
hek293t,9583,1,10,GTTTCAGCTCATGTGCTTCCTGGATGCACAGGTGCTCCGGGGCTTTCACTGGGCTCTGCCAGGGTCTTTACTGCAAAAAAATTCTAGTTGGTTTAACGC,GTTTCAGCTCATGTGCTTCCTGGATGCACAGGTGCGATCATCCCCTCCGGGGCTTTCACTGGGCTCTGCCAGGGTCTTTACTGCAAAAAAATTCTAGTT,10,30,14,27,27,39,27,49,27,36,36,39,46,49,55.88,0.16400164
hek293t,9584,1,8,GCTACGCAGGAAAGAATACAAGAGAGACCAGGTCACACAAGCTTCTTTCAGCCTCACACATAGCATCAGCTATAAAAAAATTCTAGTTGGTTTAACGCG,GCTACGCAGGAAAGAATACAAGAGAGACCAGCACCGAGGGTCACACAAGCTTCTTTCAGCCTCACACATAGCATCAGCTATAAAAAAATTCTAGTTGGT,10,30,14,27,27,42,27,50,27,32,32,42,40,50,60.4,11.08296852
hek293t,9584,1,8,TAATGGCAGGAAAGAATACAAGAGAGACCAGGTCACACAAGCTTCTTTCAGCCTCACACATAGCATCAGCTATGGTGGCAAAAAAAATTCTAGTTGGTT,TAATGGCAGGAAAGAATACAAGAGAGACCAGCACCGAGGGTCACACAAGCTTCTTTCAGCCTCACACATAGCATCAGCTATGGTGGCAAAAAAAATTCT,10,30,14,27,27,35,27,43,27,32,32,35,40,43,60.4,0.687229276
hek293t,20530,1,8,ATGACAAACCATCTTAATGTTTTAAGGCAAGGAAAGCATACCTCTCCAGTACTCTGTCTTGTTTTACTTTTAAAAAAATTCTAGTTGGTTTAACGCGTA,ATGACAAACCATCTTAATGTTTTAAGGCAAGGAAAGCATAGGGGAAGCCCTCTCCAGTACTCTGTCTTGTTTTACTTTTAAAAAAATTCTAGTTGGTTT,10,30,14,27,27,44,27,52,27,41,41,44,49,52,2.95,0.0
hek293t,9588,1,4,TATCCAGCGTGCGCTGACTCCTATTCGGCTGGCAGAGGGAGGGCAGGGAGCGGCAGAGAGGGGCAGCCAAAAAAAATTCTAGTTGGTTTAACGCGTAAC,TATCCAGCGTGCGCTGACTCCTATTCGGCTGGCAATTTGAGGGAGGGCAGGGAGCGGCAGAGAGGGGCAGCCAAAAAAAATTCTAGTTGGTTTAACGCG,10,30,14,27,27,50,27,54,27,35,35,50,39,54,44.08,58.22225141
hek293t,10981,1,14,GTCAGTAGGGCCTATGCCATTATCCAGGTAGGGCAGGTGAGTAATAGCACTGCACCATGCCCAGCCTTCAAAAAAATTCTAGTTGGTTTAACGCGTAAC,GTCAGTAGGGCCTATGCCATTATCCAGGTCCCCTGCGCATACCAGGGCAGGTGAGTAATAGCACTGCACCATGCCCAGCCTTCAAAAAAATTCTAGTTG,10,30,14,27,27,40,27,54,27,30,30,40,44,54,55.48,8.92579001
hek293t,10981,1,14,GTTCATAGGGCCTATGCCATTATCCAGGTAGGGCAGGTGAGTAATAGCACTGCACCATGCCCAGAAAAAAATTCTAGTTGGTTTAACGCGTAACTAGAT,GTTCATAGGGCCTATGCCATTATCCAGGTCCCCTGCGCATACCAGGGCAGGTGAGTAATAGCACTGCACCATGCCCAGAAAAAAATTCTAGTTGGTTTA,10,30,14,27,27,45,27,59,27,30,30,45,44,59,55.48,17.28898037
hek293t,22353,1,10,GGAGAGCATTACTGATAATTTATTAGGCATGGAGTAATAGGTAAAACAATATGACAGGAAAAGGAAAGAGAAAAAAATTCTAGTTGGTTTAACGCGTAA,GGAGAGCATTACTGATAATTTATTAGGCATGGAGTAGTTAACACTAATAGGTAAAACAATATGACAGGAAAAGGAAAGAGAAAAAAATTCTAGTTGGTT,10,30,14,27,27,43,27,53,27,36,36,43,46,53,8.99,0.0
hek293t,22353,1,10,ACTCTGCATTACTGATAATTTATTAGGCATGGAGTAATAGGTAAAACAATATGACAGGAAAAGGAAAAAAAAAATTCTAGTTGGTTTAACGCGTAACTA,ACTCTGCATTACTGATAATTTATTAGGCATGGAGTAGTTAACACTAATAGGTAAAACAATATGACAGGAAAAGGAAAAAAAAAATTCTAGTTGGTTTAA,10,30,14,27,27,46,27,56,27,36,36,46,46,56,8.99,0.0
hek293t,9594,1,1,GGAAGCTCAGTAGTATGCTTCTTGAACATAGGTAAAGCAGCACTTGTTGTTCTTAACCATTATAAACAACAAAAAAAATTCTAGTTGGTTTAACGCGTA,GGAAGCTCAGTAGTATGCTTCTTGAACATAGGTAACAGCAGCACTTGTTGTTCTTAACCATTATAAACAACAAAAAAAATTCTAGTTGGTTTAACGCGT,10,30,14,27,27,51,27,52,27,36,36,51,37,52,61.43,70.21102919
hek293t,9599,1,8,GGGCCCTCAGGAATAAAGCAGAAGTCTCAAGGCTAAAGCAATTTGTGCCAGTGACAATCTGACATGCTAGAAAAAAATTCTAGTTGGTTTAACGCGTAA,GGGCCCTCAGGAATAAAGCAGAAGTCTCAAGGCTGCAGCTCAAAAGCAATTTGTGCCAGTGACAATCTGACATGCTAGAAAAAAATTCTAGTTGGTTTA,10,30,14,27,27,45,27,53,27,35,35,45,43,53,44.4,2.840478673
hek293t,9601,1,3,TAAGATTTCTGCAAAATCAAACCTGTGTGAGGTTATTTTAGGCACTGGTATTAAATGGAGCCAGAAAGTTGAAGGAAAAAAAAATTCTAGTTGGTTTAA,TAAGATTTCTGCAAAATCAAACCTGTGTGAGGTTAGCTTTTTAGGCACTGGTATTAAATGGAGCCAGAAAGTTGAAGGAAAAAAAAATTCTAGTTGGTT,10,30,14,27,27,43,27,46,27,36,36,43,39,46,51.72,0.029638411
hek293t,9601,1,3,CTTGCTTTCTGCAAAATCAAACCTGTGTGAGGTTATTTTAGGCACTGGTATTAAATGGAGCCAGAAAGTTGAAGGAACAGAAAAAAAATTCTAGTTGGT,CTTGCTTTCTGCAAAATCAAACCTGTGTGAGGTTAGCTTTTTAGGCACTGGTATTAAATGGAGCCAGAAAGTTGAAGGAACAGAAAAAAAATTCTAGTT,10,30,14,27,27,39,27,42,27,36,36,39,39,42,51.72,0.045646468
hek293t,9603,1,9,AGTGTCTTGTCTTTATAGCTGCATTATACAGGGAACTTATTTTGTTTGCTCAGGAAATGTGTATGTTTGAAAAAAATTCTAGTTGGTTTAACGCGTAAC,AGTGTCTTGTCTTTATAGCTGCATTATACAGGGAACTGATGGTCAGTATTTTGTTTGCTCAGGAAATGTGTATGTTTGAAAAAAATTCTAGTTGGTTTA,10,30,14,27,27,45,27,54,27,38,38,45,47,54,13.28,0.0
hek293t,9603,1,9,TACCGCTTGTCTTTATAGCTGCATTATACAGGGAACTTATTTTGTTTGCTCAGGAAATGTGTATGTTTGGCATAAAAAAATTCTAGTTGGTTTAACGCG,TACCGCTTGTCTTTATAGCTGCATTATACAGGGAACTGATGGTCAGTATTTTGTTTGCTCAGGAAATGTGTATGTTTGGCATAAAAAAATTCTAGTTGG,10,30,14,27,27,41,27,50,27,38,38,41,47,50,13.28,0.136612022
hek293t,9605,1,6,TAATTAGCACTTGCTCACAGTCTTCAGCATGGGTGTTTAATTGGAAGTCCTTCTGAATCCAGTCTGGAGTTGTTTGTATAGAAAAAAATTCTAGTTGGT,TAATTAGCACTTGCTCACAGTCTTCAGCGTAGGTATGGGTGTTTAATTGGAAGTCCTTCTGAATCCAGTCTGGAGTTGTTTGTATAGAAAAAAATTCTA,10,30,14,27,27,36,27,42,27,29,29,36,35,42,59.53,0.802938236
hek293t,9607,1,8,AAAATAGATCTAGCAGTAGAAAGTGTCCTAGGAGCGGAAGACATCACCACCCTTGTGCTACACAGGGCTGCAAAAAAATTCTAGTTGGTTTAACGCGTA,AAAATAGATCTAGCAGTAGAAAGTGTCCTAGGAACTAGGACGCGGAAGACATCACCACCCTTGTGCTACACAGGGCTGCAAAAAAATTCTAGTTGGTTT,10,30,14,27,27,44,27,52,27,34,34,44,42,52,58.06,0.785284249
hek293t,9609,1,5,CCCTAAAGTCCATAAGAATTCCTAAATATAGGTCTTTCTAAATTTAGCCCATCATGAACATATCCAAAACTAAAAAAATTCTAGTTGGTTTAACGCGTA,CCCTAAAGTCCATAAGAATTCCTAAATATAGGTCTTTCTACAGGAAATTTAGCCCATCATGAACATATCCAAAACTAAAAAAATTCTAGTTGGTTTAAC,10,30,14,27,27,47,27,52,27,40,40,47,45,52,27.47,3.568473266
hek293t,9610,1,6,TCCTCATTCTCCTCCCTCCTGCAATCTTGTGGTTAGAAACTATGTTTTCCCATAGCAAGGAGAGGGTCTCTAGAAAAAAATTCTAGTTGGTTTAACGCG,TCCTCATTCTCCTCCCTCCTGCAATCTTGTGGTCACCCTTAGAAACTATGTTTTCCCATAGCAAGGAGAGGGTCTCTAGAAAAAAATTCTAGTTGGTTT,10,30,14,27,27,44,27,50,27,34,34,44,40,50,44.02,28.60647759
hek293t,9610,1,6,CACGAATTCTCCTCCCTCCTGCAATCTTGTGGTTAGAAACTATGTTTTCCCATAGCAAGGAGAGGGTCTCTAGCATACTGAAAAAAATTCTAGTTGGTT,CACGAATTCTCCTCCCTCCTGCAATCTTGTGGTCACCCTTAGAAACTATGTTTTCCCATAGCAAGGAGAGGGTCTCTAGCATACTGAAAAAAATTCTAG,10,30,14,27,27,37,27,43,27,34,34,37,40,43,44.02,0.0
hek293t,9613,1,4,TGTCGAAAGAGAACAGAACATCTGCATTCAGGGGCCTGGTCCACTATTAAAAGAATTCTGTTGACTTGGACATTTGGACTGAACCCCTAAAAAAATTCT,TGTCGAAAGAGAACAGAACATCTGCATCATGTCAGGGGCCTGGTCCACTATTAAAAGAATTCTGTTGACTTGGACATTTGGACTGAACCCCTAAAAAAA,10,30,14,27,27,31,27,35,27,28,28,31,32,35,23.15,10.83129085
hek293t,9613,1,4,GTTGGAAAGAGAACAGAACATCTGCATTCAGGGGCCTGGTCCACTATTAAAAGAATTCTGTTGACTTGGACATTTGGACTGAAAAAAATTCTAGTTGGT,GTTGGAAAGAGAACAGAACATCTGCATCATGTCAGGGGCCTGGTCCACTATTAAAAGAATTCTGTTGACTTGGACATTTGGACTGAAAAAAATTCTAGT,10,30,14,27,27,38,27,42,27,28,28,38,32,42,23.15,62.3817577
hek293t,9615,1,1,TATCCCGGACTGTTGATTGCCACAGTAAATGGTGCATGACTAAAATGGGGACTGCAGCGCTCGTTACAACTGGCATCATAGCAGGTTCAAAAAAATTCT,TATCCCGGACTGTTGATTGCCACAGTAAATCGGTGCATGACTAAAATGGGGACTGCAGCGCTCGTTACAACTGGCATCATAGCAGGTTCAAAAAAATTC,10,30,14,27,27,34,27,35,27,31,31,34,32,35,13.7,17.19248276
hek293t,9617,1,11,ATGGGTCCCAGAACAGGCAGCGAGATGGTCGGTAGAGGTGGGTGGTGTAACATCTCGCTGCGCTGACGGCAGATGCAAAAAAAAATTCTAGTTGGTTTA,ATGGGTCCCAGAACAGGCAGCGAGATATTGGCACCCGGGTCGGTAGAGGTGGGTGGTGTAACATCTCGCTGCGCTGACGGCAGATGCAAAAAAAAATTC,10,30,14,27,27,34,27,45,27,27,27,34,38,45,73.84,4.08228746
hek293t,9617,1,11,TGTAATCCCAGAACAGGCAGCGAGATGGTCGGTAGAGGTGGGTGGTGTAACATCTCGCTGCGCTGACGGCAAAAAAATTCTAGTTGGTTTAACGCGTAA,TGTAATCCCAGAACAGGCAGCGAGATATTGGCACCCGGGTCGGTAGAGGTGGGTGGTGTAACATCTCGCTGCGCTGACGGCAAAAAAATTCTAGTTGGT,10,30,14,27,27,42,27,53,27,27,27,42,38,53,73.84,34.908952
hek293t,9619,1,15,TGCCTTGTCAAAGCTCCCATTGACTTTAAAGGTATCGTATGAGGCCATCTAACTGGAAACTCAAGAGAAAAAAATTCTAGTTGGTTTAACGCGTAACTA,TGCCTTGTCAAAGCTCCCATTGACTTTAAAGGTATCGGTGCTGTCAACACTATATGAGGCCATCTAACTGGAAACTCAAGAGAAAAAAATTCTAGTTGG,10,30,14,27,27,41,27,56,27,38,38,41,53,56,7.48,0.0
hek293t,9620,1,11,GGGGGTTAAATTAATTTTTTAAGTGTAAATGGAAGGAAAACGATGTTATCAGAAAAACTGGATACTTGCTAAAAAAATTCTAGTTGGTTTAACGCGTAA,GGGGGTTAAATTAATTTTTTAAGTGTAAATGGAAGGAAAATTTTATCTTAACGATGTTATCAGAAAAACTGGATACTTGCTAAAAAAATTCTAGTTGGT,10,30,14,27,27,42,27,53,27,39,39,42,50,53,-2.22,0.0
hek293t,9622,1,7,CGGTCGGGGAGCTATACCAACTGCTGTGTTGGCAGCCTTGGAGTTGCCTCTGGGTCTGCCTTGCCGGCTTAAAAAAATTCTAGTTGGTTTAACGCGTAA,CGGTCGGGGAGCTATACCAACTGCTGTGTTATGGGGCGGCAGCCTTGGAGTTGCCTCTGGGTCTGCCTTGCCGGCTTAAAAAAATTCTAGTTGGTTTAA,10,30,14,27,27,46,27,53,27,31,31,46,38,53,59.99,69.74013328
hek293t,20966,1,15,GAACGTGCTGCACGGGACATCCAAAGCGAAGGAGGGTGCTGCCGTGTCAAGGTTGCTTCAACTTCTTCAAAAAAATTCTAGTTGGTTTAACGCGTAACT,GAACGTGCTGCACGGGACATCCAAAGCGAAGGAGGGCGGCCATTGTAGCCCTGCTGCCGTGTCAAGGTTGCTTCAACTTCTTCAAAAAAATTCTAGTTG,10,30,14,27,27,40,27,55,27,37,37,40,52,55,72.45,1.84522854
hek293t,9629,1,5,TCAGCGTTTGCCCTGCTCCTTTAAAGATCAGGCCTAGCACAACCTTGCAGGGAGGAAGAAACTACATCAGCAAAAAAAATTCTAGTTGGTTTAACGCGT,TCAGCGTTTGCCCTGCTCCTTTAAAGATCAGGCCTAGCTCAGCACAACCTTGCAGGGAGGAAGAAACTACATCAGCAAAAAAAATTCTAGTTGGTTTAA,10,30,14,27,27,46,27,51,27,39,39,46,44,51,26.85,59.86644221
hek293t,9629,1,5,TGTTCGTTTGCCCTGCTCCTTTAAAGATCAGGCCTAGCACAACCTTGCAGGGAGGAAGAAACTAAAAAAAATTCTAGTTGGTTTAACGCGTAACTAGAT,TGTTCGTTTGCCCTGCTCCTTTAAAGATCAGGCCTAGCTCAGCACAACCTTGCAGGGAGGAAGAAACTAAAAAAAATTCTAGTTGGTTTAACGCGTAAC,10,30,14,27,27,54,27,59,27,39,39,54,44,59,26.85,59.87014162
hek293t,9631,1,14,CGCTGTTGCAGCCTACCTGAATGTGTTTTTGGAAATGCAGACGAGCACGTGCCTATTTGTGTCCTGGCAAAAAAAATTCTAGTTGGTTTAACGCGTAAC,CGCTGTTGCAGCCTACCTGAATGTGTTTTTGGAAATTATTGCTGCCTGCTGCAGACGAGCACGTGCCTATTTGTGTCCTGGCAAAAAAAATTCTAGTTG,10,30,14,27,27,40,27,54,27,37,37,40,51,54,4.87,0.0
hek293t,17686,1,2,GTCCCAATATCACTTCCATTAGCTCCCTGTGGACCTGCGCTTTTCTTCATTGAATCTGGAAAACCATCAAACATGACAAAAAAATTCTAGTTGGTTTAA,GTCCCAATATCACTTCCATTAGCTCCCTGTGGACCTGCGCTCTTTTCTTCATTGAATCTGGAAAACCATCAAACATGACAAAAAAATTCTAGTTGGTTT,10,30,14,27,27,44,27,46,27,41,41,44,43,46,55.41,1.240648164
hek293t,17686,1,2,GTAACAATATCACTTCCATTAGCTCCCTGTGGACCTGCGCTTTTCTTCATTGAATCTGGAAAACCATCAAAAAAAAATTCTAGTTGGTTTAACGCGTAA,GTAACAATATCACTTCCATTAGCTCCCTGTGGACCTGCGCTCTTTTCTTCATTGAATCTGGAAAACCATCAAAAAAAAATTCTAGTTGGTTTAACGCGT,10,30,14,27,27,51,27,53,27,41,41,51,43,53,55.41,74.82500724
hek293t,9635,1,9,GACCCATAGGGGACAGGGCAGGTGCTCTGTGGTATTTAGCAAAATAGAGTTCCTGTTCTGTATTTTGCTGTGGAAAAAAATTCTAGTTGGTTTAACGCG,GACCCATAGGGGACAGGGCAGGTGCTCTGTGGTTATGGAAGGATTTAGCAAAATAGAGTTCCTGTTCTGTATTTTGCTGTGGAAAAAAATTCTAGTTGG,10,30,14,27,27,41,27,50,27,34,34,41,43,50,63.29,3.793086181
hek293t,9635,1,9,TCCCGATAGGGGACAGGGCAGGTGCTCTGTGGTATTTAGCAAAATAGAGTTCCTGTTCTGTATTTAAAAAAATTCTAGTTGGTTTAACGCGTAACTAGA,TCCCGATAGGGGACAGGGCAGGTGCTCTGTGGTTATGGAAGGATTTAGCAAAATAGAGTTCCTGTTCTGTATTTAAAAAAATTCTAGTTGGTTTAACGC,10,30,14,27,27,49,27,58,27,34,34,49,43,58,63.29,0.0
hek293t,9638,1,15,TCGAGGGAATGTCTGTCCTTTATGGGCTGTGGGATTTGGAAGCTCAAAGGATGACTGTAATTGCATTAAAAAAAATTCTAGTTGGTTTAACGCGTAACT,TCGAGGGAATGTCTGTCCTTTATGGGCTGAGCCTCTAGCCGTAGTGGGATTTGGAAGCTCAAAGGATGACTGTAATTGCATTAAAAAAAATTCTAGTTG,10,30,14,27,27,40,27,55,27,30,30,40,45,55,34.61,12.03977088
hek293t,22995,1,5,CAGCAGTTCTGACCCCGAAGGACATGAAAAGGAGATACAGAATTGTTAAAGATCATTTTCTTATGCTTCATGCTTAAAAAAATTCTAGTTGGTTTAACG,CAGCAGTTCTGACCCCGAAGGACATGAAAAGGACAACAGATACAGAATTGTTAAAGATCATTTTCTTATGCTTCATGCTTAAAAAAATTCTAGTTGGTT,10,30,14,27,27,43,27,48,27,33,33,43,38,48,48.29,2.797418905
hek293t,22995,1,5,GTGGGGTTCTGACCCCGAAGGACATGAAAAGGAGATACAGAATTGTTAAAGATCATTTTCTTATGCTTCATGCTTCACACGAAAAAAAATTCTAGTTGG,GTGGGGTTCTGACCCCGAAGGACATGAAAAGGACAACAGATACAGAATTGTTAAAGATCATTTTCTTATGCTTCATGCTTCACACGAAAAAAAATTCTA,10,30,14,27,27,36,27,41,27,33,33,36,38,41,48.29,0.12266176
hek293t,9641,1,8,CACCCGATACCCATGTGCTGCATGACTAGAGGAAGGAAAAATGCTCCCTAGGAGCTTTCTGTTATAAACTGGAAAAAAATTCTAGTTGGTTTAACGCGT,CACCCGATACCCATGTGCTGCATGACTAGAGGGTACTACCAAGGAAAAATGCTCCCTAGGAGCTTTCTGTTATAAACTGGAAAAAAATTCTAGTTGGTT,10,30,14,27,27,43,27,51,27,33,33,43,41,51,51.24,48.79539032
hek293t,9641,1,8,ACATCGATACCCATGTGCTGCATGACTAGAGGAAGGAAAAATGCTCCCTAGGAGCTTTCTGTTATAAACTGGTGAAAAAAAATTCTAGTTGGTTTAACG,ACATCGATACCCATGTGCTGCATGACTAGAGGGTACTACCAAGGAAAAATGCTCCCTAGGAGCTTTCTGTTATAAACTGGTGAAAAAAAATTCTAGTTG,10,30,14,27,27,40,27,48,27,33,33,40,41,48,51.24,1.36692579
hek293t,9643,1,12,ATCTCTGCTAGTGCAGTGTGAGCAGTTAAAGGCATTTTCCACCTTTGGAAGTGGTGAGTAGTGTTTCAGAAAAAAAAAAATTCTAGTTGGTTTAACGCG,ATCTCTGCTAGTGCAGTGTGAGCAGTTAAAGGCATTTTAGCTTCCATTTTCCACCTTTGGAAGTGGTGAGTAGTGTTTCAGAAAAAAAAAAATTCTAGT,10,30,14,27,27,38,27,50,27,35,35,38,47,50,38.39,0.0
hek293t,9645,1,6,CGCAGAGCATCTCACTCTAGATTTTGCAGTGGCTACGTACCATTGAATTAAATCTTGCTGTGCTTTTGTGGAAAAAAAATTCTAGTTGGTTTAACGCGT,CGCAGAGCATCTCACTCTAGATTTTGCAGTGGCTCAGGCTACGTACCATTGAATTAAATCTTGCTGTGCTTTTGTGGAAAAAAAATTCTAGTTGGTTTA,10,30,14,27,27,45,27,51,27,35,35,45,41,51,52.93,2.082530976
hek293t,9645,1,6,GGTTAAGCATCTCACTCTAGATTTTGCAGTGGCTACGTACCATTGAATTAAATCTTGCTGTGCTTTTAAAAAAATTCTAGTTGGTTTAACGCGTAACTA,GGTTAAGCATCTCACTCTAGATTTTGCAGTGGCTCAGGCTACGTACCATTGAATTAAATCTTGCTGTGCTTTTAAAAAAATTCTAGTTGGTTTAACGCG,10,30,14,27,27,50,27,56,27,35,35,50,41,56,52.93,4.438414672
hek293t,9647,1,10,CCGGGATACCCTATCTTTCTTGGAGCAAGGGGAAGAAGGTCTGCGTGCTGCTCTTCCTAGTTTTGTTAAGCCAAAAAAATTCTAGTTGGTTTAACGCGT,CCGGGATACCCTATCTTTCTTGGAGCAAGGTTAACAGTAGGGAAGAAGGTCTGCGTGCTGCTCTTCCTAGTTTTGTTAAGCCAAAAAAATTCTAGTTGG,10,30,14,27,27,41,27,51,27,31,31,41,41,51,32.09,29.36705857
hek293t,9647,1,10,TTTGAATACCCTATCTTTCTTGGAGCAAGGGGAAGAAGGTCTGCGTGCTGCTCTTCCTAGTTTTGTTAAGCCCCCAAAAAAATTCTAGTTGGTTTAACG,TTTGAATACCCTATCTTTCTTGGAGCAAGGTTAACAGTAGGGAAGAAGGTCTGCGTGCTGCTCTTCCTAGTTTTGTTAAGCCCCCAAAAAAATTCTAGT,10,30,14,27,27,38,27,48,27,31,31,38,41,48,32.09,23.23146404
hek293t,9649,1,3,TCCGGCTTAAATGCTAGCTCTGCACAGTCTGGAACTTATTTGTCACAAACAGTAAGTTTTTGCATTCAGCTTTTTAATCGGAGTACAAAAAAATTCTAG,TCCGGCTTAAATGCTAGCTCTGCACAGTCTAGAGGAACTTATTTGTCACAAACAGTAAGTTTTTGCATTCAGCTTTTTAATCGGAGTACAAAAAAATTC,10,30,14,27,27,34,27,37,27,31,31,34,34,37,43.72,1.786477139
hek293t,9649,1,3,TAGACCTTAAATGCTAGCTCTGCACAGTCTGGAACTTATTTGTCACAAACAGTAAGTTTTTGCATTCAGCTTTTTAATCAAAAAAATTCTAGTTGGTTT,TAGACCTTAAATGCTAGCTCTGCACAGTCTAGAGGAACTTATTTGTCACAAACAGTAAGTTTTTGCATTCAGCTTTTTAATCAAAAAAATTCTAGTTGG,10,30,14,27,27,41,27,44,27,31,31,41,34,44,43.72,81.1996156
hek293t,9651,1,7,GCAGCAGCTCCTATTGACTGTTACCAGCATGGCTAAGTACTGCAGAGATACAGCTCTAATCTGGAATCATTTCCACATTAAAAAAATTCTAGTTGGTTT,GCAGCAGCTCCTATTGACTGTTACCAGCATTGCGTGTGGCTAAGTACTGCAGAGATACAGCTCTAATCTGGAATCATTTCCACATTAAAAAAATTCTAG,10,30,14,27,27,37,27,44,27,30,30,37,37,44,56.75,22.50126057
hek293t,9651,1,7,ATCCAAGCTCCTATTGACTGTTACCAGCATGGCTAAGTACTGCAGAGATACAGCTCTAATCTGGAATCATTAAAAAAATTCTAGTTGGTTTAACGCGTA,ATCCAAGCTCCTATTGACTGTTACCAGCATTGCGTGTGGCTAAGTACTGCAGAGATACAGCTCTAATCTGGAATCATTAAAAAAATTCTAGTTGGTTTA,10,30,14,27,27,45,27,52,27,30,30,45,37,52,56.75,54.87724494
hek293t,9653,1,12,TGTTAGATTCTGCAATACTAATTCCACGTTGGAATGGCAGTACAACGCGCATAGCTCGTGCCCGAGTTTTAACCACGGAAAAAAATTCTAGTTGGTTTA,TGTTAGATTCTGCAATACTAATTCCACGTTGCATGATCTACTGGAATGGCAGTACAACGCGCATAGCTCGTGCCCGAGTTTTAACCACGGAAAAAAATT,10,30,14,27,27,33,27,45,27,30,30,33,42,45,49.39,0.048239267
hek293t,9653,1,12,GGCCTGATTCTGCAATACTAATTCCACGTTGGAATGGCAGTACAACGCGCATAGCTCGTGCCCGAGTTTTAACCAAAAAAATTCTAGTTGGTTTAACGC,GGCCTGATTCTGCAATACTAATTCCACGTTGCATGATCTACTGGAATGGCAGTACAACGCGCATAGCTCGTGCCCGAGTTTTAACCAAAAAAATTCTAG,10,30,14,27,27,37,27,49,27,30,30,37,42,49,49.39,8.492906132
hek293t,9656,1,1,CTTGTGCTTCTCTAAAAGTACTACATTTTAGGAAAATAAAATAAGTATCTGTTTTCTCAACCTGTTTCTTCTCATTATGAGTACAGTAAAAAAATTCTA,CTTGTGCTTCTCTAAAAGTACTACATTTTAGAGAAAATAAAATAAGTATCTGTTTTCTCAACCTGTTTCTTCTCATTATGAGTACAGTAAAAAAATTCT,10,30,14,27,27,35,27,36,27,32,32,35,33,36,3.01,0.0
hek293t,9658,1,3,GTAGTCCCCCCCCCTTCCCTATTAATCTACGGACGAATGAAAGGAGTGAAAACATAAATAGAAGCAGCTCCTGCTTTACTTCAAAAAAATTCTAGTTGG,GTAGTCCCCCCCCCTTCCCTATTAATCTACGGACCCAGAATGAAAGGAGTGAAAACATAAATAGAAGCAGCTCCTGCTTTACTTCAAAAAAATTCTAGT,10,30,14,27,27,38,27,41,27,35,35,38,38,41,31.75,0.0
hek293t,9660,1,9,GATGAAATGCCAAGCTTATATCTAAAAAGAGGAAGGCTAAAATATACCTATTTTCTTCCAAGCGCAGTAAAAAAAATTCTAGTTGGTTTAACGCGTAAC,GATGAAATGCCAAGCTTATATCTAAAAAGAGGAACGCATCGCAGGCTAAAATATACCTATTTTCTTCCAAGCGCAGTAAAAAAAATTCTAGTTGGTTTA,10,30,14,27,27,45,27,54,27,35,35,45,44,54,49.73,0.068587106
hek293t,9660,1,9,TATGGAATGCCAAGCTTATATCTAAAAAGAGGAAGGCTAAAATATACCTATTTTCTTCCAAGCGCAGTAGATCAGTAAAAAAATTCTAGTTGGTTTAAC,TATGGAATGCCAAGCTTATATCTAAAAAGAGGAACGCATCGCAGGCTAAAATATACCTATTTTCTTCCAAGCGCAGTAGATCAGTAAAAAAATTCTAGT,10,30,14,27,27,38,27,47,27,35,35,38,44,47,49.73,0.0
hek293t,9662,1,1,CACGTTTGTTTGCAATGCTACTTAGTTTTTGGCATTTTTAGATTTGATACTGTAATGAAAGCTTCAGATTTTGATCTAAAAAAATTCTAGTTGGTTTAA,CACGTTTGTTTGCAATGCTACTTAGTTTTTGGCATTTTTTAGATTTGATACTGTAATGAAAGCTTCAGATTTTGATCTAAAAAAATTCTAGTTGGTTTA,10,30,14,27,27,45,27,46,27,38,38,45,39,46,5.54,2.463487585
hek293t,9664,1,7,TCCCCCAAGATGTACAGCTTTTAGTTACTTGGCTTGGGGGCGATGGCTACAAGCCTTTCAGAGAGATCATATTTATAAAAAAATTCTAGTTGGTTTAAC,TCCCCCAAGATGTACAGCTTTTAGTTACTAGTCCTGTGGCTTGGGGGCGATGGCTACAAGCCTTTCAGAGAGATCATATTTATAAAAAAATTCTAGTTG,10,30,14,27,27,40,27,47,27,30,30,40,37,47,11.88,15.6571535
hek293t,9664,1,7,CCAAGCAAGATGTACAGCTTTTAGTTACTTGGCTTGGGGGCGATGGCTACAAGCCTTTCAGAGAGATCATATTTATTGTAAAAAAATTCTAGTTGGTTT,CCAAGCAAGATGTACAGCTTTTAGTTACTAGTCCTGTGGCTTGGGGGCGATGGCTACAAGCCTTTCAGAGAGATCATATTTATTGTAAAAAAATTCTAG,10,30,14,27,27,37,27,44,27,30,30,37,37,44,11.88,8.578673682
hek293t,9666,1,10,TCTTGCTCAAATGCATCTGCAGTGATCTAAGGTTGCAACTGGTAGACATAGAAATTTTTCCAAGATGCTAAAAAAATTCTAGTTGGTTTAACGCGTAAC,TCTTGCTCAAATGCATCTGCAGTGATCTAAGGTTGCCCCTCAGAGCAACTGGTAGACATAGAAATTTTTCCAAGATGCTAAAAAAATTCTAGTTGGTTT,10,30,14,27,27,44,27,54,27,37,37,44,47,54,60.59,5.664726086
hek293t,9666,1,10,GAGAGCTCAAATGCATCTGCAGTGATCTAAGGTTGCAACTGGTAGACATAGAAATTTTTCCAAGATAAAAAAATTCTAGTTGGTTTAACGCGTAACTAG,GAGAGCTCAAATGCATCTGCAGTGATCTAAGGTTGCCCCTCAGAGCAACTGGTAGACATAGAAATTTTTCCAAGATAAAAAAATTCTAGTTGGTTTAAC,10,30,14,27,27,47,27,57,27,37,37,47,47,57,60.59,4.927936243
hek293t,9668,1,8,ACCTATGAATCATTTTCCTACGTGTACACAGGAAAGCTTGGATTATTTCATTCCCAGGGCAACTATGAAAAAAATTCTAGTTGGTTTAACGCGTAACTA,ACCTATGAATCATTTTCCTACGTGTACACAGGATAAGTGAAAAGCTTGGATTATTTCATTCCCAGGGCAACTATGAAAAAAATTCTAGTTGGTTTAACG,10,30,14,27,27,48,27,56,27,33,33,48,41,56,45.14,13.5228742
hek293t,9672,1,2,CAGGAAAAACGTAGATGGATTGGAGATGCAGGGAGAAATGCTAGCTCTAAAAGAAATGGAAAGAGAGGAGAATCAAGAAAAAAATTCTAGTTGGTTTAA,CAGGAAAAACGTAGATGGATTGGAGATGTCCAGGGAGAAATGCTAGCTCTAAAAGAAATGGAAAGAGAGGAGAATCAAGAAAAAAATTCTAGTTGGTTT,10,30,14,27,27,44,27,46,27,29,29,44,31,46,54.67,65.64981813
hek293t,9672,1,2,TGTAGAAAACGTAGATGGATTGGAGATGCAGGGAGAAATGCTAGCTCTAAAAGAAATGGAAAGAGAGGAGAATCAAGGGGTACCCAAAAAAATTCTAGT,TGTAGAAAACGTAGATGGATTGGAGATGTCCAGGGAGAAATGCTAGCTCTAAAAGAAATGGAAAGAGAGGAGAATCAAGGGGTACCCAAAAAAATTCTA,10,30,14,27,27,36,27,38,27,29,29,36,31,38,54.67,73.75405526
hek293t,9674,1,8,AGAGCAAATATGGTATGAAAGGATGGAGGAGGTTGTTTATTGGTGTATCTAGGCTTGCTGAAGCTGTAAAAAAATTCTAGTTGGTTTAACGCGTAACTA,AGAGCAAATATGGTATGAAAGGATGGAGGAGGCAACTGTTTTGTTTATTGGTGTATCTAGGCTTGCTGAAGCTGTAAAAAAATTCTAGTTGGTTTAACG,10,30,14,27,27,48,27,56,27,33,33,48,41,56,60.13,0.742857751
hek293t,9674,1,8,ACTTAAAATATGGTATGAAAGGATGGAGGAGGTTGTTTATTGGTGTATCTAGGCTTGCTGAAGCTGTGCCCTTGTAAAAAAATTCTAGTTGGTTTAACG,ACTTAAAATATGGTATGAAAGGATGGAGGAGGCAACTGTTTTGTTTATTGGTGTATCTAGGCTTGCTGAAGCTGTGCCCTTGTAAAAAAATTCTAGTTG,10,30,14,27,27,40,27,48,27,33,33,40,41,48,60.13,0.543996216
hek293t,9676,1,7,TAATGGTCTACATGAAAAATAAACAGAGCTGGAACAAAGTTGTCATATTACTATGTATTTATGATTTGCAACAACCTCTTAAAAAAAAATTCTAGTTGG,TAATGGTCTACATGAAAAATAAACAGGTACCAGAGCTGGAACAAAGTTGTCATATTACTATGTATTTATGATTTGCAACAACCTCTTAAAAAAAAATTC,10,30,14,27,27,34,27,41,27,27,27,34,34,41,27.05,1.826725825
hek293t,9676,1,7,AAGCCGTCTACATGAAAAATAAACAGAGCTGGAACAAAGTTGTCATATTACTATGTATTTATGATTTGCAACAACCTCTTAATGAGAAAAAAATTCTAG,AAGCCGTCTACATGAAAAATAAACAGGTACCAGAGCTGGAACAAAGTTGTCATATTACTATGTATTTATGATTTGCAACAACCTCTTAATGAGAAAAAA,10,30,14,27,27,30,27,37,27,27,27,30,34,37,27.05,0.0
hek293t,9678,1,12,TGCCCCTGAGACACAGCTATAGAAAAAACAGGCTTTGTTAGTTTTGCTGCTCAAGGAACACCAATTCAAAAAAATTCTAGTTGGTTTAACGCGTAACTA,TGCCCCTGAGACACAGCTATAGAAAAAACAGGCTTTGTTAGAGCATTACAACGTTTTGCTGCTCAAGGAACACCAATTCAAAAAAATTCTAGTTGGTTT,10,30,14,27,27,44,27,56,27,41,41,44,53,56,47.21,0.0
hek293t,3191,1,3,TGTTCATGTATATTCAAGGTCTGAATTAATGGAGAGAAAAAAGCAAGTGCTGAATTACATGCATATTGATAGGGAAAAAAATTCTAGTTGGTTTAACGC,TGTTCATGTATATTCAAGGTCTGAATTAATCGGGGAGAGAAAAAAGCAAGTGCTGAATTACATGCATATTGATAGGGAAAAAAATTCTAGTTGGTTTAA,10,30,14,27,27,46,27,49,27,31,31,46,34,49,9.75,1.427586294
hek293t,9681,1,3,GTGCTTATAATGTCACACAGTAATGTTCATGGGCAGACAAAGCATCTGATCCTATGGGTCTGCCTTTTCTTGTAAAGAAAGAAAAAAAAATTCTAGTTG,GTGCTTATAATGTCACACAGTAATGTCCCTCATGGGCAGACAAAGCATCTGATCCTATGGGTCTGCCTTTTCTTGTAAAGAAAGAAAAAAAAATTCTAG,10,30,14,27,27,37,27,40,27,27,27,37,30,40,40.47,54.47961414
hek293t,9681,1,3,TTAATTATAATGTCACACAGTAATGTTCATGGGCAGACAAAGCATCTGATCCTATGGGTCTGCCTTTTCTTGTAAAGAAAGAAGGATGAAAAAAAAATT,TTAATTATAATGTCACACAGTAATGTCCCTCATGGGCAGACAAAGCATCTGATCCTATGGGTCTGCCTTTTCTTGTAAAGAAAGAAGGATGAAAAAAAA,10,30,14,27,27,30,27,33,27,27,27,30,30,33,40.47,0.08912656
hek293t,9683,1,3,GATATGACTTCAGAGTCCAGAAGTCTCACTGGAAGATAGTTGGATGCACTCCACAATATTATTTGTTCTCAACTGTTTACAAAAAAATTCTAGTTGGTT,GATATGACTTCAGAGTCCAGAAGTCTCACTGGCCAAAGATAGTTGGATGCACTCCACAATATTATTTGTTCTCAACTGTTTACAAAAAAATTCTAGTTG,10,30,14,27,27,40,27,43,27,33,33,40,36,43,61.07,77.07312197
hek293t,9685,1,4,ACCTCGGTATCAGCTTTGTGCAGCCTTTACGGTGCCCCAGCTGCCCGCTGCGTCGCAGGCGGGAGGGCCGGCAAAAAAATTCTAGTTGGTTTAACGCGT,ACCTCGGTATCAGCTTTGTGCAGCCTTTACGAGGGGTGCCCCAGCTGCCCGCTGCGTCGCAGGCGGGAGGGCCGGCAAAAAAATTCTAGTTGGTTTAAC,10,30,14,27,27,47,27,51,27,32,32,47,36,51,8.68,34.1795626
hek293t,9685,1,4,AGATTGGTATCAGCTTTGTGCAGCCTTTACGGTGCCCCAGCTGCCCGCTGCGTCGCAGGCGGGAGGGCCGGCGATGGGCAAAAAAAATTCTAGTTGGTT,AGATTGGTATCAGCTTTGTGCAGCCTTTACGAGGGGTGCCCCAGCTGCCCGCTGCGTCGCAGGCGGGAGGGCCGGCGATGGGCAAAAAAAATTCTAGTT,10,30,14,27,27,39,27,43,27,32,32,39,36,43,8.68,26.42973856
hek293t,9687,1,2,TATACTTCTCAAGGATCATTTCACAACGTTGGTAAATAAATTATAATTTTAGACATGCTTTTATGCTAAAAACCCTGCATATTGAACAAAAAAATTCTA,TATACTTCTCAAGGATCATTTCACAACGTTACGGTAAATAAATTATAATTTTAGACATGCTTTTATGCTAAAAACCCTGCATATTGAACAAAAAAATTC,10,30,14,27,27,34,27,36,27,31,31,34,33,36,55.94,0.0
hek293t,9687,1,2,AGTCCTTCTCAAGGATCATTTCACAACGTTGGTAAATAAATTATAATTTTAGACATGCTTTTATGCTAAAAACCCTGCATATTAAAAAAATTCTAGTTG,AGTCCTTCTCAAGGATCATTTCACAACGTTACGGTAAATAAATTATAATTTTAGACATGCTTTTATGCTAAAAACCCTGCATATTAAAAAAATTCTAGT,10,30,14,27,27,38,27,40,27,31,31,38,33,40,55.94,48.10174337
hek293t,938,1,11,TAGAGTATTTTTAGAAATAAATTGTGGCCTGGGGAGGAGAAGGATTTTCTTACTCATGTTCTAAGAGTACAAAAAAATTCTAGTTGGTTTAACGCGTAA,TAGAGTATTTTTAGAAATAAATTGTGGCCTGGGGAGGAGTGATGTTACGGAAGGATTTTCTTACTCATGTTCTAAGAGTACAAAAAAATTCTAGTTGGT,10,30,14,27,27,42,27,53,27,39,39,42,50,53,-2.64,0.0
hek293t,9690,1,13,CAACCAAACTGAAGAAAATTGGCTATTAGAGGACCACTGCTGCTACACCCCAAAATCTCCCACGGAGACTAATTGAAAAAAATTCTAGTTGGTTTAACG,CAACCAAACTGAAGAAAATTGGCTATTCAGTTGCCCGTGCAGAGGACCACTGCTGCTACACCCCAAAATCTCCCACGGAGACTAATTGAAAAAAATTCT,10,30,14,27,27,35,27,48,27,28,28,35,41,48,8.24,0.162496405
hek293t,9690,1,13,AGGCGAAACTGAAGAAAATTGGCTATTAGAGGACCACTGCTGCTACACCCCAAAATCTCCCACGGAGACTAAAAAAAAATTCTAGTTGGTTTAACGCGT,AGGCGAAACTGAAGAAAATTGGCTATTCAGTTGCCCGTGCAGAGGACCACTGCTGCTACACCCCAAAATCTCCCACGGAGACTAAAAAAAAATTCTAGT,10,30,14,27,27,38,27,51,27,28,28,38,41,51,8.24,0.18515861
hek293t,9692,1,2,CTTAACAGGACATCCTTCTCCAGTCGATTCGGGGTTGAGGGCAACCTCAGGTTGGTGGGGGAACGAGCCTGCGGGGCTCAAAAAAATTCTAGTTGGTTT,CTTAACAGGACATCCTTCTCCAGTCGATTCGGAGGGTTGAGGGCAACCTCAGGTTGGTGGGGGAACGAGCCTGCGGGGCTCAAAAAAATTCTAGTTGGT,10,30,14,27,27,42,27,44,27,32,32,42,34,44,21.59,81.73490929
hek293t,9692,1,2,TCAAGCAGGACATCCTTCTCCAGTCGATTCGGGGTTGAGGGCAACCTCAGGTTGGTGGGGGAACGAGCCTGCGGAAAAAAATTCTAGTTGGTTTAACGC,TCAAGCAGGACATCCTTCTCCAGTCGATTCGGAGGGTTGAGGGCAACCTCAGGTTGGTGGGGGAACGAGCCTGCGGAAAAAAATTCTAGTTGGTTTAAC,10,30,14,27,27,47,27,49,27,32,32,47,34,49,21.59,76.24247904
hek293t,9696,1,12,TCGATGCGGGGGGAGGGAAGAGGTATGTAAGGAACCTCTGGCAGTTTATTTGCATAGGGGCATTTATTAAAAAAATTCTAGTTGGTTTAACGCGTAACT,TCGATGCGGGGGGAGGGAAGAGGTATGTAAGGCGAGTAGATATTAACCTCTGGCAGTTTATTTGCATAGGGGCATTTATTAAAAAAATTCTAGTTGGTT,10,30,14,27,27,43,27,55,27,33,33,43,45,55,54.42,1.578456312
hek293t,9697,1,7,ACTGCTAAATGAAACTATTTACTTTTTTCAGGAAGTAACAAAGGTGCCCTCTTTCTGAGGCAAGAATGCTTACCTATTAAAAAAAATTCTAGTTGGTTT,ACTGCTAAATGAAACTATTTACTTTTGCGCGTATTCAGGAAGTAACAAAGGTGCCCTCTTTCTGAGGCAAGAATGCTTACCTATTAAAAAAAATTCTAG,10,30,14,27,27,37,27,44,27,27,27,37,34,44,1.87,0.0
hek293t,13373,1,11,ATAATAGTGATACCTGCAGTTCCTCAGAAAGGCTGGCCTGATGACTATGCGGTTGATGCCAGTGTTTTTGGAAAAAGCTGACAAAAAAATTCTAGTTGG,ATAATAGTGATACCTGCAGTTCCTCAAGGACGGTCGCGAAAGGCTGGCCTGATGACTATGCGGTTGATGCCAGTGTTTTTGGAAAAAGCTGACAAAAAA,10,30,14,27,27,30,27,41,27,27,27,30,38,41,59.31,2.35042735
hek293t,13373,1,11,TTGGCAGTGATACCTGCAGTTCCTCAGAAAGGCTGGCCTGATGACTATGCGGTTGATGCCAGTGTTTTTGAAAAAAATTCTAGTTGGTTTAACGCGTAA,TTGGCAGTGATACCTGCAGTTCCTCAAGGACGGTCGCGAAAGGCTGGCCTGATGACTATGCGGTTGATGCCAGTGTTTTTGAAAAAAATTCTAGTTGGT,10,30,14,27,27,42,27,53,27,27,27,42,38,53,59.31,22.88046672
hek293t,9701,1,9,CTCGGATAATGGTAGTAAAATTCATTATGAGGATATTTTGTCACCAGAGTAACTCAACACGCAAGCAAACGTTCTGTTAAGAAGAAAAAAATTCTAGTT,CTCGGATAATGGTAGTAAAATTCATTAGCTCAGGTATGAGGATATTTTGTCACCAGAGTAACTCAACACGCAAGCAAACGTTCTGTTAAGAAGAAAAAA,10,30,14,27,27,30,27,39,27,27,27,30,36,39,43.38,0.0
hek293t,9701,1,9,CAATAATAATGGTAGTAAAATTCATTATGAGGATATTTTGTCACCAGAGTAACTCAACACGCAAGCAAACGTTCTGTAAAAAAATTCTAGTTGGTTTAA,CAATAATAATGGTAGTAAAATTCATTAGCTCAGGTATGAGGATATTTTGTCACCAGAGTAACTCAACACGCAAGCAAACGTTCTGTAAAAAAATTCTAG,10,30,14,27,27,37,27,46,27,27,27,37,36,46,43.38,1.204382449
hek293t,1644,1,6,GTCAGGGAGCCCAAGCTGCTCCTCCCCACTGGTCCGCAGCTGCACTCAGGCCTGGGCTTTTCACTGAGTTTCCTTTTTTGTAGAAAAAAAAAATTCTAG,GTCAGGGAGCCCAAGCTGCTCCTCCCCGACGAGACTGGTCCGCAGCTGCACTCAGGCCTGGGCTTTTCACTGAGTTTCCTTTTTTGTAGAAAAAAAAAA,10,30,14,27,27,31,27,37,27,28,28,31,34,37,52.57,11.97020877
hek293t,9705,1,1,TAAGGAGGATCCCAGCCCATGCGGGACTGTGGCTTGTCGTGCCCAGACCTCTGCAAGCAGAGGGAAGGTTGCTGCCCAAAAAAAATTCTAGTTGGTTTA,TAAGGAGGATCCCAGCCCATGCGGGACTGTGGCTTGCTCGTGCCCAGACCTCTGCAAGCAGAGGGAAGGTTGCTGCCCAAAAAAAATTCTAGTTGGTTT,10,30,14,27,27,44,27,45,27,37,37,44,38,45,63.06,74.75781073
hek293t,9705,1,1,TTGAGAGGATCCCAGCCCATGCGGGACTGTGGCTTGTCGTGCCCAGACCTCTGCAAGCAGAGGGAAGGTTGCTGCCCAGCCTAAAAAAATTCTAGTTGG,TTGAGAGGATCCCAGCCCATGCGGGACTGTGGCTTGCTCGTGCCCAGACCTCTGCAAGCAGAGGGAAGGTTGCTGCCCAGCCTAAAAAAATTCTAGTTG,10,30,14,27,27,40,27,41,27,37,37,40,38,41,63.06,0.480389687
hek293t,9707,1,15,AATAAGCTGTGACCGGGACATGATTGCACAGGATGTTTGTGTCTGGAGTCCGGAACAGAAGTCAGTGCTAAAAAAATTCTAGTTGGTTTAACGCGTAAC,AATAAGCTGTGACCGGGACATGATTGCACAGCGACCGGTATCACGTGATGTTTGTGTCTGGAGTCCGGAACAGAAGTCAGTGCTAAAAAAATTCTAGTT,10,30,14,27,27,39,27,54,27,32,32,39,47,54,69.7,4.418774352
hek293t,9708,1,2,CTGAGAAAATAGCCATACTAACATAGCACTGGAAGGGAGGGAAATTCATCACTTTGATTTCTGTTGTGCCAAAAAAATTCTAGTTGGTTTAACGCGTAA,CTGAGAAAATAGCCATACTAACATAGCACTGGAAGGGAGGGCGAAATTCATCACTTTGATTTCTGTTGTGCCAAAAAAATTCTAGTTGGTTTAACGCGT,10,30,14,27,27,51,27,53,27,41,41,51,43,53,65.59,45.34498097
hek293t,9708,1,2,CAAGCAAAATAGCCATACTAACATAGCACTGGAAGGGAGGGAAATTCATCACTTTGATTTCTGTTGTGCCATTTCTGAAAAAAATTCTAGTTGGTTTAA,CAAGCAAAATAGCCATACTAACATAGCACTGGAAGGGAGGGCGAAATTCATCACTTTGATTTCTGTTGTGCCATTTCTGAAAAAAATTCTAGTTGGTTT,10,30,14,27,27,44,27,46,27,41,41,44,43,46,65.59,0.0
hek293t,9710,1,1,AGGTATGTTTCTGGCGGCAGAAGCTTATTTGGAAATAATTTTCCTTGTCATGAAAGCTGAGTAGACAAGTGACGGCACTGCTCAAAAAAATTCTAGTTG,AGGTATGTTTCTGGCGGCAGAAGCTTATATTGGAAATAATTTTCCTTGTCATGAAAGCTGAGTAGACAAGTGACGGCACTGCTCAAAAAAATTCTAGTT,10,30,14,27,27,39,27,40,27,29,29,39,30,40,4.13,72.92973693
hek293t,9712,1,11,ATTCGCCCCTTCTAAAAGCAACAAGGAGGAGGCTCTGAGCCATAGGAAACCTATTTATTCCTCCCTGAAGTAAAAAAATTCTAGTTGGTTTAACGCGTA,ATTCGCCCCTTCTAAAAGCAACAAGGAGGAGGCTCCCTTGTTATTCTGAGCCATAGGAAACCTATTTATTCCTCCCTGAAGTAAAAAAATTCTAGTTGG,10,30,14,27,27,41,27,52,27,34,34,41,45,52,45.6,0.0
hek293t,9712,1,11,AATGGCCCCTTCTAAAAGCAACAAGGAGGAGGCTCTGAGCCATAGGAAACCTATTTATTCCTCCCTGAAAAAAAATTCTAGTTGGTTTAACGCGTAACT,AATGGCCCCTTCTAAAAGCAACAAGGAGGAGGCTCCCTTGTTATTCTGAGCCATAGGAAACCTATTTATTCCTCCCTGAAAAAAAATTCTAGTTGGTTT,10,30,14,27,27,44,27,55,27,34,34,44,45,55,45.6,0.24833848
hek293t,9714,1,8,CTCTCTATGGCTTGTGTCACAGAGAAGATAGGACTAGATAATCTTCAGGCTAGGTAAGGGACTTAAAATTAAAAAAATTCTAGTTGGTTTAACGCGTAA,CTCTCTATGGCTTGTGTCACAGAGAAGATAGCCATGTAGGACTAGATAATCTTCAGGCTAGGTAAGGGACTTAAAATTAAAAAAATTCTAGTTGGTTTA,10,30,14,27,27,45,27,53,27,30,30,45,38,53,54.84,37.33361595
hek293t,9714,1,8,CATTTTATGGCTTGTGTCACAGAGAAGATAGGACTAGATAATCTTCAGGCTAGGTAAGGGACTTAAAATTTCTGACATTTACAAAAAAATTCTAGTTGG,CATTTTATGGCTTGTGTCACAGAGAAGATAGCCATGTAGGACTAGATAATCTTCAGGCTAGGTAAGGGACTTAAAATTTCTGACATTTACAAAAAAATT,10,30,14,27,27,33,27,41,27,30,30,33,38,41,54.84,0.0
hek293t,9720,1,8,GCTGCCCAGACAATAACTTTCATTGTCTTAGGCGGTCATAACTATTCAGCAATAAGGCTGTATGGACTATCAAAAAAATTCTAGTTGGTTTAACGCGTA,GCTGCCCAGACAATAACTTTCATTGTCTGTTAGCTTTAGGCGGTCATAACTATTCAGCAATAAGGCTGTATGGACTATCAAAAAAATTCTAGTTGGTTT,10,30,14,27,27,44,27,52,27,29,29,44,37,52,9.41,37.13334695
hek293t,9720,1,8,GCTTTCCAGACAATAACTTTCATTGTCTTAGGCGGTCATAACTATTCAGCAATAAGGCTGTATGGACTATCTCCCAAAAAAAATTCTAGTTGGTTTAAC,GCTTTCCAGACAATAACTTTCATTGTCTGTTAGCTTTAGGCGGTCATAACTATTCAGCAATAAGGCTGTATGGACTATCTCCCAAAAAAAATTCTAGTT,10,30,14,27,27,39,27,47,27,29,29,39,37,47,9.41,24.46197313
hek293t,9722,1,9,TTTTTTGAAGGAAAGAACTGCTTTAAGATAGGCAGAAAATGATACAAAAATAATTATCATAGGATAGTGATCATTATGTCAAAAAAAATTCTAGTTGGT,TTTTTTGAAGGAAAGAACTGCTTTAAGATGCAGGACGGAGGCAGAAAATGATACAAAAATAATTATCATAGGATAGTGATCATTATGTCAAAAAAAATT,10,30,14,27,27,33,27,42,27,30,30,33,39,42,37.9,0.0
hek293t,9725,1,7,CCATTTCTTCCTGGCGCAAATGGATCACCAGGACAACCGGTAAATATTCCTTATTCTGCAGTATTTAAATGGAAAAAAATTCTAGTTGGTTTAACGCGT,CCATTTCTTCCTGGCGCAAATGGATCACAGCCGGCCAGGACAACCGGTAAATATTCCTTATTCTGCAGTATTTAAATGGAAAAAAATTCTAGTTGGTTT,10,30,14,27,27,44,27,51,27,29,29,44,36,51,38.96,63.11080853
hek293t,9727,1,15,CAGCCTTGACAAATATTTGACAGCAAGTTTGGCTTAATATGGTCTACTGCTTCTTGCTTAGAAAGCAAAAAAAAATTCTAGTTGGTTTAACGCGTAACT,CAGCCTTGACAAATATTTGACAGCAAGTTCTAGCCACCGCTAGCTGGCTTAATATGGTCTACTGCTTCTTGCTTAGAAAGCAAAAAAAAATTCTAGTTG,10,30,14,27,27,40,27,55,27,30,30,40,45,55,0.1,0.941648414
hek293t,9728,1,1,ATCCCGGCTGAATAGCATCACATATTGCCAGGGAGAATTAGGATTTCAAGGAGGAGATGGCTTTATGTAGTTAAAAAAAAAATTCTAGTTGGTTTAACG,ATCCCGGCTGAATAGCATCACATATTGCCAGGGAGAATTTAGGATTTCAAGGAGGAGATGGCTTTATGTAGTTAAAAAAAAAATTCTAGTTGGTTTAAC,10,30,14,27,27,47,27,48,27,40,40,47,41,48,46.99,47.4494449
hek293t,15312,1,10,AATCCGATAAAGGGTACAGATTTGTTGGTCGGCTTCATGGTCTTAGAATGATTTGTTGTTCAGGATGTCTAAAAAAAATTCTAGTTGGTTTAACGCGTA,AATCCGATAAAGGGTACAGATTTGTTGGTCGGCTTTGCCTGAAATCATGGTCTTAGAATGATTTGTTGTTCAGGATGTCTAAAAAAAATTCTAGTTGGT,10,30,14,27,27,42,27,52,27,35,35,42,45,52,48.73,0.887371491
hek293t,15312,1,10,TGATGGATAAAGGGTACAGATTTGTTGGTCGGCTTCATGGTCTTAGAATGATTTGTTGTTCAGGATGTAAAAAAATTCTAGTTGGTTTAACGCGTAACT,TGATGGATAAAGGGTACAGATTTGTTGGTCGGCTTTGCCTGAAATCATGGTCTTAGAATGATTTGTTGTTCAGGATGTAAAAAAATTCTAGTTGGTTTA,10,30,14,27,27,45,27,55,27,35,35,45,45,55,48.73,6.52817203
hek293t,9736,1,11,TCGTGGCATTTATACAGTGCCTACCACACTGGTGTTTCTGTTTCATTGGAGGTTCCCCCCCCCCAAAAAAATTCTAGTTGGTTTAACGCGTAACTAGAT,TCGTGGCATTTATACAGTGCCTACCACACTGGTGTTTCGAGAGTTACCCTGTTTCATTGGAGGTTCCCCCCCCCCAAAAAAATTCTAGTTGGTTTAACG,10,30,14,27,27,48,27,59,27,38,38,48,49,59,59.29,0.678471804
hek293t,9737,1,9,AACCATTCTGATGCTTCCTGTAAGAAGAAAGGCCAGTCTATTTAGGAAATGGTGAACCTCTGGATCTGAGAGGAAAAAAATTCTAGTTGGTTTAACGCG,AACCATTCTGATGCTTCCTGTAAGAAGAAATAAGCCTCTGGCCAGTCTATTTAGGAAATGGTGAACCTCTGGATCTGAGAGGAAAAAAATTCTAGTTGG,10,30,14,27,27,41,27,50,27,31,31,41,40,50,59.39,3.586966695
hek293t,9737,1,9,TACTATTCTGATGCTTCCTGTAAGAAGAAAGGCCAGTCTATTTAGGAAATGGTGAACCTCTGGATCTGAGAGGATAAAAAAAATTCTAGTTGGTTTAAC,TACTATTCTGATGCTTCCTGTAAGAAGAAATAAGCCTCTGGCCAGTCTATTTAGGAAATGGTGAACCTCTGGATCTGAGAGGATAAAAAAAATTCTAGT,10,30,14,27,27,38,27,47,27,31,31,38,40,47,59.39,1.650835097
hek293t,9739,1,2,GAGAGAAAATACTTACAAAATACTCATAAAGGAGACCAAACCAGGGTAATTTTGAAATAATGGTCAGAAGACAGTTGGCCATATGTAAAAAAATTCTAG,GAGAGAAAATACTTACAAAATACTCATAAAGTGGAGACCAAACCAGGGTAATTTTGAAATAATGGTCAGAAGACAGTTGGCCATATGTAAAAAAATTCT,10,30,14,27,27,35,27,37,27,32,32,35,34,37,27.17,0.0
hek293t,9739,1,2,CCCACAAAATACTTACAAAATACTCATAAAGGAGACCAAACCAGGGTAATTTTGAAATAATGGTCAGAAGACAGTTGGCAAAAAAATTCTAGTTGGTTT,CCCACAAAATACTTACAAAATACTCATAAAGTGGAGACCAAACCAGGGTAATTTTGAAATAATGGTCAGAAGACAGTTGGCAAAAAAATTCTAGTTGGT,10,30,14,27,27,42,27,44,27,32,32,42,34,44,27.17,0.316273491
hek293t,9741,1,9,CCTTCATAACTAAATATTCCTTAATATCCAGGCTGTTGATTCCCACTCCTATGTTTTGGCCAATAAGAAAAAAATTCTAGTTGGTTTAACGCGTAACTA,CCTTCATAACTAAATATTCCTTAATATCCAGAGCCACTAGGCTGTTGATTCCCACTCCTATGTTTTGGCCAATAAGAAAAAAATTCTAGTTGGTTTAAC,10,30,14,27,27,47,27,56,27,32,32,47,41,56,19.04,9.504661916
hek293t,9741,1,9,CTGCGATAACTAAATATTCCTTAATATCCAGGCTGTTGATTCCCACTCCTATGTTTTGGCCAATAAGCAAGAAAAAAAATTCTAGTTGGTTTAACGCGT,CTGCGATAACTAAATATTCCTTAATATCCAGAGCCACTAGGCTGTTGATTCCCACTCCTATGTTTTGGCCAATAAGCAAGAAAAAAAATTCTAGTTGGT,10,30,14,27,27,42,27,51,27,32,32,42,41,51,19.04,10.8366384
hek293t,9743,1,7,TTTCGTTTCCCTTCAGCTTTCTGACAGAGTGGTCTTTCTGGAGTTTTTGCATTTAATGTAGAAGTAGACAACAGAACACAAAAAAAAAATTCTAGTTGG,TTTCGTTTCCCTTCAGCTTTCTGACAACACCCGGAGTGGTCTTTCTGGAGTTTTTGCATTTAATGTAGAAGTAGACAACAGAACACAAAAAAAAAATTC,10,30,14,27,27,34,27,41,27,27,27,34,34,41,40.72,8.560785481
hek293t,9743,1,7,CTGGCTTTCCCTTCAGCTTTCTGACAGAGTGGTCTTTCTGGAGTTTTTGCATTTAATGTAGAAGTAGACAACAGAACACAAAAAACAAAAAAATTCTAG,CTGGCTTTCCCTTCAGCTTTCTGACAACACCCGGAGTGGTCTTTCTGGAGTTTTTGCATTTAATGTAGAAGTAGACAACAGAACACAAAAAACAAAAAA,10,30,14,27,27,30,27,37,27,27,27,30,34,37,40.72,0.0
hek293t,9745,1,15,CACAGCCCCCCCAGTGGGAAAACTAAAATTGGTTAACTCACTGTGAAATCCCAATAGATCAACCATCAGTAAAAAAAATTCTAGTTGGTTTAACGCGTA,CACAGCCCCCCCAGTGGGAAAACTAAAATGTCTACCTGACTATGTGGTTAACTCACTGTGAAATCCCAATAGATCAACCATCAGTAAAAAAAATTCTAG,10,30,14,27,27,37,27,52,27,30,30,37,45,52,7.43,0.0
hek293t,9745,1,15,CCTAGCCCCCCCAGTGGGAAAACTAAAATTGGTTAACTCACTGTGAAATCCCAATAGATCAACCATCAGTAAGGTAAAAAAATTCTAGTTGGTTTAACG,CCTAGCCCCCCCAGTGGGAAAACTAAAATGTCTACCTGACTATGTGGTTAACTCACTGTGAAATCCCAATAGATCAACCATCAGTAAGGTAAAAAAATT,10,30,14,27,27,33,27,48,27,30,30,33,45,48,7.43,0.0
hek293t,18334,1,2,GGATTGCAGTGTGTGGGCTGCAAGAGTTCTGGTGGGAGAAGAAGGAGTTGATGCAAACAGAGTTGTGAAAGTCTGATTGAAAAAAATTCTAGTTGGTTT,GGATTGCAGTGTGTGGGCTGCAAGAGTTCTGGTGGGAGTGAAGAAGGAGTTGATGCAAACAGAGTTGTGAAAGTCTGATTGAAAAAAATTCTAGTTGGT,10,30,14,27,27,42,27,44,27,39,39,42,41,44,53.35,16.80163335
hek293t,9749,1,12,AGCTGTGTCCATAGCATTGCTCATGTATTTGGGAAGGCTCACAAGCACTGTGAAAGTCAAGCTTTGGATAAAAAAATTCTAGTTGGTTTAACGCGTAAC,AGCTGTGTCCATAGCATTGCTCATGTATTTGGGAAGGTAGTGCACAAGGCTCACAAGCACTGTGAAAGTCAAGCTTTGGATAAAAAAATTCTAGTTGGT,10,30,14,27,27,42,27,54,27,35,35,42,47,54,7.36,0.0
hek293t,9749,1,12,GCGAGTGTCCATAGCATTGCTCATGTATTTGGGAAGGCTCACAAGCACTGTGAAAGTCAAGCTTTGGATTAAAAAAAAAATTCTAGTTGGTTTAACGCG,GCGAGTGTCCATAGCATTGCTCATGTATTTGGGAAGGTAGTGCACAAGGCTCACAAGCACTGTGAAAGTCAAGCTTTGGATTAAAAAAAAAATTCTAGT,10,30,14,27,27,38,27,50,27,35,35,38,47,50,7.36,0.0
hek293t,9753,1,3,TATTATAATTCCAATAGGAGCCAAATATGAGGCTGACTCAAGTACTAGAGATTTAATTTTGGGGTGAACAAAGGAGATACTCAAAAAAAATTCTAGTTG,TATTATAATTCCAATAGGAGCCAAATATGATTAGGCTGACTCAAGTACTAGAGATTTAATTTTGGGGTGAACAAAGGAGATACTCAAAAAAAATTCTAG,10,30,14,27,27,37,27,40,27,30,30,37,33,40,60.52,23.17445833
hek293t,9753,1,3,TTACCTAATTCCAATAGGAGCCAAATATGAGGCTGACTCAAGTACTAGAGATTTAATTTTGGGGTGAACAAAGGAGATACAAAAAAATTCTAGTTGGTT,TTACCTAATTCCAATAGGAGCCAAATATGATTAGGCTGACTCAAGTACTAGAGATTTAATTTTGGGGTGAACAAAGGAGATACAAAAAAATTCTAGTTG,10,30,14,27,27,40,27,43,27,30,30,40,33,43,60.52,59.74757385
hek293t,9755,1,8,TTGCAGAGTATATTGATTACACATACTGAAGGCTTAGATTAGCCATTAGGGAACTTTAACTTGTAAGAATAATTAAGCAAAAAAATTCTAGTTGGTTTA,TTGCAGAGTATATTGATTACACATACTGAAGGCTCGTAGCTTTAGATTAGCCATTAGGGAACTTTAACTTGTAAGAATAATTAAGCAAAAAAATTCTAG,10,30,14,27,27,37,27,45,27,34,34,37,42,45,58.69,3.250674861
hek293t,9755,1,8,TGAAAGAGTATATTGATTACACATACTGAAGGCTTAGATTAGCCATTAGGGAACTTTAACTTGTAAGAATAAAAAAAATTCTAGTTGGTTTAACGCGTA,TGAAAGAGTATATTGATTACACATACTGAAGGCTCGTAGCTTTAGATTAGCCATTAGGGAACTTTAACTTGTAAGAATAAAAAAAATTCTAGTTGGTTT,10,30,14,27,27,44,27,52,27,34,34,44,42,52,58.69,16.6901454
hek293t,9757,1,6,ATCGAGTGTTTTGGTAAGCTGGTTTTCTAAGGCTGAGTGACTAGCTCTTTCTGGGAGTTACATGTTGTGTGCAAGAAAAAAATTCTAGTTGGTTTAACG,ATCGAGTGTTTTGGTAAGCTGGTTTTAAGCGGCTAAGGCTGAGTGACTAGCTCTTTCTGGGAGTTACATGTTGTGTGCAAGAAAAAAATTCTAGTTGGT,10,30,14,27,27,42,27,48,27,27,27,42,33,48,15.81,42.59348193
hek293t,9757,1,6,TGAAAGTGTTTTGGTAAGCTGGTTTTCTAAGGCTGAGTGACTAGCTCTTTCTGGGAGTTACATGTTGTGTGCAAGTGTGTTTTAAAAAAATTCTAGTTG,TGAAAGTGTTTTGGTAAGCTGGTTTTAAGCGGCTAAGGCTGAGTGACTAGCTCTTTCTGGGAGTTACATGTTGTGTGCAAGTGTGTTTTAAAAAAATTC,10,30,14,27,27,34,27,40,27,27,27,34,33,40,15.81,5.424516147
hek293t,9759,1,12,GTCTTCAGTGCAAAGAAGGAAGAAAAACGTGGTTCAGCGTTAATGAAACGTCAGCCAAGTTAGACTGGGAAAAAAATTCTAGTTGGTTTAACGCGTAAC,GTCTTCAGTGCAAAGAAGGAAGAAAAACGTGGTTGTACATGATGGGCAGCGTTAATGAAACGTCAGCCAAGTTAGACTGGGAAAAAAATTCTAGTTGGT,10,30,14,27,27,42,27,54,27,35,35,42,47,54,69.03,0.033636058
hek293t,9759,1,12,AGTCTCAGTGCAAAGAAGGAAGAAAAACGTGGTTCAGCGTTAATGAAACGTCAGCCAAGTTAGACTGGGACAGAAAAAAATTCTAGTTGGTTTAACGCG,AGTCTCAGTGCAAAGAAGGAAGAAAAACGTGGTTGTACATGATGGGCAGCGTTAATGAAACGTCAGCCAAGTTAGACTGGGACAGAAAAAAATTCTAGT,10,30,14,27,27,38,27,50,27,35,35,38,47,50,69.03,0.0
hek293t,2590,1,14,AAGCCTAGGCACCAAAGGATCTCAGAGGAAGGCTAGATGAATGCTCCCAGCCATGGGTAAAACCCAAAAAAATTCTAGTTGGTTTAACGCGTAACTAGA,AAGCCTAGGCACCAAAGGATCTCAGAGGAAGGCTGTGCGTTCGAAGTTAGATGAATGCTCCCAGCCATGGGTAAAACCCAAAAAAATTCTAGTTGGTTT,10,30,14,27,27,44,27,58,27,34,34,44,48,58,44.37,0.0
hek293t,2590,1,14,GATCGTAGGCACCAAAGGATCTCAGAGGAAGGCTAGATGAATGCTCCCAGCCATGGGTAAAACCCACCAAAAAAATTCTAGTTGGTTTAACGCGTAACT,GATCGTAGGCACCAAAGGATCTCAGAGGAAGGCTGTGCGTTCGAAGTTAGATGAATGCTCCCAGCCATGGGTAAAACCCACCAAAAAAATTCTAGTTGG,10,30,14,27,27,41,27,55,27,34,34,41,48,55,44.37,0.0
hek293t,9763,1,4,CCAATTGCATGACTGCCTGCAGCCAGAAAAGGGATTTGTGGTAGTCCTTGTCATTAGAAGAGATTCTAAAGATCATGTTAGGTACAAAAAAATTCTAGT,CCAATTGCATGACTGCCTGCAGCCAGCATCAAAAGGGATTTGTGGTAGTCCTTGTCATTAGAAGAGATTCTAAAGATCATGTTAGGTACAAAAAAATTC,10,30,14,27,27,34,27,38,27,27,27,34,31,38,36.15,3.838843223
hek293t,9763,1,4,CGACGTGCATGACTGCCTGCAGCCAGAAAAGGGATTTGTGGTAGTCCTTGTCATTAGAAGAGATTCTAAAGATCATGTTAGGAAAAAAATTCTAGTTGG,CGACGTGCATGACTGCCTGCAGCCAGCATCAAAAGGGATTTGTGGTAGTCCTTGTCATTAGAAGAGATTCTAAAGATCATGTTAGGAAAAAAATTCTAG,10,30,14,27,27,37,27,41,27,27,27,37,31,41,36.15,4.814944858
hek293t,9765,1,3,GCATGACGGCCCCCACACTGCCGAGCTGGTGGAGTTCCACCTGGCACAAATTCACAACGCAATCTGCTGAAACGTGACAAATAAAAAAATTCTAGTTGG,GCATGACGGCCCCCACACTGCCGAGCTGTGGGTGGAGTTCCACCTGGCACAAATTCACAACGCAATCTGCTGAAACGTGACAAATAAAAAAATTCTAGT,10,30,14,27,27,38,27,41,27,28,28,38,31,41,47.58,75.24547879
hek293t,9769,1,6,CTTGGTGGGAACAGCCATTATGGGCAGTATGGTACCTTTTCAACACTGCTCTGAAGACCCTGAGGTGAGTTTAAGCTAAAAAAATTCTAGTTGGTTTAA,CTTGGTGGGAACAGCCATTATGGGCAGTATGGTACCGTCTTGTTTTCAACACTGCTCTGAAGACCCTGAGGTGAGTTTAAGCTAAAAAAATTCTAGTTG,10,30,14,27,27,40,27,46,27,37,37,40,43,46,45.77,1.271186441
hek293t,9771,1,13,GCTACTTGAGCTTTCATTCCCACAGGGAGAGGTTGGTACAAAGATTAAATGCTGATTTGATGATAAAAAAAATTCTAGTTGGTTTAACGCGTAACTAGA,GCTACTTGAGCTTTCATTCCCACAGGGAGAGGTTGGTTCTAACTAGGCCAACAAAGATTAAATGCTGATTTGATGATAAAAAAAATTCTAGTTGGTTTA,10,30,14,27,27,45,27,58,27,38,38,45,51,58,43.35,0.0
hek293t,9773,1,12,TTATTGAAACCTGCTGTTTTATTTGATTCTGGACAAATACTGTTAGTGGTATGAACCTGCAAAATCCTCCCAAAAAAATTCTAGTTGGTTTAACGCGTA,TTATTGAAACCTGCTGTTTTATTTGATTCTGGTACATACACTGCACAAATACTGTTAGTGGTATGAACCTGCAAAATCCTCCCAAAAAAATTCTAGTTG,10,30,14,27,27,40,27,52,27,33,33,40,45,52,2.45,0.0
hek293t,9775,1,7,GCCCGTTAGAAGTCCTACTGAAGCTGATGGGGATTATTCACTTATTTAAATTCTGTACAACTTTATGCAAAAAAATTCTAGTTGGTTTAACGCGTAACT,GCCCGTTAGAAGTCCTACTGAAGCTGATGGGGATTATAGCTTCATCACTTATTTAAATTCTGTACAACTTTATGCAAAAAAATTCTAGTTGGTTTAACG,10,30,14,27,27,48,27,55,27,38,38,48,45,55,50.1,2.924704744
hek293t,9777,1,11,CACAAGTAGGCTTAAAGCAGGCACCACACAGGAAAGGAGATTAAAAGAAAAGAGAATATAAAAGCTTGAAAAAAATTCTAGTTGGTTTAACGCGTAACT,CACAAGTAGGCTTAAAGCAGGCACCACACAGGAAAGTAGGACACAGTGAGATTAAAAGAAAAGAGAATATAAAAGCTTGAAAAAAATTCTAGTTGGTTT,10,30,14,27,27,44,27,55,27,37,37,44,48,55,63.1,4.040232923
hek293t,9779,1,9,GTAGGTAATGCAATTACAAATAAAAATACAGGCTATTAAACCTGTTTGTGACTAAATGTCATAAAGTTAAAAAAATTCTAGTTGGTTTAACGCGTAACT,GTAGGTAATGCAATTACAAATAAAAATACAGGCTAGCCAGGCCATTAAACCTGTTTGTGACTAAATGTCATAAAGTTAAAAAAATTCTAGTTGGTTTAA,10,30,14,27,27,46,27,55,27,36,36,46,45,55,20.72,0.0
hek293t,9780,1,13,CCACAACTTTGCAGAAGAATTTTGAGAGTTGGCTCACTCCGTGCAGAGAGAGAGGCACTTGTTCCTGTGGAAAAAAAAATTCTAGTTGGTTTAACGCGT,CCACAACTTTGCAGAAGAATTTTGAGAGTTGCAACTCAATGTTGGCTCACTCCGTGCAGAGAGAGAGGCACTTGTTCCTGTGGAAAAAAAAATTCTAGT,10,30,14,27,27,38,27,51,27,31,31,38,44,51,1.69,1.294097129
hek293t,9780,1,13,CAATGACTTTGCAGAAGAATTTTGAGAGTTGGCTCACTCCGTGCAGAGAGAGAGGCACTTGTTCAAAAAAATTCTAGTTGGTTTAACGCGTAACTAGAT,CAATGACTTTGCAGAAGAATTTTGAGAGTTGCAACTCAATGTTGGCTCACTCCGTGCAGAGAGAGAGGCACTTGTTCAAAAAAATTCTAGTTGGTTTAA,10,30,14,27,27,46,27,59,27,31,31,46,44,59,1.69,1.002828521
hek293t,9782,1,14,GACGGGGGAGACAGAATACAGAGCATGAAAGGGTCGGAACACTCCACTATTATTTTCTTATTATTTTAAAAAAATTCTAGTTGGTTTAACGCGTAACTA,GACGGGGGAGACAGAATACAGAGCATGAAAGGGTCGTCTATCCACTAGCGGAACACTCCACTATTATTTTCTTATTATTTTAAAAAAATTCTAGTTGGT,10,30,14,27,27,42,27,56,27,35,35,42,49,56,47.65,0.0
hek293t,21701,1,13,ATTACGGATATTCTGAGTACATAGATCTGAGGAACTTCAAGCAAGCAGTTTAGGAAAGACTGTTTCAAAAAAATTCTAGTTGGTTTAACGCGTAACTAG,ATTACGGATATTCTGAGTACATAGATCTTACCGTTGTGGAAGAGGAACTTCAAGCAAGCAGTTTAGGAAAGACTGTTTCAAAAAAATTCTAGTTGGTTT,10,30,14,27,27,44,27,57,27,29,29,44,42,57,71.03,7.20856758
hek293t,21701,1,13,TACCTGGATATTCTGAGTACATAGATCTGAGGAACTTCAAGCAAGCAGTTTAGGAAAGACTGTTTCTTCAGTTTTAATAAAAAAATTCTAGTTGGTTTA,TACCTGGATATTCTGAGTACATAGATCTTACCGTTGTGGAAGAGGAACTTCAAGCAAGCAGTTTAGGAAAGACTGTTTCTTCAGTTTTAATAAAAAAAT,10,30,14,27,27,32,27,45,27,29,29,32,42,45,71.03,0.197628458
hek293t,9785,1,2,TAGCATGTCCAGCAGCGTGACATCCTTTCCGGACGAAAGGGGAAAAAACAGCAGAAACTTGTTTTTCCTTAAAAAAATTCTAGTTGGTTTAACGCGTAA,TAGCATGTCCAGCAGCGTGACATCCTTTCCGGACGCGAAAGGGGAAAAAACAGCAGAAACTTGTTTTTCCTTAAAAAAATTCTAGTTGGTTTAACGCGT,10,30,14,27,27,51,27,53,27,36,36,51,38,53,12.72,7.391435755
hek293t,9786,1,5,GTGACAGGACTGAGTGGGTCTGCCCGAAGGGGCCCTTCACTCGAGCTGATGCCATTTCCCTGAACTCTGTCTCTCTTTTCAAAAAAATTCTAGTTGGTT,GTGACAGGACTGAGTGGGTCTGCCCGAAGGATGTGGGCCCTTCACTCGAGCTGATGCCATTTCCCTGAACTCTGTCTCTCTTTTCAAAAAAATTCTAGT,10,30,14,27,27,38,27,43,27,31,31,38,36,43,49.88,32.8750859
hek293t,9788,1,8,CGGGATTAACGCATGAAGCATGAGACAACAGGCTTTTTGGGGCAAGGTCCTGGAGACCAAGCTGTAATACACAGGACTAAAAAAATTCTAGTTGGTTTA,CGGGATTAACGCATGAAGCATGAGACAACAGGCACTTTGTCTTTTTGGGGCAAGGTCCTGGAGACCAAGCTGTAATACACAGGACTAAAAAAATTCTAG,10,30,14,27,27,37,27,45,27,34,34,37,42,45,31.6,0.386390697
hek293t,9788,1,8,GCCAGTTAACGCATGAAGCATGAGACAACAGGCTTTTTGGGGCAAGGTCCTGGAGACCAAGCTGTAATACAAAAAAAATTCTAGTTGGTTTAACGCGTA,GCCAGTTAACGCATGAAGCATGAGACAACAGGCACTTTGTCTTTTTGGGGCAAGGTCCTGGAGACCAAGCTGTAATACAAAAAAAATTCTAGTTGGTTT,10,30,14,27,27,44,27,52,27,34,34,44,42,52,31.6,4.193628023
hek293t,17219,1,6,TACGGTGTGATTATCGTCACAGGTCATTCTGGAAATTTGGCGTGACTATGCGTTAAGTGAATAGGAAAAAAATTCTAGTTGGTTTAACGCGTAACTAGA,TACGGTGTGATTATCGTCACAGGTCATTCTGGAAATTGCCCGTTGGCGTGACTATGCGTTAAGTGAATAGGAAAAAAATTCTAGTTGGTTTAACGCGTA,10,30,14,27,27,52,27,58,27,37,37,52,43,58,14.78,48.1093111
hek293t,17219,1,6,CTCTTTGTGATTATCGTCACAGGTCATTCTGGAAATTTGGCGTGACTATGCGTTAAGTGAATAGGGCAAATGGTCAAAAAAAAATTCTAGTTGGTTTAA,CTCTTTGTGATTATCGTCACAGGTCATTCTGGAAATTGCCCGTTGGCGTGACTATGCGTTAAGTGAATAGGGCAAATGGTCAAAAAAAAATTCTAGTTG,10,30,14,27,27,40,27,46,27,37,37,40,43,46,14.78,0.0
hek293t,9792,1,14,TCTATTAAGGAGCCAGCGTATTTCCTTTTAGGGAAATACTTTGAAAGCACCTCATTCTTCTATTAATTCAAAAAAAAATTCTAGTTGGTTTAACGCGTA,TCTATTAAGGAGCCAGCGTATTTCCTTTTACTGTATTTAGCAGAGGGAAATACTTTGAAAGCACCTCATTCTTCTATTAATTCAAAAAAAAATTCTAGT,10,30,14,27,27,38,27,52,27,31,31,38,45,52,1.33,0.077160494
hek293t,9792,1,14,ACGACTAAGGAGCCAGCGTATTTCCTTTTAGGGAAATACTTTGAAAGCACCTCATTCTTCTATTAATTCAACATAAAAAAAATTCTAGTTGGTTTAACG,ACGACTAAGGAGCCAGCGTATTTCCTTTTACTGTATTTAGCAGAGGGAAATACTTTGAAAGCACCTCATTCTTCTATTAATTCAACATAAAAAAAATTC,10,30,14,27,27,34,27,48,27,31,31,34,45,48,1.33,0.0
hek293t,9794,1,13,TTCCGACAGGCTTAACTGCTGGTGTGACCAGGGTTGCTAAGGTTCATGTCCAGTAAAACAGTGAAACTCAAAAAAAATTCTAGTTGGTTTAACGCGTAA,TTCCGACAGGCTTAACTGCTGGTGTGACCTGTAAGAGCGATCAGGGTTGCTAAGGTTCATGTCCAGTAAAACAGTGAAACTCAAAAAAAATTCTAGTTG,10,30,14,27,27,40,27,53,27,30,30,40,43,53,40.13,18.0610467
hek293t,9794,1,13,ATAGCACAGGCTTAACTGCTGGTGTGACCAGGGTTGCTAAGGTTCATGTCCAGTAAAACAGTGAAACTCATGTAAAAAAATTCTAGTTGGTTTAACGCG,ATAGCACAGGCTTAACTGCTGGTGTGACCTGTAAGAGCGATCAGGGTTGCTAAGGTTCATGTCCAGTAAAACAGTGAAACTCATGTAAAAAAATTCTAG,10,30,14,27,27,37,27,50,27,30,30,37,43,50,40.13,4.597536623
hek293t,9796,1,10,TCTTTAGAGAAAAAGAGGACAACAGTGAAAGGTGATGTAAATCACAGTACCACAAAGTCTGCATTACATTTTTAAAAAAATTCTAGTTGGTTTAACGCG,TCTTTAGAGAAAAAGAGGACAACAGTGAAAGGTGATATGGTAGGTCGTAAATCACAGTACCACAAAGTCTGCATTACATTTTTAAAAAAATTCTAGTTG,10,30,14,27,27,40,27,50,27,37,37,40,47,50,41.43,0.0
hek293t,9797,1,13,GAATCAAGGTTATAACAAAGAAGATGCAAAGGAAAACAAACTGCAAGACTTTAGAGAGCAGAAGGAGAAAAAAATTCTAGTTGGTTTAACGCGTAACTA,GAATCAAGGTTATAACAAAGAAGATGCAAAGGAAAACAAGCTATTGGTGAACACTGCAAGACTTTAGAGAGCAGAAGGAGAAAAAAATTCTAGTTGGTT,10,30,14,27,27,43,27,56,27,40,40,43,53,56,54.14,0.0
hek293t,9798,1,11,CCAAAAGTGTAAAGCATAAATGTTTTTCTAGGAGAAGGCTTCCTTGCTCCAGCCATTCATTCCTGTTAGATAAAAAAATTCTAGTTGGTTTAACGCGTA,CCAAAAGTGTAAAGCATAAATGTTTTTCTAGGAGAAGAGTCGGTCAGGGCTTCCTTGCTCCAGCCATTCATTCCTGTTAGATAAAAAAATTCTAGTTGG,10,30,14,27,27,41,27,52,27,38,38,41,49,52,7.22,0.0
hek293t,9801,1,8,CCCGGTAAAATGGCGGGTAATGAATATGTTGGATTCAGTAATGCTACGTGAGTATTTCTTTTATTTACTTAATGCAGTTAGGAAAAAAATTCTAGTTGG,CCCGGTAAAATGGCGGGTAATGAATATGTACATAAGTTGGATTCAGTAATGCTACGTGAGTATTTCTTTTATTTACTTAATGCAGTTAGGAAAAAAATT,10,30,14,27,27,33,27,41,27,30,30,33,38,41,61.46,1.52167811
hek293t,9801,1,8,CAGTCTAAAATGGCGGGTAATGAATATGTTGGATTCAGTAATGCTACGTGAGTATTTCTTTTATTTACTTAAAAAAATTCTAGTTGGTTTAACGCGTAA,CAGTCTAAAATGGCGGGTAATGAATATGTACATAAGTTGGATTCAGTAATGCTACGTGAGTATTTCTTTTATTTACTTAAAAAAATTCTAGTTGGTTTA,10,30,14,27,27,45,27,53,27,30,30,45,38,53,61.46,32.95031056
hek293t,22668,1,10,CATGGGGAAAGAGACCATCCAATGAATGGAGGAAAGGTCTGGGATCAAGCACATCTGCACTACTGTAAGGACAGCTTCTGCTAAAAAAATTCTAGTTGG,CATGGGGAAAGAGACCATCCAATGAATTAGCTTATTTGGAGGAAAGGTCTGGGATCAAGCACATCTGCACTACTGTAAGGACAGCTTCTGCTAAAAAAA,10,30,14,27,27,31,27,41,27,28,28,31,38,41,74.22,0.82437353
hek293t,22668,1,10,AATGGGGAAAGAGACCATCCAATGAATGGAGGAAAGGTCTGGGATCAAGCACATCTGCACTACTGTAAGGAAAAAAATTCTAGTTGGTTTAACGCGTAA,AATGGGGAAAGAGACCATCCAATGAATTAGCTTATTTGGAGGAAAGGTCTGGGATCAAGCACATCTGCACTACTGTAAGGAAAAAAATTCTAGTTGGTT,10,30,14,27,27,43,27,53,27,28,28,43,38,53,74.22,43.94174351
hek293t,9806,1,11,TAATTCATTTAAAACAAGCAAGTTCTCCAAGGTCTTTTAGATCGGTTCCTACCAGGAACTGTTTTTCTCTAAAAAAATTCTAGTTGGTTTAACGCGTAA,TAATTCATTTAAAACAAGCAAGTTCTCCAAGGCCCGGTAGATGTCTTTTAGATCGGTTCCTACCAGGAACTGTTTTTCTCTAAAAAAATTCTAGTTGGT,10,30,14,27,27,42,27,53,27,32,32,42,43,53,53.59,2.411631607
hek293t,9806,1,11,GTAAGCATTTAAAACAAGCAAGTTCTCCAAGGTCTTTTAGATCGGTTCCTACCAGGAACTGTTTTTCTCTGCAAAAAAAATTCTAGTTGGTTTAACGCG,GTAAGCATTTAAAACAAGCAAGTTCTCCAAGGCCCGGTAGATGTCTTTTAGATCGGTTCCTACCAGGAACTGTTTTTCTCTGCAAAAAAAATTCTAGTT,10,30,14,27,27,39,27,50,27,32,32,39,43,50,53.59,0.158521798
hek293t,9808,1,13,ATCTGTTCTCTGTGACAACTCTAGCTGTTTGGGACTACGTGGCTGCAAAAGCTGGCCCCATAAAAGCAGAGCCTTAAAAAAATTCTAGTTGGTTTAACG,ATCTGTTCTCTGTGACAACTCTAGCTGTCTATCTTAGCGTTTTGGGACTACGTGGCTGCAAAAGCTGGCCCCATAAAAGCAGAGCCTTAAAAAAATTCT,10,30,14,27,27,35,27,48,27,28,28,35,41,48,24.59,0.0
hek293t,9808,1,13,TCGCATTCTCTGTGACAACTCTAGCTGTTTGGGACTACGTGGCTGCAAAAGCTGGCCCCATAAAAGCAAAAAAATTCTAGTTGGTTTAACGCGTAACTA,TCGCATTCTCTGTGACAACTCTAGCTGTCTATCTTAGCGTTTTGGGACTACGTGGCTGCAAAAGCTGGCCCCATAAAAGCAAAAAAATTCTAGTTGGTT,10,30,14,27,27,43,27,56,27,28,28,43,41,56,24.59,1.39946214
hek293t,9810,1,13,TCAAAAAGAAAAGGTGCTTATTTTGTATCAGGAAGGGCTAAACAAAGCCCCCACAACCCTGACTGGCTCCAAAAAAATTCTAGTTGGTTTAACGCGTAA,TCAAAAAGAAAAGGTGCTTATTTTGTATCCATTCATTCCTAAAGGAAGGGCTAAACAAAGCCCCCACAACCCTGACTGGCTCCAAAAAAATTCTAGTTG,10,30,14,27,27,40,27,53,27,30,30,40,43,53,2.8,1.274939943
hek293t,9810,1,13,CCTGTAAGAAAAGGTGCTTATTTTGTATCAGGAAGGGCTAAACAAAGCCCCCACAACCCTGACTGAAAAAAATTCTAGTTGGTTTAACGCGTAACTAGA,CCTGTAAGAAAAGGTGCTTATTTTGTATCCATTCATTCCTAAAGGAAGGGCTAAACAAAGCCCCCACAACCCTGACTGAAAAAAATTCTAGTTGGTTTA,10,30,14,27,27,45,27,58,27,30,30,45,43,58,2.8,1.650017067
hek293t,9812,1,7,CTACGTACTGTTATATCAATTGTTAGTCTCGGTGGTTATGCCACTATGTGTCTCTGCACAGTTTGAAGACTCACTCAGTTCTAAAAAAATTCTAGTTGG,CTACGTACTGTTATATCAATTGTTAGTACAAAATCTCGGTGGTTATGCCACTATGTGTCTCTGCACAGTTTGAAGACTCACTCAGTTCTAAAAAAATTC,10,30,14,27,27,34,27,41,27,27,27,34,34,41,34.61,27.54424772
hek293t,9812,1,7,ACTGGTACTGTTATATCAATTGTTAGTCTCGGTGGTTATGCCACTATGTGTCTCTGCACAGTTTGAAGACTCACAAAAAAATTCTAGTTGGTTTAACGC,ACTGGTACTGTTATATCAATTGTTAGTACAAAATCTCGGTGGTTATGCCACTATGTGTCTCTGCACAGTTTGAAGACTCACAAAAAAATTCTAGTTGGT,10,30,14,27,27,42,27,49,27,27,27,42,34,49,34.61,48.43539177
hek293t,9814,1,8,AAGGTTTGATCAAGCTGGTGTTTATGTGCAGGGATGACAACCATTTCGACAACAGTAGAGAGAGATGTGTCAGAAAAAAATTCTAGTTGGTTTAACGCG,AAGGTTTGATCAAGCTGGTGTTTATGTGCAGGGATGACCTGACCGCAACCATTTCGACAACAGTAGAGAGAGATGTGTCAGAAAAAAATTCTAGTTGGT,10,30,14,27,27,42,27,50,27,39,39,42,47,50,40.73,0.181818182
hek293t,9815,1,5,AGGTATTGCTGATCAACATCCCAAGGTCCTGGGAGAGGGCAATATTTGGCTGTACCATGTAGCTGTGTGTCAAAAAAAAATTCTAGTTGGTTTAACGCG,AGGTATTGCTGATCAACATCCCAAGGTCCGCTATTGGGAGAGGGCAATATTTGGCTGTACCATGTAGCTGTGTGTCAAAAAAAAATTCTAGTTGGTTTA,10,30,14,27,27,45,27,50,27,30,30,45,35,50,51.23,62.11476676
hek293t,9815,1,5,ATTTGTTGCTGATCAACATCCCAAGGTCCTGGGAGAGGGCAATATTTGGCTGTACCATGTAGCTGTGTGTCAAGCTGAACTAAAAAAATTCTAGTTGGT,ATTTGTTGCTGATCAACATCCCAAGGTCCGCTATTGGGAGAGGGCAATATTTGGCTGTACCATGTAGCTGTGTGTCAAGCTGAACTAAAAAAATTCTAG,10,30,14,27,27,37,27,42,27,30,30,37,35,42,51.23,75.43282349
hek293t,9817,1,14,ACCCCGTCATCTGTGAGACTGAGAGAATTTGGCCAGACACCATTACATGCACACATTTCTCCGTTCAAAAAAATTCTAGTTGGTTTAACGCGTAACTAG,ACCCCGTCATCTGTGAGACTGAGAGAATTTGGGACCAGCTCTGAGGCCAGACACCATTACATGCACACATTTCTCCGTTCAAAAAAATTCTAGTTGGTT,10,30,14,27,27,43,27,57,27,33,33,43,47,57,24.36,6.331022626
hek293t,9818,1,7,CCAGTATCTACTGTGCTTTAGTGTTCCCGAGGCCATATTTCAACAAGATGCCTATGGCCACAGCTAAAAAAAATTCTAGTTGGTTTAACGCGTAACTAG,CCAGTATCTACTGTGCTTTAGTGTTCCCGAGGCCATATTGTGGTGATCAACAAGATGCCTATGGCCACAGCTAAAAAAAATTCTAGTTGGTTTAACGCG,10,30,14,27,27,50,27,57,27,40,40,50,47,57,62.52,7.97595571
hek293t,9819,1,13,AGTTAGAGTTACTGGTACAGATTTACTATTGGGACTGTGTGACAGTACTGTAATTCAAAGGCTTAAAAAAAAATTCTAGTTGGTTTAACGCGTAACTAG,AGTTAGAGTTACTGGTACAGATTTACTATTGGGACTGTGTGGGAACAGTTACCGACAGTACTGTAATTCAAAGGCTTAAAAAAAAATTCTAGTTGGTTT,10,30,14,27,27,44,27,57,27,41,41,44,54,57,18.5,0.0
hek293t,9820,1,6,AGGACACCAATTGAAATGATGCTCACAAATGGTAAAAAAGCTGCAAGTGTGCTTTATGGTTGAAGCCCCAAAAAAATTCTAGTTGGTTTAACGCGTAAC,AGGACACCAATTGAAATGATGCTCACAAATGGCCCCGGTAAAAAAGCTGCAAGTGTGCTTTATGGTTGAAGCCCCAAAAAAATTCTAGTTGGTTTAACG,10,30,14,27,27,48,27,54,27,33,33,48,39,54,38.14,4.822244754
hek293t,9822,1,2,GCCCCACTGTAACTTTTTGTACAGTTTATTGGCAAAGCAACCATTACATAAGTTATAGTAAATTCCATCCTAAAATATCTGGAAAAAAAATTCTAGTTG,GCCCCACTGTAACTTTTTGTACAGTTTAAATTGGCAAAGCAACCATTACATAAGTTATAGTAAATTCCATCCTAAAATATCTGGAAAAAAAATTCTAGT,10,30,14,27,27,38,27,40,27,28,28,38,30,40,-2.06,1.342508937
hek293t,9822,1,2,CTGACACTGTAACTTTTTGTACAGTTTATTGGCAAAGCAACCATTACATAAGTTATAGTAAATTCCATCCTAAAATATCTGGAATCAAAAAAATTCTAG,CTGACACTGTAACTTTTTGTACAGTTTAAATTGGCAAAGCAACCATTACATAAGTTATAGTAAATTCCATCCTAAAATATCTGGAATCAAAAAAATTCT,10,30,14,27,27,35,27,37,27,28,28,35,30,37,-2.06,2.330048375
hek293t,9824,1,14,GTAGTTGAAGGTACAGGTTAATTGAACTGTGGGTCACTATGCAAAACATTATTTTGGCAACAAATAATTTAAAAAAAAATTCTAGTTGGTTTAACGCGT,GTAGTTGAAGGTACAGGTTAATTGAACTGTGGGCGAACGTATGGAGTTCACTATGCAAAACATTATTTTGGCAACAAATAATTTAAAAAAAAATTCTAG,10,30,14,27,27,37,27,51,27,34,34,37,48,51,69.44,0.034831069
hek293t,9824,1,14,AAGGCTGAAGGTACAGGTTAATTGAACTGTGGGTCACTATGCAAAACATTATTTTGGCAACAAATAAAAAAATTCTAGTTGGTTTAACGCGTAACTAGA,AAGGCTGAAGGTACAGGTTAATTGAACTGTGGGCGAACGTATGGAGTTCACTATGCAAAACATTATTTTGGCAACAAATAAAAAAATTCTAGTTGGTTT,10,30,14,27,27,44,27,58,27,34,34,44,48,58,69.44,1.934217991
hek293t,9826,1,4,GGTTATGGAAACAATATTTTACATACATAAGGTTGAAATGTGTTTTGGATTAAGTACTACCCTGCCCAAGATGAAAAAAATTCTAGTTGGTTTAACGCG,GGTTATGGAAACAATATTTTACATACATAACTGAGGTTGAAATGTGTTTTGGATTAAGTACTACCCTGCCCAAGATGAAAAAAATTCTAGTTGGTTTAA,10,30,14,27,27,46,27,50,27,31,31,46,35,50,4.13,0.799834759
hek293t,9826,1,4,CTTCTTGGAAACAATATTTTACATACATAAGGTTGAAATGTGTTTTGGATTAAGTACTACCCTGCCCAAGATGCCACTGCCAAAAAAATTCTAGTTGGT,CTTCTTGGAAACAATATTTTACATACATAACTGAGGTTGAAATGTGTTTTGGATTAAGTACTACCCTGCCCAAGATGCCACTGCCAAAAAAATTCTAGT,10,30,14,27,27,38,27,42,27,31,31,38,35,42,4.13,2.014991093
hek293t,9828,1,13,TCAGCTTTTGATATTTCTGGAAAAATGGGAGGAGGATTTCAGTGAAGGGCAGAGATACCCCATCTTTTTCCTCTAAAAAAATTCTAGTTGGTTTAACGC,TCAGCTTTTGATATTTCTGGAAAAATGGTATACGTTTCGTCGAGGAGGATTTCAGTGAAGGGCAGAGATACCCCATCTTTTTCCTCTAAAAAAATTCTA,10,30,14,27,27,36,27,49,27,29,29,36,42,49,44.7,0.0
hek293t,5915,1,4,TTCCTTAAATTGCTAAGGCTTCACTTTCATGGTTAATGATGTCAGCTGAATCCCTTGAGAAGATATTTGCCTTCCGAAAAAAATTCTAGTTGGTTTAAC,TTCCTTAAATTGCTAAGGCTTCACTTTCATGGTTACAACATGATGTCAGCTGAATCCCTTGAGAAGATATTTGCCTTCCGAAAAAAATTCTAGTTGGTT,10,30,14,27,27,43,27,47,27,36,36,43,40,47,10.02,36.77231474
hek293t,5915,1,4,ATTATTAAATTGCTAAGGCTTCACTTTCATGGTTAATGATGTCAGCTGAATCCCTTGAGAAGATATTTAAAAAAATTCTAGTTGGTTTAACGCGTAACT,ATTATTAAATTGCTAAGGCTTCACTTTCATGGTTACAACATGATGTCAGCTGAATCCCTTGAGAAGATATTTAAAAAAATTCTAGTTGGTTTAACGCGT,10,30,14,27,27,51,27,55,27,36,36,51,40,55,10.02,55.65525319
hek293t,9832,1,8,CTCCCCCTTCAGACTGTAGATGTATCACCAGGTGATGAACAGTCAGAGACTGCTTTGGGATCAGGAGTGCAACAAGCAAAAAAATTCTAGTTGGTTTAA,CTCCCCCTTCAGACTGTAGATGTATCAACGTAGCACCAGGTGATGAACAGTCAGAGACTGCTTTGGGATCAGGAGTGCAACAAGCAAAAAAATTCTAGT,10,30,14,27,27,38,27,46,27,28,28,38,36,46,70.59,24.51589249
hek293t,9834,1,6,AGGTGAATTTGCACAGACTAATAAAAGGATGGTTTACACTCACAGAAGTTACCCAAAAAGAAACACAAAAAAATTCTAGTTGGTTTAACGCGTAACTAG,AGGTGAATTTGCACAGACTAATAAAAGGATGGTTTGATTCCACACTCACAGAAGTTACCCAAAAAGAAACACAAAAAAATTCTAGTTGGTTTAACGCGT,10,30,14,27,27,51,27,57,27,36,36,51,42,57,52.45,0.0
hek293t,9834,1,6,GAATCAATTTGCACAGACTAATAAAAGGATGGTTTACACTCACAGAAGTTACCCAAAAAGAAACACTAGTTAAAAAAATTCTAGTTGGTTTAACGCGTA,GAATCAATTTGCACAGACTAATAAAAGGATGGTTTGATTCCACACTCACAGAAGTTACCCAAAAAGAAACACTAGTTAAAAAAATTCTAGTTGGTTTAA,10,30,14,27,27,46,27,52,27,36,36,46,42,52,52.45,0.0
hek293t,9838,1,15,TAAGTGTCAATAAAATGATATTGTACAAGTGGATACATTTTATGTTTACATTCTTTTTACAATTATGAGTTGCTCAAAAAAAAATTCTAGTTGGTTTAA,TAAGTGTCAATAAAATGATATTGTACAGTGATGCGTGCAACGAGTGGATACATTTTATGTTTACATTCTTTTTACAATTATGAGTTGCTCAAAAAAAAA,10,30,14,27,27,31,27,46,27,28,28,31,43,46,22.21,0.0
hek293t,9838,1,15,ACGACGTCAATAAAATGATATTGTACAAGTGGATACATTTTATGTTTACATTCTTTTTACAATTAAAAAAAATTCTAGTTGGTTTAACGCGTAACTAGA,ACGACGTCAATAAAATGATATTGTACAGTGATGCGTGCAACGAGTGGATACATTTTATGTTTACATTCTTTTTACAATTAAAAAAAATTCTAGTTGGTT,10,30,14,27,27,43,27,58,27,28,28,43,43,58,22.21,1.261442441
hek293t,9840,1,13,CCGCCCAACTCAAATGAATAGGGCAAGACAGGACCTAAGAGAAAAACACAGGTGGACATTTACTTAAGTAAAAAAATTCTAGTTGGTTTAACGCGTAAC,CCGCCCAACTCAAATGAATAGGGCAAGACAGGACCTAGGCAAACACTTCCAGAGAAAAACACAGGTGGACATTTACTTAAGTAAAAAAATTCTAGTTGG,10,30,14,27,27,41,27,54,27,38,38,41,51,54,30.02,0.0
hek293t,9840,1,13,TTGGGCAACTCAAATGAATAGGGCAAGACAGGACCTAAGAGAAAAACACAGGTGGACATTTACTTAAAAAAATTCTAGTTGGTTTAACGCGTAACTAGA,TTGGGCAACTCAAATGAATAGGGCAAGACAGGACCTAGGCAAACACTTCCAGAGAAAAACACAGGTGGACATTTACTTAAAAAAATTCTAGTTGGTTTA,10,30,14,27,27,45,27,58,27,38,38,45,51,58,30.02,0.0
hek293t,9842,1,10,AGGATGGTTTTCAAATAAGTAATCACCTAAGGAAGAATTAGTAAAGAAGAAATACTGGGATTGAATCTAAAAAAATTCTAGTTGGTTTAACGCGTAACT,AGGATGGTTTTCAAATAAGTAATCACCTAAGGAAGATTGGATGCGAATTAGTAAAGAAGAAATACTGGGATTGAATCTAAAAAAATTCTAGTTGGTTTA,10,30,14,27,27,45,27,55,27,35,35,45,45,55,18.21,0.093710574
hek293t,9842,1,10,GTCATGGTTTTCAAATAAGTAATCACCTAAGGAAGAATTAGTAAAGAAGAAATACTGGGATTGAATCTTTTAAAAAAATTCTAGTTGGTTTAACGCGTA,GTCATGGTTTTCAAATAAGTAATCACCTAAGGAAGATTGGATGCGAATTAGTAAAGAAGAAATACTGGGATTGAATCTTTTAAAAAAATTCTAGTTGGT,10,30,14,27,27,42,27,52,27,35,35,42,45,52,18.21,0.0
hek293t,9844,1,5,ATCGGCAAGCTGGGCCCGTAGGAAGGGGAAGGGCGGGCAGAGCCGCCGAGGCTGTGCCGAGCGGACAAGCTAAAAAAATTCTAGTTGGTTTAACGCGTA,ATCGGCAAGCTGGGCCCGTAGGAAGGGGAAGGGCGGCGGGAGCAGAGCCGCCGAGGCTGTGCCGAGCGGACAAGCTAAAAAAATTCTAGTTGGTTTAAC,10,30,14,27,27,47,27,52,27,37,37,47,42,52,41.83,35.74295954
hek293t,9846,1,9,GTATCAATTTCATTGTGGTACCGAGAAACTGGAGGAAAACAAAAAATCCACATTCTTGGAGGAAAGCCCCCCCGAAAAAAAAATTCTAGTTGGTTTAAC,GTATCAATTTCATTGTGGTACCGAGAAACTGGAGGGTGGCTGGGAAAACAAAAAATCCACATTCTTGGAGGAAAGCCCCCCCGAAAAAAAAATTCTAGT,10,30,14,27,27,38,27,47,27,35,35,38,44,47,27.4,0.0
hek293t,9848,1,4,AGGCATACAACATAGTGTATCAAGCCATATGGCTCAGTTGTTTGATATGGATATGCAGTGTAGAGAACACTATCCTATAAAAAAATTCTAGTTGGTTTA,AGGCATACAACATAGTGTATCAAGCCATATGGCTCAGAAGCTTGTTTGATATGGATATGCAGTGTAGAGAACACTATCCTATAAAAAAATTCTAGTTGG,10,30,14,27,27,41,27,45,27,38,38,41,42,45,46.93,8.643779371
hek293t,9848,1,4,GGCTATACAACATAGTGTATCAAGCCATATGGCTCAGTTGTTTGATATGGATATGCAGTGTAGAGAACACTAAAAAAATTCTAGTTGGTTTAACGCGTA,GGCTATACAACATAGTGTATCAAGCCATATGGCTCAGAAGCTTGTTTGATATGGATATGCAGTGTAGAGAACACTAAAAAAATTCTAGTTGGTTTAACG,10,30,14,27,27,48,27,52,27,38,38,48,42,52,46.93,46.70939738
hek293t,484,1,1,GTGGCAGGAATTATCAGCATACTGCATAGAGGTTTTTATTATTATGTAGTGCATAATGAAAATGATTTGAAGGACCCCAAAGCGTCAAAAAAATTCTAG,GTGGCAGGAATTATCAGCATACTGCATAGAGGATTTTTATTATTATGTAGTGCATAATGAAAATGATTTGAAGGACCCCAAAGCGTCAAAAAAATTCTA,10,30,14,27,27,36,27,37,27,33,33,36,34,37,62.77,32.84593966
hek293t,484,1,1,CACTAAGGAATTATCAGCATACTGCATAGAGGTTTTTATTATTATGTAGTGCATAATGAAAATGATTTGAAGGAAAAAAAATTCTAGTTGGTTTAACGC,CACTAAGGAATTATCAGCATACTGCATAGAGGATTTTTATTATTATGTAGTGCATAATGAAAATGATTTGAAGGAAAAAAAATTCTAGTTGGTTTAACG,10,30,14,27,27,48,27,49,27,33,33,48,34,49,62.77,68.61513054
hek293t,9853,1,15,GTCATCTCTTTTTCATTAAAGGTCAGATTAGGTTTTCAGAACTGTGTTTGGCTATTTGTTGAGAATTGTTTGCCTACAAAAAAAATTCTAGTTGGTTTA,GTCATCTCTTTTTCATTAAAGGTCAGTGTAGAAGGGCAGCCATTAGGTTTTCAGAACTGTGTTTGGCTATTTGTTGAGAATTGTTTGCCTACAAAAAAA,10,30,14,27,27,30,27,45,27,27,27,30,42,45,3.74,0.0
hek293t,9853,1,15,TGATCCTCTTTTTCATTAAAGGTCAGATTAGGTTTTCAGAACTGTGTTTGGCTATTTGTTGAGAATTGTTTGCCAAAAAAATTCTAGTTGGTTTAACGC,TGATCCTCTTTTTCATTAAAGGTCAGTGTAGAAGGGCAGCCATTAGGTTTTCAGAACTGTGTTTGGCTATTTGTTGAGAATTGTTTGCCAAAAAAATTC,10,30,14,27,27,34,27,49,27,27,27,34,42,49,3.74,0.0
hek293t,9855,1,7,CCGATTCCTTGGATTTGGAATTACTGCTATGGCATCCTATTGTAGGATGACCAAGGACAACTTCACTTACCAAAAAAAATTCTAGTTGGTTTAACGCGT,CCGATTCCTTGGATTTGGAATTACTGCTATGGCATCCTATCCGGTAATGTAGGATGACCAAGGACAACTTCACTTACCAAAAAAAATTCTAGTTGGTTT,10,30,14,27,27,44,27,51,27,41,41,44,48,51,50.07,0.0
hek293t,9857,1,3,GAGCATGTTTGTCTGGGAAAGGGCAGAACAGGCCTGCCTTGTATCAGCTACACTAGGCTAGATTGTTAAAAAAAAATTCTAGTTGGTTTAACGCGTAAC,GAGCATGTTTGTCTGGGAAAGGGCAGAACAGGCCTGCCTTTCCGTATCAGCTACACTAGGCTAGATTGTTAAAAAAAAATTCTAGTTGGTTTAACGCGT,10,30,14,27,27,51,27,54,27,41,41,51,44,54,39.75,24.08115064
hek293t,9857,1,3,CCTGTTGTTTGTCTGGGAAAGGGCAGAACAGGCCTGCCTTGTATCAGCTACACTAGGCTAGATTGTTAACCATCTCAAAAAAATTCTAGTTGGTTTAAC,CCTGTTGTTTGTCTGGGAAAGGGCAGAACAGGCCTGCCTTTCCGTATCAGCTACACTAGGCTAGATTGTTAACCATCTCAAAAAAATTCTAGTTGGTTT,10,30,14,27,27,44,27,47,27,41,41,44,44,47,39.75,0.27835769
hek293t,9859,1,10,CCCGGTGCAAACCTCATAAGAATTCTAGTTGGTGTTACCACTTTGTGGTAACATACAGCATTTCTGAAAAAAATTCTAGTTGGTTTAACGCGTAACTAG,CCCGGTGCAAACCTCATAAGAATTCTAGTTGGTGTTCTTACGAACGACCACTTTGTGGTAACATACAGCATTTCTGAAAAAAATTCTAGTTGGTTTAAC,10,30,14,27,27,47,27,57,27,37,37,47,47,57,40.53,0.301682012
hek293t,9861,1,15,TCCATTTCAGCAGCATAGATGTTTGTTTATGGGCACTCTAAGAAGTACATTAAGATGGCAGGAATTAGATTTTAAAAAAATTCTAGTTGGTTTAACGCG,TCCATTTCAGCAGCATAGATGTTTGTTCCCAGAGAGCCGACTTATGGGCACTCTAAGAAGTACATTAAGATGGCAGGAATTAGATTTTAAAAAAATTCT,10,30,14,27,27,35,27,50,27,28,28,35,43,50,9.99,3.186247068
hek293t,9861,1,15,ACTGGTTCAGCAGCATAGATGTTTGTTTATGGGCACTCTAAGAAGTACATTAAGATGGCAGGAATAAAAAAATTCTAGTTGGTTTAACGCGTAACTAGA,ACTGGTTCAGCAGCATAGATGTTTGTTCCCAGAGAGCCGACTTATGGGCACTCTAAGAAGTACATTAAGATGGCAGGAATAAAAAAATTCTAGTTGGTT,10,30,14,27,27,43,27,58,27,28,28,43,43,58,9.99,10.48417548
hek293t,9863,1,5,CATTGCCTGTAATTCCTGCAGCCCCACCTCGGCTCTCGCTGGAAGCAGAAGGGGTTGCGCCGACCCGGCGGGGGCTGTGAAAAAAATTCTAGTTGGTTT,CATTGCCTGTAATTCCTGCAGCCCCACCGAACCTCGGCTCTCGCTGGAAGCAGAAGGGGTTGCGCCGACCCGGCGGGGGCTGTGAAAAAAATTCTAGTT,10,30,14,27,27,39,27,44,27,29,29,39,34,44,61.06,85.5358498
hek293t,9869,1,7,CAACATTCCCTGCTTTTGGACTAAACAGCTGGAAAAAGTCAGCAAGGAAGGGCCTCTTGATTCCACCCCCCCAAGCCATAAAAAAATTCTAGTTGGTTT,CAACATTCCCTGCTTTTGGACTAAACAGCCGAAGCCTGGAAAAAGTCAGCAAGGAAGGGCCTCTTGATTCCACCCCCCCAAGCCATAAAAAAATTCTAG,10,30,14,27,27,37,27,44,27,30,30,37,37,44,22.24,0.295161858
hek293t,9869,1,7,CCTATTTCCCTGCTTTTGGACTAAACAGCTGGAAAAAGTCAGCAAGGAAGGGCCTCTTGATTCCACCCCCCAAAAAAATTCTAGTTGGTTTAACGCGTA,CCTATTTCCCTGCTTTTGGACTAAACAGCCGAAGCCTGGAAAAAGTCAGCAAGGAAGGGCCTCTTGATTCCACCCCCCAAAAAAATTCTAGTTGGTTTA,10,30,14,27,27,45,27,52,27,30,30,45,37,52,22.24,0.0
hek293t,9871,1,12,GTTCCGAACAGGCCCTTCTGGACTTGTAATGGAGAAATCAAAGGGCTGGAAAAGCCCCTTGGATAAAAAAATTCTAGTTGGTTTAACGCGTAACTAGAT,GTTCCGAACAGGCCCTTCTGGACTTGTAATGGAGAAGAAGAGCTTATCATCAAAGGGCTGGAAAAGCCCCTTGGATAAAAAAATTCTAGTTGGTTTAAC,10,30,14,27,27,47,27,59,27,37,37,47,49,59,27.5,4.345071305
hek293t,9871,1,12,TTCCAGAACAGGCCCTTCTGGACTTGTAATGGAGAAATCAAAGGGCTGGAAAAGCCCCTTGGATAAGAAAAAAATTCTAGTTGGTTTAACGCGTAACTA,TTCCAGAACAGGCCCTTCTGGACTTGTAATGGAGAAGAAGAGCTTATCATCAAAGGGCTGGAAAAGCCCCTTGGATAAGAAAAAAATTCTAGTTGGTTT,10,30,14,27,27,44,27,56,27,37,37,44,49,56,27.5,0.225988701
hek293t,9873,1,2,TGATCTCTTTACTAGGTGTGGAAAAGACCAGGTTAGAATAGCAATGAATGTTTTACATAGGTTTGAAAAAAATTCTAGTTGGTTTAACGCGTAACTAGA,TGATCTCTTTACTAGGTGTGGAAAAGACCAGGTTAGAATAGCGCAATGAATGTTTTACATAGGTTTGAAAAAAATTCTAGTTGGTTTAACGCGTAACTA,10,30,14,27,27,56,27,58,27,41,41,56,43,58,56.41,14.48539753
hek293t,9873,1,2,CGCGGTCTTTACTAGGTGTGGAAAAGACCAGGTTAGAATAGCAATGAATGTTTTACATAGGTTTGAAGGCAAAAAAATTCTAGTTGGTTTAACGCGTAA,CGCGGTCTTTACTAGGTGTGGAAAAGACCAGGTTAGAATAGCGCAATGAATGTTTTACATAGGTTTGAAGGCAAAAAAATTCTAGTTGGTTTAACGCGT,10,30,14,27,27,51,27,53,27,41,41,51,43,53,56.41,31.73073753
hek293t,9875,1,14,GGGCCGTCCTAGATAATTAAAATCAAGCAAGGAGTATGTATTATCCCATCTAGTATATAAGCTTAAAAAAAATTCTAGTTGGTTTAACGCGTAACTAGA,GGGCCGTCCTAGATAATTAAAATCAAGCAAGGAGTAGTTGTACTAACCCTTGTATTATCCCATCTAGTATATAAGCTTAAAAAAAATTCTAGTTGGTTT,10,30,14,27,27,44,27,58,27,37,37,44,51,58,37.1,0.0
hek293t,9876,1,5,ATGTCCTGATTCCCATCTCCCTTCCCACTCGGCCAGAAGCTTTAAGCCTCCCACCAATTTCTGCTGTGGTTGTACAAAAAAAATTCTAGTTGGTTTAAC,ATGTCCTGATTCCCATCTCCCTTCCCACTCGGCCAGAAAGGTCGCTTTAAGCCTCCCACCAATTTCTGCTGTGGTTGTACAAAAAAAATTCTAGTTGGT,10,30,14,27,27,42,27,47,27,39,39,42,44,47,35.04,0.306748466
hek293t,9880,1,5,AGACAATTAGGATCCAGTCACAAGTCTCGTGGGTTCCCACAGTGAGAGGGAAAAAACGCATTATTTAAAGAAGTGACACCGAAAAAAATTCTAGTTGGT,AGACAATTAGGATCCAGTCACAAGTCTCGTGGGGCCATTTCCCACAGTGAGAGGGAAAAAACGCATTATTTAAAGAAGTGACACCGAAAAAAATTCTAG,10,30,14,27,27,37,27,42,27,34,34,37,39,42,57.8,1.855354532
hek293t,9880,1,5,GATAAATTAGGATCCAGTCACAAGTCTCGTGGGTTCCCACAGTGAGAGGGAAAAAACGCATTATTTAAAGAAGTAAAAAAATTCTAGTTGGTTTAACGC,GATAAATTAGGATCCAGTCACAAGTCTCGTGGGGCCATTTCCCACAGTGAGAGGGAAAAAACGCATTATTTAAAGAAGTAAAAAAATTCTAGTTGGTTT,10,30,14,27,27,44,27,49,27,34,34,44,39,49,57.8,49.29892499
hek293t,10290,1,8,GGCTCCAATCTCAAATATGATGCTTCTAAAGGCACAAGGACAGAAGAGGCTCAGACTGGACATTTTGAAAAAAATTCTAGTTGGTTTAACGCGTAACTA,GGCTCCAATCTCAAATATGATGCTTCTAAAGGCACAAGGAGTTAGCCCCAGAAGAGGCTCAGACTGGACATTTTGAAAAAAATTCTAGTTGGTTTAACG,10,30,14,27,27,48,27,56,27,41,41,48,49,56,9.16,0.0
hek293t,10290,1,8,ACGTCCAATCTCAAATATGATGCTTCTAAAGGCACAAGGACAGAAGAGGCTCAGACTGGACATTTTGAAGAAAAAAAATTCTAGTTGGTTTAACGCGTA,ACGTCCAATCTCAAATATGATGCTTCTAAAGGCACAAGGAGTTAGCCCCAGAAGAGGCTCAGACTGGACATTTTGAAGAAAAAAAATTCTAGTTGGTTT,10,30,14,27,27,44,27,52,27,41,41,44,49,52,9.16,0.0
hek293t,9884,1,15,TGAGGCTGCTTATGCCTGGAGCAGGAGTGAGGCCAGGGTGTGTAATGCAGCAGTGGAACAAATCCATGGTGCATCAAAAAAATTCTAGTTGGTTTAACG,TGAGGCTGCTTATGCCTGGAGCAGGAGTGTCCCCACAGTGCAAAAGGCCAGGGTGTGTAATGCAGCAGTGGAACAAATCCATGGTGCATCAAAAAAATT,10,30,14,27,27,33,27,48,27,30,30,33,45,48,55.9,0.0
hek293t,9885,1,14,GCAACATAAAATCCCCTCCACATAAATTTTGGAAGCAACTCTACACACAAAGTTTATTAATTCAGAAGAAAAAAATTCTAGTTGGTTTAACGCGTAACT,GCAACATAAAATCCCCTCCACATAAATTTTGGAAGCAATCCTAGATGCCTTACTCTACACACAAAGTTTATTAATTCAGAAGAAAAAAATTCTAGTTGG,10,30,14,27,27,41,27,55,27,38,38,41,52,55,20.91,0.0
hek293t,9888,1,15,TATGAGTGGATCTGACGCAGAGGGCACAGCGGTGTGGACGGCAGTGAAGTCCTTACGGCTTGATGAGAAAAAAATTCTAGTTGGTTTAACGCGTAACTA,TATGAGTGGATCTGACGCAGAGGGCACAGCGGTCCGGCACAAGCCTACGTGGACGGCAGTGAAGTCCTTACGGCTTGATGAGAAAAAAATTCTAGTTGG,10,30,14,27,27,41,27,56,27,34,34,41,49,56,75.1,14.22363045
hek293t,9892,1,4,GCACGAAAGTTTAAGACCTGTGTCAATGACGGAGTTGAAAAGCACTTAATGTAATTATGCAATGTTCTAAAAAAATTCTAGTTGGTTTAACGCGTAACT,GCACGAAAGTTTAAGACCTGTGTCAATGACGGAGTTGAAATTAGAGCACTTAATGTAATTATGCAATGTTCTAAAAAAATTCTAGTTGGTTTAACGCGT,10,30,14,27,27,51,27,55,27,41,41,51,45,55,61.2,46.90327243
hek293t,9892,1,4,CGTAAAAAGTTTAAGACCTGTGTCAATGACGGAGTTGAAAAGCACTTAATGTAATTATGCAATGTTCTGTTACTTAAAAAAATTCTAGTTGGTTTAACG,CGTAAAAAGTTTAAGACCTGTGTCAATGACGGAGTTGAAATTAGAGCACTTAATGTAATTATGCAATGTTCTGTTACTTAAAAAAATTCTAGTTGGTTT,10,30,14,27,27,44,27,48,27,41,41,44,45,48,61.2,0.372439479
hek293t,19734,1,15,CTGTCCTATGGCCCAGTTCAGGCCCTTCACGGGCAACTCCCCGAATCTGAGCGCTTGTGTAGGAAGCAAAAAAATTCTAGTTGGTTTAACGCGTAACTA,CTGTCCTATGGCCCAGTTCAGGCCCTTCACGGGACGCAAAGCCAGAACCAACTCCCCGAATCTGAGCGCTTGTGTAGGAAGCAAAAAAATTCTAGTTGG,10,30,14,27,27,41,27,56,27,34,34,41,49,56,28.27,1.333105329
hek293t,9895,1,4,GTAGGTTTGCAAGGCAGCAACGTTCTTTTTGGAGCTGGTAGGTGGTGTTACTGGTTGCAATAGGCAAAAAAAATTCTAGTTGGTTTAACGCGTAACTAG,GTAGGTTTGCAAGGCAGCAACGTTCTTTTTGGAGCTGGGGAGTAGGTGGTGTTACTGGTTGCAATAGGCAAAAAAAATTCTAGTTGGTTTAACGCGTAA,10,30,14,27,27,53,27,57,27,38,38,53,42,57,7.74,3.807639166
hek293t,9895,1,4,GAGCATTTGCAAGGCAGCAACGTTCTTTTTGGAGCTGGTAGGTGGTGTTACTGGTTGCAATAGGCAAGGACGGCAAGGAAAAAAATTCTAGTTGGTTTA,GAGCATTTGCAAGGCAGCAACGTTCTTTTTGGAGCTGGGGAGTAGGTGGTGTTACTGGTTGCAATAGGCAAGGACGGCAAGGAAAAAAATTCTAGTTGG,10,30,14,27,27,41,27,45,27,38,38,41,42,45,7.74,0.0
hek293t,9897,1,13,TATTACCTGTGTGGAATGCGAAGAGTCCATGGCTTAGTGAAACCATCAGTGTCTGGGAAAAGAGAAAAAAATTCTAGTTGGTTTAACGCGTAACTAGAT,TATTACCTGTGTGGAATGCGAAGAGTCCATAGGAACTCACTAAGGCTTAGTGAAACCATCAGTGTCTGGGAAAAGAGAAAAAAATTCTAGTTGGTTTAA,10,30,14,27,27,46,27,59,27,31,31,46,44,59,60.74,13.37915943
hek293t,9899,1,12,GTCTGAATTAGAGAAATCACTGACTAGAATGGGACCAAATACACAATTCAGAATAAAATTTCCTCTCAATACATAAAAAAAATTCTAGTTGGTTTAACG,GTCTGAATTAGAGAAATCACTGACTAGAATGGGGCGGTTAAGCTGACCAAATACACAATTCAGAATAAAATTTCCTCTCAATACATAAAAAAAATTCTA,10,30,14,27,27,36,27,48,27,33,33,36,45,48,17.74,0.151057402
hek293t,9899,1,12,CTGCAAATTAGAGAAATCACTGACTAGAATGGGACCAAATACACAATTCAGAATAAAATTTCCTCTCAATAAAAAAAATTCTAGTTGGTTTAACGCGTA,CTGCAAATTAGAGAAATCACTGACTAGAATGGGGCGGTTAAGCTGACCAAATACACAATTCAGAATAAAATTTCCTCTCAATAAAAAAAATTCTAGTTG,10,30,14,27,27,40,27,52,27,33,33,40,45,52,17.74,0.196895671
hek293t,14526,1,2,GCTAAACTGTCACTGTATGTAGAGAAGGATGGAAAATGATTATCATAAAGCAGGAGGGTCTGAACTGACTGCTGAAGCTAAAAAAATTCTAGTTGGTTT,GCTAAACTGTCACTGTATGTAGAGAAGGATGGAAAATGAGATTATCATAAAGCAGGAGGGTCTGAACTGACTGCTGAAGCTAAAAAAATTCTAGTTGGT,10,30,14,27,27,42,27,44,27,39,39,42,41,44,59.93,0.0
hek293t,14526,1,2,TAAGCACTGTCACTGTATGTAGAGAAGGATGGAAAATGATTATCATAAAGCAGGAGGGTCTGAACTGAAAAAAATTCTAGTTGGTTTAACGCGTAACTA,TAAGCACTGTCACTGTATGTAGAGAAGGATGGAAAATGAGATTATCATAAAGCAGGAGGGTCTGAACTGAAAAAAATTCTAGTTGGTTTAACGCGTAAC,10,30,14,27,27,54,27,56,27,39,39,54,41,56,59.93,3.500000762
hek293t,9903,1,5,AGTCAGAATGCAGGGATGCAATGAGACCCAGGCCAGCCTTGGCAGGGTGCTCGAAGTGGCGTGGAGCCCTCCTGCCAAAAAAATTCTAGTTGGTTTAAC,AGTCAGAATGCAGGGATGCAATGAGACCCAGGCCTTACCAGCCTTGGCAGGGTGCTCGAAGTGGCGTGGAGCCCTCCTGCCAAAAAAATTCTAGTTGGT,10,30,14,27,27,42,27,47,27,35,35,42,40,47,66.14,60.90318689
hek293t,9905,1,11,TCAAGTGAAGAGAAAAGCTTGATCTTTACAGGGTATTTGAACATACAGAGAGTTTACGCAACACCAAAAAAATTCTAGTTGGTTTAACGCGTAACTAGA,TCAAGTGAAGAGAAAAGCTTGATCTTTACAGGTTAGCTATAAGGTATTTGAACATACAGAGAGTTTACGCAACACCAAAAAAATTCTAGTTGGTTTAAC,10,30,14,27,27,47,27,58,27,32,32,47,43,58,4.42,20.41769322
hek293t,9905,1,11,CGTTCTGAAGAGAAAAGCTTGATCTTTACAGGGTATTTGAACATACAGAGAGTTTACGCAACACCAGTTCTCTTGAAAAAAAAATTCTAGTTGGTTTAA,CGTTCTGAAGAGAAAAGCTTGATCTTTACAGGTTAGCTATAAGGTATTTGAACATACAGAGAGTTTACGCAACACCAGTTCTCTTGAAAAAAAAATTCT,10,30,14,27,27,35,27,46,27,32,32,35,43,46,4.42,0.0
hek293t,9907,1,13,TCCGTTCTGAATAATTTTGTTTGGTAGGCAGGCATGAGATGTACTTGTCATGTTAACTTTGTTTGCAAAAAAATTCTAGTTGGTTTAACGCGTAACTAG,TCCGTTCTGAATAATTTTGTTTGGTAGGTCATAGATTGTAACAGGCATGAGATGTACTTGTCATGTTAACTTTGTTTGCAAAAAAATTCTAGTTGGTTT,10,30,14,27,27,44,27,57,27,29,29,44,42,57,-0.07,1.7360461
hek293t,9907,1,13,GGAAGTCTGAATAATTTTGTTTGGTAGGCAGGCATGAGATGTACTTGTCATGTTAACTTTGTTTGCTAACTAAAAAAATTCTAGTTGGTTTAACGCGTA,GGAAGTCTGAATAATTTTGTTTGGTAGGTCATAGATTGTAACAGGCATGAGATGTACTTGTCATGTTAACTTTGTTTGCTAACTAAAAAAATTCTAGTT,10,30,14,27,27,39,27,52,27,29,29,39,42,52,-0.07,0.557866244
hek293t,9909,1,2,CTTAAAAATTGACGTAAAAGAAGTGAGAGAGGAAGAAAACTACTCAGTTCTACACAGAAGATGTTATGTAAAAAAATTCTAGTTGGTTTAACGCGTAAC,CTTAAAAATTGACGTAAAAGAAGTGAGAGAGGAAGACTAAACTACTCAGTTCTACACAGAAGATGTTATGTAAAAAAATTCTAGTTGGTTTAACGCGTA,10,30,14,27,27,52,27,54,27,37,37,52,39,54,42.59,0.278143078
hek293t,9909,1,2,CTGCGAAATTGACGTAAAAGAAGTGAGAGAGGAAGAAAACTACTCAGTTCTACACAGAAGATGTTATGTACATGCATGTGGAAAAAAATTCTAGTTGGT,CTGCGAAATTGACGTAAAAGAAGTGAGAGAGGAAGACTAAACTACTCAGTTCTACACAGAAGATGTTATGTACATGCATGTGGAAAAAAATTCTAGTTG,10,30,14,27,27,40,27,42,27,37,37,40,39,42,42.59,0.0
hek293t,9915,1,9,CCTTGAGCATGCTTCAGCATTTAGTTCTTTGGGCCAAGAAAATACCTTCGCTCCAGCTGCTCCAATTTAAAAAAATTCTAGTTGGTTTAACGCGTAACT,CCTTGAGCATGCTTCAGCATTTAGTTCTTTAATTCGTAGGGGCCAAGAAAATACCTTCGCTCCAGCTGCTCCAATTTAAAAAAATTCTAGTTGGTTTAA,10,30,14,27,27,46,27,55,27,31,31,46,40,55,1.78,1.132307114
hek293t,9915,1,9,GACGTAGCATGCTTCAGCATTTAGTTCTTTGGGCCAAGAAAATACCTTCGCTCCAGCTGCTCCAATTTCACCTTTTAAAAAAATTCTAGTTGGTTTAAC,GACGTAGCATGCTTCAGCATTTAGTTCTTTAATTCGTAGGGGCCAAGAAAATACCTTCGCTCCAGCTGCTCCAATTTCACCTTTTAAAAAAATTCTAGT,10,30,14,27,27,38,27,47,27,31,31,38,40,47,1.78,17.96989877
hek293t,9917,1,5,TCGTTACTACTGGGAGAAATTCTAATATTTGGGGAATGAGAAAGATGAGGATGTCTGACAGGAAATGTATCATAATAAAAAAATTCTAGTTGGTTTAAC,TCGTTACTACTGGGAGAAATTCTAATCCCGCATTTGGGGAATGAGAAAGATGAGGATGTCTGACAGGAAATGTATCATAATAAAAAAATTCTAGTTGGT,10,30,14,27,27,42,27,47,27,27,27,42,32,47,6.59,16.83249196
hek293t,9917,1,5,TCACGACTACTGGGAGAAATTCTAATATTTGGGGAATGAGAAAGATGAGGATGTCTGACAGGAAATGTATCATAATAAAAGAACAAAAAAATTCTAGTT,TCACGACTACTGGGAGAAATTCTAATCCCGCATTTGGGGAATGAGAAAGATGAGGATGTCTGACAGGAAATGTATCATAATAAAAGAACAAAAAAATTC,10,30,14,27,27,34,27,39,27,27,27,34,32,39,6.59,13.34747425
hek293t,9919,1,11,CGTTGCACTTTTTGCACAAATGCTTTGTATGGATGCATGAGCTAGTACACTGCATCATGACAACCATGAAAAAAATTCTAGTTGGTTTAACGCGTAACT,CGTTGCACTTTTTGCACAAATGCTTTGTATGGATGCATGAAAGGGCATCGGGCTAGTACACTGCATCATGACAACCATGAAAAAAATTCTAGTTGGTTT,10,30,14,27,27,44,27,55,27,41,41,44,52,55,16.81,0.0
hek293t,2015,1,3,TACCGGTCAATGTCTCGGGTTTCTGGTAGTGGAACACCTTTGCCATCCCGATGTTCAGGACTCCCTCTTGTCCCAAAAAAAAAATTCTAGTTGGTTTAA,TACCGGTCAATGTCTCGGGTTTCTGGTAGTGGAACACCTTCATTGCCATCCCGATGTTCAGGACTCCCTCTTGTCCCAAAAAAAAAATTCTAGTTGGTT,10,30,14,27,27,43,27,46,27,40,40,43,43,46,33.6,3.344718903
hek293t,2015,1,3,CCTTTGTCAATGTCTCGGGTTTCTGGTAGTGGAACACCTTTGCCATCCCGATGTTCAGGACTCCCTCTTGTCCAAAAAAATTCTAGTTGGTTTAACGCG,CCTTTGTCAATGTCTCGGGTTTCTGGTAGTGGAACACCTTCATTGCCATCCCGATGTTCAGGACTCCCTCTTGTCCAAAAAAATTCTAGTTGGTTTAAC,10,30,14,27,27,47,27,50,27,40,40,47,43,50,33.6,76.8718274
hek293t,22213,1,9,AGGAGTTCTCTGTTCTGGAGCTGACTTACAGGAGAGCCTGTGCTCTCCTATCCAAAGAAGATAAATAAAGAAAGTCAAAAAAATTCTAGTTGGTTTAAC,AGGAGTTCTCTGTTCTGGAGCTGACTTCACTCCCAGACAGGAGAGCCTGTGCTCTCCTATCCAAAGAAGATAAATAAAGAAAGTCAAAAAAATTCTAGT,10,30,14,27,27,38,27,47,27,28,28,38,37,47,10.17,77.70175464
hek293t,22213,1,9,GATAGTTCTCTGTTCTGGAGCTGACTTACAGGAGAGCCTGTGCTCTCCTATCCAAAGAAGATAAATAAAGAAAAAAAATTCTAGTTGGTTTAACGCGTA,GATAGTTCTCTGTTCTGGAGCTGACTTCACTCCCAGACAGGAGAGCCTGTGCTCTCCTATCCAAAGAAGATAAATAAAGAAAAAAAATTCTAGTTGGTT,10,30,14,27,27,43,27,52,27,28,28,43,37,52,10.17,59.54936051
hek293t,9927,1,3,ACGCGAATATCTTTGTATTACATGCCAAATGGTACTCTAACATAGCCTTGGATCTATTTCATAGCCCCTCACTTTTCAAAAAAATTCTAGTTGGTTTAA,ACGCGAATATCTTTGTATTACATGCCAAATGGGAATACTCTAACATAGCCTTGGATCTATTTCATAGCCCCTCACTTTTCAAAAAAATTCTAGTTGGTT,10,30,14,27,27,43,27,46,27,33,33,43,36,46,12.8,54.17186106
hek293t,9929,1,6,CAACCCGACAATACAGGCAGGGGACTGACTGGGTGGGAGGCTAAAGGGCTACTAAAACATATATCAAAATGGACAAGGAGAAGCTAAAAAAATTCTAGT,CAACCCGACAATACAGGCAGGGGACTGAAGCAATCTGGGTGGGAGGCTAAAGGGCTACTAAAACATATATCAAAATGGACAAGGAGAAGCTAAAAAAAT,10,30,14,27,27,32,27,38,27,29,29,32,35,38,47.85,1.477377655
hek293t,9929,1,6,TGTAGCGACAATACAGGCAGGGGACTGACTGGGTGGGAGGCTAAAGGGCTACTAAAACATATATCAAAATGGACAAGGAAAAAAATTCTAGTTGGTTTA,TGTAGCGACAATACAGGCAGGGGACTGAAGCAATCTGGGTGGGAGGCTAAAGGGCTACTAAAACATATATCAAAATGGACAAGGAAAAAAATTCTAGTT,10,30,14,27,27,39,27,45,27,29,29,39,35,45,47.85,71.91986308
hek293t,9932,1,6,CTCGGATGCAGCATCTGCTGCTTTTCAACAGGATGGTTAAGTTTTATCCTGAGGCATGCTGCTATAAACCATACTGTTTAAAAAAATTCTAGTTGGTTT,CTCGGATGCAGCATCTGCTGCTTTTCAGACTGAACAGGATGGTTAAGTTTTATCCTGAGGCATGCTGCTATAAACCATACTGTTTAAAAAAATTCTAGT,10,30,14,27,27,38,27,44,27,28,28,38,34,44,14.53,59.54328562
hek293t,9932,1,6,CGATTATGCAGCATCTGCTGCTTTTCAACAGGATGGTTAAGTTTTATCCTGAGGCATGCTGCTATAAACCATACAAAAAAATTCTAGTTGGTTTAACGC,CGATTATGCAGCATCTGCTGCTTTTCAGACTGAACAGGATGGTTAAGTTTTATCCTGAGGCATGCTGCTATAAACCATACAAAAAAATTCTAGTTGGTT,10,30,14,27,27,43,27,49,27,28,28,43,34,49,14.53,35.83175577
hek293t,9933,1,12,CTAGCGAATCCCACAGAGGGTTTTAGATTTGGGCACCTTGGCTTTTCTAGATGTTAAAATAGACTGTGAAAAGTGTAAAAAAATTCTAGTTGGTTTAAC,CTAGCGAATCCCACAGAGGGTTTTAGATTTGTTAGTGCGAGGTGGCACCTTGGCTTTTCTAGATGTTAAAATAGACTGTGAAAAGTGTAAAAAAATTCT,10,30,14,27,27,35,27,47,27,32,32,35,44,47,7.28,1.259087725
hek293t,9933,1,12,ATAACGAATCCCACAGAGGGTTTTAGATTTGGGCACCTTGGCTTTTCTAGATGTTAAAATAGACTGTGAAAAAAAATTCTAGTTGGTTTAACGCGTAAC,ATAACGAATCCCACAGAGGGTTTTAGATTTGTTAGTGCGAGGTGGCACCTTGGCTTTTCTAGATGTTAAAATAGACTGTGAAAAAAAATTCTAGTTGGT,10,30,14,27,27,42,27,54,27,32,32,42,44,54,7.28,23.90917002
hek293t,9935,1,2,CAGGCGGGGGCGAGCAGGAGCCAGCTGAGAGGGCTCCAGCTGCACCAAAGAACCTGCGCATACATCTACCAGATGCTCTTTTAAAAAAATTCTAGTTGG,CAGGCGGGGGCGAGCAGGAGCCAGCTGAGAGGGCTGCCCAGCTGCACCAAAGAACCTGCGCATACATCTACCAGATGCTCTTTTAAAAAAATTCTAGTT,10,30,14,27,27,39,27,41,27,36,36,39,38,41,66.34,22.38198644
hek293t,9937,1,6,CACTCTGGGCTCGACTCTGCGAGAGTAAACGGCGTCGATGATGCTGCAAACTTCAGAACAGTGAGGGTAAAAAAAATTCTAGTTGGTTTAACGCGTAAC,CACTCTGGGCTCGACTCTGCGAGAGTAAACGGCGTCGCTGTTGATGATGCTGCAAACTTCAGAACAGTGAGGGTAAAAAAAATTCTAGTTGGTTTAACG,10,30,14,27,27,48,27,54,27,38,38,48,44,54,15.9,8.210125043
hek293t,9937,1,6,GGCGATGGGCTCGACTCTGCGAGAGTAAACGGCGTCGATGATGCTGCAAACTTCAGAACAGTGAGGGTAAGAAATGAAAAAAATTCTAGTTGGTTTAAC,GGCGATGGGCTCGACTCTGCGAGAGTAAACGGCGTCGCTGTTGATGATGCTGCAAACTTCAGAACAGTGAGGGTAAGAAATGAAAAAAATTCTAGTTGG,10,30,14,27,27,41,27,47,27,38,38,41,44,47,15.9,1.63070098
hek293t,9939,1,3,TGTGTGACAATAGGAATTCAGCTTGCTTAAGGTACTTTACTGGAATTGTTCAGCTTTTTGTAGGATAAGGTTGTCAGTTAAGAAAGAAAAAAATTCTAG,TGTGTGACAATAGGAATTCAGCTTGCTTAAAGGGGTACTTTACTGGAATTGTTCAGCTTTTTGTAGGATAAGGTTGTCAGTTAAGAAAGAAAAAAATTC,10,30,14,27,27,34,27,37,27,31,31,34,34,37,34.65,0.227143668
hek293t,9939,1,3,GTCTCGACAATAGGAATTCAGCTTGCTTAAGGTACTTTACTGGAATTGTTCAGCTTTTTGTAGGATAAGGTTGTAAAAAAATTCTAGTTGGTTTAACGC,GTCTCGACAATAGGAATTCAGCTTGCTTAAAGGGGTACTTTACTGGAATTGTTCAGCTTTTTGTAGGATAAGGTTGTAAAAAAATTCTAGTTGGTTTAA,10,30,14,27,27,46,27,49,27,31,31,46,34,49,34.65,63.52548006
hek293t,9941,1,7,GTTACAAGGCAACAAGATAGTAACAAATATGGCTCTCCTGATTACTCCAGCTCTCAGTAAAGCTCCATAGAAACAAGATAAAAAAAATTCTAGTTGGTT,GTTACAAGGCAACAAGATAGTAACAAATATGGGGGACCTCTCTCCTGATTACTCCAGCTCTCAGTAAAGCTCCATAGAAACAAGATAAAAAAAATTCTA,10,30,14,27,27,36,27,43,27,33,33,36,40,43,25.49,0.0
hek293t,9941,1,7,ATACAAAGGCAACAAGATAGTAACAAATATGGCTCTCCTGATTACTCCAGCTCTCAGTAAAGCTCCATAGAAAAAAAAAATTCTAGTTGGTTTAACGCG,ATACAAAGGCAACAAGATAGTAACAAATATGGGGGACCTCTCTCCTGATTACTCCAGCTCTCAGTAAAGCTCCATAGAAAAAAAAAATTCTAGTTGGTT,10,30,14,27,27,43,27,50,27,33,33,43,40,50,25.49,3.390173923
hek293t,9943,1,5,GTGGATCTCTTAATGCTATTAAGCGTCTTAGGAGCTTTCTGTTCTGCAGAAATCAAATATTTAGTTTTACTAAAGGGACAAAAAAATTCTAGTTGGTTT,GTGGATCTCTTAATGCTATTAAGCGTCTTAGCAGTAGAGCTTTCTGTTCTGCAGAAATCAAATATTTAGTTTTACTAAAGGGACAAAAAAATTCTAGTT,10,30,14,27,27,39,27,44,27,32,32,39,37,44,10.49,6.701473879
hek293t,9943,1,5,CTATGTCTCTTAATGCTATTAAGCGTCTTAGGAGCTTTCTGTTCTGCAGAAATCAAATATTTAGTTTTACTAAAGGAAAAAAATTCTAGTTGGTTTAAC,CTATGTCTCTTAATGCTATTAAGCGTCTTAGCAGTAGAGCTTTCTGTTCTGCAGAAATCAAATATTTAGTTTTACTAAAGGAAAAAAATTCTAGTTGGT,10,30,14,27,27,42,27,47,27,32,32,42,37,47,10.49,2.185889749
hek293t,9945,1,7,AACCGCAGTTTAAACACTGACTTCCACATTGGCATTATTGACAAAGAGGACCATAGAGATCTTGTCTTCCAACGTTATTTAAAAAAATTCTAGTTGGTT,AACCGCAGTTTAAACACTGACTTCCACAATACTCGTTGGCATTATTGACAAAGAGGACCATAGAGATCTTGTCTTCCAACGTTATTTAAAAAAATTCTA,10,30,14,27,27,36,27,43,27,29,29,36,36,43,49.71,25.35045601
hek293t,9945,1,7,ATAATCAGTTTAAACACTGACTTCCACATTGGCATTATTGACAAAGAGGACCATAGAGATCTTGTCTTCCAACGTTATTTAATGAAAAAAATTCTAGTT,ATAATCAGTTTAAACACTGACTTCCACAATACTCGTTGGCATTATTGACAAAGAGGACCATAGAGATCTTGTCTTCCAACGTTATTTAATGAAAAAAAT,10,30,14,27,27,32,27,39,27,29,29,32,36,39,49.71,0.696517413
hek293t,9947,1,1,GCATTTACTGCGCTAATAGACTCATCAACAGGCTTTGAAGGTCATAAAATTATACTGACAACTGAGATAAACAAAAAAAATTCTAGTTGGTTTAACGCG,GCATTTACTGCGCTAATAGACTCATCAACAGGCTTTGACAGGTCATAAAATTATACTGACAACTGAGATAAACAAAAAAAATTCTAGTTGGTTTAACGC,10,30,14,27,27,49,27,50,27,39,39,49,40,50,37.05,41.62180267
hek293t,9951,1,8,TCCAGGCACAGGGTTAGGGGAGAAGGCGGTGGCAGCAGGTCAGAAGGAAAGGGGATATGAAGTTTCACCCACTAAAAAAATTCTAGTTGGTTTAACGCG,TCCAGGCACAGGGTTAGGGGAGAAGGCGGTGTATAACTTGCAGCAGGTCAGAAGGAAAGGGGATATGAAGTTTCACCCACTAAAAAAATTCTAGTTGGT,10,30,14,27,27,42,27,50,27,32,32,42,40,50,51.26,42.71427525
hek293t,9953,1,10,CCATGAAGTCTGGTAAAATGTGCTTGGGTAGGACAGAGTAGAGTGCTGTCTCTGGTTAAACAGTGTTCTACTTACAAAAAAATTCTAGTTGGTTTAACG,CCATGAAGTCTGGTAAAATGTGCTTGGGTAGTGACGAGATGGACAGAGTAGAGTGCTGTCTCTGGTTAAACAGTGTTCTACTTACAAAAAAATTCTAGT,10,30,14,27,27,38,27,48,27,31,31,38,41,48,51.97,1.037142753
hek293t,9953,1,10,TGTGCAAGTCTGGTAAAATGTGCTTGGGTAGGACAGAGTAGAGTGCTGTCTCTGGTTAAACAGTGTTCTACTAAAAAAATTCTAGTTGGTTTAACGCGT,TGTGCAAGTCTGGTAAAATGTGCTTGGGTAGTGACGAGATGGACAGAGTAGAGTGCTGTCTCTGGTTAAACAGTGTTCTACTAAAAAAATTCTAGTTGG,10,30,14,27,27,41,27,51,27,31,31,41,41,51,51.97,13.15709432
hek293t,9955,1,3,CGTGCTGTCTCCTTCAGAGTGGATAAAGGAGGCAAGGACCTGCAGAATGAGGCAGAGGGTGGCTAGGGGGGAAAAAAATTCTAGTTGGTTTAACGCGTA,CGTGCTGTCTCCTTCAGAGTGGATAAAGGAGGCAAGGACACCCTGCAGAATGAGGCAGAGGGTGGCTAGGGGGGAAAAAAATTCTAGTTGGTTTAACGC,10,30,14,27,27,49,27,52,27,39,39,49,42,52,69.29,67.90271147
hek293t,9955,1,3,GTCGCTGTCTCCTTCAGAGTGGATAAAGGAGGCAAGGACCTGCAGAATGAGGCAGAGGGTGGCTAGAAAAAAATTCTAGTTGGTTTAACGCGTAACTAG,GTCGCTGTCTCCTTCAGAGTGGATAAAGGAGGCAAGGACACCCTGCAGAATGAGGCAGAGGGTGGCTAGAAAAAAATTCTAGTTGGTTTAACGCGTAAC,10,30,14,27,27,54,27,57,27,39,39,54,42,57,69.29,22.90041314
hek293t,9957,1,15,GCTAGGTAATGTTTTGTCATCTTGTCTGGTGGACCACCTATAACTTAAGCTGGCTATCCTCAAATTCAACAGTGAAAAAAATTCTAGTTGGTTTAACGC,GCTAGGTAATGTTTTGTCATCTTGTCTGGTTGGATCATAATTGCAGGACCACCTATAACTTAAGCTGGCTATCCTCAAATTCAACAGTGAAAAAAATTC,10,30,14,27,27,34,27,49,27,31,31,34,46,49,28.81,0.0
hek293t,9959,1,14,CCACTTAAATCAAGCATGGAAGTGTTGTATGGGTCAGGCTATCACAGTTCTTGAAAATTTATCTGCTCATAGAATCATCAAAAAAATTCTAGTTGGTTT,CCACTTAAATCAAGCATGGAAGTGTTATATGAGCGGATTTGTATGGGTCAGGCTATCACAGTTCTTGAAAATTTATCTGCTCATAGAATCATCAAAAAA,10,30,14,27,27,30,27,44,27,27,27,30,41,44,36.33,0.151515152
hek293t,9959,1,14,CAGGATAAATCAAGCATGGAAGTGTTGTATGGGTCAGGCTATCACAGTTCTTGAAAATTTATCTGCTCATAGAATAAAAAAATTCTAGTTGGTTTAACG,CAGGATAAATCAAGCATGGAAGTGTTATATGAGCGGATTTGTATGGGTCAGGCTATCACAGTTCTTGAAAATTTATCTGCTCATAGAATAAAAAAATTC,10,30,14,27,27,34,27,48,27,27,27,34,41,48,36.33,0.305807257
hek293t,9961,1,5,CAGCTAATAATATGGAACTCATTTAAGTGGGGTCAGAATTAGGTCCTTCAACTTAGTGTAATTTGTTGGACAGCAAAAAAAAAAATTCTAGTTGGTTTA,CAGCTAATAATATGGAACTCATTTAAGTGGGAAAGGGTCAGAATTAGGTCCTTCAACTTAGTGTAATTTGTTGGACAGCAAAAAAAAAAATTCTAGTTG,10,30,14,27,27,40,27,45,27,30,30,40,35,45,51.39,6.244619044
hek293t,9961,1,5,TCTTCAATAATATGGAACTCATTTAAGTGGGGTCAGAATTAGGTCCTTCAACTTAGTGTAATTTGTTGGACAGCAAAACTAAAAAAAATTCTAGTTGGT,TCTTCAATAATATGGAACTCATTTAAGTGGGAAAGGGTCAGAATTAGGTCCTTCAACTTAGTGTAATTTGTTGGACAGCAAAACTAAAAAAAATTCTAG,10,30,14,27,27,37,27,42,27,30,30,37,35,42,51.39,0.0
hek293t,9963,1,7,GATTGGTGTGCATGTGTATATGATACTGAAGGGACTGGCTTGGCAATCAAGAACTATTTCACTCTCAGTTCTGAAAAAAATTCTAGTTGGTTTAACGCG,GATTGGTGTGCATGTGTATATGATACTGAAGGCATGCCAGACTGGCTTGGCAATCAAGAACTATTTCACTCTCAGTTCTGAAAAAAATTCTAGTTGGTT,10,30,14,27,27,43,27,50,27,33,33,43,40,50,49.56,75.96882196
hek293t,9963,1,7,AGGGGGTGTGCATGTGTATATGATACTGAAGGGACTGGCTTGGCAATCAAGAACTATTTCACTCTCAGTTCTGTTTAAAAAAATTCTAGTTGGTTTAAC,AGGGGGTGTGCATGTGTATATGATACTGAAGGCATGCCAGACTGGCTTGGCAATCAAGAACTATTTCACTCTCAGTTCTGTTTAAAAAAATTCTAGTTG,10,30,14,27,27,40,27,47,27,33,33,40,40,47,49.56,54.64097453
hek293t,9967,1,15,GTCTAGCACCACGTTCCTGCAGCTGAAACCGGCCCCAGGGACGCTGGCAGCCCCGGTGGCGCGAAGGAAAGAAAAAAATTCTAGTTGGTTTAACGCGTA,GTCTAGCACCACGTTCCTGCAGCTGAAACTTGATCACTAAATCTCGGCCCCAGGGACGCTGGCAGCCCCGGTGGCGCGAAGGAAAGAAAAAAATTCTAG,10,30,14,27,27,37,27,52,27,30,30,37,45,52,18.99,0.214069224
hek293t,9969,1,10,TCTGCGTTGATAAATTAAGATTATTATATAGGTTTAGAAAGAGGCAGTCATAGGTCCGGTGCTAGCAAAAAAATTCTAGTTGGTTTAACGCGTAACTAG,TCTGCGTTGATAAATTAAGATTATTATATAGGTTTAGAACCGCTTGGCAAGAGGCAGTCATAGGTCCGGTGCTAGCAAAAAAATTCTAGTTGGTTTAAC,10,30,14,27,27,47,27,57,27,40,40,47,50,57,7.9,0.309186197
hek293t,9969,1,10,ACCCTGTTGATAAATTAAGATTATTATATAGGTTTAGAAAGAGGCAGTCATAGGTCCGGTGCTAGCTTATAAAAAAATTCTAGTTGGTTTAACGCGTAA,ACCCTGTTGATAAATTAAGATTATTATATAGGTTTAGAACCGCTTGGCAAGAGGCAGTCATAGGTCCGGTGCTAGCTTATAAAAAAATTCTAGTTGGTT,10,30,14,27,27,43,27,53,27,40,40,43,50,53,7.9,0.0
hek293t,9971,1,10,AATCAGTTCTCTCAGCCTGGTTACAACGTTGGCTGCACTCAGGTCAAAGGAATCACACAACTATGTTGAACTATATTAACTAAAAAAATTCTAGTTGGT,AATCAGTTCTCTCAGCCTGGTTACAACGCATCAGCTGCTTGGCTGCACTCAGGTCAAAGGAATCACACAACTATGTTGAACTATATTAACTAAAAAAAT,10,30,14,27,27,32,27,42,27,29,29,32,39,42,66.72,0.555555556
hek293t,9971,1,10,CGGGGGTTCTCTCAGCCTGGTTACAACGTTGGCTGCACTCAGGTCAAAGGAATCACACAACTATGTTGAAAAAAAATTCTAGTTGGTTTAACGCGTAAC,CGGGGGTTCTCTCAGCCTGGTTACAACGCATCAGCTGCTTGGCTGCACTCAGGTCAAAGGAATCACACAACTATGTTGAAAAAAAATTCTAGTTGGTTT,10,30,14,27,27,44,27,54,27,29,29,44,39,54,66.72,29.42227708
hek293t,9973,1,9,GAGGAGATGGACAAAAGATCCTTTCTGGGTGGCAAAATGTATCTACAGGGGCTCTTGGGCCATTCGTCTGAAAAAAATTCTAGTTGGTTTAACGCGTAA,GAGGAGATGGACAAAAGATCCTTTCTGGGTGGCAAAATGTTTGTATCCCATCTACAGGGGCTCTTGGGCCATTCGTCTGAAAAAAATTCTAGTTGGTTT,10,30,14,27,27,44,27,53,27,41,41,44,50,53,65.66,0.0
hek293t,9974,1,10,AACAGCATAAGCTTTCAAGCTACTAAATATGGATTAATTCCCCCCCCCTAGTACCTGTTTTGTTTTTCTGTGAAGTAAAAAAATTCTAGTTGGTTTAAC,AACAGCATAAGCTTTCAAGCTACTAAATAGCACACCCCTTGGATTAATTCCCCCCCCCTAGTACCTGTTTTGTTTTTCTGTGAAGTAAAAAAATTCTAG,10,30,14,27,27,37,27,47,27,30,30,37,40,47,7.96,0.215168863
hek293t,9974,1,10,CTGTGCATAAGCTTTCAAGCTACTAAATATGGATTAATTCCCCCCCCCTAGTACCTGTTTTGTTTTTCTGTGAAGTTGCTAAAAAAATTCTAGTTGGTT,CTGTGCATAAGCTTTCAAGCTACTAAATAGCACACCCCTTGGATTAATTCCCCCCCCCTAGTACCTGTTTTGTTTTTCTGTGAAGTTGCTAAAAAAATT,10,30,14,27,27,33,27,43,27,30,30,33,40,43,7.96,0.0
hek293t,9976,1,7,GGATATCTTTCTGTAGTTACAGTAGCTTACGGAAGAAAGAGTTTCAGAAAAGACTTTTATTGCTCATGTGAAAAAAATTCTAGTTGGTTTAACGCGTAA,GGATATCTTTCTGTAGTTACAGTAGCTTACGGAAGAAAATATGTAGAGTTTCAGAAAAGACTTTTATTGCTCATGTGAAAAAAATTCTAGTTGGTTTAA,10,30,14,27,27,46,27,53,27,39,39,46,46,53,58.16,0.049019608
hek293t,9976,1,7,ATCCATCTTTCTGTAGTTACAGTAGCTTACGGAAGAAAGAGTTTCAGAAAAGACTTTTATTGCTCATGTGTTTTAAAAAAATTCTAGTTGGTTTAACGC,ATCCATCTTTCTGTAGTTACAGTAGCTTACGGAAGAAAATATGTAGAGTTTCAGAAAAGACTTTTATTGCTCATGTGTTTTAAAAAAATTCTAGTTGGT,10,30,14,27,27,42,27,49,27,39,39,42,46,49,58.16,0.0
hek293t,9978,1,2,CCACGACAAGTGTACCTCCTAAACCACAAAGGCCAAGAACATGTATTCATTTATTTATATGGGAGATCTGAGTTATGGGGCTGCAGAAAAAAATTCTAG,CCACGACAAGTGTACCTCCTAAACCACAAAAAGGCCAAGAACATGTATTCATTTATTTATATGGGAGATCTGAGTTATGGGGCTGCAGAAAAAAATTCT,10,30,14,27,27,35,27,37,27,28,28,35,30,37,55.37,1.368508796
hek293t,9978,1,2,AAGCGACAAGTGTACCTCCTAAACCACAAAGGCCAAGAACATGTATTCATTTATTTATATGGGAGATCTGAGTTATGGGGCTGCAGATGGAAAAAAATT,AAGCGACAAGTGTACCTCCTAAACCACAAAAAGGCCAAGAACATGTATTCATTTATTTATATGGGAGATCTGAGTTATGGGGCTGCAGATGGAAAAAAA,10,30,14,27,27,31,27,33,27,28,28,31,30,33,55.37,0.0
hek293t,9980,1,9,TCCCCGAATTACTTTAAAGAGGAACCTAATGGTTCTTCTTAAGAAAGATTTTTACTGATCAGAAAAGATTGTTTGACTCCAAAAAAAAAATTCTAGTTG,TCCCCGAATTACTTTAAAGAGGAACCTATAGGTTGCAATGGTTCTTCTTAAGAAAGATTTTTACTGATCAGAAAAGATTGTTTGACTCCAAAAAAAAAA,10,30,14,27,27,31,27,40,27,28,28,31,37,40,14.75,0.0
hek293t,9980,1,9,ATGTAGAATTACTTTAAAGAGGAACCTAATGGTTCTTCTTAAGAAAGATTTTTACTGATCAGAAAAGATTGTTTGACTCAAAAAAATTCTAGTTGGTTT,ATGTAGAATTACTTTAAAGAGGAACCTATAGGTTGCAATGGTTCTTCTTAAGAAAGATTTTTACTGATCAGAAAAGATTGTTTGACTCAAAAAAATTCT,10,30,14,27,27,35,27,44,27,28,28,35,37,44,14.75,0.0
hek293t,9982,1,14,AGGTGAAGCAGCTATACTTTGGGGAAATCAGGATTCAGATCCAGAAGCATTTCATCTAAGTATCTCAGACCCCCCCAAAAAAATTCTAGTTGGTTTAAC,AGGTGAAGCAGCTATACTTTGGGGAAATCGCGCTATTTACTAAAGGATTCAGATCCAGAAGCATTTCATCTAAGTATCTCAGACCCCCCCAAAAAAATT,10,30,14,27,27,33,27,47,27,30,30,33,44,47,11.41,0.156862745
hek293t,9982,1,14,CAGCCAAGCAGCTATACTTTGGGGAAATCAGGATTCAGATCCAGAAGCATTTCATCTAAGTATCAAAAAAATTCTAGTTGGTTTAACGCGTAACTAGAT,CAGCCAAGCAGCTATACTTTGGGGAAATCGCGCTATTTACTAAAGGATTCAGATCCAGAAGCATTTCATCTAAGTATCAAAAAAATTCTAGTTGGTTTA,10,30,14,27,27,45,27,59,27,30,30,45,44,59,11.41,8.727557013
hek293t,9984,1,11,TCTCTCTCCGAACTTTTCTGTGGGAACCTAGGGTCGGGCCCTGTTATGGTGGCCGACAAGCCTAATTTCCATAAAAAAATTCTAGTTGGTTTAACGCGT,TCTCTCTCCGAACTTTTCTGTGGGAACCTAGGGGACATATAGGGTCGGGCCCTGTTATGGTGGCCGACAAGCCTAATTTCCATAAAAAAATTCTAGTTG,10,30,14,27,27,40,27,51,27,30,30,40,41,51,38.68,36.06581362
hek293t,9987,1,11,TCGTGTAAAGTCAATTTAAAGTACACTTGGGGATCCTCCAGCATAAGTTATGGATTTACCAAGGAACTGCAAAAAAATTCTAGTTGGTTTAACGCGTAA,TCGTGTAAAGTCAATTTAAAGTACACTTGGGGCAGAGCCCGTGATCCTCCAGCATAAGTTATGGATTTACCAAGGAACTGCAAAAAAATTCTAGTTGGT,10,30,14,27,27,42,27,53,27,32,32,42,43,53,36.82,2.646820491
hek293t,9987,1,11,GCAACTAAAGTCAATTTAAAGTACACTTGGGGATCCTCCAGCATAAGTTATGGATTTACCAAGGAACTGCCCACATAAAAAAAATTCTAGTTGGTTTAA,GCAACTAAAGTCAATTTAAAGTACACTTGGGGCAGAGCCCGTGATCCTCCAGCATAAGTTATGGATTTACCAAGGAACTGCCCACATAAAAAAAATTCT,10,30,14,27,27,35,27,46,27,32,32,35,43,46,36.82,0.0
hek293t,9989,1,9,CATTGTATACTGCCCTTGCCGGCGTGAACAGGGAGAACGCAACAGCCCTTCCGATTCTGGGCTCTGAGACAAAAAAATTCTAGTTGGTTTAACGCGTAA,CATTGTATACTGCCCTTGCCGGCGTGAACAGGGAGAACGCACACCCGATAACAGCCCTTCCGATTCTGGGCTCTGAGACAAAAAAATTCTAGTTGGTTT,10,30,14,27,27,44,27,53,27,41,41,44,50,53,18.93,0.0
hek293t,9991,1,14,ATTTTAGAAAATGGCATGTCCCCAATGGATGGCCACTAGAACTGAGTCAATGCAAAATATTATCTATGAAAAAAATTCTAGTTGGTTTAACGCGTAACT,ATTTTAGAAAATGGCATGTCCCCAATGGATGGCCACTATCTGAAAAGTCGAAGAACTGAGTCAATGCAAAATATTATCTATGAAAAAAATTCTAGTTGG,10,30,14,27,27,41,27,55,27,38,38,41,52,55,62.29,0.247142416
hek293t,9992,1,8,CTCGAAGTTCCATTCATGCATTATTAAACTGGTGTCACAACACAGTTCACTTTAGAATTAGCCAGGCCACCATAAAAAAATTCTAGTTGGTTTAACGCG,CTCGAAGTTCCATTCATGCATTATTAAACTGGTGTCACTAGGCTAAAACACAGTTCACTTTAGAATTAGCCAGGCCACCATAAAAAAATTCTAGTTGGT,10,30,14,27,27,42,27,50,27,39,39,42,47,50,8.31,0.381679389
hek293t,9993,1,7,AACAGTTATGGTGATCTAGACAGCAGCAGTGGCTTGGCATCTTTCTCAAAGAGGCCACACACTCATTCCACTCCTCTACAAAAAAAAATTCTAGTTGGT,AACAGTTATGGTGATCTAGACAGCAGCAAGCTCAAGTGGCTTGGCATCTTTCTCAAAGAGGCCACACACTCATTCCACTCCTCTACAAAAAAAAATTCT,10,30,14,27,27,35,27,42,27,28,28,35,35,42,51.22,26.45718424
hek293t,9993,1,7,TATGATTATGGTGATCTAGACAGCAGCAGTGGCTTGGCATCTTTCTCAAAGAGGCCACACACTCATTCCACTCCTCTAAAAAAAATTCTAGTTGGTTTA,TATGATTATGGTGATCTAGACAGCAGCAAGCTCAAGTGGCTTGGCATCTTTCTCAAAGAGGCCACACACTCATTCCACTCCTCTAAAAAAAATTCTAGT,10,30,14,27,27,38,27,45,27,28,28,38,35,45,51.22,58.10678611
hek293t,9995,1,9,ACCGTAGCTTAAGAAAGCTTCAGCTAGCATGGATATCAGCAGTCATCCTGCTAGGCAATGTTAAGCCAGGATGAAAAAAATTCTAGTTGGTTTAACGCG,ACCGTAGCTTAAGAAAGCTTCAGCTAGCATGGACGTTCTACGTATCAGCAGTCATCCTGCTAGGCAATGTTAAGCCAGGATGAAAAAAATTCTAGTTGG,10,30,14,27,27,41,27,50,27,34,34,41,43,50,29.64,1.170904911
hek293t,9995,1,9,CTGATAGCTTAAGAAAGCTTCAGCTAGCATGGATATCAGCAGTCATCCTGCTAGGCAATGTTAAGAAAAAAATTCTAGTTGGTTTAACGCGTAACTAGA,CTGATAGCTTAAGAAAGCTTCAGCTAGCATGGACGTTCTACGTATCAGCAGTCATCCTGCTAGGCAATGTTAAGAAAAAAATTCTAGTTGGTTTAACGC,10,30,14,27,27,49,27,58,27,34,34,49,43,58,29.64,9.764518729
hek293t,9997,1,12,ATGCTTGAAGTCCATGAGTTTCCACACAGAGGCACATGCTAATCTGAATTGGTTTTCAGGAAAGGAAAAAAATTCTAGTTGGTTTAACGCGTAACTAGA,ATGCTTGAAGTCCATGAGTTTCCACACAGACCCTGGACGATGGGCACATGCTAATCTGAATTGGTTTTCAGGAAAGGAAAAAAATTCTAGTTGGTTTAA,10,30,14,27,27,46,27,58,27,31,31,46,43,58,70.94,52.63213787
hek293t,9997,1,12,GGAGATGAAGTCCATGAGTTTCCACACAGAGGCACATGCTAATCTGAATTGGTTTTCAGGAAAGGGCTTAACTCAGTAAAAAAATTCTAGTTGGTTTAA,GGAGATGAAGTCCATGAGTTTCCACACAGACCCTGGACGATGGGCACATGCTAATCTGAATTGGTTTTCAGGAAAGGGCTTAACTCAGTAAAAAAATTC,10,30,14,27,27,34,27,46,27,31,31,34,43,46,70.94,1.421973352
hek293t,9999,1,14,TGACAGCTCTCAAGTTCGCACTTGACATCTGGCTGTTGTGCACTTGCTGCAAGGCTGTACCATTCACAAAAAAATTCTAGTTGGTTTAACGCGTAACTA,TGACAGCTCTCAAGTTCGCACTTGACATCTGAATATTTGTATACCGCTGTTGTGCACTTGCTGCAAGGCTGTACCATTCACAAAAAAATTCTAGTTGGT,10,30,14,27,27,42,27,56,27,32,32,42,46,56,20.18,12.28520163
hek293t,9999,1,14,TATCGGCTCTCAAGTTCGCACTTGACATCTGGCTGTTGTGCACTTGCTGCAAGGCTGTACCATTCACCACAGCCAAAAAAATTCTAGTTGGTTTAACGC,TATCGGCTCTCAAGTTCGCACTTGACATCTGAATATTTGTATACCGCTGTTGTGCACTTGCTGCAAGGCTGTACCATTCACCACAGCCAAAAAAATTCT,10,30,14,27,27,35,27,49,27,32,32,35,46,49,20.18,5.330136604
hek293t,10001,1,11,GCCACTCACTGGGCACTTGCAAAACTTTCTGGGGCTGAAACATGGACATATTTGGAAGGAAGAAAACTAAAAAAATTCTAGTTGGTTTAACGCGTAACT,GCCACTCACTGGGCACTTGCAAAACTTTCTGGGGCTACGCGCTACACGAAACATGGACATATTTGGAAGGAAGAAAACTAAAAAAATTCTAGTTGGTTT,10,30,14,27,27,44,27,55,27,37,37,44,48,55,-0.76,0.030138638
hek293t,10001,1,11,ATTTCTCACTGGGCACTTGCAAAACTTTCTGGGGCTGAAACATGGACATATTTGGAAGGAAGAAAACTAGAGAAAAAAATTCTAGTTGGTTTAACGCGT,ATTTCTCACTGGGCACTTGCAAAACTTTCTGGGGCTACGCGCTACACGAAACATGGACATATTTGGAAGGAAGAAAACTAGAGAAAAAAATTCTAGTTG,10,30,14,27,27,40,27,51,27,37,37,40,48,51,-0.76,0.0
hek293t,10003,1,13,TAAGGAAACTGCTTATTCTCTAAGGGAGCTGGATGCCAAGATAAGCTGTATCAATATGCTGTAATATGAATCCAGATGAGAAAAAAATTCTAGTTGGTT,TAAGGAAACTGCTTATTCTCTAAGGGCGCTCTGGTTGTTAGCTGGATGCCAAGATAAGCTGTATCAATATGCTGTAATATGAATCCAGATGAGAAAAAA,10,30,14,27,27,30,27,43,27,27,27,30,40,43,18.67,0.395256917
hek293t,10003,1,13,GGTAGAAACTGCTTATTCTCTAAGGGAGCTGGATGCCAAGATAAGCTGTATCAATATGCTGTAATATGAATCCAGAAAAAAAATTCTAGTTGGTTTAAC,GGTAGAAACTGCTTATTCTCTAAGGGCGCTCTGGTTGTTAGCTGGATGCCAAGATAAGCTGTATCAATATGCTGTAATATGAATCCAGAAAAAAAATTC,10,30,14,27,27,34,27,47,27,27,27,34,40,47,18.67,1.104072815
hek293t,10005,1,3,TGGTGTAGCATCTTGCTTATTTCTCGCCCTGGCAACCCTTCCTGCCGCATCATTCTTCAAATGTTAAGCACTGGCAAAAGAGTAAAAAAAATTCTAGTT,TGGTGTAGCATCTTGCTTATTTCTCGCCAGCCTGGCAACCCTTCCTGCCGCATCATTCTTCAAATGTTAAGCACTGGCAAAAGAGTAAAAAAAATTCTA,10,30,14,27,27,36,27,39,27,29,29,36,32,39,35.84,41.93193923
hek293t,10005,1,3,CCTCGTAGCATCTTGCTTATTTCTCGCCCTGGCAACCCTTCCTGCCGCATCATTCTTCAAATGTTAAGCACTGGCAAAAAAAATTCTAGTTGGTTTAAC,CCTCGTAGCATCTTGCTTATTTCTCGCCAGCCTGGCAACCCTTCCTGCCGCATCATTCTTCAAATGTTAAGCACTGGCAAAAAAAATTCTAGTTGGTTT,10,30,14,27,27,44,27,47,27,29,29,44,32,47,35.84,58.86242494
hek293t,10007,1,7,ATAATAGTGAGACCAAGTCTTGAGTTGCCAGGATATGAAGCAGGCGATCCATTTGTGCAGAGAGGTACATACCTAAAAAAATTCTAGTTGGTTTAACGC,ATAATAGTGAGACCAAGTCTTGAGTTGCCAGCAAGCGTGATATGAAGCAGGCGATCCATTTGTGCAGAGAGGTACATACCTAAAAAAATTCTAGTTGGT,10,30,14,27,27,42,27,49,27,32,32,42,39,49,36.5,34.36572398
hek293t,10007,1,7,TCGGAAGTGAGACCAAGTCTTGAGTTGCCAGGATATGAAGCAGGCGATCCATTTGTGCAGAGAGGTACATACCTTACATATAAAAAAATTCTAGTTGGT,TCGGAAGTGAGACCAAGTCTTGAGTTGCCAGCAAGCGTGATATGAAGCAGGCGATCCATTTGTGCAGAGAGGTACATACCTTACATATAAAAAAATTCT,10,30,14,27,27,35,27,42,27,32,32,35,39,42,36.5,6.913264957
hek293t,10009,1,3,ATGTCAAGATCTCTGATACTACCAACGAATGGAGTTATTCCCTTAGCTCAAAAAGCAGCTTCAGTCTTCCAGCCAAAAAAATTCTAGTTGGTTTAACGC,ATGTCAAGATCTCTGATACTACCAACGAATGGAGTTATTTCTCCCTTAGCTCAAAAAGCAGCTTCAGTCTTCCAGCCAAAAAAATTCTAGTTGGTTTAA,10,30,14,27,27,46,27,49,27,39,39,46,42,49,59.26,79.04533378
hek293t,10009,1,3,CTCATAAGATCTCTGATACTACCAACGAATGGAGTTATTCCCTTAGCTCAAAAAGCAGCTTCAGTCAAAAAAATTCTAGTTGGTTTAACGCGTAACTAG,CTCATAAGATCTCTGATACTACCAACGAATGGAGTTATTTCTCCCTTAGCTCAAAAAGCAGCTTCAGTCAAAAAAATTCTAGTTGGTTTAACGCGTAAC,10,30,14,27,27,54,27,57,27,39,39,54,42,57,59.26,43.44290748
hek293t,10011,1,12,GATTCACCAGCCTCTTACAATGCTGGCATTGGTCTATACAGATTCTTTGTAATTTCGAGTCAGTTTGGATCAAAGGGAAAAAAATTCTAGTTGGTTTAA,GATTCACCAGCCTCTTACAATGCTGGCATTACTGCTGAGCATGGTCTATACAGATTCTTTGTAATTTCGAGTCAGTTTGGATCAAAGGGAAAAAAATTC,10,30,14,27,27,34,27,46,27,31,31,34,43,46,44.09,0.048875855
hek293t,10011,1,12,TTACGACCAGCCTCTTACAATGCTGGCATTGGTCTATACAGATTCTTTGTAATTTCGAGTCAGTTTGGATCAAAAAAAAATTCTAGTTGGTTTAACGCG,TTACGACCAGCCTCTTACAATGCTGGCATTACTGCTGAGCATGGTCTATACAGATTCTTTGTAATTTCGAGTCAGTTTGGATCAAAAAAAAATTCTAGT,10,30,14,27,27,38,27,50,27,31,31,38,43,50,44.09,5.969502679
hek293t,10013,1,6,AGCCTATGTTTGCACTCTGATTAGTATTCAGGTATCACAGGAAATGTAGTAATCACATCAGATGCTTTTGTGAAAAAAATTCTAGTTGGTTTAACGCGT,AGCCTATGTTTGCACTCTGATTAGTATTCGCGGTCAGGTATCACAGGAAATGTAGTAATCACATCAGATGCTTTTGTGAAAAAAATTCTAGTTGGTTTA,10,30,14,27,27,45,27,51,27,30,30,45,36,51,16.41,20.45906333
hek293t,10013,1,6,CCCCCATGTTTGCACTCTGATTAGTATTCAGGTATCACAGGAAATGTAGTAATCACATCAGATGCTTTTGTGCTAAACAGAAAAAAATTCTAGTTGGTT,CCCCCATGTTTGCACTCTGATTAGTATTCGCGGTCAGGTATCACAGGAAATGTAGTAATCACATCAGATGCTTTTGTGCTAAACAGAAAAAAATTCTAG,10,30,14,27,27,37,27,43,27,30,30,37,36,43,16.41,22.12760109
hek293t,10015,1,8,CTTGATTGCCCCCCTCCCGCGGGAGATGCTGGGGAAGCTGGGAAGCCCCCACTGCATTCCCAGCTAAAAAAATTCTAGTTGGTTTAACGCGTAACTAGA,CTTGATTGCCCCCCTCCCGCGGGAGATGCTGGGGATTCTCGGAAGCTGGGAAGCCCCCACTGCATTCCCAGCTAAAAAAATTCTAGTTGGTTTAACGCG,10,30,14,27,27,50,27,58,27,35,35,50,43,58,17.89,12.64652669
hek293t,10015,1,8,ATTTATTGCCCCCCTCCCGCGGGAGATGCTGGGGAAGCTGGGAAGCCCCCACTGCATTCCCAGCTCCCTCGTCGCCGAAAAAAATTCTAGTTGGTTTAA,ATTTATTGCCCCCCTCCCGCGGGAGATGCTGGGGATTCTCGGAAGCTGGGAAGCCCCCACTGCATTCCCAGCTCCCTCGTCGCCGAAAAAAATTCTAGT,10,30,14,27,27,38,27,46,27,35,35,38,43,46,17.89,13.69021289
hek293t,10019,1,8,GGCGCTTACATGGTTCTAAGTCTTTTGACTGGAGTTGAAATTTTATGAAAGCAGCCACTAAGAATGTTGGCAGATGGAAAAATAAAAAAATTCTAGTTG,GGCGCTTACATGGTTCTAAGTCTTTTGAACCGCCCACTGGAGTTGAAATTTTATGAAAGCAGCCACTAAGAATGTTGGCAGATGGAAAAATAAAAAAAT,10,30,14,27,27,32,27,40,27,29,29,32,37,40,36.04,0.0
hek293t,10019,1,8,GGACCTTACATGGTTCTAAGTCTTTTGACTGGAGTTGAAATTTTATGAAAGCAGCCACTAAGAATGTTGGCAGATGGAAAAAAAAATTCTAGTTGGTTT,GGACCTTACATGGTTCTAAGTCTTTTGAACCGCCCACTGGAGTTGAAATTTTATGAAAGCAGCCACTAAGAATGTTGGCAGATGGAAAAAAAAATTCTA,10,30,14,27,27,36,27,44,27,29,29,36,37,44,36.04,2.715563953
hek293t,10021,1,2,GTGTGTAACTTAATCCATTACTTTAAAGGTGGTTTACATACTATTTATTTGTTACATCCAGCAGCACAAGGGTGATAAAAAAAAAATTCTAGTTGGTTT,GTGTGTAACTTAATCCATTACTTTAATTAGGTGGTTTACATACTATTTATTTGTTACATCCAGCAGCACAAGGGTGATAAAAAAAAAATTCTAGTTGGT,10,30,14,27,27,42,27,44,27,27,27,42,29,44,36.55,9.229936609
hek293t,10021,1,2,AGTGCTAACTTAATCCATTACTTTAAAGGTGGTTTACATACTATTTATTTGTTACATCCAGCAGCACAAGGGTGATAAAATACTCCAAAAAAAATTCTA,AGTGCTAACTTAATCCATTACTTTAATTAGGTGGTTTACATACTATTTATTTGTTACATCCAGCAGCACAAGGGTGATAAAATACTCCAAAAAAAATTC,10,30,14,27,27,34,27,36,27,27,27,34,29,36,36.55,14.96024094
hek293t,10023,1,1,TGCTACTTATTCTAGGTGGAGAACTGAGATGGTAGAGCCACTGACTGTAGATACTGCAGTATGTGTGCTGAAGTACAGAAAAAAATTCTAGTTGGTTTA,TGCTACTTATTCTAGGTGGAGAACTGAGAATGGTAGAGCCACTGACTGTAGATACTGCAGTATGTGTGCTGAAGTACAGAAAAAAATTCTAGTTGGTTT,10,30,14,27,27,44,27,45,27,29,29,44,30,45,52.66,72.05084818
hek293t,10023,1,1,TCATACTTATTCTAGGTGGAGAACTGAGATGGTAGAGCCACTGACTGTAGATACTGCAGTATGTGTGCTGAAGTACAGAAAAGAAAAAAATTCTAGTTG,TCATACTTATTCTAGGTGGAGAACTGAGAATGGTAGAGCCACTGACTGTAGATACTGCAGTATGTGTGCTGAAGTACAGAAAAGAAAAAAATTCTAGTT,10,30,14,27,27,39,27,40,27,29,29,39,30,40,52.66,63.54349497
hek293t,10025,1,4,GCCCTGGCCCTAAGCCAAGCAGATGTCTAAGGCAAGCATATTTTTAAGAGCTGTTGAATGCACTGGAACTATGCAAAAAAATTCTAGTTGGTTTAACGC,GCCCTGGCCCTAAGCCAAGCAGATGTCTAAGGCAGCTGAGCATATTTTTAAGAGCTGTTGAATGCACTGGAACTATGCAAAAAAATTCTAGTTGGTTTA,10,30,14,27,27,45,27,49,27,35,35,45,39,49,48.58,26.55386949
hek293t,10025,1,4,CCGCCGGCCCTAAGCCAAGCAGATGTCTAAGGCAAGCATATTTTTAAGAGCTGTTGAATGCACTGGAACAAAAAAATTCTAGTTGGTTTAACGCGTAAC,CCGCCGGCCCTAAGCCAAGCAGATGTCTAAGGCAGCTGAGCATATTTTTAAGAGCTGTTGAATGCACTGGAACAAAAAAATTCTAGTTGGTTTAACGCG,10,30,14,27,27,50,27,54,27,35,35,50,39,54,48.58,19.83512142
hek293t,10027,1,9,TAGGTTAAAAGAGAAGGTTTATTTTCTAAAGGAAATGACTGACTTGCCTAACTCCTCCTCCTGGTAACACAAAAAAATTCTAGTTGGTTTAACGCGTAA,TAGGTTAAAAGAGAAGGTTTATTTTCTAAAGGAAATGACTTGTCCGATTGACTTGCCTAACTCCTCCTCCTGGTAACACAAAAAAATTCTAGTTGGTTT,10,30,14,27,27,44,27,53,27,41,41,44,50,53,5.0,0.0
hek293t,10028,1,15,ACGGGAACACTAAACACAAACCTTTTTTCTGGAACTCAGCTTTGAAACTGTATGAAAATAATAGCTGTAATCATAAAAAAAAAATTCTAGTTGGTTTAA,ACGGGAACACTAAACACAAACCTTTTTAATAGGCAACGGTCCTCTGGAACTCAGCTTTGAAACTGTATGAAAATAATAGCTGTAATCATAAAAAAAAAA,10,30,14,27,27,31,27,46,27,28,28,31,43,46,2.51,0.0
hek293t,10028,1,15,ACCTCAACACTAAACACAAACCTTTTTTCTGGAACTCAGCTTTGAAACTGTATGAAAATAATAGCTGTAATCAAAAAAAATTCTAGTTGGTTTAACGCG,ACCTCAACACTAAACACAAACCTTTTTAATAGGCAACGGTCCTCTGGAACTCAGCTTTGAAACTGTATGAAAATAATAGCTGTAATCAAAAAAAATTCT,10,30,14,27,27,35,27,50,27,28,28,35,43,50,2.51,0.0
hek293t,10032,1,2,TATGAAAAATGTATAAGCAAGCTCCATCATGGCTTACGCTTTCACAGGCAGAACTTTCTGCTTGGATTAAAAAAAATTCTAGTTGGTTTAACGCGTAAC,TATGAAAAATGTATAAGCAAGCTCCATCATGGCTTACTCGCTTTCACAGGCAGAACTTTCTGCTTGGATTAAAAAAAATTCTAGTTGGTTTAACGCGTA,10,30,14,27,27,52,27,54,27,37,37,52,39,54,61.4,64.64264982
hek293t,10032,1,2,TCGCTAAAATGTATAAGCAAGCTCCATCATGGCTTACGCTTTCACAGGCAGAACTTTCTGCTTGGATTAACAGCAGGTTAAAAAAAAATTCTAGTTGGT,TCGCTAAAATGTATAAGCAAGCTCCATCATGGCTTACTCGCTTTCACAGGCAGAACTTTCTGCTTGGATTAACAGCAGGTTAAAAAAAAATTCTAGTTG,10,30,14,27,27,40,27,42,27,37,37,40,39,42,61.4,1.059494703
hek293t,10036,1,4,AGCTTTACAATAGGATATGCGTATCAGACTGGACATATCCTAGCTTAACACAAGCTATGTTTCTACTGATCCTACCAAAAAAATTCTAGTTGGTTTAAC,AGCTTTACAATAGGATATGCGTATCAGACTGGACACGGTTATCCTAGCTTAACACAAGCTATGTTTCTACTGATCCTACCAAAAAAATTCTAGTTGGTT,10,30,14,27,27,43,27,47,27,36,36,43,40,47,52.62,85.85179644
hek293t,10036,1,4,GTTGGTACAATAGGATATGCGTATCAGACTGGACATATCCTAGCTTAACACAAGCTATGTTTCTACTGAAAAAAATTCTAGTTGGTTTAACGCGTAACT,GTTGGTACAATAGGATATGCGTATCAGACTGGACACGGTTATCCTAGCTTAACACAAGCTATGTTTCTACTGAAAAAAATTCTAGTTGGTTTAACGCGT,10,30,14,27,27,51,27,55,27,36,36,51,40,55,52.62,59.03323298
hek293t,10038,1,1,CTAATAGCATTATATTCCCTATAATGCAAAGGTAAGAAAATATGAAGTTCTTTTGTCCTCTTACCTTTAGAACACAAAAAAAATTCTAGTTGGTTTAAC,CTAATAGCATTATATTCCCTATAATGCAAAGGTAAGAAGAATATGAAGTTCTTTTGTCCTCTTACCTTTAGAACACAAAAAAAATTCTAGTTGGTTTAA,10,30,14,27,27,46,27,47,27,39,39,46,40,47,40.37,0.592222288
hek293t,10038,1,1,GCAAGAGCATTATATTCCCTATAATGCAAAGGTAAGAAAATATGAAGTTCTTTTGTCCTCTTACCTTTAAAAAAATTCTAGTTGGTTTAACGCGTAACT,GCAAGAGCATTATATTCCCTATAATGCAAAGGTAAGAAGAATATGAAGTTCTTTTGTCCTCTTACCTTTAAAAAAATTCTAGTTGGTTTAACGCGTAAC,10,30,14,27,27,54,27,55,27,39,39,54,40,55,40.37,1.990382068
hek293t,10040,1,3,TGGTTAAGGCCGAGCAGCACTGCCAGGGATGGGAGACATGGTGAGGGCAGATACAGCGTGGATTTTTACATATGTGTTTGGAATGAAAAAAAATTCTAG,TGGTTAAGGCCGAGCAGCACTGCCAGGGATTACGGGAGACATGGTGAGGGCAGATACAGCGTGGATTTTTACATATGTGTTTGGAATGAAAAAAAATTC,10,30,14,27,27,34,27,37,27,31,31,34,34,37,45.71,0.795544948
hek293t,10042,1,13,GAGTGCTGCTCCATCACATCCCCTGCTTTCGGGGATGCTGCTTTGGTTCCCTGCTTGGGAGGGGATTTCAAAAAAATTCTAGTTGGTTTAACGCGTAAC,GAGTGCTGCTCCATCACATCCCCTGCTTTCGGGTTGTGAAAGGAGCGATGCTGCTTTGGTTCCCTGCTTGGGAGGGGATTTCAAAAAAATTCTAGTTGG,10,30,14,27,27,41,27,54,27,34,34,41,47,54,24.18,0.349216201
hek293t,10042,1,13,GTGTACTGCTCCATCACATCCCCTGCTTTCGGGGATGCTGCTTTGGTTCCCTGCTTGGGAGGGGATTTCTGATAAAAAAATTCTAGTTGGTTTAACGCG,GTGTACTGCTCCATCACATCCCCTGCTTTCGGGTTGTGAAAGGAGCGATGCTGCTTTGGTTCCCTGCTTGGGAGGGGATTTCTGATAAAAAAATTCTAG,10,30,14,27,27,37,27,50,27,34,34,37,47,50,24.18,0.275482094
hek293t,10044,1,6,GAAAGGAAGAGTGGGAAATTCCTATCTAAAGGAAGTCTGTTTTCAGCTTTGTTACAAAGTCTGTCAAAAAAAAATTCTAGTTGGTTTAACGCGTAACTA,GAAAGGAAGAGTGGGAAATTCCTATCTAAAGGAAGTCTGAAGGGCTTTTCAGCTTTGTTACAAAGTCTGTCAAAAAAAAATTCTAGTTGGTTTAACGCG,10,30,14,27,27,50,27,56,27,40,40,50,46,56,48.58,6.301493792
hek293t,10044,1,6,CCTTGGAAGAGTGGGAAATTCCTATCTAAAGGAAGTCTGTTTTCAGCTTTGTTACAAAGTCTGTCAATCTAAAAAAATTCTAGTTGGTTTAACGCGTAA,CCTTGGAAGAGTGGGAAATTCCTATCTAAAGGAAGTCTGAAGGGCTTTTCAGCTTTGTTACAAAGTCTGTCAATCTAAAAAAATTCTAGTTGGTTTAAC,10,30,14,27,27,47,27,53,27,40,40,47,46,53,48.58,0.716342941
hek293t,10046,1,14,AACAGTTTGGTAAGCTTTGAGCTGCAGACTGGGAATTCTGCAGCTGCTCCAAGTAAACACCAAACTAGAGGTTAAAAAAATTCTAGTTGGTTTAACGCG,AACAGTTTGGTAAGCTTTGAGCTGCAGACTGGAACATCGTCAATTCGAATTCTGCAGCTGCTCCAAGTAAACACCAAACTAGAGGTTAAAAAAATTCTA,10,30,14,27,27,36,27,50,27,33,33,36,47,50,21.3,1.116659731
hek293t,10046,1,14,TCGACTTTGGTAAGCTTTGAGCTGCAGACTGGGAATTCTGCAGCTGCTCCAAGTAAACACCAAACTAAAAAAATTCTAGTTGGTTTAACGCGTAACTAG,TCGACTTTGGTAAGCTTTGAGCTGCAGACTGGAACATCGTCAATTCGAATTCTGCAGCTGCTCCAAGTAAACACCAAACTAAAAAAATTCTAGTTGGTT,10,30,14,27,27,43,27,57,27,33,33,43,47,57,21.3,31.70630688
hek293t,10048,1,3,GACAAAGATGGACTTCTAGATGGGTTTTTAGGGTAGTATAGCTCTAGCTCCCTATACAACAGCTTACTCTACCTTGTAAAAAAATTCTAGTTGGTTTAA,GACAAAGATGGACTTCTAGATGGGTTTTTAGGAAAGTAGTATAGCTCTAGCTCCCTATACAACAGCTTACTCTACCTTGTAAAAAAATTCTAGTTGGTT,10,30,14,27,27,43,27,46,27,33,33,43,36,46,2.05,48.04329536
hek293t,10048,1,3,GTGCCAGATGGACTTCTAGATGGGTTTTTAGGGTAGTATAGCTCTAGCTCCCTATACAACAGCTTACTCTACCTTGTATGCATTAAAAAAATTCTAGTT,GTGCCAGATGGACTTCTAGATGGGTTTTTAGGAAAGTAGTATAGCTCTAGCTCCCTATACAACAGCTTACTCTACCTTGTATGCATTAAAAAAATTCTA,10,30,14,27,27,36,27,39,27,33,33,36,36,39,2.05,3.675523683
hek293t,10050,1,4,TGTGCCAGAAAGCCCAAGTGAAGAAGGGGAGGGAGCAGGTATCTTCATGAATATTCTCCCTCCTGTACAGCCCAGGAAAAAAATTCTAGTTGGTTTAAC,TGTGCCAGAAAGCCCAAGTGAAGAAGGGGAGGGAGCAGGTCCTTATCTTCATGAATATTCTCCCTCCTGTACAGCCCAGGAAAAAAATTCTAGTTGGTT,10,30,14,27,27,43,27,47,27,40,40,43,44,47,47.95,0.663546342
hek293t,10054,1,2,CGTTGTTTCAGTGAATTTATGCTGGAAAAAGGAACTCTTCAAAGAAACATTATAAGCCTATTGTTATTCAACAGAATGATTGAAAAAAAATTCTAGTTG,CGTTGTTTCAGTGAATTTATGCTGGAAAAAGGAATACTCTTCAAAGAAACATTATAAGCCTATTGTTATTCAACAGAATGATTGAAAAAAAATTCTAGT,10,30,14,27,27,38,27,40,27,35,35,38,37,40,11.87,0.0
hek293t,10054,1,2,TTCTTTTTCAGTGAATTTATGCTGGAAAAAGGAACTCTTCAAAGAAACATTATAAGCCTATTGTTATTCAACAGAATGAAAAAAAATTCTAGTTGGTTT,TTCTTTTTCAGTGAATTTATGCTGGAAAAAGGAATACTCTTCAAAGAAACATTATAAGCCTATTGTTATTCAACAGAATGAAAAAAAATTCTAGTTGGT,10,30,14,27,27,42,27,44,27,35,35,42,37,44,11.87,10.6524065
hek293t,10056,1,3,ACAGAAGCTCACCATCACAACAGTTTGTTTGGAGTAGAATGGAGATTAAGTAGCTTTGTATCTTTCTTCATTCACCAAGCATTTCTCAAAAAAAAATTC,ACAGAAGCTCACCATCACAACAGTTTGGTTTTTGGAGTAGAATGGAGATTAAGTAGCTTTGTATCTTTCTTCATTCACCAAGCATTTCTCAAAAAAAAA,10,30,14,27,27,31,27,34,27,28,28,31,31,34,12.25,0.0
hek293t,10056,1,3,GAAGGAGCTCACCATCACAACAGTTTGTTTGGAGTAGAATGGAGATTAAGTAGCTTTGTATCTTTCTTCATTCACCAAAAAAAATTCTAGTTGGTTTAA,GAAGGAGCTCACCATCACAACAGTTTGGTTTTTGGAGTAGAATGGAGATTAAGTAGCTTTGTATCTTTCTTCATTCACCAAAAAAAATTCTAGTTGGTT,10,30,14,27,27,43,27,46,27,28,28,43,31,46,12.25,9.918726186
hek293t,10058,1,7,CTATAAACACCATTATCAGTGCACAGTCTTGGAGGAGGACACAGAAAAGCAAAACCATTCACATCTGCCAAAAAAAAAAATTCTAGTTGGTTTAACGCG,CTATAAACACCATTATCAGTGCACAGTCTTGGCAACTTAAGGAGGACACAGAAAAGCAAAACCATTCACATCTGCCAAAAAAAAAAATTCTAGTTGGTT,10,30,14,27,27,43,27,50,27,33,33,43,40,50,45.21,49.93468088
hek293t,10058,1,7,AGATGAACACCATTATCAGTGCACAGTCTTGGAGGAGGACACAGAAAAGCAAAACCATTCACATCTGCCAAAATCTGCAGAAAAAAATTCTAGTTGGTT,AGATGAACACCATTATCAGTGCACAGTCTTGGCAACTTAAGGAGGACACAGAAAAGCAAAACCATTCACATCTGCCAAAATCTGCAGAAAAAAATTCTA,10,30,14,27,27,36,27,43,27,33,33,36,40,43,45.21,0.0
hek293t,10060,1,2,GCTTTACTAAATCATATTTTTACTTACGCTGGTTGTATCTGTAGTATCAAAATGTCTGGTAACTTCAGCAAAATGACAAAAAAATTCTAGTTGGTTTAA,GCTTTACTAAATCATATTTTTACTTACGCTGGTTGTATCTTTGTAGTATCAAAATGTCTGGTAACTTCAGCAAAATGACAAAAAAATTCTAGTTGGTTT,10,30,14,27,27,44,27,46,27,41,41,44,43,46,5.53,0.0
hek293t,10060,1,2,TAGGAACTAAATCATATTTTTACTTACGCTGGTTGTATCTGTAGTATCAAAATGTCTGGTAACTTCAGCAAAAAAAATTCTAGTTGGTTTAACGCGTAA,TAGGAACTAAATCATATTTTTACTTACGCTGGTTGTATCTTTGTAGTATCAAAATGTCTGGTAACTTCAGCAAAAAAAATTCTAGTTGGTTTAACGCGT,10,30,14,27,27,51,27,53,27,41,41,51,43,53,5.53,0.579959963
hek293t,10062,1,4,CAAGTCATTCCTCAGTTTGAAATTGTAAAAGGGTATATTTCTCCAAAATTTATCAGGCAGTTCACCATAAAAAAATTCTAGTTGGTTTAACGCGTAACT,CAAGTCATTCCTCAGTTTGAAATTGTAAAAGGGTATATTTGGTGCTCCAAAATTTATCAGGCAGTTCACCATAAAAAAATTCTAGTTGGTTTAACGCGT,10,30,14,27,27,51,27,55,27,41,41,51,45,55,1.55,0.318471338
hek293t,10063,1,9,AAGCAACCTGGGTTTACACTCTCCACCTGTGGTGGGGGAGCAGGAAGGGGAGATATTATGTTTATTTGAAAAAAATTCTAGTTGGTTTAACGCGTAACT,AAGCAACCTGGGTTTACACTCTCCACCTGTGGTGGGGCAAGACCGGGAGCAGGAAGGGGAGATATTATGTTTATTTGAAAAAAATTCTAGTTGGTTTAA,10,30,14,27,27,46,27,55,27,36,36,46,45,55,55.16,8.071658521
hek293t,10065,1,8,CATTGTAAGCCTCTGGCTGAGCTGGCTACAGGAATTTTGACCTCATAAATGGGAAAGGTCTTCCCCCAAACACGCCAGGTCAAAAAAATTCTAGTTGGT,CATTGTAAGCCTCTGGCTGAGCTGGCCCCGGCTGTACAGGAATTTTGACCTCATAAATGGGAAAGGTCTTCCCCCAAACACGCCAGGTCAAAAAAATTC,10,30,14,27,27,34,27,42,27,27,27,34,35,42,43.31,2.724164542
hek293t,10065,1,8,CTTCTTAAGCCTCTGGCTGAGCTGGCTACAGGAATTTTGACCTCATAAATGGGAAAGGTCTTCCCCCAAACACGCCAGGTCATGCAAAAAAATTCTAGT,CTTCTTAAGCCTCTGGCTGAGCTGGCCCCGGCTGTACAGGAATTTTGACCTCATAAATGGGAAAGGTCTTCCCCCAAACACGCCAGGTCATGCAAAAAA,10,30,14,27,27,30,27,38,27,27,27,30,35,38,43.31,0.0
hek293t,10067,1,9,CATTGAAGTAAGTGAATATGTGAATTATCTGGGGAGAACAGGGAAAGGAAGGAACAAATGTGATGGACAATGAAAAAAAATTCTAGTTGGTTTAACGCG,CATTGAAGTAAGTGAATATGTGAATTATCTAACAGCGTTGGGGAGAACAGGGAAAGGAAGGAACAAATGTGATGGACAATGAAAAAAAATTCTAGTTGG,10,30,14,27,27,41,27,50,27,31,31,41,40,50,5.67,6.952807768
hek293t,10067,1,9,GTAGAAAGTAAGTGAATATGTGAATTATCTGGGGAGAACAGGGAAAGGAAGGAACAAATGTGATGGACAATGAGTAAAAAAAATTCTAGTTGGTTTAAC,GTAGAAAGTAAGTGAATATGTGAATTATCTAACAGCGTTGGGGAGAACAGGGAAAGGAAGGAACAAATGTGATGGACAATGAGTAAAAAAAATTCTAGT,10,30,14,27,27,38,27,47,27,31,31,38,40,47,5.67,3.913299102
hek293t,10069,1,10,GTAGCTGCATTGCATTCGTACTGTTATACTGGAATAACACATTCAATACTGCATGAAAACTCTACTTAAAAAAATTCTAGTTGGTTTAACGCGTAACTA,GTAGCTGCATTGCATTCGTACTGTTATACTGGAATAACAAAGCCCCAGACATTCAATACTGCATGAAAACTCTACTTAAAAAAATTCTAGTTGGTTTAA,10,30,14,27,27,46,27,56,27,39,39,46,49,56,13.2,0.0
hek293t,10069,1,10,ATTAGTGCATTGCATTCGTACTGTTATACTGGAATAACACATTCAATACTGCATGAAAACTCTAAAAAAAATTCTAGTTGGTTTAACGCGTAACTAGAT,ATTAGTGCATTGCATTCGTACTGTTATACTGGAATAACAAAGCCCCAGACATTCAATACTGCATGAAAACTCTAAAAAAAATTCTAGTTGGTTTAACGC,10,30,14,27,27,49,27,59,27,39,39,49,49,59,13.2,0.694444444
hek293t,10071,1,9,GTTAGAAGCAGTCTGATACAGAAACATCAAGGATTAGAAATAAGGATTAGAACTAAAACAACTGTAGAAAAAAATTCTAGTTGGTTTAACGCGTAACTA,GTTAGAAGCAGTCTGATACAGAAACATCAAGTAGCGGTGAGATTAGAAATAAGGATTAGAACTAAAACAACTGTAGAAAAAAATTCTAGTTGGTTTAAC,10,30,14,27,27,47,27,56,27,32,32,47,41,56,60.83,0.418123084
hek293t,10075,1,8,GCGGGGCTGCTCAAGGAACACCAATTCTGAGGCTCCAGTATGCTGCCACTGTGATGCCAATATTCTCCAGATTAAAAAAATTCTAGTTGGTTTAACGCG,GCGGGGCTGCTCAAGGAACACCAATTCGCGTGATCTGAGGCTCCAGTATGCTGCCACTGTGATGCCAATATTCTCCAGATTAAAAAAATTCTAGTTGGT,10,30,14,27,27,42,27,50,27,27,27,42,35,50,45.76,39.10298364
hek293t,10075,1,8,TAGTGGCTGCTCAAGGAACACCAATTCTGAGGCTCCAGTATGCTGCCACTGTGATGCCAATATTCTCCAGATTGGCTTTCCAAAAAAATTCTAGTTGGT,TAGTGGCTGCTCAAGGAACACCAATTCGCGTGATCTGAGGCTCCAGTATGCTGCCACTGTGATGCCAATATTCTCCAGATTGGCTTTCCAAAAAAATTC,10,30,14,27,27,34,27,42,27,27,27,34,35,42,45.76,9.481226965
hek293t,10077,1,12,TTTGAGAAAAGCTGGTGAAAGAGGATTTCAGGTAAGACCAAAGCAAACAACTTACTGTTTATTTACTTCTAAAAAAATTCTAGTTGGTTTAACGCGTAA,TTTGAGAAAAGCTGGTGAAAGAGGATTTCAACTTTTCACCGTGGTAAGACCAAAGCAAACAACTTACTGTTTATTTACTTCTAAAAAAATTCTAGTTGG,10,30,14,27,27,41,27,53,27,31,31,41,43,53,10.21,7.075099411
hek293t,10077,1,12,GCAACGAAAAGCTGGTGAAAGAGGATTTCAGGTAAGACCAAAGCAAACAACTTACTGTTTATTTACTTCTTTCATCTAAAAAAATTCTAGTTGGTTTAA,GCAACGAAAAGCTGGTGAAAGAGGATTTCAACTTTTCACCGTGGTAAGACCAAAGCAAACAACTTACTGTTTATTTACTTCTTTCATCTAAAAAAATTC,10,30,14,27,27,34,27,46,27,31,31,34,43,46,10.21,0.336623993
hek293t,10079,1,9,GCACCAACAATGAACTTCAGGGAAAACTGAGGAATGTGTCCCGCTATATAATGGAACGTTTGTATTTGATTCTGAAAAAAATTCTAGTTGGTTTAACGC,GCACCAACAATGAACTTCAGGGAAAACTGAGGGAGAGACCTAATGTGTCCCGCTATATAATGGAACGTTTGTATTTGATTCTGAAAAAAATTCTAGTTG,10,30,14,27,27,40,27,49,27,33,33,40,42,49,71.76,0.661000367
hek293t,10079,1,9,ACAAAAACAATGAACTTCAGGGAAAACTGAGGAATGTGTCCCGCTATATAATGGAACGTTTGTATTTGATTAAAAAAATTCTAGTTGGTTTAACGCGTA,ACAAAAACAATGAACTTCAGGGAAAACTGAGGGAGAGACCTAATGTGTCCCGCTATATAATGGAACGTTTGTATTTGATTAAAAAAATTCTAGTTGGTT,10,30,14,27,27,43,27,52,27,33,33,43,42,52,71.76,10.227614
hek293t,10081,1,4,ATGTCTACATCTCGTATCTGGAAAATGCCTGGACTGTTCTCCCTATGGAAGTACTTCAAGGTAAGACAGTTCATTACGGAAAAAAATTCTAGTTGGTTT,ATGTCTACATCTCGTATCTGGAAAATGCCTGGACTGAACTTTCTCCCTATGGAAGTACTTCAAGGTAAGACAGTTCATTACGGAAAAAAATTCTAGTTG,10,30,14,27,27,40,27,44,27,37,37,40,41,44,40.04,0.0
hek293t,10084,1,13,TTCGCCAAGTTTGTAGCTCAAAGCAAAGGTGGCAAAAAGACTCAAAACCTGTCATTCTCATAGCTTAAAAAAATTCTAGTTGGTTTAACGCGTAACTAG,TTCGCCAAGTTTGTAGCTCAAAGCAAAGGTGGCAAATGCGAACTCGCCTAAGACTCAAAACCTGTCATTCTCATAGCTTAAAAAAATTCTAGTTGGTTT,10,30,14,27,27,44,27,57,27,37,37,44,50,57,58.01,0.243309002
hek293t,10085,1,9,TTTTATTAAGGGTCCTTTTTCAAAGAACCAGGGTTTCAGATGAACAGAGGGAGACTGCTAGATGTTTTGGCACTTCTGAAAAAAATTCTAGTTGGTTTA,TTTTATTAAGGGTCCTTTTTCAAAGAACGAGGTTCAGCAGGGTTTCAGATGAACAGAGGGAGACTGCTAGATGTTTTGGCACTTCTGAAAAAAATTCTA,10,30,14,27,27,36,27,45,27,29,29,36,38,45,29.45,0.507450677
hek293t,10087,1,11,AAGGGTTTCCCAGAGTTATTCCAATGTCCTGGCTGCACACAAGGGCATGGAGAGTAATGAGGCGAGGTTTTGTCAGAAAAAAATTCTAGTTGGTTTAAC,AAGGGTTTCCCAGAGTTATTCCAATGTCCTGGAGATACTGCACCTGCACACAAGGGCATGGAGAGTAATGAGGCGAGGTTTTGTCAGAAAAAAATTCTA,10,30,14,27,27,36,27,47,27,33,33,36,44,47,54.81,0.376222724
hek293t,10087,1,11,GCCAATTTCCCAGAGTTATTCCAATGTCCTGGCTGCACACAAGGGCATGGAGAGTAATGAGGCGAAAAAAATTCTAGTTGGTTTAACGCGTAACTAGAT,GCCAATTTCCCAGAGTTATTCCAATGTCCTGGAGATACTGCACCTGCACACAAGGGCATGGAGAGTAATGAGGCGAAAAAAATTCTAGTTGGTTTAACG,10,30,14,27,27,48,27,59,27,33,33,48,44,59,54.81,3.428954829
hek293t,10089,1,13,GCGACGGTTTACGCTGGTATTTTGTAGGCAGGTAGGAACGAACTGCCTGAGTTCTGCTGCAGCCTAAAAAAAAATTCTAGTTGGTTTAACGCGTAACTA,GCGACGGTTTACGCTGGTATTTTGTAGGCAGGTAGGGAGTCCTCGAGTGAACGAACTGCCTGAGTTCTGCTGCAGCCTAAAAAAAAATTCTAGTTGGTT,10,30,14,27,27,43,27,56,27,36,36,43,49,56,31.05,0.0
hek293t,10092,1,9,TTCTAGCCTTTCTACAAAGATGGGCCAGATGGTCCCATAGAAATTGGAAAATGAAGGAAGCATTAATGAATCAAAAAAATTCTAGTTGGTTTAACGCGT,TTCTAGCCTTTCTACAAAGATGGGCCAGATGGTCGGAGTGTAGCCATAGAAATTGGAAAATGAAGGAAGCATTAATGAATCAAAAAAATTCTAGTTGGT,10,30,14,27,27,42,27,51,27,35,35,42,44,51,28.66,2.161977213
hek293t,10092,1,9,GGGCCGCCTTTCTACAAAGATGGGCCAGATGGTCCCATAGAAATTGGAAAATGAAGGAAGCATTAATGAATCATCCAAAAAAATTCTAGTTGGTTTAAC,GGGCCGCCTTTCTACAAAGATGGGCCAGATGGTCGGAGTGTAGCCATAGAAATTGGAAAATGAAGGAAGCATTAATGAATCATCCAAAAAAATTCTAGT,10,30,14,27,27,38,27,47,27,35,35,38,44,47,28.66,0.0
hek293t,10094,1,13,TCCGCTCAGTGTTGACCAAAACCCAACTGGGGATGATCCTGAACAAACACATCTTTGGCTTTTCCTTTTAAAAAAATTCTAGTTGGTTTAACGCGTAAC,TCCGCTCAGTGTTGACCAAAACCCAACTGGGGATGATTAAACCAAGGCCACCTGAACAAACACATCTTTGGCTTTTCCTTTTAAAAAAATTCTAGTTGG,10,30,14,27,27,41,27,54,27,38,38,41,51,54,66.81,0.0
hek293t,10096,1,3,TGGGGCGCAACATAACAGCAAATTAGAAATGGCATTCTAACTTGCGACACTTATAAAAGGCCAAGTTTTCTAAGAAGTTACTATAAAAATAAAAAAATT,TGGGGCGCAACATAACAGCAAATTAGGCTAAATGGCATTCTAACTTGCGACACTTATAAAAGGCCAAGTTTTCTAAGAAGTTACTATAAAAATAAAAAA,10,30,14,27,27,30,27,33,27,27,27,30,30,33,21.69,0.0
hek293t,10098,1,2,TTTTGCATGTTGCAAGTTGAACAGCACTTTGGCCTCTTGCTGGCATGTTCAGAGACTGCCATAATGTGGCTAATGAGAAAAAAATTCTAGTTGGTTTAA,TTTTGCATGTTGCAAGTTGAACAGCACTTTGGCCTCTTGCTCTGGCATGTTCAGAGACTGCCATAATGTGGCTAATGAGAAAAAAATTCTAGTTGGTTT,10,30,14,27,27,44,27,46,27,41,41,44,43,46,42.41,0.26916172
hek293t,10098,1,2,TTCAGCATGTTGCAAGTTGAACAGCACTTTGGCCTCTTGCTGGCATGTTCAGAGACTGCCATAATAAAAAAATTCTAGTTGGTTTAACGCGTAACTAGA,TTCAGCATGTTGCAAGTTGAACAGCACTTTGGCCTCTTGCTCTGGCATGTTCAGAGACTGCCATAATAAAAAAATTCTAGTTGGTTTAACGCGTAACTA,10,30,14,27,27,56,27,58,27,41,41,56,43,58,42.41,65.63540529
hek293t,10100,1,3,AATGTTTCTTAAAACAAGTGTTTTAACAAAGGTTAAGGAATAACACTGCAACACAGCATTATTGTATGTTGGCAGGGATATTAAAAAAAATTCTAGTTG,AATGTTTCTTAAAACAAGTGTTTTAACAAAGGTATGTAAGGAATAACACTGCAACACAGCATTATTGTATGTTGGCAGGGATATTAAAAAAAATTCTAG,10,30,14,27,27,37,27,40,27,34,34,37,37,40,14.87,0.0
hek293t,10100,1,3,CCAATTTCTTAAAACAAGTGTTTTAACAAAGGTTAAGGAATAACACTGCAACACAGCATTATTGTATGTTGGCAGGGATAAAAAAATTCTAGTTGGTTT,CCAATTTCTTAAAACAAGTGTTTTAACAAAGGTATGTAAGGAATAACACTGCAACACAGCATTATTGTATGTTGGCAGGGATAAAAAAATTCTAGTTGG,10,30,14,27,27,41,27,44,27,34,34,41,37,44,14.87,2.208342134
hek293t,10102,1,2,TAACCGGCTGGGAACAAGAGGCAGTTAAATGGGAAGCTTTTTCTTTTCTTTCTGTTCCTTCGGTATCACTGGCCAAGTGAGGCAAAAAAATTCTAGTTG,TAACCGGCTGGGAACAAGAGGCAGTTAAATCAGGGAAGCTTTTTCTTTTCTTTCTGTTCCTTCGGTATCACTGGCCAAGTGAGGCAAAAAAATTCTAGT,10,30,14,27,27,38,27,40,27,31,31,38,33,40,16.12,49.99496721
hek293t,10102,1,2,CAGTGGGCTGGGAACAAGAGGCAGTTAAATGGGAAGCTTTTTCTTTTCTTTCTGTTCCTTCGGTATCACTGGCCAAGTGAAAAAAAATTCTAGTTGGTT,CAGTGGGCTGGGAACAAGAGGCAGTTAAATCAGGGAAGCTTTTTCTTTTCTTTCTGTTCCTTCGGTATCACTGGCCAAGTGAAAAAAAATTCTAGTTGG,10,30,14,27,27,41,27,43,27,31,31,41,33,43,16.12,72.94690523
hek293t,10105,1,1,AGGTAGCGGGTAAATTTAGTTGAGCATGCAGGTGCAGCTCCCAGGGTGGGAAGCCAATAGAGGACCCCCTTCCACGCACAAAAAAATTCTAGTTGGTTT,AGGTAGCGGGTAAATTTAGTTGAGCATGCAGGTGCTAGCTCCCAGGGTGGGAAGCCAATAGAGGACCCCCTTCCACGCACAAAAAAATTCTAGTTGGTT,10,30,14,27,27,43,27,44,27,36,36,43,37,44,30.84,68.37739099
hek293t,10105,1,1,TTGATGCGGGTAAATTTAGTTGAGCATGCAGGTGCAGCTCCCAGGGTGGGAAGCCAATAGAGGACCCCCTTCCACGCACACATAAAAAAATTCTAGTTG,TTGATGCGGGTAAATTTAGTTGAGCATGCAGGTGCTAGCTCCCAGGGTGGGAAGCCAATAGAGGACCCCCTTCCACGCACACATAAAAAAATTCTAGTT,10,30,14,27,27,39,27,40,27,36,36,39,37,40,30.84,2.600050595
hek293t,10107,1,4,GATCAAACTATGGGGCAAATAACACGGGCAGGGGAAGGAATTAAAGGTGATGAGACACACTTTATGCTTGAGCAGATACTGTAAAAAAATTCTAGTTGG,GATCAAACTATGGGGCAAATAACACGAACAGGCAGGGGAAGGAATTAAAGGTGATGAGACACACTTTATGCTTGAGCAGATACTGTAAAAAAATTCTAG,10,30,14,27,27,37,27,41,27,27,27,37,31,41,44.96,81.30784797
hek293t,10107,1,4,CCATTAACTATGGGGCAAATAACACGGGCAGGGGAAGGAATTAAAGGTGATGAGACACACTTTATGCTTGAGCAGATAAAAAAATTCTAGTTGGTTTAA,CCATTAACTATGGGGCAAATAACACGAACAGGCAGGGGAAGGAATTAAAGGTGATGAGACACACTTTATGCTTGAGCAGATAAAAAAATTCTAGTTGGT,10,30,14,27,27,42,27,46,27,27,27,42,31,46,44.96,75.08046595
hek293t,10109,1,5,GATGTGCCTACTAAATCTTGCATTGTAAAAGGCAGCTTTGTAGGCCTTTAAAAACACACACCAACCTGATCCTGAAAAAAATTCTAGTTGGTTTAACGC,GATGTGCCTACTAAATCTTGCATTGTAAAAGGCGGAACAGCTTTGTAGGCCTTTAAAAACACACACCAACCTGATCCTGAAAAAAATTCTAGTTGGTTT,10,30,14,27,27,44,27,49,27,34,34,44,39,49,14.01,45.57431976
hek293t,10111,1,15,TTAACCATGTATAGCTATTCATGAGCTACAGGGGTGCTTTGCTCTGGCTCCTAAGGGCAAGCAATAAAAAAATTCTAGTTGGTTTAACGCGTAACTAGA,TTAACCATGTATAGCTATTCATGAGCTACAGGGGTGCTTAGTATTACATGCCATTGCTCTGGCTCCTAAGGGCAAGCAATAAAAAAATTCTAGTTGGTT,10,30,14,27,27,43,27,58,27,40,40,43,55,58,30.18,0.0
hek293t,10112,1,5,CAGCGTGAAAGGGAATGATTTTAATGTCTAGGGCTAAGGAAGGAGGGGCAGAAGGGAAAATATTTGGGAGAAAAAAATTCTAGTTGGTTTAACGCGTAA,CAGCGTGAAAGGGAATGATTTTAATGTCTAGGGCTAAGGACTCTGAGGAGGGGCAGAAGGGAAAATATTTGGGAGAAAAAAATTCTAGTTGGTTTAACG,10,30,14,27,27,48,27,53,27,41,41,48,46,53,20.5,1.367953367
hek293t,10114,1,5,CTTTGCACAGAAAGTAATTACCTAGCAGTAGGAGATGCTCATGGGGAGAAGAGAAAGAGAAACAGCAAAAAAAATTCTAGTTGGTTTAACGCGTAACTA,CTTTGCACAGAAAGTAATTACCTAGCAGTAGGAGATGCTCATGTCATGGGGAGAAGAGAAAGAGAAACAGCAAAAAAAATTCTAGTTGGTTTAACGCGT,10,30,14,27,27,51,27,56,27,41,41,51,46,56,54.18,71.91755238
hek293t,10116,1,1,TTGACTTTTGATATGAACACACAACTGTGAGGTAGGAGAGAACTTTGGGTTTGAATGACAATGATGAATAATGTTAATACAAAAAAATTCTAGTTGGTT,TTGACTTTTGATATGAACACACAACTGTGAGGTAGGAGAAGAACTTTGGGTTTGAATGACAATGATGAATAATGTTAATACAAAAAAATTCTAGTTGGT,10,30,14,27,27,42,27,43,27,39,39,42,40,43,76.37,4.02999432
hek293t,10116,1,1,CTACCTTTTGATATGAACACACAACTGTGAGGTAGGAGAGAACTTTGGGTTTGAATGACAATGATGAAAAAAAAATTCTAGTTGGTTTAACGCGTAACT,CTACCTTTTGATATGAACACACAACTGTGAGGTAGGAGAAGAACTTTGGGTTTGAATGACAATGATGAAAAAAAAATTCTAGTTGGTTTAACGCGTAAC,10,30,14,27,27,54,27,55,27,39,39,54,40,55,76.37,53.10461428
hek293t,10118,1,4,GAAAGAGCATGCCCAGAGGCCCACAGCTCAGGGGGCCTTGGGTGGGAGACCCAGGCTCACCACTCAGACAGAAAAAAATTCTAGTTGGTTTAACGCGTA,GAAAGAGCATGCCCAGAGGCCCACAGCTCAGGGGGCCTTGAGAGGGTGGGAGACCCAGGCTCACCACTCAGACAGAAAAAAATTCTAGTTGGTTTAACG,10,30,14,27,27,48,27,52,27,41,41,48,45,52,47.43,9.333569656
hek293t,10120,1,10,TGGTGATGCTCTTCCCTTTCACTGCTGGCAGGGCAAGTACAGCCCAGGTGTCCCCATTTGAATGTTCAAAAAAATTCTAGTTGGTTTAACGCGTAACTA,TGGTGATGCTCTTCCCTTTCACTGCTGGCAGGGCAAGTTGACCAATGAACAGCCCAGGTGTCCCCATTTGAATGTTCAAAAAAATTCTAGTTGGTTTAA,10,30,14,27,27,46,27,56,27,39,39,46,49,56,55.07,2.718723596
hek293t,10121,1,5,GACAAGCTTTCCCTAAGGCCTGTGCTTTCTGGAGGACAGTCAGAATGAAGCGTTCAACTGTTCATCTCACTACTGAACTTAAAAAAAATTCTAGTTGGT,GACAAGCTTTCCCTAAGGCCTGTGCTTATGCTTCTGGAGGACAGTCAGAATGAAGCGTTCAACTGTTCATCTCACTACTGAACTTAAAAAAAATTCTAG,10,30,14,27,27,37,27,42,27,27,27,37,32,42,7.35,73.32105024
hek293t,10123,1,14,TGGGGATGCTCTGCAGCACAGCTCAGGCCAGGGGCCTCTAACTAGCTCCAGATTCAGCATGAAGCCATTATTGTCCAAAAAAATTCTAGTTGGTTTAAC,TGGGGATGCTCTGCAGCACAGCTCAGGCCTGAGTCGATTTTCTAGGGGCCTCTAACTAGCTCCAGATTCAGCATGAAGCCATTATTGTCCAAAAAAATT,10,30,14,27,27,33,27,47,27,30,30,33,44,47,52.59,0.0
hek293t,10125,1,10,ACGGCGACCACTAAACCATGAGGGAACACAGGTGCTTATTTTTGTAATAATGCTGAGGAAGAGAGAAAAAAATTCTAGTTGGTTTAACGCGTAACTAGA,ACGGCGACCACTAAACCATGAGGGAACACAGGTTTACTGGTCTGCTTATTTTTGTAATAATGCTGAGGAAGAGAGAAAAAAATTCTAGTTGGTTTAACG,10,30,14,27,27,48,27,58,27,33,33,48,43,58,73.25,0.872457259
hek293t,10125,1,10,AGAGAGACCACTAAACCATGAGGGAACACAGGTGCTTATTTTTGTAATAATGCTGAGGAAGAGAGAGCAATCCTTTCAAAAAAATTCTAGTTGGTTTAA,AGAGAGACCACTAAACCATGAGGGAACACAGGTTTACTGGTCTGCTTATTTTTGTAATAATGCTGAGGAAGAGAGAGCAATCCTTTCAAAAAAATTCTA,10,30,14,27,27,36,27,46,27,33,33,36,43,46,73.25,0.260416667
hek293t,10129,1,7,AAACGAGCTCAGGAGAACTCAGTACCATACGGAAATGAAATTTGTTCATTTTCATCTTCATCCTCAAAAAAAATTCTAGTTGGTTTAACGCGTAACTAG,AAACGAGCTCAGGAGAACTCAGTACCATACGGAAACGGATGATGAAATTTGTTCATTTTCATCTTCATCCTCAAAAAAAATTCTAGTTGGTTTAACGCG,10,30,14,27,27,50,27,57,27,35,35,50,42,57,44.01,20.24158231
hek293t,10129,1,7,AAGCCAGCTCAGGAGAACTCAGTACCATACGGAAATGAAATTTGTTCATTTTCATCTTCATCCTCATCATCAAAAAAATTCTAGTTGGTTTAACGCGTA,AAGCCAGCTCAGGAGAACTCAGTACCATACGGAAACGGATGATGAAATTTGTTCATTTTCATCTTCATCCTCATCATCAAAAAAATTCTAGTTGGTTTA,10,30,14,27,27,45,27,52,27,35,35,45,42,52,44.01,6.677460709
hek293t,10134,1,11,GAAAAAACGGAGGATTTTATAATTTGTGCAGGGGCTATGCAGCTATATTCCCGCACAAATGTTATTGCTGAGTTTGTAAAAAAATTCTAGTTGGTTTAA,GAAAAAACGGAGGATTTTATAATTTGTATTCGCCAGTTGCAGGGGCTATGCAGCTATATTCCCGCACAAATGTTATTGCTGAGTTTGTAAAAAAATTCT,10,30,14,27,27,35,27,46,27,28,28,35,39,46,21.52,0.746439758
hek293t,10134,1,11,GTCCAAACGGAGGATTTTATAATTTGTGCAGGGGCTATGCAGCTATATTCCCGCACAAATGTTATTGCTGAGTTTGTCCACAAAAAAATTCTAGTTGGT,GTCCAAACGGAGGATTTTATAATTTGTATTCGCCAGTTGCAGGGGCTATGCAGCTATATTCCCGCACAAATGTTATTGCTGAGTTTGTCCACAAAAAAA,10,30,14,27,27,31,27,42,27,28,28,31,39,42,21.52,2.310093126
hek293t,10136,1,14,GATGACTTAGGTTGCAGGGGGGAAAAATTTGGTTTGAAGGTTCTCAGCATCCATTCTAGCCAAAGCAAAAAAAAAAAATTCTAGTTGGTTTAACGCGTA,GATGACTTAGGTTGCAGGGGGGAAAAATTTGGTTATGGCGCTCAGCTATGAAGGTTCTCAGCATCCATTCTAGCCAAAGCAAAAAAAAAAAATTCTAGT,10,30,14,27,27,38,27,52,27,35,35,38,49,52,9.3,0.0
hek293t,10137,1,15,TAGCTTTAAAGGATTGCAGGAATAACATGAGGTTTTTTAGAATCTATGTACCAATTCAGGACTTTGAAAAGCCAAAAAAAAAATTCTAGTTGGTTTAAC,TAGCTTTAAAGGATTGCAGGAATAACATACGCCGTGTGCCCTGGAGGTTTTTTAGAATCTATGTACCAATTCAGGACTTTGAAAAGCCAAAAAAAAAAT,10,30,14,27,27,32,27,47,27,29,29,32,44,47,61.61,0.0
hek293t,10139,1,8,TTTGACAAAAACAGCATTCAAGTAATTGATGGATTTTGTCAAAGCGACTAGAATCAGTGCCTGCTAAAAAAATTCTAGTTGGTTTAACGCGTAACTAGA,TTTGACAAAAACAGCATTCAAGTAATTGATGGATACTGGAGCTTTGTCAAAGCGACTAGAATCAGTGCCTGCTAAAAAAATTCTAGTTGGTTTAACGCG,10,30,14,27,27,50,27,58,27,35,35,50,43,58,24.31,31.52702151
hek293t,10144,1,5,GGTGTGCATGAGCACATTCTCCCCACTCCTGGGGTTTGGCTGCCTAAGCTCAGGGCAAACTTAGGGACAGCACAGCAAAAAAATTCTAGTTGGTTTAAC,GGTGTGCATGAGCACATTCTCCCCACTCCTGGGGAGAATTTTGGCTGCCTAAGCTCAGGGCAAACTTAGGGACAGCACAGCAAAAAAATTCTAGTTGGT,10,30,14,27,27,42,27,47,27,35,35,42,40,47,46.62,24.63224789
hek293t,10144,1,5,GTTGAGCATGAGCACATTCTCCCCACTCCTGGGGTTTGGCTGCCTAAGCTCAGGGCAAACTTAGGGACAGCACAGCTGGTAAAAAAATTCTAGTTGGTT,GTTGAGCATGAGCACATTCTCCCCACTCCTGGGGAGAATTTTGGCTGCCTAAGCTCAGGGCAAACTTAGGGACAGCACAGCTGGTAAAAAAATTCTAGT,10,30,14,27,27,38,27,43,27,35,35,38,40,43,46.62,0.0
hek293t,10146,1,11,GACACATACACAAAGAGGAATTGGCTCTTTGGTCTCCTCAGCATTAATGTTATTACCAAAATGTGAAACAAATAATAAAAAAATTCTAGTTGGTTTAAC,GACACATACACAAAGAGGAATTGGCTCTTTGGCATTGTCTCTTTCTCCTCAGCATTAATGTTATTACCAAAATGTGAAACAAATAATAAAAAAATTCTA,10,30,14,27,27,36,27,47,27,33,33,36,44,47,24.52,0.252945135
hek293t,10146,1,11,CGGCGATACACAAAGAGGAATTGGCTCTTTGGTCTCCTCAGCATTAATGTTATTACCAAAATGTGAAACAAAAAAAAAATTCTAGTTGGTTTAACGCGT,CGGCGATACACAAAGAGGAATTGGCTCTTTGGCATTGTCTCTTTCTCCTCAGCATTAATGTTATTACCAAAATGTGAAACAAAAAAAAAATTCTAGTTG,10,30,14,27,27,40,27,51,27,33,33,40,44,51,24.52,0.424085303
hek293t,10148,1,1,AAGTACCATTGCACAGCTTCAGATGATGGTGGATCTCAGATTTTCGTAAGAAGCCCTTCCAGAACTGACGATGACAGCAGTTTTGAAAAAAATTCTAGT,AAGTACCATTGCACAGCTTCAGATGATGGTGGATTCTCAGATTTTCGTAAGAAGCCCTTCCAGAACTGACGATGACAGCAGTTTTGAAAAAAATTCTAG,10,30,14,27,27,37,27,38,27,34,34,37,35,38,65.09,1.449767339
hek293t,10148,1,1,GCACCCCATTGCACAGCTTCAGATGATGGTGGATCTCAGATTTTCGTAAGAAGCCCTTCCAGAACTGACGATGACAGCAAAAAAATTCTAGTTGGTTTA,GCACCCCATTGCACAGCTTCAGATGATGGTGGATTCTCAGATTTTCGTAAGAAGCCCTTCCAGAACTGACGATGACAGCAAAAAAATTCTAGTTGGTTT,10,30,14,27,27,44,27,45,27,34,34,44,35,45,65.09,75.81096325
hek293t,10150,1,15,CCAGTTCTGGCCATTGGGGACAAAGGCATTGGGAGCTTTTCTTCCGTTGTCTTGGAACAACGGAGATGTGTTAAAAAAATTCTAGTTGGTTTAACGCGT,CCAGTTCTGGCCATTGGGGACAAAGGCATAATACTGTATAAGATTGGGAGCTTTTCTTCCGTTGTCTTGGAACAACGGAGATGTGTTAAAAAAATTCTA,10,30,14,27,27,36,27,51,27,29,29,36,44,51,39.39,0.319403083
hek293t,10150,1,15,GTCATTCTGGCCATTGGGGACAAAGGCATTGGGAGCTTTTCTTCCGTTGTCTTGGAACAACGGAGATGTGTTAGTTAAAAAAATTCTAGTTGGTTTAAC,GTCATTCTGGCCATTGGGGACAAAGGCATAATACTGTATAAGATTGGGAGCTTTTCTTCCGTTGTCTTGGAACAACGGAGATGTGTTAGTTAAAAAAAT,10,30,14,27,27,32,27,47,27,29,29,32,44,47,39.39,0.807900365
hek293t,10152,1,14,CAGGTTAAACGAAAGAATAGGGTAGACTGGGGATGAAAAAGAAAAACGAGCACTGAAAATGCCTTTCAAAAAAATTCTAGTTGGTTTAACGCGTAACTA,CAGGTTAAACGAAAGAATAGGGTAGAAATCTGGTCTCGGTCTGGGGATGAAAAAGAAAAACGAGCACTGAAAATGCCTTTCAAAAAAATTCTAGTTGGT,10,30,14,27,27,42,27,56,27,27,27,42,41,56,63.77,0.256932699
hek293t,10152,1,14,AAGAATAAACGAAAGAATAGGGTAGACTGGGGATGAAAAAGAAAAACGAGCACTGAAAATGCCTTTCTCTATTTTGAATAAAAAAATTCTAGTTGGTTT,AAGAATAAACGAAAGAATAGGGTAGAAATCTGGTCTCGGTCTGGGGATGAAAAAGAAAAACGAGCACTGAAAATGCCTTTCTCTATTTTGAATAAAAAA,10,30,14,27,27,30,27,44,27,27,27,30,41,44,63.77,0.0
hek293t,10154,1,4,CATGTATAATTGCTTTTGCAGGATAAGGAAGGACAGGAGGAAATATTCCTGCAATTGTGGCTTTATATCTTGAAAAAAAATTCTAGTTGGTTTAACGCG,CATGTATAATTGCTTTTGCAGGATAAGGAAGGACAGGAAGACGGAAATATTCCTGCAATTGTGGCTTTATATCTTGAAAAAAAATTCTAGTTGGTTTAA,10,30,14,27,27,46,27,50,27,39,39,46,43,50,36.18,1.256325278
hek293t,10154,1,4,AAGGGATAATTGCTTTTGCAGGATAAGGAAGGACAGGAGGAAATATTCCTGCAATTGTGGCTTTAAAAAAAATTCTAGTTGGTTTAACGCGTAACTAGA,AAGGGATAATTGCTTTTGCAGGATAAGGAAGGACAGGAAGACGGAAATATTCCTGCAATTGTGGCTTTAAAAAAAATTCTAGTTGGTTTAACGCGTAAC,10,30,14,27,27,54,27,58,27,39,39,54,43,58,36.18,19.5376192
hek293t,10156,1,9,AGCTCCGTTTGGAAATCAGTAAGAAAACTTGGTTAAGGCAAGTATGTGATTGTTTTACCACAAGTTTAGAAGTAAGCAAAAAAATTCTAGTTGGTTTAA,AGCTCCGTTTGGAAATCAGTAAGAAAACTAGACGAACATGGTTAAGGCAAGTATGTGATTGTTTTACCACAAGTTTAGAAGTAAGCAAAAAAATTCTAG,10,30,14,27,27,37,27,46,27,30,30,37,39,46,28.54,0.0
hek293t,10157,1,8,GCCCATGATCCAGCTTTATTAATATTCTGGGGTTCTGTAAAGCTCTTCTTTCTTCCTTGCTTTCCTCTTACAAAAAAATTCTAGTTGGTTTAACGCGTA,GCCCATGATCCAGCTTTATTAATATTCTGGGGTTCTGTAAGAAGAAATAGCTCTTCTTTCTTCCTTGCTTTCCTCTTACAAAAAAATTCTAGTTGGTTT,10,30,14,27,27,44,27,52,27,41,41,44,49,52,19.37,0.0
hek293t,10158,1,6,ACTTACCTGTCCATTTTGGTGGATGAGCCTGGTGTCTCAGATGTCACTCAATGGAAAATTGTTAGATGAGATAAAAAAATTCTAGTTGGTTTAACGCGT,ACTTACCTGTCCATTTTGGTGGATGAGCCTGGTGACCGGGTCTCAGATGTCACTCAATGGAAAATTGTTAGATGAGATAAAAAAATTCTAGTTGGTTTA,10,30,14,27,27,45,27,51,27,35,35,45,41,51,11.68,0.675575074
hek293t,10160,1,13,GCTAGAGTCAAGTGTATCAGCCATTCAGCAGGTCAAGCAGTGTAATAACAACCTTGCATTAATCAAAAAAAATTCTAGTTGGTTTAACGCGTAACTAGA,GCTAGAGTCAAGTGTATCAGCCATTCAGCAGGTCAAGCACAGCCGGCCCTCAGTGTAATAACAACCTTGCATTAATCAAAAAAAATTCTAGTTGGTTTA,10,30,14,27,27,45,27,58,27,38,38,45,51,58,41.3,0.559842834
hek293t,10161,1,5,GGGGATCGTACTTAGACTGCAGAAATTTCAGGGCAACTAAAGTTTCAATTTGCTTCATGTTCAAGACTTCATGAAAAAAATTCTAGTTGGTTTAACGCG,GGGGATCGTACTTAGACTGCAGAAATTTCAGGGCCGTAAAACTAAAGTTTCAATTTGCTTCATGTTCAAGACTTCATGAAAAAAATTCTAGTTGGTTTA,10,30,14,27,27,45,27,50,27,35,35,45,40,50,10.56,2.505241566
hek293t,10163,1,1,CCCTCTTCTGAATAATAATGGCCTCTTAAAGGGAGACAGTGGGAATATTTCAAACTGAAACAAGAGCTCTATAATACACAAAAAAATTCTAGTTGGTTT,CCCTCTTCTGAATAATAATGGCCTCTTGAAAGGGAGACAGTGGGAATATTTCAAACTGAAACAAGAGCTCTATAATACACAAAAAAATTCTAGTTGGTT,10,30,14,27,27,43,27,44,27,28,28,43,29,44,13.37,58.75250623
hek293t,10163,1,1,CAAACTTCTGAATAATAATGGCCTCTTAAAGGGAGACAGTGGGAATATTTCAAACTGAAACAAGAGCTCTATAATACACAGTTTCCCAAAAAAATTCTA,CAAACTTCTGAATAATAATGGCCTCTTGAAAGGGAGACAGTGGGAATATTTCAAACTGAAACAAGAGCTCTATAATACACAGTTTCCCAAAAAAATTCT,10,30,14,27,27,35,27,36,27,28,28,35,29,36,13.37,62.93679638
hek293t,10165,1,4,ATATTAAACCTATAACTGTTCAAAGGCAATGGCAGTTTGTCTTCAACTGAAAATATATCTGTCTTAATTTTAAAATTAAAAAAATTCTAGTTGGTTTAA,ATATTAAACCTATAACTGTTCAAAGGCAATGGCATTGAGTTTGTCTTCAACTGAAAATATATCTGTCTTAATTTTAAAATTAAAAAAATTCTAGTTGGT,10,30,14,27,27,42,27,46,27,35,35,42,39,46,40.89,10.9868411
hek293t,10167,1,13,ACCGGCAGAAAACTAGCTACAGCAATTTGGGGGAGGAAATCAAGTTTCAGAGGCAACTGTATTCCCTCTAAAAAAATTCTAGTTGGTTTAACGCGTAAC,ACCGGCAGAAAACTAGCTACAGCAATTTGGGGGGAATCGCAGTCAAAGGAAATCAAGTTTCAGAGGCAACTGTATTCCCTCTAAAAAAATTCTAGTTGG,10,30,14,27,27,41,27,54,27,34,34,41,47,54,44.57,0.0
hek293t,10168,1,7,CTGACATTACAGAACACCAGTTTGTATGAAGGGGTTACAGCAAAGACTCCCCTTCAGAGCAAATCCTCTCACACAAAAAAAATTCTAGTTGGTTTAACG,CTGACATTACAGAACACCAGTTTGTATGAAGGGGTTAACTAAATCAGCAAAGACTCCCCTTCAGAGCAAATCCTCTCACACAAAAAAAATTCTAGTTGG,10,30,14,27,27,41,27,48,27,38,38,41,45,48,39.27,0.097751711
hek293t,10169,1,10,CGCCTTTGGTTTTGAAAACGTAGATGGATTGGAGATGCAGGGAGAAATGCTAGCTCTAAAAGAAAAAAAAATTCTAGTTGGTTTAACGCGTAACTAGAT,CGCCTTTGGTTTTGAAAACGTAGATGGATTGGACTGCGAGTACGATGCAGGGAGAAATGCTAGCTCTAAAAGAAAAAAAAATTCTAGTTGGTTTAACGC,10,30,14,27,27,49,27,59,27,34,34,49,44,59,22.68,0.021436284
hek293t,10169,1,10,GATCGTTGGTTTTGAAAACGTAGATGGATTGGAGATGCAGGGAGAAATGCTAGCTCTAAAAGAAATGGAAAGAGAGAAAAAAATTCTAGTTGGTTTAAC,GATCGTTGGTTTTGAAAACGTAGATGGATTGGACTGCGAGTACGATGCAGGGAGAAATGCTAGCTCTAAAAGAAATGGAAAGAGAGAAAAAAATTCTAG,10,30,14,27,27,37,27,47,27,34,34,37,44,47,22.68,0.028368794
hek293t,10171,1,6,GCAATCTAAGTGATACAAATTCCTTAGCTTGGAAGGCATTACACAAGATTTACAGAGTCAATGGGCTGTGGTAACCAAAAAAAATTCTAGTTGGTTTAA,GCAATCTAAGTGATACAAATTCCTTAGCTTCCCCATGGAAGGCATTACACAAGATTTACAGAGTCAATGGGCTGTGGTAACCAAAAAAAATTCTAGTTG,10,30,14,27,27,40,27,46,27,30,30,40,36,46,51.02,53.91834961
hek293t,10173,1,7,CTCAGGTCTGCCGATGTTACTGAGAGCTGAGGGCATTCAGCAGCTCACAGAAGTGATGAACATCCCTCATGATTAATCAAAAAAATTCTAGTTGGTTTA,CTCAGGTCTGCCGATGTTACTGAGAGCGTACACATGAGGGCATTCAGCAGCTCACAGAAGTGATGAACATCCCTCATGATTAATCAAAAAAATTCTAGT,10,30,14,27,27,38,27,45,27,28,28,38,35,45,64.02,68.67563079
hek293t,10173,1,7,TCCACGTCTGCCGATGTTACTGAGAGCTGAGGGCATTCAGCAGCTCACAGAAGTGATGAACATCCCTCATGATTAATCTCTACACAAAAAAATTCTAGT,TCCACGTCTGCCGATGTTACTGAGAGCGTACACATGAGGGCATTCAGCAGCTCACAGAAGTGATGAACATCCCTCATGATTAATCTCTACACAAAAAAA,10,30,14,27,27,31,27,38,27,28,28,31,35,38,64.02,5.734722704
hek293t,10175,1,12,AAAACTCCGGAATGGATTGAAAGCTGCTGAGGCAAAAGCAGACCTGAAGGGAGGGACCTACCCTGTAAAAAAATTCTAGTTGGTTTAACGCGTAACTAG,AAAACTCCGGAATGGATTGAAAGCTGCTGAGGCAAAAGGGAAGAAAATGGCAGACCTGAAGGGAGGGACCTACCCTGTAAAAAAATTCTAGTTGGTTTA,10,30,14,27,27,45,27,57,27,38,38,45,50,57,54.0,0.0
hek293t,10178,1,9,GAAGGGTCTTCTGGTTAGTGCCACTTGAAAGGAAATAGTCAAAAAGACTTTTGGTGGCCCCCCCCATCCTAAAAAAATTCTAGTTGGTTTAACGCGTAA,GAAGGGTCTTCTGGTTAGTGCCACTTGAAAGGAGTAGGCTGCAATAGTCAAAAAGACTTTTGGTGGCCCCCCCCATCCTAAAAAAATTCTAGTTGGTTT,10,30,14,27,27,44,27,53,27,34,34,44,43,53,30.53,1.517351491
hek293t,10183,1,3,ATCACTATACAAAATGGAAAAAATGATTGGGGTAGCTATAAAGTATGGAGAAAATACCATTTCTGCTCAAATCAATAGGAGATTTTCAAAAAAATTCTA,ATCACTATACAAAATGGAAAAAATGATTGCGCGGGTAGCTATAAAGTATGGAGAAAATACCATTTCTGCTCAAATCAATAGGAGATTTTCAAAAAAATT,10,30,14,27,27,33,27,36,27,30,30,33,33,36,33.7,0.0
hek293t,10183,1,3,AGCCATATACAAAATGGAAAAAATGATTGGGGTAGCTATAAAGTATGGAGAAAATACCATTTCTGCTCAAATCAAAAAAAAATTCTAGTTGGTTTAACG,AGCCATATACAAAATGGAAAAAATGATTGCGCGGGTAGCTATAAAGTATGGAGAAAATACCATTTCTGCTCAAATCAAAAAAAAATTCTAGTTGGTTTA,10,30,14,27,27,45,27,48,27,30,30,45,33,48,33.7,0.0
hek293t,10185,1,5,GAACCCGTCATGGGACAAAATATCCTTTGAGGTATATTGATGATGCTTGGACTTCAGAAGTGCTGAGGTCCAAAAAAAATTCTAGTTGGTTTAACGCGT,GAACCCGTCATGGGACAAAATATCCTTTGAGGTATATTACAACGATGATGCTTGGACTTCAGAAGTGCTGAGGTCCAAAAAAAATTCTAGTTGGTTTAA,10,30,14,27,27,46,27,51,27,39,39,46,44,51,49.29,0.0
hek293t,10185,1,5,GATATCGTCATGGGACAAAATATCCTTTGAGGTATATTGATGATGCTTGGACTTCAGAAGTGCTGAGGTCCAGGTTAAAAAAATTCTAGTTGGTTTAAC,GATATCGTCATGGGACAAAATATCCTTTGAGGTATATTACAACGATGATGCTTGGACTTCAGAAGTGCTGAGGTCCAGGTTAAAAAAATTCTAGTTGGT,10,30,14,27,27,42,27,47,27,39,39,42,44,47,49.29,1.467723861
hek293t,10187,1,12,TTCTACAGGTGCCCAGTTATCGCAGACTATGGAGAGGAAGATGAGGAGGTGAAGGTACTGTGAGCGAGTAGAAAAAAAATTCTAGTTGGTTTAACGCGT,TTCTACAGGTGCCCAGTTATCGCAGACTATGGAGAGGAGTTATTCCGGGAAGATGAGGAGGTGAAGGTACTGTGAGCGAGTAGAAAAAAAATTCTAGTT,10,30,14,27,27,39,27,51,27,36,36,39,48,51,49.38,0.0
hek293t,10187,1,12,CTGTTCAGGTGCCCAGTTATCGCAGACTATGGAGAGGAAGATGAGGAGGTGAAGGTACTGTGAGCGAGAAAAAAATTCTAGTTGGTTTAACGCGTAACT,CTGTTCAGGTGCCCAGTTATCGCAGACTATGGAGAGGAGTTATTCCGGGAAGATGAGGAGGTGAAGGTACTGTGAGCGAGAAAAAAATTCTAGTTGGTT,10,30,14,27,27,43,27,55,27,36,36,43,48,55,49.38,0.277483911
hek293t,10189,1,4,AGGAACATTAGGCTCTTTACAAACATTTAAGGAAGGATGCAATTGTAGTAAATGCTGCCAGTTTTTCTAAAAAAATTCTAGTTGGTTTAACGCGTAACT,AGGAACATTAGGCTCTTTACAAACATTTAAGGAAGGATGCTCGTAATTGTAGTAAATGCTGCCAGTTTTTCTAAAAAAATTCTAGTTGGTTTAACGCGT,10,30,14,27,27,51,27,55,27,41,41,51,45,55,4.67,3.109837866
hek293t,10189,1,4,CGCAACATTAGGCTCTTTACAAACATTTAAGGAAGGATGCAATTGTAGTAAATGCTGCCAGTTTTTCTGAATTCTAAAAAAATTCTAGTTGGTTTAACG,CGCAACATTAGGCTCTTTACAAACATTTAAGGAAGGATGCTCGTAATTGTAGTAAATGCTGCCAGTTTTTCTGAATTCTAAAAAAATTCTAGTTGGTTT,10,30,14,27,27,44,27,48,27,41,41,44,45,48,4.67,0.0
hek293t,10191,1,14,CCATCAGAGAATGTTTGACAATTCCCAGTAGGTTACAAACCTGCATCCTTAGAGATGTACGTAGAGGCTAAAAAAATTCTAGTTGGTTTAACGCGTAAC,CCATCAGAGAATGTTTGACAATTCCCAGTAGGACTCATTACAACGATTACAAACCTGCATCCTTAGAGATGTACGTAGAGGCTAAAAAAATTCTAGTTG,10,30,14,27,27,40,27,54,27,33,33,40,47,54,47.28,9.477283289
hek293t,10192,1,12,ATCTCATGCTGCCACACTATAGGAAAACTTGGAATACTGTAGGATTCAACTCCACTGAAAAGCAAAGTGCAAAAAAATTCTAGTTGGTTTAACGCGTAA,ATCTCATGCTGCCACACTATAGGAAAACTTGGAATACATGAGGATGCCATGTAGGATTCAACTCCACTGAAAAGCAAAGTGCAAAAAAATTCTAGTTGG,10,30,14,27,27,41,27,53,27,38,38,41,50,53,43.86,0.047824008
hek293t,10193,1,9,TCTGTTTCCAGTGCCCTCAGGCTTGAAGTCGGGCCTTTTCTTAGCCACTTTCTCTTACAAAGATTGCCAGCAAAAAAATTCTAGTTGGTTTAACGCGTA,TCTGTTTCCAGTGCCCTCAGGCTTGAAGTCGGGCCTTTTATTCGTGGACTTAGCCACTTTCTCTTACAAAGATTGCCAGCAAAAAAATTCTAGTTGGTT,10,30,14,27,27,43,27,52,27,40,40,43,49,52,46.41,0.637284701
hek293t,10196,1,13,GTAACAACTGGGACAAACTCTTTTCGCACTGGGCTCACCGTCAGCGCAAGATTGCAGAGCTGTCAAGGTGCTGGAAAAAAATTCTAGTTGGTTTAACGC,GTAACAACTGGGACAAACTCTTTTCGCAGTCAGCAAGTGATCTGGGCTCACCGTCAGCGCAAGATTGCAGAGCTGTCAAGGTGCTGGAAAAAAATTCTA,10,30,14,27,27,36,27,49,27,29,29,36,42,49,20.45,0.804597701
hek293t,10196,1,13,GCAGAAACTGGGACAAACTCTTTTCGCACTGGGCTCACCGTCAGCGCAAGATTGCAGAGCTGTCAAGGTGCTGGCATCAAAAAAATTCTAGTTGGTTTA,GCAGAAACTGGGACAAACTCTTTTCGCAGTCAGCAAGTGATCTGGGCTCACCGTCAGCGCAAGATTGCAGAGCTGTCAAGGTGCTGGCATCAAAAAAAT,10,30,14,27,27,32,27,45,27,29,29,32,42,45,20.45,0.107874865
hek293t,10198,1,15,ATAGAAATGTTATACTCCTTACATTTGCCTGGATTTAGTGAAGGTTTTGCCCTTAATCAGTATTAAAAAAATTCTAGTTGGTTTAACGCGTAACTAGAT,ATAGAAATGTTATACTCCTTACATTTGCCTGGATTTAGTGTGTTCAGTGTCATTCAAGGTTTTGCCCTTAATCAGTATTAAAAAAATTCTAGTTGGTTT,10,30,14,27,27,44,27,59,27,41,41,44,56,59,38.43,0.0
hek293t,10199,1,3,TCCTATTTGTGAGCTCCCCGCTCTATGCCAGGTATACACCCTTCGTGGGGAGCAGCGGGGGAGAGGCCGTGCGGCAAAAAAAATTCTAGTTGGTTTAAC,TCCTATTTGTGAGCTCCCCGCTCTATGCAACCAGGTATACACCCTTCGTGGGGAGCAGCGGGGGAGAGGCCGTGCGGCAAAAAAAATTCTAGTTGGTTT,10,30,14,27,27,44,27,47,27,29,29,44,32,47,54.31,82.86676181
hek293t,10199,1,3,CGCAATTTGTGAGCTCCCCGCTCTATGCCAGGTATACACCCTTCGTGGGGAGCAGCGGGGGAGAGGCCGTGCGGCAGGGTTGGTAAAAAAATTCTAGTT,CGCAATTTGTGAGCTCCCCGCTCTATGCAACCAGGTATACACCCTTCGTGGGGAGCAGCGGGGGAGAGGCCGTGCGGCAGGGTTGGTAAAAAAATTCTA,10,30,14,27,27,36,27,39,27,29,29,36,32,39,54.31,74.66274147
hek293t,10201,1,4,GGCTCGGATACAATTTTTAGAAGGTTAAATGGATTCAAATACTTAATGTGATGAAGAATCCAGATCATCAAAAAAATTCTAGTTGGTTTAACGCGTAAC,GGCTCGGATACAATTTTTAGAAGGTTAAATGGATCGGCTCAAATACTTAATGTGATGAAGAATCCAGATCATCAAAAAAATTCTAGTTGGTTTAACGCG,10,30,14,27,27,50,27,54,27,35,35,50,39,54,0.4,13.63642584
hek293t,10201,1,4,CGCGTGGATACAATTTTTAGAAGGTTAAATGGATTCAAATACTTAATGTGATGAAGAATCCAGATCATCACTTGAAAAAAATTCTAGTTGGTTTAACGC,CGCGTGGATACAATTTTTAGAAGGTTAAATGGATCGGCTCAAATACTTAATGTGATGAAGAATCCAGATCATCACTTGAAAAAAATTCTAGTTGGTTTA,10,30,14,27,27,45,27,49,27,35,35,45,39,49,0.4,26.48951951
hek293t,10203,1,5,ATGTATCCCTATAGGCACCTGGCACTTTCTGGGAGCAAAGTAGAGGGAAAATGTAATTGCTAAAAGCTCACACAAAAAAAATTCTAGTTGGTTTAACGC,ATGTATCCCTATAGGCACCTGGCACTTTCTGGGAGTAGAGCAAAGTAGAGGGAAAATGTAATTGCTAAAAGCTCACACAAAAAAAATTCTAGTTGGTTT,10,30,14,27,27,44,27,49,27,34,34,44,39,49,8.44,11.33958986
hek293t,10203,1,5,GTGAATCCCTATAGGCACCTGGCACTTTCTGGGAGCAAAGTAGAGGGAAAATGTAATTGCTAAAAGCTCACACACTCAAAAAAATTCTAGTTGGTTTAA,GTGAATCCCTATAGGCACCTGGCACTTTCTGGGAGTAGAGCAAAGTAGAGGGAAAATGTAATTGCTAAAAGCTCACACACTCAAAAAAATTCTAGTTGG,10,30,14,27,27,41,27,46,27,34,34,41,39,46,8.44,4.067916725
hek293t,10205,1,7,GATTTGGGAAGACAAAGGGAGGGAGTGACAGGAATATATCATTCTGTCTATAAAATAAAATAGGAAAGAAGTACAAAAAAATTCTAGTTGGTTTAACGC,GATTTGGGAAGACAAAGGGAGGGAGTGACAGGAACCGTCAGTATATCATTCTGTCTATAAAATAAAATAGGAAAGAAGTACAAAAAAATTCTAGTTGGT,10,30,14,27,27,42,27,49,27,35,35,42,42,49,39.09,0.249652996
hek293t,10205,1,7,ACGTCGGGAAGACAAAGGGAGGGAGTGACAGGAATATATCATTCTGTCTATAAAATAAAATAGGAAAGAAGTACATGCAAAAAAATTCTAGTTGGTTTA,ACGTCGGGAAGACAAAGGGAGGGAGTGACAGGAACCGTCAGTATATCATTCTGTCTATAAAATAAAATAGGAAAGAAGTACATGCAAAAAAATTCTAGT,10,30,14,27,27,38,27,45,27,35,35,38,42,45,39.09,0.173999503
hek293t,10207,1,14,CTACACACATCCATAATTGTCGCTGATCTTGGACCAACTCAAAACCCTACTACTGAGTTCAGTAGACTAAAAAAATTCTAGTTGGTTTAACGCGTAACT,CTACACACATCCATAATTGTCGCTGATCTTGGAGGTCCCCCTGTGCACCAACTCAAAACCCTACTACTGAGTTCAGTAGACTAAAAAAATTCTAGTTGG,10,30,14,27,27,41,27,55,27,34,34,41,48,55,13.12,0.0
hek293t,10208,1,15,CGGCGAGGCACCAGTCTCCTAAACCAGCATGGCTTTTAGGCACTGTGATTTCCAAGGTTTAATAAGGAGTGCAAAAAAATTCTAGTTGGTTTAACGCGT,CGGCGAGGCACCAGTCTCCTAAACCAGCATGGTCATAAAGGGTATACCTTTTAGGCACTGTGATTTCCAAGGTTTAATAAGGAGTGCAAAAAAATTCTA,10,30,14,27,27,36,27,51,27,33,33,36,48,51,46.7,0.0
hek293t,10208,1,15,CATGGAGGCACCAGTCTCCTAAACCAGCATGGCTTTTAGGCACTGTGATTTCCAAGGTTTAATAAAAAAAAATTCTAGTTGGTTTAACGCGTAACTAGA,CATGGAGGCACCAGTCTCCTAAACCAGCATGGTCATAAAGGGTATACCTTTTAGGCACTGTGATTTCCAAGGTTTAATAAAAAAAAATTCTAGTTGGTT,10,30,14,27,27,43,27,58,27,33,33,43,48,58,46.7,4.556336018
hek293t,10212,1,9,ATTTCTCTCTCAAGTAACAGCAGTTTCTTTGGTGTTTAAAAAGGAGCAAATTTTAACAGGGTGGGGATTTAGTATAGAAAAAAATTCTAGTTGGTTTAA,ATTTCTCTCTCAAGTAACAGCAGTTTCTTTGGTCGCGATTCAGTTTAAAAAGGAGCAAATTTTAACAGGGTGGGGATTTAGTATAGAAAAAAATTCTAG,10,30,14,27,27,37,27,46,27,34,34,37,43,46,10.05,0.0
hek293t,10214,1,14,CCTGCGCGGCATGTGCGATGCCCAGCCATAGGGGTGCCCCAGGAGCTGTGGGCTGTGCAAAGCTCCAAAAAAATTCTAGTTGGTTTAACGCGTAACTAG,CCTGCGCGGCATGTGCGATGCCCAGCCATAGGTGCTAATAGACCGGGGTGCCCCAGGAGCTGTGGGCTGTGCAAAGCTCCAAAAAAATTCTAGTTGGTT,10,30,14,27,27,43,27,57,27,33,33,43,47,57,51.45,17.48471026
hek293t,10215,1,6,GACGATGAGGATGGATTCAGCTATGCTTGAGGATGGATATGTCTCTGAGTTAAGTTCTAGCTACATACACCAGTTATTATAGAAAAAAATTCTAGTTGG,GACGATGAGGATGGATTCAGCTATGCTTGAGGAAAACGATGGATATGTCTCTGAGTTAAGTTCTAGCTACATACACCAGTTATTATAGAAAAAAATTCT,10,30,14,27,27,35,27,41,27,32,32,35,38,41,56.59,2.636408559
hek293t,10215,1,6,GCTCATGAGGATGGATTCAGCTATGCTTGAGGATGGATATGTCTCTGAGTTAAGTTCTAGCTACATACACCAGTTATTAAAAAAATTCTAGTTGGTTTA,GCTCATGAGGATGGATTCAGCTATGCTTGAGGAAAACGATGGATATGTCTCTGAGTTAAGTTCTAGCTACATACACCAGTTATTAAAAAAATTCTAGTT,10,30,14,27,27,39,27,45,27,32,32,39,38,45,56.59,0.259008442
hek293t,10218,1,2,GGTAGTTCAGAACGAAAACAAAAATGGAGCGGTTCTAAGTCTTGGTCGGCTTTCCTTCTGCATTTAAAAAAATTCTAGTTGGTTTAACGCGTAACTAGA,GGTAGTTCAGAACGAAAACAAAAATGGAGCGGTTCTAAGTTGCTTGGTCGGCTTTCCTTCTGCATTTAAAAAAATTCTAGTTGGTTTAACGCGTAACTA,10,30,14,27,27,56,27,58,27,41,41,56,43,58,39.41,0.0
hek293t,10218,1,2,ACGGATTCAGAACGAAAACAAAAATGGAGCGGTTCTAAGTCTTGGTCGGCTTTCCTTCTGCATTTTCAGATTAAAAAAAATTCTAGTTGGTTTAACGCG,ACGGATTCAGAACGAAAACAAAAATGGAGCGGTTCTAAGTTGCTTGGTCGGCTTTCCTTCTGCATTTTCAGATTAAAAAAAATTCTAGTTGGTTTAACG,10,30,14,27,27,48,27,50,27,41,41,48,43,50,39.41,0.0
hek293t,10220,1,15,CCGAACATTCCTTTCTACCCTTCAACAAATGGCTGTGCTTAATAAAATTTGAGTTTGGCAAGGCTCAGTTAAAAAAAAATTCTAGTTGGTTTAACGCGT,CCGAACATTCCTTTCTACCCTTCAACAAATGGTAATAAATAATGAGTCTGTGCTTAATAAAATTTGAGTTTGGCAAGGCTCAGTTAAAAAAAAATTCTA,10,30,14,27,27,36,27,51,27,33,33,36,48,51,17.52,0.0
hek293t,10223,1,5,TAAGGTTATACTAAGCATGTGTATTAAGGAGGTTGGTTTCTTTTTCTGGTGGAGCTCAGCAGGAGAACACAAAAAAAATTCTAGTTGGTTTAACGCGTA,TAAGGTTATACTAAGCATGTGTATTAAGGAGGTTGGCGAGATTTCTTTTTCTGGTGGAGCTCAGCAGGAGAACACAAAAAAAATTCTAGTTGGTTTAAC,10,30,14,27,27,47,27,52,27,37,37,47,42,52,61.27,33.68043065
hek293t,10223,1,5,CCGCTTTATACTAAGCATGTGTATTAAGGAGGTTGGTTTCTTTTTCTGGTGGAGCTCAGCAGGAGAACACAAAACTTGAAAAAAATTCTAGTTGGTTTA,CCGCTTTATACTAAGCATGTGTATTAAGGAGGTTGGCGAGATTTCTTTTTCTGGTGGAGCTCAGCAGGAGAACACAAAACTTGAAAAAAATTCTAGTTG,10,30,14,27,27,40,27,45,27,37,37,40,42,45,61.27,0.60495261
hek293t,10225,1,8,ATGGCATTCCTGTTTTAAATTGACTTCTTTGGAAAAGAGCAGCAAGTAACTGCTGGGAAAGGTGCAAAAAAAATTCTAGTTGGTTTAACGCGTAACTAG,ATGGCATTCCTGTTTTAAATTGACTTCTTTGGAAAAGACCCCAAAAGCAGCAAGTAACTGCTGGGAAAGGTGCAAAAAAAATTCTAGTTGGTTTAACGC,10,30,14,27,27,49,27,57,27,39,39,49,47,57,-3.73,0.0
hek293t,10225,1,8,TAACGATTCCTGTTTTAAATTGACTTCTTTGGAAAAGAGCAGCAAGTAACTGCTGGGAAAGGTGCAGAGAAAAAAATTCTAGTTGGTTTAACGCGTAAC,TAACGATTCCTGTTTTAAATTGACTTCTTTGGAAAAGACCCCAAAAGCAGCAAGTAACTGCTGGGAAAGGTGCAGAGAAAAAAATTCTAGTTGGTTTAA,10,30,14,27,27,46,27,54,27,39,39,46,47,54,-3.73,0.205200508
hek293t,10227,1,13,AGATCACTACTGGACTCCACTGAAGTCAAAGGACTTACAAGCCAGAAAGGAATTGGCCTTTTATCAGTGAAAAAAAATTCTAGTTGGTTTAACGCGTAA,AGATCACTACTGGACTCCACTGAAGTCAAAGGACTTAGCAGACGCGACGACAAGCCAGAAAGGAATTGGCCTTTTATCAGTGAAAAAAAATTCTAGTTG,10,30,14,27,27,40,27,53,27,37,37,40,50,53,52.01,0.02718869
hek293t,10228,1,8,CCGGAGCCGTAACTTCATGGTTTCTAGCTAGGAGAGAAGAAATAACCTGGCTAACAGTACTGCAAAAAAAAATTCTAGTTGGTTTAACGCGTAACTAGA,CCGGAGCCGTAACTTCATGGTTTCTAGCTAGGAGAGAAGGCTGGCTGAAATAACCTGGCTAACAGTACTGCAAAAAAAAATTCTAGTTGGTTTAACGCG,10,30,14,27,27,50,27,58,27,40,40,50,48,58,24.24,1.902601208
hek293t,10228,1,8,AGCATGCCGTAACTTCATGGTTTCTAGCTAGGAGAGAAGAAATAACCTGGCTAACAGTACTGCAAATGGAGAAAAAAAATTCTAGTTGGTTTAACGCGT,AGCATGCCGTAACTTCATGGTTTCTAGCTAGGAGAGAAGGCTGGCTGAAATAACCTGGCTAACAGTACTGCAAATGGAGAAAAAAAATTCTAGTTGGTT,10,30,14,27,27,43,27,51,27,40,40,43,48,51,24.24,0.0
hek293t,10232,1,9,ACCCTAAACTTAATATGGTAACCTGAAAGAGGAAATTCAGTTTTTAGCTGAGCACTGCTTTATGTAAAAAAATTCTAGTTGGTTTAACGCGTAACTAGA,ACCCTAAACTTAATATGGTAACCTGAAAGAGGAAATTCACGTAATTTAGTTTTTAGCTGAGCACTGCTTTATGTAAAAAAATTCTAGTTGGTTTAACGC,10,30,14,27,27,49,27,58,27,39,39,49,48,58,37.09,0.469041981
hek293t,10234,1,10,TTCAGAAGCTAATCTGTTCATAGATGTGAAGGTTATAATGTCTTACAGTTGAGATTGTCAGCATTTGTTAAAAAAAAATTCTAGTTGGTTTAACGCGTA,TTCAGAAGCTAATCTGTTCATAGATGAGTACGTTTATGAAGGTTATAATGTCTTACAGTTGAGATTGTCAGCATTTGTTAAAAAAAAATTCTAGTTGGT,10,30,14,27,27,42,27,52,27,27,27,42,37,52,47.33,16.11886918
hek293t,10234,1,10,AGATTAAGCTAATCTGTTCATAGATGTGAAGGTTATAATGTCTTACAGTTGAGATTGTCAGCATTTGTTAAACTCTGTTTTGAAAAAAAATTCTAGTTG,AGATTAAGCTAATCTGTTCATAGATGAGTACGTTTATGAAGGTTATAATGTCTTACAGTTGAGATTGTCAGCATTTGTTAAACTCTGTTTTGAAAAAAA,10,30,14,27,27,30,27,40,27,27,27,30,37,40,47.33,0.435323383
hek293t,10236,1,2,CGGCAAAACATTTTATGACATGCATTAAAAGGATTATCATCTAACTGTATAAATTGTGTTAATACTTTTACTGAGGAAAAAAATTCTAGTTGGTTTAAC,CGGCAAAACATTTTATGACATGCATTAAACAAGGATTATCATCTAACTGTATAAATTGTGTTAATACTTTTACTGAGGAAAAAAATTCTAGTTGGTTTA,10,30,14,27,27,45,27,47,27,30,30,45,32,47,8.09,11.5282743
hek293t,10236,1,2,ACAAAAAACATTTTATGACATGCATTAAAAGGATTATCATCTAACTGTATAAATTGTGTTAATACTTTTACTGAGGCTTGTTTCAAAAAAATTCTAGTT,ACAAAAAACATTTTATGACATGCATTAAACAAGGATTATCATCTAACTGTATAAATTGTGTTAATACTTTTACTGAGGCTTGTTTCAAAAAAATTCTAG,10,30,14,27,27,37,27,39,27,30,30,37,32,39,8.09,3.541242142
hek293t,10238,1,15,CCAAGCATCTCTGTATAGCCAAAACACTCTGGTGCAGGAGTGCAATACTGGCTGTTGCACTGTTCTCTCTCAAAAAAATTCTAGTTGGTTTAACGCGTA,CCAAGCATCTCTGTATAGCCAAAACACTCTTCTCGTCCGTACCTTGGTGCAGGAGTGCAATACTGGCTGTTGCACTGTTCTCTCTCAAAAAAATTCTAG,10,30,14,27,27,37,27,52,27,30,30,37,45,52,53.85,0.877982148
hek293t,10238,1,15,ACCTGCATCTCTGTATAGCCAAAACACTCTGGTGCAGGAGTGCAATACTGGCTGTTGCACTGTTCTCTCTCTGCTAAAAAAATTCTAGTTGGTTTAACG,ACCTGCATCTCTGTATAGCCAAAACACTCTTCTCGTCCGTACCTTGGTGCAGGAGTGCAATACTGGCTGTTGCACTGTTCTCTCTCTGCTAAAAAAATT,10,30,14,27,27,33,27,48,27,30,30,33,45,48,53.85,0.0
hek293t,10240,1,10,GCACTCTGTGTTCTGACTGCTCCACCAACCGGTCGTTCCCCCATGTCTCTCCCTCTCTTCAGGCCTCCCTATTCCCTGAGAAAAAAATTCTAGTTGGTT,GCACTCTGTGTTCTGACTGCTCCACCAACATGAGACAGTCGGTCGTTCCCCCATGTCTCTCCCTCTCTTCAGGCCTCCCTATTCCCTGAGAAAAAAATT,10,30,14,27,27,33,27,43,27,30,30,33,40,43,53.0,2.427691202
hek293t,10242,1,15,GCCACCTGACATCCTTTCTGTAGGCATACAGGGGAAGAGAGGACAGTGTTGTTCAAAAAGTGGTAAAAAAATTCTAGTTGGTTTAACGCGTAACTAGAT,GCCACCTGACATCCTTTCTGTAGGCATACAGGGGAAGAGAAGCTGGGGCCTCGACGGACAGTGTTGTTCAAAAAGTGGTAAAAAAATTCTAGTTGGTTT,10,30,14,27,27,44,27,59,27,41,41,44,56,59,17.83,0.0
hek293t,10243,1,3,AACTATTAATGGATGAGACATCAAACTAGAGGCTATCCAGTACCTATTGTCTCCAGTGACATAACTCTGGGTTCAAAAAAAAATTCTAGTTGGTTTAAC,AACTATTAATGGATGAGACATCAAACTAACGGAGGCTATCCAGTACCTATTGTCTCCAGTGACATAACTCTGGGTTCAAAAAAAAATTCTAGTTGGTTT,10,30,14,27,27,44,27,47,27,29,29,44,32,47,61.76,63.63903374
hek293t,10243,1,3,TAGCTTTAATGGATGAGACATCAAACTAGAGGCTATCCAGTACCTATTGTCTCCAGTGACATAACTCTGGGTTCAATATATGGTAAAAAAATTCTAGTT,TAGCTTTAATGGATGAGACATCAAACTAACGGAGGCTATCCAGTACCTATTGTCTCCAGTGACATAACTCTGGGTTCAATATATGGTAAAAAAATTCTA,10,30,14,27,27,36,27,39,27,29,29,36,32,39,61.76,64.48395231
hek293t,7679,1,12,CCCAATTTTAATTATTGTCTCATGTGTAAAGGAGACTTTCAGAGCACAAGGGTCATATAAATAGTCTTTAGAAAAAAATTCTAGTTGGTTTAACGCGTA,CCCAATTTTAATTATTGTCTCATGTGTAAAGGTTAGAAGCCCCAAGACTTTCAGAGCACAAGGGTCATATAAATAGTCTTTAGAAAAAAATTCTAGTTG,10,30,14,27,27,40,27,52,27,33,33,40,45,52,5.07,0.660268377
hek293t,7679,1,12,GAACCTTTTAATTATTGTCTCATGTGTAAAGGAGACTTTCAGAGCACAAGGGTCATATAAATAGTCTTTAGTACAAAAAAAATTCTAGTTGGTTTAACG,GAACCTTTTAATTATTGTCTCATGTGTAAAGGTTAGAAGCCCCAAGACTTTCAGAGCACAAGGGTCATATAAATAGTCTTTAGTACAAAAAAAATTCTA,10,30,14,27,27,36,27,48,27,33,33,36,45,48,5.07,3.046429716
hek293t,10247,1,1,AAGATCTTTCCTCATCCAGTTGTCTGAGGAGGAAGCACATCTTGCATGCAGCTGTATTTTATTCTGTTTCCCTGTGAAAAAAATTCTAGTTGGTTTAAC,AAGATCTTTCCTCATCCAGTTGTCTGAGGAGGAAGCACTATCTTGCATGCAGCTGTATTTTATTCTGTTTCCCTGTGAAAAAAATTCTAGTTGGTTTAA,10,30,14,27,27,46,27,47,27,39,39,46,40,47,52.48,73.13273595
hek293t,10247,1,1,AGACTCTTTCCTCATCCAGTTGTCTGAGGAGGAAGCACATCTTGCATGCAGCTGTATTTTATTCTGTTTCCCTGTGGCTAAAAAAAATTCTAGTTGGTT,AGACTCTTTCCTCATCCAGTTGTCTGAGGAGGAAGCACTATCTTGCATGCAGCTGTATTTTATTCTGTTTCCCTGTGGCTAAAAAAAATTCTAGTTGGT,10,30,14,27,27,42,27,43,27,39,39,42,40,43,52.48,0.752687578
hek293t,10249,1,3,GGAACCTCTTCACCCATGGAAGGTCTCCTTGGCAATGGGAAATATCTGGACCATGACACATCTTTGTTCCTTTGAAAAAAAAATTCTAGTTGGTTTAAC,GGAACCTCTTCACCCATGGAAGGTCTCCTTGGCAATGTGGGGAAATATCTGGACCATGACACATCTTTGTTCCTTTGAAAAAAAAATTCTAGTTGGTTT,10,30,14,27,27,44,27,47,27,37,37,44,40,47,48.82,29.78055703
hek293t,10249,1,3,TCGAACTCTTCACCCATGGAAGGTCTCCTTGGCAATGGGAAATATCTGGACCATGACACATCTTTGTTAAAAAAATTCTAGTTGGTTTAACGCGTAACT,TCGAACTCTTCACCCATGGAAGGTCTCCTTGGCAATGTGGGGAAATATCTGGACCATGACACATCTTTGTTAAAAAAATTCTAGTTGGTTTAACGCGTA,10,30,14,27,27,52,27,55,27,37,37,52,40,55,48.82,29.89708017
hek293t,10251,1,5,GACTTTGAACGCACCAAGGCTCACCTCATTGGAGAGTCCTGAAGCCAAATCTTGCTGGGAATGACGTAAAAAAATTCTAGTTGGTTTAACGCGTAACTA,GACTTTGAACGCACCAAGGCTCACCTCATTGGAGAGTCCTCTGCAGAAGCCAAATCTTGCTGGGAATGACGTAAAAAAATTCTAGTTGGTTTAACGCGT,10,30,14,27,27,51,27,56,27,41,41,51,46,56,16.44,4.463546725
hek293t,10252,1,4,GGTCAATTAAACCATTGATGGAAAATTGTTGGAAACCTATTTATTGTTTGTTCCTCACACATATGTAATTGCCACTGTTAAAAAAATTCTAGTTGGTTT,GGTCAATTAAACCATTGATGGAAAATTGTTGGAAACGAGACTATTTATTGTTTGTTCCTCACACATATGTAATTGCCACTGTTAAAAAAATTCTAGTTG,10,30,14,27,27,40,27,44,27,37,37,40,41,44,17.24,0.0
hek293t,10252,1,4,ACGAAATTAAACCATTGATGGAAAATTGTTGGAAACCTATTTATTGTTTGTTCCTCACACATATGTAAAAAAAATTCTAGTTGGTTTAACGCGTAACTA,ACGAAATTAAACCATTGATGGAAAATTGTTGGAAACGAGACTATTTATTGTTTGTTCCTCACACATATGTAAAAAAAATTCTAGTTGGTTTAACGCGTA,10,30,14,27,27,52,27,56,27,37,37,52,41,56,17.24,6.718382854
hek293t,10256,1,14,GCCTCAACTTACCCTCAAAGAAGAGCAGGAGGAATACATCCGAGAGGTAATACTTAAATCAGTCTTAAAAAAATTCTAGTTGGTTTAACGCGTAACTAG,GCCTCAACTTACCCTCAAAGAAGAGCAGGAGGAATACATAAGACTCCCGGGGCCCGAGAGGTAATACTTAAATCAGTCTTAAAAAAATTCTAGTTGGTT,10,30,14,27,27,43,27,57,27,40,40,43,54,57,61.57,0.0
hek293t,10257,1,9,TTCAGCTGCTTTACAAGAGCAGCCAATAAAGGCTAGTCAATAATAGAGCAATATGAGATCTACCTGTGCAAATGCAGATATGAAAAAAAAATTCTAGTT,TTCAGCTGCTTTACAAGAGCAGCCAAATTGAGTTCTAAAGGCTAGTCAATAATAGAGCAATATGAGATCTACCTGTGCAAATGCAGATATGAAAAAAAA,10,30,14,27,27,30,27,39,27,27,27,30,36,39,40.23,0.0
hek293t,10257,1,9,CTACACTGCTTTACAAGAGCAGCCAATAAAGGCTAGTCAATAATAGAGCAATATGAGATCTACCTGTGCAAAAAAAAAATTCTAGTTGGTTTAACGCGT,CTACACTGCTTTACAAGAGCAGCCAAATTGAGTTCTAAAGGCTAGTCAATAATAGAGCAATATGAGATCTACCTGTGCAAAAAAAAAATTCTAGTTGGT,10,30,14,27,27,42,27,51,27,27,27,42,36,51,40.23,4.459940078
hek293t,10259,1,9,GTAAACCAAGATTAGTTTTCTGTTTTGTGTGGATTTTCATAAAGCAAAGTTGATCTCTCACTTGTATCAATACTTAAAAAAAATTCTAGTTGGTTTAAC,GTAAACCAAGATTAGTTTTCTGTTTTGTGTCTTATAACGGGATTTTCATAAAGCAAAGTTGATCTCTCACTTGTATCAATACTTAAAAAAAATTCTAGT,10,30,14,27,27,38,27,47,27,31,31,38,40,47,39.7,0.368559035
hek293t,10259,1,9,TCGAGCCAAGATTAGTTTTCTGTTTTGTGTGGATTTTCATAAAGCAAAGTTGATCTCTCACTTGTATCAAAAAAATTCTAGTTGGTTTAACGCGTAACT,TCGAGCCAAGATTAGTTTTCTGTTTTGTGTCTTATAACGGGATTTTCATAAAGCAAAGTTGATCTCTCACTTGTATCAAAAAAATTCTAGTTGGTTTAA,10,30,14,27,27,46,27,55,27,31,31,46,40,55,39.7,0.862412406
hek293t,10263,1,11,AAGTGCTTGCTAGGTTAGTTCAAATACTGTGGAATGAAGAACAACTAAATCATACCTCTACTTTTACCTGCTCCTGTAAAAAAATTCTAGTTGGTTTAA,AAGTGCTTGCTAGGTTAGTTCAAATACTCCAAGGCGACTGTGGAATGAAGAACAACTAAATCATACCTCTACTTTTACCTGCTCCTGTAAAAAAATTCT,10,30,14,27,27,35,27,46,27,28,28,35,39,46,61.78,1.765314248
hek293t,10263,1,11,TTAGGCTTGCTAGGTTAGTTCAAATACTGTGGAATGAAGAACAACTAAATCATACCTCTACTTTTACCTGCTCCAAAAAAATTCTAGTTGGTTTAACGC,TTAGGCTTGCTAGGTTAGTTCAAATACTCCAAGGCGACTGTGGAATGAAGAACAACTAAATCATACCTCTACTTTTACCTGCTCCAAAAAAATTCTAGT,10,30,14,27,27,38,27,49,27,28,28,38,39,49,61.78,2.879560385
hek293t,10265,1,2,AGATAGAATTCTTTGCCACAAGCTGCACCAGGTGCTAAAAGTTACCCTCGATTTGTTGGTTGAATGGGCAAATACAAAAAAAATTCTAGTTGGTTTAAC,AGATAGAATTCTTTGCCACAAGCTGCACCCGAGGTGCTAAAAGTTACCCTCGATTTGTTGGTTGAATGGGCAAATACAAAAAAAATTCTAGTTGGTTTA,10,30,14,27,27,45,27,47,27,30,30,45,32,47,44.9,2.033287772
hek293t,10267,1,4,CCTCAATTGTCACCAGTAATATTACAACATGGTGCGGGGAGCAGGAGTAACTTTGTTATTACCTGCTTCAAGGACAGAAAAAAATTCTAGTTGGTTTAA,CCTCAATTGTCACCAGTAATATTACAACATGGTGATTACGGGGAGCAGGAGTAACTTTGTTATTACCTGCTTCAAGGACAGAAAAAAATTCTAGTTGGT,10,30,14,27,27,42,27,46,27,35,35,42,39,46,69.72,16.27288602
hek293t,10267,1,4,GTACAATTGTCACCAGTAATATTACAACATGGTGCGGGGAGCAGGAGTAACTTTGTTATTACCTGCTTCAAGGACAGTATTAAAAAAATTCTAGTTGGT,GTACAATTGTCACCAGTAATATTACAACATGGTGATTACGGGGAGCAGGAGTAACTTTGTTATTACCTGCTTCAAGGACAGTATTAAAAAAATTCTAGT,10,30,14,27,27,38,27,42,27,35,35,38,39,42,69.72,0.0
hek293t,10271,1,15,AGGCCGATGGAAGGGGCAGAGGAAATAAGTGGTATTGCAAGCTCTGGTCATTAATCTAGATTCATAAAAAAAATTCTAGTTGGTTTAACGCGTAACTAG,AGGCCGATGGAAGGGGCAGAGGAAATAAGTGGTATTGCTCTCTATGTTGGCATAAGCTCTGGTCATTAATCTAGATTCATAAAAAAAATTCTAGTTGGT,10,30,14,27,27,42,27,57,27,39,39,42,54,57,66.19,0.0
hek293t,10272,1,4,CTGTAGCACAAAAAGACATCATGTTTGTAAGGATTCCCATGCAGGATATTTCTACGGCCCCCCCCCAAAAAAATTCTAGTTGGTTTAACGCGTAACTAG,CTGTAGCACAAAAAGACATCATGTTTGTAAGGATTCCGTCGCATGCAGGATATTTCTACGGCCCCCCCCCAAAAAAATTCTAGTTGGTTTAACGCGTAA,10,30,14,27,27,53,27,57,27,38,38,53,42,57,11.02,33.50870757
hek293t,10274,1,7,TAACGGCTTGGGTTTTTATAAGATTTGAAAGGTCAAGAGGGTAAGCAGATGGCTAGCTGCAGAATTTATTGCACTTAAAAAAATTCTAGTTGGTTTAAC,TAACGGCTTGGGTTTTTATAAGATTTGAATTACCGTAGGTCAAGAGGGTAAGCAGATGGCTAGCTGCAGAATTTATTGCACTTAAAAAAATTCTAGTTG,10,30,14,27,27,40,27,47,27,30,30,40,37,47,23.91,0.725959944
hek293t,10276,1,5,AGAGGTACAAGAATAAAAGACAGCATAGCAGGCTATGGAAATTTTATATGGTTTAGTAAGAAAGGATAATTATATGCAAAAAAAAATTCTAGTTGGTTT,AGAGGTACAAGAATAAAAGACAGCATAGCAGTAGCCGCTATGGAAATTTTATATGGTTTAGTAAGAAAGGATAATTATATGCAAAAAAAAATTCTAGTT,10,30,14,27,27,39,27,44,27,32,32,39,37,44,33.19,3.629618244
hek293t,10276,1,5,ATTGATACAAGAATAAAAGACAGCATAGCAGGCTATGGAAATTTTATATGGTTTAGTAAGAAAGGATAATTAAAAAAATTCTAGTTGGTTTAACGCGTA,ATTGATACAAGAATAAAAGACAGCATAGCAGTAGCCGCTATGGAAATTTTATATGGTTTAGTAAGAAAGGATAATTAAAAAAATTCTAGTTGGTTTAAC,10,30,14,27,27,47,27,52,27,32,32,47,37,52,33.19,7.543715247
hek293t,10278,1,1,AAGCATTAGACCATCTTTTAAGACAGTTCTGGTGGCAGCATGTAATAACCTTTACAGCATTATCAGTGACGAGTGTAAAAAAATTCTAGTTGGTTTAAC,AAGCATTAGACCATCTTTTAAGACAGTTCTTGGTGGCAGCATGTAATAACCTTTACAGCATTATCAGTGACGAGTGTAAAAAAATTCTAGTTGGTTTAA,10,30,14,27,27,46,27,47,27,31,31,46,32,47,17.09,63.25415269
hek293t,10278,1,1,GTGGATTAGACCATCTTTTAAGACAGTTCTGGTGGCAGCATGTAATAACCTTTACAGCATTATCAGTGACGAGTGTGTGTATGTAAAAAAATTCTAGTT,GTGGATTAGACCATCTTTTAAGACAGTTCTTGGTGGCAGCATGTAATAACCTTTACAGCATTATCAGTGACGAGTGTGTGTATGTAAAAAAATTCTAGT,10,30,14,27,27,38,27,39,27,31,31,38,32,39,17.09,70.50275586
hek293t,10280,1,6,TACGGGTTGTCACAAGGGTAGACGAGCAGCGGTACTTGCTATCTCCTCTTGGGTGAGTCGCAGCAGCCAGAAAACAGGAAAAAAATTCTAGTTGGTTTA,TACGGGTTGTCACAAGGGTAGACGAGCAGCGGTACATAGGGTTGCTATCTCCTCTTGGGTGAGTCGCAGCAGCCAGAAAACAGGAAAAAAATTCTAGTT,10,30,14,27,27,39,27,45,27,36,36,39,42,45,53.42,0.232693426
hek293t,10280,1,6,ATAACGTTGTCACAAGGGTAGACGAGCAGCGGTACTTGCTATCTCCTCTTGGGTGAGTCGCAGCAGCCAGAAAAAAAAAAATTCTAGTTGGTTTAACGC,ATAACGTTGTCACAAGGGTAGACGAGCAGCGGTACATAGGGTTGCTATCTCCTCTTGGGTGAGTCGCAGCAGCCAGAAAAAAAAAAATTCTAGTTGGTT,10,30,14,27,27,43,27,49,27,36,36,43,42,49,53.42,3.582987056
hek293t,10282,1,3,CTTGTTGTTGTTTATAAATGTGAGTTTCGTGGCCTAAAGCAATAGGGTAAGAACTCGTATTTACTGTTCTGAGTTGCTAAAAAAAATTCTAGTTGGTTT,CTTGTTGTTGTTTATAAATGTGAGTTTCGTGGCTGACTAAAGCAATAGGGTAAGAACTCGTATTTACTGTTCTGAGTTGCTAAAAAAAATTCTAGTTGG,10,30,14,27,27,41,27,44,27,34,34,41,37,44,15.13,13.84359844
hek293t,10282,1,3,ACGTCTGTTGTTTATAAATGTGAGTTTCGTGGCCTAAAGCAATAGGGTAAGAACTCGTATTTACTGTTCTGAGTTGAAAAAAATTCTAGTTGGTTTAAC,ACGTCTGTTGTTTATAAATGTGAGTTTCGTGGCTGACTAAAGCAATAGGGTAAGAACTCGTATTTACTGTTCTGAGTTGAAAAAAATTCTAGTTGGTTT,10,30,14,27,27,44,27,47,27,34,34,44,37,47,15.13,52.51488964
hek293t,10284,1,6,ACTGGTTCTATGTAAAGAATCAATCATGGTGGCCTTTTCTGGTGCCTTCAAAGTTAACGAGCTTGAACTGCAGGTGGCAAAAAAATTCTAGTTGGTTTA,ACTGGTTCTATGTAAAGAATCAATCATGGTGGACAACGCCTTTTCTGGTGCCTTCAAAGTTAACGAGCTTGAACTGCAGGTGGCAAAAAAATTCTAGTT,10,30,14,27,27,39,27,45,27,32,32,39,38,45,61.25,0.528402967
hek293t,10286,1,2,GTTCATTTCCCTTCCGCCAGGCTTCAAAGGGGTAAAGGGAGGGAAGAGGCAACAAGGATGATAAACACAATGGGGCCTGCAGAACAAAAAAATTCTAGT,GTTCATTTCCCTTCCGCCAGGCTTCAAACGGGGGTAAAGGGAGGGAAGAGGCAACAAGGATGATAAACACAATGGGGCCTGCAGAACAAAAAAATTCTA,10,30,14,27,27,36,27,38,27,29,29,36,31,38,69.06,25.76463421
hek293t,10286,1,2,GATCGTTTCCCTTCCGCCAGGCTTCAAAGGGGTAAAGGGAGGGAAGAGGCAACAAGGATGATAAACACAATGGGGCCTGCAGAAAAAAATTCTAGTTGG,GATCGTTTCCCTTCCGCCAGGCTTCAAACGGGGGTAAAGGGAGGGAAGAGGCAACAAGGATGATAAACACAATGGGGCCTGCAGAAAAAAATTCTAGTT,10,30,14,27,27,39,27,41,27,29,29,39,31,41,69.06,47.4368759
hek293t,10288,1,5,ATTAATAAGCTCTGAAAATAACCTGTCATTGGTATCCATTTGCCTTGATCCATGCTTTTATTAATACCACTAGAAAAAAAAATTCTAGTTGGTTTAACG,ATTAATAAGCTCTGAAAATAACCTGTCATTGGTATCATGGCCATTTGCCTTGATCCATGCTTTTATTAATACCACTAGAAAAAAAAATTCTAGTTGGTT,10,30,14,27,27,43,27,48,27,36,36,43,41,48,19.21,0.0
hek293t,10288,1,5,CCGAGTAAGCTCTGAAAATAACCTGTCATTGGTATCCATTTGCCTTGATCCATGCTTTTATTAATACCACTAAAAAAAATTCTAGTTGGTTTAACGCGT,CCGAGTAAGCTCTGAAAATAACCTGTCATTGGTATCATGGCCATTTGCCTTGATCCATGCTTTTATTAATACCACTAAAAAAAATTCTAGTTGGTTTAA,10,30,14,27,27,46,27,51,27,36,36,46,41,51,19.21,1.027272713
hek293t,10290,1,5,GCGAAAAATATGATGCTTCTAAAGGCACAAGGACAGAAGAGGCTCAGACTGGACATTTTGAAGAACTGGAGCTACTTTTTGATAAAAAAAAATTCTAGT,GCGAAAAATATGATGCTTCTAAAGGCACAGTGCGAGGACAGAAGAGGCTCAGACTGGACATTTTGAAGAACTGGAGCTACTTTTTGATAAAAAAAAATT,10,30,14,27,27,33,27,38,27,30,30,33,35,38,53.52,0.091261592
hek293t,10290,1,5,ATGGGAAATATGATGCTTCTAAAGGCACAAGGACAGAAGAGGCTCAGACTGGACATTTTGAAGAACTGGAGCTACTTTAAAAAAATTCTAGTTGGTTTA,ATGGGAAATATGATGCTTCTAAAGGCACAGTGCGAGGACAGAAGAGGCTCAGACTGGACATTTTGAAGAACTGGAGCTACTTTAAAAAAATTCTAGTTG,10,30,14,27,27,40,27,45,27,30,30,40,35,45,53.52,27.78367905
hek293t,10292,1,10,AATACAGGAAAGTGCTTAATGTAGAATCATGGTCTGTTATTTCTTTTCAGGCCATAAAAACCCAGTTTAAAAAAATTCTAGTTGGTTTAACGCGTAACT,AATACAGGAAAGTGCTTAATGTAGAATCATGGTCAAGCTAAGCGTGTTATTTCTTTTCAGGCCATAAAAACCCAGTTTAAAAAAATTCTAGTTGGTTTA,10,30,14,27,27,45,27,55,27,35,35,45,45,55,60.55,10.96186708
hek293t,10293,1,15,TGGTCAATAATAGCCTTGCTTTTCTTCTGTGGCCCCTTAGAAAGTACCTGCAGGACCTCCCCTCCCCCAAAAAAATTCTAGTTGGTTTAACGCGTAACT,TGGTCAATAATAGCCTTGCTTTTCTTCTGTTAGCGGACACGGTGTGGCCCCTTAGAAAGTACCTGCAGGACCTCCCCTCCCCCAAAAAAATTCTAGTTG,10,30,14,27,27,40,27,55,27,30,30,40,45,55,29.05,21.82756694
hek293t,10295,1,3,GACCCGAACATAAAAATGTCATAATCTAACGGCACCAAACATAGAACACTTAAAATGTCAGTAAGCAAGGAAAAGCATGCAAAAAAATTCTAGTTGGTT,GACCCGAACATAAAAATGTCATAATCTAACGGCACCATAAAACATAGAACACTTAAAATGTCAGTAAGCAAGGAAAAGCATGCAAAAAAATTCTAGTTG,10,30,14,27,27,40,27,43,27,37,37,40,40,43,15.66,0.0
hek293t,10295,1,3,CCAGTGAACATAAAAATGTCATAATCTAACGGCACCAAACATAGAACACTTAAAATGTCAGTAAGCAAGGAAAAGCAAAAAAATTCTAGTTGGTTTAAC,CCAGTGAACATAAAAATGTCATAATCTAACGGCACCATAAAACATAGAACACTTAAAATGTCAGTAAGCAAGGAAAAGCAAAAAAATTCTAGTTGGTTT,10,30,14,27,27,44,27,47,27,37,37,44,40,47,15.66,0.360140607
hek293t,10297,1,6,GCTTCTCGCATTAGCAACAGTTACATTTCAGGAAATAAACTTGATACACCTCACAGAGGTAAATTTCTAATCTATTAGCAAAAAAAAAATTCTAGTTGG,GCTTCTCGCATTAGCAACAGTTACATTAATTGCTCAGGAAATAAACTTGATACACCTCACAGAGGTAAATTTCTAATCTATTAGCAAAAAAAAAATTCT,10,30,14,27,27,35,27,41,27,28,28,35,34,41,11.61,13.60355886
hek293t,10298,1,9,ACCGACAGTGCTAAGGAATCTGTTTTTGGAGGGGGCAGCAAAAACGTGAATAAGGGCGATACAGTCAATTCAGTGTTCTTAAAAAAATTCTAGTTGGTT,ACCGACAGTGCTAAGGAATCTGTTTTGTACCACCATGGAGGGGGCAGCAAAAACGTGAATAAGGGCGATACAGTCAATTCAGTGTTCTTAAAAAAATTC,10,30,14,27,27,34,27,43,27,27,27,34,36,43,48.88,3.774331808
hek293t,10302,1,15,TTAGTTGACATGCTGTGTGCTTTCTCTGAAGGACTGAGACAAAATTATTCCAAACAAAATTCCCCTGGAATAAAAAAAATTCTAGTTGGTTTAACGCGT,TTAGTTGACATGCTGTGTGCTTTCTCTGAAGGACCGGGTCGTTTGCGACTGAGACAAAATTATTCCAAACAAAATTCCCCTGGAATAAAAAAAATTCTA,10,30,14,27,27,36,27,51,27,33,33,36,48,51,36.97,0.136787741
hek293t,10302,1,15,TGCTCTGACATGCTGTGTGCTTTCTCTGAAGGACTGAGACAAAATTATTCCAAACAAAATTCCCCTGGAAAAAAATTCTAGTTGGTTTAACGCGTAACT,TGCTCTGACATGCTGTGTGCTTTCTCTGAAGGACCGGGTCGTTTGCGACTGAGACAAAATTATTCCAAACAAAATTCCCCTGGAAAAAAATTCTAGTTG,10,30,14,27,27,40,27,55,27,33,33,40,48,55,36.97,1.116738604
hek293t,10306,1,13,CAGGCTTAGATGAATCAATAGCTGAGCTTCGGCACACTTGATTTATACTGGGAACTACGCGTACTATTCAGAAGAACAAAAAAAATTCTAGTTGGTTTA,CAGGCTTAGATGAATCAATAGCTGAGCTGGACTCGTAAAACTCGGCACACTTGATTTATACTGGGAACTACGCGTACTATTCAGAAGAACAAAAAAAAT,10,30,14,27,27,32,27,45,27,29,29,32,42,45,50.87,0.0
hek293t,10306,1,13,GTTCTTTAGATGAATCAATAGCTGAGCTTCGGCACACTTGATTTATACTGGGAACTACGCGTACTAAAAAAAATTCTAGTTGGTTTAACGCGTAACTAG,GTTCTTTAGATGAATCAATAGCTGAGCTGGACTCGTAAAACTCGGCACACTTGATTTATACTGGGAACTACGCGTACTAAAAAAAATTCTAGTTGGTTT,10,30,14,27,27,44,27,57,27,29,29,44,42,57,50.87,13.00283014
hek293t,10309,1,10,TACCTTACCACAACTGCAGAAAGAATAAGTGGAAGCTGAGCTAAAGTAATACAGACCATGTTAGAAAGGAAAAAAATTCTAGTTGGTTTAACGCGTAAC,TACCTTACCACAACTGCAGAAAGAATAAGTGGAAGCTGCTACCGTGTGAGCTAAAGTAATACAGACCATGTTAGAAAGGAAAAAAATTCTAGTTGGTTT,10,30,14,27,27,44,27,54,27,37,37,44,47,54,56.2,0.0
hek293t,10310,1,8,GACCGCGTTTTCTGTAGTTTTCACAACATTGGGTCATTTTGTTTTTATACATTATACATAAACAGCACACACAAAAAAATTCTAGTTGGTTTAACGCGT,GACCGCGTTTTCTGTAGTTTTCACAACATTGGGTCCGGAGTCGATTTTGTTTTTATACATTATACATAAACAGCACACACAAAAAAATTCTAGTTGGTT,10,30,14,27,27,43,27,51,27,36,36,43,44,51,7.52,0.0
hek293t,10310,1,8,TCCACCGTTTTCTGTAGTTTTCACAACATTGGGTCATTTTGTTTTTATACATTATACATAAACAAAAAAAATTCTAGTTGGTTTAACGCGTAACTAGAT,TCCACCGTTTTCTGTAGTTTTCACAACATTGGGTCCGGAGTCGATTTTGTTTTTATACATTATACATAAACAAAAAAAATTCTAGTTGGTTTAACGCGT,10,30,14,27,27,51,27,59,27,36,36,51,44,59,7.52,0.0
hek293t,10312,1,10,CGTTTGACAAATAAAATTTTCTTCATCAGTGGGTTGGACACTGAGGGAACACACTAGAATTGGTGCAGTGCCAATTTACAAAAAAATTCTAGTTGGTTT,CGTTTGACAAATAAAATTTTCTTCATCAGTGGCTACGACTGGGTTGGACACTGAGGGAACACACTAGAATTGGTGCAGTGCCAATTTACAAAAAAATTC,10,30,14,27,27,34,27,44,27,31,31,34,41,44,8.16,0.069156293
hek293t,10312,1,10,GCACGGACAAATAAAATTTTCTTCATCAGTGGGTTGGACACTGAGGGAACACACTAGAATTGGTGCAAAAAAAATTCTAGTTGGTTTAACGCGTAACTA,GCACGGACAAATAAAATTTTCTTCATCAGTGGCTACGACTGGGTTGGACACTGAGGGAACACACTAGAATTGGTGCAAAAAAAATTCTAGTTGGTTTAA,10,30,14,27,27,46,27,56,27,31,31,46,41,56,8.16,0.128205128
hek293t,10314,1,15,ACTAATGGCTGACTTTAGCTCAAGGTCATTGGGTGAAGCTGTAGGGAACAGTTGGTTTCTGTGTAGCACAGGCTTAAAAAAATTCTAGTTGGTTTAACG,ACTAATGGCTGACTTTAGCTCAAGGTCATTAGGTGCACGTGGTATGGGTGAAGCTGTAGGGAACAGTTGGTTTCTGTGTAGCACAGGCTTAAAAAAATT,10,30,14,27,27,33,27,48,27,30,30,33,45,48,18.32,0.332778702
hek293t,10314,1,15,ACGTGTGGCTGACTTTAGCTCAAGGTCATTGGGTGAAGCTGTAGGGAACAGTTGGTTTCTGTGTAGCAAAAAAAATTCTAGTTGGTTTAACGCGTAACT,ACGTGTGGCTGACTTTAGCTCAAGGTCATTAGGTGCACGTGGTATGGGTGAAGCTGTAGGGAACAGTTGGTTTCTGTGTAGCAAAAAAAATTCTAGTTG,10,30,14,27,27,40,27,55,27,30,30,40,45,55,18.32,1.141411779
hek293t,10316,1,12,GTTAAGACAGAACATTCTCAGAGTGTAAATGGTTTATTTTTCACCTCATTTGCGCTGGTTTCTAAAAAAAATTCTAGTTGGTTTAACGCGTAACTAGAT,GTTAAGACAGAACATTCTCAGAGTGTAAATGGTTTAATTTTATAAGCTTTTTTCACCTCATTTGCGCTGGTTTCTAAAAAAAATTCTAGTTGGTTTAAC,10,30,14,27,27,47,27,59,27,37,37,47,49,59,11.86,1.465994714
hek293t,10316,1,12,AATATGACAGAACATTCTCAGAGTGTAAATGGTTTATTTTTCACCTCATTTGCGCTGGTTTCTAAGTAAAAAAATTCTAGTTGGTTTAACGCGTAACTA,AATATGACAGAACATTCTCAGAGTGTAAATGGTTTAATTTTATAAGCTTTTTTCACCTCATTTGCGCTGGTTTCTAAGTAAAAAAATTCTAGTTGGTTT,10,30,14,27,27,44,27,56,27,37,37,44,49,56,11.86,0.0
hek293t,10318,1,15,ACGGTCCGTAGCAGAAAAGGCCCACCAGAAGGAGATTTATAGTTCGCGCCTGTGTCAAACTGTCTGGACATACTAGCAAAAAAATTCTAGTTGGTTTAA,ACGGTCCGTAGCAGAAAAGGCCCACCATTATCAGCTTCTGGTGAAGGAGATTTATAGTTCGCGCCTGTGTCAAACTGTCTGGACATACTAGCAAAAAAA,10,30,14,27,27,31,27,46,27,28,28,31,43,46,43.28,0.882800609
hek293t,10318,1,15,TAACGCCGTAGCAGAAAAGGCCCACCAGAAGGAGATTTATAGTTCGCGCCTGTGTCAAACTGTCTGGACAAAAAAAATTCTAGTTGGTTTAACGCGTAA,TAACGCCGTAGCAGAAAAGGCCCACCATTATCAGCTTCTGGTGAAGGAGATTTATAGTTCGCGCCTGTGTCAAACTGTCTGGACAAAAAAAATTCTAGT,10,30,14,27,27,38,27,53,27,28,28,38,43,53,43.28,46.38883239
hek293t,10320,1,7,CATAATTCATTATGGCAATAAAGGGTAAAAGGCTTTTTAATAAATTTGATACATATAGTACAGCCATCTCTTAACCCAAAAAAAATTCTAGTTGGTTTA,CATAATTCATTATGGCAATAAAGGGTACGCACCCAAAGGCTTTTTAATAAATTTGATACATATAGTACAGCCATCTCTTAACCCAAAAAAAATTCTAGT,10,30,14,27,27,38,27,45,27,28,28,38,35,45,25.53,1.040889016
hek293t,10322,1,9,CGTACAGCCACGATGGAGGGACAGTTAGGTGGTAACTTTGGCTGAACACTAATCTCTCCTGGCTAAAATGCTAAAAAAATTCTAGTTGGTTTAACGCGT,CGTACAGCCACGATGGAGGGACAGTTAGGTGGTAATATTAGCGACTTTGGCTGAACACTAATCTCTCCTGGCTAAAATGCTAAAAAAATTCTAGTTGGT,10,30,14,27,27,42,27,51,27,35,35,42,44,51,69.36,0.486673555
hek293t,10322,1,9,GTGCCAGCCACGATGGAGGGACAGTTAGGTGGTAACTTTGGCTGAACACTAATCTCTCCTGGCTAAAATGCTTCCAAAAAAAATTCTAGTTGGTTTAAC,GTGCCAGCCACGATGGAGGGACAGTTAGGTGGTAATATTAGCGACTTTGGCTGAACACTAATCTCTCCTGGCTAAAATGCTTCCAAAAAAAATTCTAGT,10,30,14,27,27,38,27,47,27,35,35,38,44,47,69.36,2.505611672
hek293t,10324,1,3,TGTCTTTCTGGGGTTTCATCAGGCCAACATGGGTTCCTAGTCAAAAGAAACTTTGGGTTGAACAAAAACAAACCTGAGCCAAAAAAATTCTAGTTGGTT,TGTCTTTCTGGGGTTTCATCAGGCCAACATGGTGAGTTCCTAGTCAAAAGAAACTTTGGGTTGAACAAAAACAAACCTGAGCCAAAAAAATTCTAGTTG,10,30,14,27,27,40,27,43,27,33,33,40,36,43,44.37,86.94302334
hek293t,10326,1,1,TGTCAGCTACCTTAATAGATTTACTGAGAAGGACAAGGCAGTCCATCTTGAAGGCTATAATGCTATTTCACTTTGGCATCTGTAAAAAAATTCTAGTTG,TGTCAGCTACCTTAATAGATTTACTGAGAAGGACATAGGCAGTCCATCTTGAAGGCTATAATGCTATTTCACTTTGGCATCTGTAAAAAAATTCTAGTT,10,30,14,27,27,39,27,40,27,36,36,39,37,40,27.05,0.92936803
hek293t,10326,1,1,TGCACGCTACCTTAATAGATTTACTGAGAAGGACAAGGCAGTCCATCTTGAAGGCTATAATGCTATTTCACAAAAAAATTCTAGTTGGTTTAACGCGTA,TGCACGCTACCTTAATAGATTTACTGAGAAGGACATAGGCAGTCCATCTTGAAGGCTATAATGCTATTTCACAAAAAAATTCTAGTTGGTTTAACGCGT,10,30,14,27,27,51,27,52,27,36,36,51,37,52,27.05,25.69843782
hek293t,10328,1,6,TCTTCTACAACTCCTCATTAATTAGGAAAAGGTTAATTCTGTACCTTCTAGTACTCTCTGTCTTAGTTTTGTGCGAGAAAAAAATTCTAGTTGGTTTAA,TCTTCTACAACTCCTCATTAATTAGGAAAGCCATTAGGTTAATTCTGTACCTTCTAGTACTCTCTGTCTTAGTTTTGTGCGAGAAAAAAATTCTAGTTG,10,30,14,27,27,40,27,46,27,30,30,40,36,46,27.15,1.939542198
hek293t,10328,1,6,CGGCTTACAACTCCTCATTAATTAGGAAAAGGTTAATTCTGTACCTTCTAGTACTCTCTGTCTTAGTTTTGTGCGAGATAAAAAAAATTCTAGTTGGTT,CGGCTTACAACTCCTCATTAATTAGGAAAGCCATTAGGTTAATTCTGTACCTTCTAGTACTCTCTGTCTTAGTTTTGTGCGAGATAAAAAAAATTCTAG,10,30,14,27,27,37,27,43,27,30,30,37,36,43,27.15,0.102158379
hek293t,10330,1,9,TGCTTGCTCCCACCAGCAGGAAAGGGACCTGGGGAGCACAAGGCTCCCTCCCACCTGCGGCCGAGCAAACAGAAAAAAATTCTAGTTGGTTTAACGCGT,TGCTTGCTCCCACCAGCAGGAAAGGGACCTGGGGTCGCAAAAAAGCACAAGGCTCCCTCCCACCTGCGGCCGAGCAAACAGAAAAAAATTCTAGTTGGT,10,30,14,27,27,42,27,51,27,35,35,42,44,51,41.28,1.076435326
hek293t,10330,1,9,CAACCGCTCCCACCAGCAGGAAAGGGACCTGGGGAGCACAAGGCTCCCTCCCACCTGCGGCCGAAAAAAAATTCTAGTTGGTTTAACGCGTAACTAGAT,CAACCGCTCCCACCAGCAGGAAAGGGACCTGGGGTCGCAAAAAAGCACAAGGCTCCCTCCCACCTGCGGCCGAAAAAAAATTCTAGTTGGTTTAACGCG,10,30,14,27,27,50,27,59,27,35,35,50,44,59,41.28,0.407925408
hek293t,10332,1,14,TCCTCTTCGAACAGTTAAAACGGGTCAGTAGGTCGCCGTGAGGTTGGCCAGGAGCGAGCACCACCGCAAAAAAATTCTAGTTGGTTTAACGCGTAACTA,TCCTCTTCGAACAGTTAAAACGGGTCAGTAGGTCGCCGGTGGCCCTTGGTTCTGAGGTTGGCCAGGAGCGAGCACCACCGCAAAAAAATTCTAGTTGGT,10,30,14,27,27,42,27,56,27,39,39,42,53,56,32.06,0.560364497
hek293t,10333,1,13,TCCGGAAAGTGAGTCATCTCCAGCTGAGGAGGACACAAAGGCTGCCTTCAATTGCATTACACAGCAGAGCGAAAAAAATTCTAGTTGGTTTAACGCGTA,TCCGGAAAGTGAGTCATCTCCAGCTGAGGAGAGCGACGTTCCCCGACACAAAGGCTGCCTTCAATTGCATTACACAGCAGAGCGAAAAAAATTCTAGTT,10,30,14,27,27,39,27,52,27,32,32,39,45,52,57.84,0.392778451
hek293t,10333,1,13,GCATCAAAGTGAGTCATCTCCAGCTGAGGAGGACACAAAGGCTGCCTTCAATTGCATTACACAGCAGAAAAAAAATTCTAGTTGGTTTAACGCGTAACT,GCATCAAAGTGAGTCATCTCCAGCTGAGGAGAGCGACGTTCCCCGACACAAAGGCTGCCTTCAATTGCATTACACAGCAGAAAAAAAATTCTAGTTGGT,10,30,14,27,27,42,27,55,27,32,32,42,45,55,57.84,8.250568693
hek293t,10337,1,13,AGGAGTTTGTATCTGTGACATAAACAAGGAGGTTCACTCCCTGTCCAGAGAGTGCCCACAGTGTAACAAAAAAAATTCTAGTTGGTTTAACGCGTAACT,AGGAGTTTGTATCTGTGACATAAACAAGGAGGTTCACTTGTAATCCAGTACCCCTGTCCAGAGAGTGCCCACAGTGTAACAAAAAAAATTCTAGTTGGT,10,30,14,27,27,42,27,55,27,39,39,42,52,55,74.18,0.0
hek293t,10338,1,3,ATCTCATGCTTGAAGTATGTGTATGTGTTTGGATATGATGTTTGGTATAAGGAGGATGTGCTTGAAAAAAAAAAATTCTAGTTGGTTTAACGCGTAACT,ATCTCATGCTTGAAGTATGTGTATGTGTTTGGATATTGTGATGTTTGGTATAAGGAGGATGTGCTTGAAAAAAAAAAATTCTAGTTGGTTTAACGCGTA,10,30,14,27,27,52,27,55,27,37,37,52,40,55,28.58,4.901956923
hek293t,10342,1,11,ACCCAATGAACCTGCTACCTGTACATTAAAGGAGCTGCCCTTCTATCGCCTGATGTGGGGCTTGAGCTGCAAAAAAAATTCTAGTTGGTTTAACGCGTA,ACCCAATGAACCTGCTACCTGTACATTAAAATCTTAGGAACGGAGCTGCCCTTCTATCGCCTGATGTGGGGCTTGAGCTGCAAAAAAAATTCTAGTTGG,10,30,14,27,27,41,27,52,27,31,31,41,42,52,23.19,33.55854494
hek293t,10342,1,11,CTTTAATGAACCTGCTACCTGTACATTAAAGGAGCTGCCCTTCTATCGCCTGATGTGGGGCTTGAGAAAAAAATTCTAGTTGGTTTAACGCGTAACTAG,CTTTAATGAACCTGCTACCTGTACATTAAAATCTTAGGAACGGAGCTGCCCTTCTATCGCCTGATGTGGGGCTTGAGAAAAAAATTCTAGTTGGTTTAA,10,30,14,27,27,46,27,57,27,31,31,46,42,57,23.19,26.20728974
hek293t,10344,1,1,CTCTTGTAACGTCTGCTATCTCCAGAAAATGGCCTTAGTATGCGGGAGCATTGACTGTAAGCAGAGCAACACCCTTACAAGCAAAAAAATTCTAGTTGG,CTCTTGTAACGTCTGCTATCTCCAGAAAAATGGCCTTAGTATGCGGGAGCATTGACTGTAAGCAGAGCAACACCCTTACAAGCAAAAAAATTCTAGTTG,10,30,14,27,27,40,27,41,27,30,30,40,31,41,21.6,5.852259492
hek293t,10344,1,1,GGACGGTAACGTCTGCTATCTCCAGAAAATGGCCTTAGTATGCGGGAGCATTGACTGTAAGCAGAGCAACACCCTTACAAGCAGTAAAAAAATTCTAGT,GGACGGTAACGTCTGCTATCTCCAGAAAAATGGCCTTAGTATGCGGGAGCATTGACTGTAAGCAGAGCAACACCCTTACAAGCAGTAAAAAAATTCTAG,10,30,14,27,27,37,27,38,27,30,30,37,31,38,21.6,3.075273211
hek293t,10346,1,6,TGAAGATTTGCTTCCACTTTCACGAAATTTGGAGTTTTGCTCCTGAACAGCTGACAGAAGCCAGGTCAGCATCGCAGCAAAAAAATTCTAGTTGGTTTA,TGAAGATTTGCTTCCACTTTCACGAAATTTGGATTTGGAGTTTTGCTCCTGAACAGCTGACAGAAGCCAGGTCAGCATCGCAGCAAAAAAATTCTAGTT,10,30,14,27,27,39,27,45,27,29,29,39,35,45,9.38,36.14234442
hek293t,10347,1,15,GTCCGGCAAGGAAGAGGAATTATTTAGTCTGGTATGTGAAAAATAATGGGGTAAGAATAAAATTAAAAAAAATTCTAGTTGGTTTAACGCGTAACTAGA,GTCCGGCAAGGAAGAGGAATTATTTAGTCTGGTATTCATGCTAGAAAGCGGTGAAAAATAATGGGGTAAGAATAAAATTAAAAAAAATTCTAGTTGGTT,10,30,14,27,27,43,27,58,27,36,36,43,51,58,16.57,0.0
hek293t,10348,1,5,AAAGCTAGACTCCTATACGGAACAGTCACTGGAAGAGATTAATGACACTTACTGTTTTCCACACGTGTATTTCAGAAAAAAATTCTAGTTGGTTTAACG,AAAGCTAGACTCCTATACGGAACAGTCACTGGAAGAGATAAGCCTAATGACACTTACTGTTTTCCACACGTGTATTTCAGAAAAAAATTCTAGTTGGTT,10,30,14,27,27,43,27,48,27,40,40,43,45,48,46.1,0.0
hek293t,10349,1,2,AACTCGCAAAATTTTTGATTTTAGCTTTTTGGATTTGAATCTTATGGGAGAAGATAGAGGAAGATCCTAGCATACTTCTAAAAAAATTCTAGTTGGTTT,AACTCGCAAAATTTTTGATTTTAGCTTTTTGGATCTTTGAATCTTATGGGAGAAGATAGAGGAAGATCCTAGCATACTTCTAAAAAAATTCTAGTTGGT,10,30,14,27,27,42,27,44,27,35,35,42,37,44,-1.3,0.0
hek293t,10349,1,2,GGGGCGCAAAATTTTTGATTTTAGCTTTTTGGATTTGAATCTTATGGGAGAAGATAGAGGAAGATCCTAGCATACTAAAAAAATTCTAGTTGGTTTAAC,GGGGCGCAAAATTTTTGATTTTAGCTTTTTGGATCTTTGAATCTTATGGGAGAAGATAGAGGAAGATCCTAGCATACTAAAAAAATTCTAGTTGGTTTA,10,30,14,27,27,45,27,47,27,35,35,45,37,47,-1.3,0.0
hek293t,10351,1,11,TGATCGCCACGGGTTTGAAACCTTAGGGATGGGGAGATCCAGGCCTGCGCACAAACATGGTTAGGGTTAAAAAAAAATTCTAGTTGGTTTAACGCGTAA,TGATCGCCACGGGTTTGAAACCTTAGGGATGGGGAGATTCGAGCTGTATCCAGGCCTGCGCACAAACATGGTTAGGGTTAAAAAAAAATTCTAGTTGGT,10,30,14,27,27,42,27,53,27,39,39,42,50,53,50.63,0.039654215
hek293t,10352,1,13,ATGTGTATGTCCCAAATGTAAGTGTTTTTTGGGATGATCACCAGGATCTGAACGATCAACTCGTTACACTGAAATAAAAAAATTCTAGTTGGTTTAACG,ATGTGTATGTCCCAAATGTAAGTGTTTTTTGCAACATAATTTATGGATGATCACCAGGATCTGAACGATCAACTCGTTACACTGAAATAAAAAAATTCT,10,30,14,27,27,35,27,48,27,32,32,35,45,48,-3.41,0.0
hek293t,10355,1,3,ATGCGAGACAGGGCCAGCTGATCATAGCGTGGCCATAACTTCAGTGATGAAACTCCAAAAAGAGAAAAGTTAACTGCGTGAAACAAAAAAAATTCTAGT,ATGCGAGACAGGGCCAGCTGATCATAGCGTGCCTGCCATAACTTCAGTGATGAAACTCCAAAAAGAGAAAAGTTAACTGCGTGAAACAAAAAAAATTCT,10,30,14,27,27,35,27,38,27,32,32,35,35,38,72.46,2.113975404
hek293t,10355,1,3,CCTCAAGACAGGGCCAGCTGATCATAGCGTGGCCATAACTTCAGTGATGAAACTCCAAAAAGAGAAAAGTTAAAAAAAAATTCTAGTTGGTTTAACGCG,CCTCAAGACAGGGCCAGCTGATCATAGCGTGCCTGCCATAACTTCAGTGATGAAACTCCAAAAAGAGAAAAGTTAAAAAAAAATTCTAGTTGGTTTAAC,10,30,14,27,27,47,27,50,27,32,32,47,35,50,72.46,25.97824952
hek293t,10357,1,2,GATCATGAGCAAGTATAACCTTGTTACACAGGTGCTTAGCCAGTTATTTTCTACTTTATATTTTTGAAGAAAAAAATTCTAGTTGGTTTAACGCGTAAC,GATCATGAGCAAGTATAACCTTGTTACACAGGTGCTTTTAGCCAGTTATTTTCTACTTTATATTTTTGAAGAAAAAAATTCTAGTTGGTTTAACGCGTA,10,30,14,27,27,52,27,54,27,37,37,52,39,54,39.09,52.87822884
hek293t,10357,1,2,GTGGGTGAGCAAGTATAACCTTGTTACACAGGTGCTTAGCCAGTTATTTTCTACTTTATATTTTTGAAGGCATTGATTCTCAAAAAAATTCTAGTTGGT,GTGGGTGAGCAAGTATAACCTTGTTACACAGGTGCTTTTAGCCAGTTATTTTCTACTTTATATTTTTGAAGGCATTGATTCTCAAAAAAATTCTAGTTG,10,30,14,27,27,40,27,42,27,37,37,40,39,42,39.09,1.296000691
hek293t,10359,1,2,CCAGCTTTTTGCATCGGATCCACTTCTGATGGAACAGTGATGTGTCATCATAGCTTTAGCTTTCTTTTTAAAAAAAATTCTAGTTGGTTTAACGCGTAA,CCAGCTTTTTGCATCGGATCCACTTCTGATGGAACAGTGAACTGTGTCATCATAGCTTTAGCTTTCTTTTTAAAAAAAATTCTAGTTGGTTTAACGCGT,10,30,14,27,27,51,27,53,27,41,41,51,43,53,30.21,64.49927088
hek293t,10359,1,2,TTACCTTTTTGCATCGGATCCACTTCTGATGGAACAGTGATGTGTCATCATAGCTTTAGCTTTCTTTTTATGCTATAAAAAAAATTCTAGTTGGTTTAA,TTACCTTTTTGCATCGGATCCACTTCTGATGGAACAGTGAACTGTGTCATCATAGCTTTAGCTTTCTTTTTATGCTATAAAAAAAATTCTAGTTGGTTT,10,30,14,27,27,44,27,46,27,41,41,44,43,46,30.21,1.301354623
hek293t,10361,1,4,CCACAACACAGATTCGTTATTCATTTTCTTGGCATTATCTGACATTTATTTTAAAGGAACTTGCTATGAAAACAAAAAAAATTCTAGTTGGTTTAACGC,CCACAACACAGATTCGTTATTCATTTTCTGATGTGGCATTATCTGACATTTATTTTAAAGGAACTTGCTATGAAAACAAAAAAAATTCTAGTTGGTTTA,10,30,14,27,27,45,27,49,27,30,30,45,34,49,3.58,2.192385735
hek293t,10363,1,15,CTTATGTTCTATTCTAGTTTGAGATGCCCAGGTTTCCTAAGAAACTCTGTTCTTCTATCTGCATTCAAAAAAAATTCTAGTTGGTTTAACGCGTAACTA,CTTATGTTCTATTCTAGTTTGAGATGCCCAGGTCCGCACGATCATCACTTCCTAAGAAACTCTGTTCTTCTATCTGCATTCAAAAAAAATTCTAGTTGG,10,30,14,27,27,41,27,56,27,34,34,41,49,56,41.07,0.2207763
hek293t,10364,1,15,CCCATGAGCATCTTGAGCTGGAAGAGATGAGGAAAATAAACAAGTGAAGAAAAATAGCTTAAGGCAGAACAAAAAAAATTCTAGTTGGTTTAACGCGTA,CCCATGAGCATCTTGAGCTGGAAGAGATGAGGAAATACGATCTTCCGGAAATAAACAAGTGAAGAAAAATAGCTTAAGGCAGAACAAAAAAAATTCTAG,10,30,14,27,27,37,27,52,27,34,34,37,49,52,58.97,0.426509024
hek293t,10364,1,15,AACTGGAGCATCTTGAGCTGGAAGAGATGAGGAAAATAAACAAGTGAAGAAAAATAGCTTAAGGCAGAAAAAAATTCTAGTTGGTTTAACGCGTAACTA,AACTGGAGCATCTTGAGCTGGAAGAGATGAGGAAATACGATCTTCCGGAAATAAACAAGTGAAGAAAAATAGCTTAAGGCAGAAAAAAATTCTAGTTGG,10,30,14,27,27,41,27,56,27,34,34,41,49,56,58.97,0.510268806
hek293t,10366,1,3,CTGCATAGAGTACAGCAACTTATAACCATTGGTTTGGGAGGGGGCCGGGGGAAAGCCAAACTGTTCTTCAGTTTAAAAAAATTCTAGTTGGTTTAACGC,CTGCATAGAGTACAGCAACTTATAACCATTCTTGGTTTGGGAGGGGGCCGGGGGAAAGCCAAACTGTTCTTCAGTTTAAAAAAATTCTAGTTGGTTTAA,10,30,14,27,27,46,27,49,27,31,31,46,34,49,57.63,63.89580007
hek293t,10366,1,3,ACCCGTAGAGTACAGCAACTTATAACCATTGGTTTGGGAGGGGGCCGGGGGAAAGCCAAACTGTTCTTCAGTTTGGACTAAAAAAATTCTAGTTGGTTT,ACCCGTAGAGTACAGCAACTTATAACCATTCTTGGTTTGGGAGGGGGCCGGGGGAAAGCCAAACTGTTCTTCAGTTTGGACTAAAAAAATTCTAGTTGG,10,30,14,27,27,41,27,44,27,31,31,41,34,44,57.63,74.7265374
hek293t,10370,1,12,GTACACTTTCTGCTGATTTCAAAGTGAAATGGGTCTAAATGAAATAGCAAGCTGAACAGAGCTGAAAAAAATTCTAGTTGGTTTAACGCGTAACTAGAT,GTACACTTTCTGCTGATTTCAAAGTGAAATGAATCTATACCTAGGTCTAAATGAAATAGCAAGCTGAACAGAGCTGAAAAAAATTCTAGTTGGTTTAAC,10,30,14,27,27,47,27,59,27,32,32,47,44,59,1.01,0.024242424
hek293t,10370,1,12,GCGTGCTTTCTGCTGATTTCAAAGTGAAATGGGTCTAAATGAAATAGCAAGCTGAACAGAGCTGACTTTTATGTCCAAAAAAATTCTAGTTGGTTTAAC,GCGTGCTTTCTGCTGATTTCAAAGTGAAATGAATCTATACCTAGGTCTAAATGAAATAGCAAGCTGAACAGAGCTGACTTTTATGTCCAAAAAAATTCT,10,30,14,27,27,35,27,47,27,32,32,35,44,47,1.01,0.0
hek293t,10372,1,11,TCCTCAAAAGTCTATACTACTTTCCGTGATGGTAAATGTTTGCTTGATTTTTAAAGCCTTCAGCTTCCATGCGAAGAAAAAAAATTCTAGTTGGTTTAA,TCCTCAAAAGTCTATACTACTTTCCGTGTCGGTTTATGGATGGTAAATGTTTGCTTGATTTTTAAAGCCTTCAGCTTCCATGCGAAGAAAAAAAATTCT,10,30,14,27,27,35,27,46,27,28,28,35,39,46,45.65,0.822684776
hek293t,10374,1,7,TTGTACCAGCCCACATCCACACGGGGTAGTGGGACTATTCAGAAATCAGGGAGCAAGCAAAGGTTGAAGGAATTGCAAAAAAATTCTAGTTGGTTTAAC,TTGTACCAGCCCACATCCACACGGGGTAGTGGGACTCCCATTGATTCAGAAATCAGGGAGCAAGCAAAGGTTGAAGGAATTGCAAAAAAATTCTAGTTG,10,30,14,27,27,40,27,47,27,37,37,40,44,47,29.63,0.299850075
hek293t,10376,1,5,CACGTGCACAGCATTGTATTATTTTTAAATGGGAAGTGATTTAATTTTTCTGCTCTTCACATTTAAATAAATAAAAAAATTCTAGTTGGTTTAACGCGT,CACGTGCACAGCATTGTATTATTTTTAAATGGGAAGTGGGGAAATTTAATTTTTCTGCTCTTCACATTTAAATAAATAAAAAAATTCTAGTTGGTTTAA,10,30,14,27,27,46,27,51,27,39,39,46,44,51,0.29,0.0
hek293t,10378,1,4,CTACACTGCTAATTTTTTAAATTGTGGAATGGTAGAAATGAAGCAAGGACTGCATAATTGCAGAACATTGTAAAAAAAATTCTAGTTGGTTTAACGCGT,CTACACTGCTAATTTTTTAAATTGTGGAATGGTAGAAATCGTTGAAGCAAGGACTGCATAATTGCAGAACATTGTAAAAAAAATTCTAGTTGGTTTAAC,10,30,14,27,27,47,27,51,27,40,40,47,44,51,2.38,0.693554828
hek293t,10378,1,4,GGATCCTGCTAATTTTTTAAATTGTGGAATGGTAGAAATGAAGCAAGGACTGCATAATTGCAGAACATTGTAGGCAAAAAAAATTCTAGTTGGTTTAAC,GGATCCTGCTAATTTTTTAAATTGTGGAATGGTAGAAATCGTTGAAGCAAGGACTGCATAATTGCAGAACATTGTAGGCAAAAAAAATTCTAGTTGGTT,10,30,14,27,27,43,27,47,27,40,40,43,44,47,2.38,0.0
hek293t,10380,1,4,CCAGGCTGTCGTATTGGTTTGGTAGTTGGTGGTGCTGTATTTCCTTCCCTTTGTCAGAGCAGGTCAGAGTACTTAAAAAAATTCTAGTTGGTTTAACGC,CCAGGCTGTCGTATTGGTTTGGTAGTTGGTGGTGCTGTAACTATTTCCTTCCCTTTGTCAGAGCAGGTCAGAGTACTTAAAAAAATTCTAGTTGGTTTA,10,30,14,27,27,45,27,49,27,38,38,45,42,49,56.48,6.193873256
hek293t,10380,1,4,TATCGCTGTCGTATTGGTTTGGTAGTTGGTGGTGCTGTATTTCCTTCCCTTTGTCAGAGCAGGTCAGAGTAAAAAAAATTCTAGTTGGTTTAACGCGTA,TATCGCTGTCGTATTGGTTTGGTAGTTGGTGGTGCTGTAACTATTTCCTTCCCTTTGTCAGAGCAGGTCAGAGTAAAAAAAATTCTAGTTGGTTTAACG,10,30,14,27,27,48,27,52,27,38,38,48,42,52,56.48,51.5623255
hek293t,10382,1,2,TAGTAACATTGAATTTTAACTGGCCCGTTTGGGTTTTTTCACAATTCACTTTCTGGTTAGAGGGTAACAGAAAATGGTAAACTGGAAAAAAAAATTCTA,TAGTAACATTGAATTTTAACTGGCCCAGGTTTGGGTTTTTTCACAATTCACTTTCTGGTTAGAGGGTAACAGAAAATGGTAAACTGGAAAAAAAAATTC,10,30,14,27,27,34,27,36,27,27,27,34,29,36,1.97,16.73380897
hek293t,10382,1,2,CGGAAACATTGAATTTTAACTGGCCCGTTTGGGTTTTTTCACAATTCACTTTCTGGTTAGAGGGTAACAGAAAATGGTAAACTGAAAAAAATTCTAGTT,CGGAAACATTGAATTTTAACTGGCCCAGGTTTGGGTTTTTTCACAATTCACTTTCTGGTTAGAGGGTAACAGAAAATGGTAAACTGAAAAAAATTCTAG,10,30,14,27,27,37,27,39,27,27,27,37,29,39,1.97,61.04868565
hek293t,10384,1,2,TATGCGCTGTTATATTTAATTCTGTGATGAGGAATTGCATGTATCAAACTTGAGAGAGGGACTAAATAGCTGAGCAGTTAAAAAAATTCTAGTTGGTTT,TATGCGCTGTTATATTTAATTCTGTGATGAGCCGAATTGCATGTATCAAACTTGAGAGAGGGACTAAATAGCTGAGCAGTTAAAAAAATTCTAGTTGGT,10,30,14,27,27,42,27,44,27,32,32,42,34,44,15.06,73.79667336
hek293t,10384,1,2,TCACAGCTGTTATATTTAATTCTGTGATGAGGAATTGCATGTATCAAACTTGAGAGAGGGACTAAATAGCTGAGAAAAAAATTCTAGTTGGTTTAACGC,TCACAGCTGTTATATTTAATTCTGTGATGAGCCGAATTGCATGTATCAAACTTGAGAGAGGGACTAAATAGCTGAGAAAAAAATTCTAGTTGGTTTAAC,10,30,14,27,27,47,27,49,27,32,32,47,34,49,15.06,72.92137011
hek293t,10387,1,8,AGAAGGCACTTGAGCATGTCTGTACCTTTAGGCATGTGCTTAAGTGTTTTGCTGCAGTGGGGCAGGCTAAAGTAAATGCTCAAAAAAAATTCTAGTTGG,AGAAGGCACTTGAGCATGTCTGTACCTTTAAATATCCAGGCATGTGCTTAAGTGTTTTGCTGCAGTGGGGCAGGCTAAAGTAAATGCTCAAAAAAAATT,10,30,14,27,27,33,27,41,27,30,30,33,38,41,23.11,0.0
hek293t,10387,1,8,ACTCCGCACTTGAGCATGTCTGTACCTTTAGGCATGTGCTTAAGTGTTTTGCTGCAGTGGGGCAGGCTAAAAAAAAATTCTAGTTGGTTTAACGCGTAA,ACTCCGCACTTGAGCATGTCTGTACCTTTAAATATCCAGGCATGTGCTTAAGTGTTTTGCTGCAGTGGGGCAGGCTAAAAAAAAATTCTAGTTGGTTTA,10,30,14,27,27,45,27,53,27,30,30,45,38,53,23.11,14.66399581
hek293t,10389,1,5,CACCTGGGCTTTCGCTGGATCCATCTGTGTGGGTTGACTACAGTTGCTGTTTCCAGTTGTGAGACTGGGAAAAAAAATTCTAGTTGGTTTAACGCGTAA,CACCTGGGCTTTCGCTGGATCCATCTGTGTGGGTTGACTACTGAACAGTTGCTGTTTCCAGTTGTGAGACTGGGAAAAAAAATTCTAGTTGGTTTAACG,10,30,14,27,27,48,27,53,27,41,41,48,46,53,58.66,2.880002337
hek293t,10390,1,13,CACTACCTGAAATCTGAAATTACACCAGCTGGAGATTTCTATATAGATATAAGCCATATATAATAGGACAAAAAAATTCTAGTTGGTTTAACGCGTAAC,CACTACCTGAAATCTGAAATTACACCAGCTGGAGATTCATCGCCACGGGCTCTATATAGATATAAGCCATATATAATAGGACAAAAAAATTCTAGTTGG,10,30,14,27,27,41,27,54,27,38,38,41,51,54,26.74,0.538680079
hek293t,10391,1,1,AGAGTCGCAGGGGTGAGAACAGACAGGGATGGCAGTTTCACAGCTTCCATAAACTGCTGCTTTTACTAATTTATAGGAAAAAAAATTCTAGTTGGTTTA,AGAGTCGCAGGGGTGAGAACAGACAGGGATGGCTAGTTTCACAGCTTCCATAAACTGCTGCTTTTACTAATTTATAGGAAAAAAAATTCTAGTTGGTTT,10,30,14,27,27,44,27,45,27,34,34,44,35,45,61.51,70.68585644
hek293t,10391,1,1,GTCATCGCAGGGGTGAGAACAGACAGGGATGGCAGTTTCACAGCTTCCATAAACTGCTGCTTTTACTAATTTATAGGAGCAAACAAAAAAAATTCTAGT,GTCATCGCAGGGGTGAGAACAGACAGGGATGGCTAGTTTCACAGCTTCCATAAACTGCTGCTTTTACTAATTTATAGGAGCAAACAAAAAAAATTCTAG,10,30,14,27,27,37,27,38,27,34,34,37,35,38,61.51,4.783728496
hek293t,10393,1,9,CGCATCTAAGCAGGACAGAACAGAGGGCCCGGGTTCGACGGAGGAGATATTCGTAAAAACATCTAAAAAAAATTCTAGTTGGTTTAACGCGTAACTAGA,CGCATCTAAGCAGGACAGAACAGAGGGCCCGGGAATCATTCATTCGACGGAGGAGATATTCGTAAAAACATCTAAAAAAAATTCTAGTTGGTTTAACGC,10,30,14,27,27,49,27,58,27,34,34,49,43,58,41.82,2.081053574
hek293t,7882,1,5,CGACAGTGTCTACATGATCCCTTTTCTGCAGGTCGGGCAATGGCTCAGCTCCATACTACGTATGACTCAGTTTTTACTTGTAAAAAAATTCTAGTTGGT,CGACAGTGTCTACATGATCCCTTTTCTGCTGACAAGGTCGGGCAATGGCTCAGCTCCATACTACGTATGACTCAGTTTTTACTTGTAAAAAAATTCTAG,10,30,14,27,27,37,27,42,27,30,30,37,35,42,26.38,33.10435124
hek293t,7882,1,5,CGTCTGTGTCTACATGATCCCTTTTCTGCAGGTCGGGCAATGGCTCAGCTCCATACTACGTATGACTCAGTTTTTACTTGTAAATAAAAAAATTCTAGT,CGTCTGTGTCTACATGATCCCTTTTCTGCTGACAAGGTCGGGCAATGGCTCAGCTCCATACTACGTATGACTCAGTTTTTACTTGTAAATAAAAAAATT,10,30,14,27,27,33,27,38,27,30,30,33,35,38,26.38,29.94736977
hek293t,10397,1,15,GGACACTCTCCTGGCTGTGACAGTATAGCAGGAGGACAGGTTCATCTGCCAAATGCCACGCGATTAGTCAAAAAAATTCTAGTTGGTTTAACGCGTAAC,GGACACTCTCCTGGCTGTGACAGTATAGCTAGCTGGGGGAAATCAGGAGGACAGGTTCATCTGCCAAATGCCACGCGATTAGTCAAAAAAATTCTAGTT,10,30,14,27,27,39,27,54,27,29,29,39,44,54,40.36,3.723249122
hek293t,10397,1,15,TCCCTCTCTCCTGGCTGTGACAGTATAGCAGGAGGACAGGTTCATCTGCCAAATGCCACGCGATTAGTCTGTAAAAAAATTCTAGTTGGTTTAACGCGT,TCCCTCTCTCCTGGCTGTGACAGTATAGCTAGCTGGGGGAAATCAGGAGGACAGGTTCATCTGCCAAATGCCACGCGATTAGTCTGTAAAAAAATTCTA,10,30,14,27,27,36,27,51,27,29,29,36,44,51,40.36,0.324131602
hek293t,10399,1,12,GGTAGGCAAAGCAGAGCTTGTAAGACTAGTGGTATACAGTGCAAAATGGTACCACTGTTTCTTGAGAAAAAAATTCTAGTTGGTTTAACGCGTAACTAG,GGTAGGCAAAGCAGAGCTTGTAAGACTAGCTAGGTCCTTGGTGGTATACAGTGCAAAATGGTACCACTGTTTCTTGAGAAAAAAATTCTAGTTGGTTTA,10,30,14,27,27,45,27,57,27,30,30,45,42,57,44.45,13.37220115
hek293t,10399,1,12,GCCGAGCAAAGCAGAGCTTGTAAGACTAGTGGTATACAGTGCAAAATGGTACCACTGTTTCTTGAGAAATATCACAAGAAAAAAATTCTAGTTGGTTTA,GCCGAGCAAAGCAGAGCTTGTAAGACTAGCTAGGTCCTTGGTGGTATACAGTGCAAAATGGTACCACTGTTTCTTGAGAAATATCACAAGAAAAAAATT,10,30,14,27,27,33,27,45,27,30,30,33,42,45,44.45,0.188750472
hek293t,10401,1,11,GCGATTGCTCTTAAATGTCCAGAAATACATGGTATCTACTTTTCAATAGATGAAATTAGAATAAAGAAAAAAATTCTAGTTGGTTTAACGCGTAACTAG,GCGATTGCTCTTAAATGTCCAGAAATACATGCAGCTCCTTAGGTATCTACTTTTCAATAGATGAAATTAGAATAAAGAAAAAAATTCTAGTTGGTTTAA,10,30,14,27,27,46,27,57,27,31,31,46,42,57,43.34,4.341521181
hek293t,10403,1,4,TCTTGACACCTACACAATCAGCCCAAAGCAGGAATTCAGCAGAGTAAGAACGATCAGAAAATTCAGCAAATAAAAAAATTCTAGTTGGTTTAACGCGTA,TCTTGACACCTACACAATCAGCCCAAAGCAGGGCGAAATTCAGCAGAGTAAGAACGATCAGAAAATTCAGCAAATAAAAAAATTCTAGTTGGTTTAACG,10,30,14,27,27,48,27,52,27,33,33,48,37,52,51.3,11.0778521
hek293t,10403,1,4,GACGCACACCTACACAATCAGCCCAAAGCAGGAATTCAGCAGAGTAAGAACGATCAGAAAATTCAGCAAATGCTTAAAAAAAATTCTAGTTGGTTTAAC,GACGCACACCTACACAATCAGCCCAAAGCAGGGCGAAATTCAGCAGAGTAAGAACGATCAGAAAATTCAGCAAATGCTTAAAAAAAATTCTAGTTGGTT,10,30,14,27,27,43,27,47,27,33,33,43,37,47,51.3,9.9821571
hek293t,10405,1,7,GGAGAATTTAATGGGTTTAATTCTCGTCCAGGATGACATCATGAGTTTTCTTATAGATAGATTATTAAAAAAATTCTAGTTGGTTTAACGCGTAACTAG,GGAGAATTTAATGGGTTTAATTCTCGTCCAGGATGACATGTCTCTTCATGAGTTTTCTTATAGATAGATTATTAAAAAAATTCTAGTTGGTTTAACGCG,10,30,14,27,27,50,27,57,27,40,40,50,47,57,40.88,4.304859395
hek293t,10406,1,7,TCTAGCCAAAGTAGAAATTTAATGCAAATTGGCTGTGTTTCTGGAAGTGGACATGAACCAACAACCAAGATAAAAAAATTCTAGTTGGTTTAACGCGTA,TCTAGCCAAAGTAGAAATTTAATGCAAATTGGCTGTGAGGTGGGTTTCTGGAAGTGGACATGAACCAACAACCAAGATAAAAAAATTCTAGTTGGTTTA,10,30,14,27,27,45,27,52,27,38,38,45,45,52,2.02,0.232865238
hek293t,10407,1,9,GTGCAAAGAAAGAGAAACATTCTTTGCGTAGGTGTGTCTTCCTAAATGATGAGCAATGTACTGTTTTGGTCAAAAAAATTCTAGTTGGTTTAACGCGTA,GTGCAAAGAAAGAGAAACATTCTTTGCGTAGGGGTTGTACGTGTGTCTTCCTAAATGATGAGCAATGTACTGTTTTGGTCAAAAAAATTCTAGTTGGTT,10,30,14,27,27,43,27,52,27,33,33,43,42,52,45.29,10.21483449
hek293t,10407,1,9,GTGCCAAGAAAGAGAAACATTCTTTGCGTAGGTGTGTCTTCCTAAATGATGAGCAATGTACTGTTTTGGTCCACAAAAAAATTCTAGTTGGTTTAACGC,GTGCCAAGAAAGAGAAACATTCTTTGCGTAGGGGTTGTACGTGTGTCTTCCTAAATGATGAGCAATGTACTGTTTTGGTCCACAAAAAAATTCTAGTTG,10,30,14,27,27,40,27,49,27,33,33,40,42,49,45.29,0.779807022
hek293t,22347,1,4,CCCTATTGAAAGTCATTTATTCCAGGAATTGGATATATCAAGAGTAAGTGGTGAAAAATACTTTGTAACATAGCACAAGAAAAAAAATTCTAGTTGGTT,CCCTATTGAAAGTCATTTATTCCAGGAATTGGATACGGCTATCAAGAGTAAGTGGTGAAAAATACTTTGTAACATAGCACAAGAAAAAAAATTCTAGTT,10,30,14,27,27,39,27,43,27,36,36,39,40,43,11.35,0.0
hek293t,2765,1,14,ATAGACAGTTTTTACTTTGTGTTTGGTACAGGGCATTGGGACAGAAAAAATGCACTGCTTTGCCTAAAAAAATTCTAGTTGGTTTAACGCGTAACTAGA,ATAGACAGTTTTTACTTTGTGTTTGGTACAGGGCATTGGGTTGCGAACATACAGACAGAAAAAATGCACTGCTTTGCCTAAAAAAATTCTAGTTGGTTT,10,30,14,27,27,44,27,58,27,41,41,44,55,58,-0.61,0.0
hek293t,10412,1,13,CCTTTAGAATTAGGATTTCAAGGAGGAGATGGCTTTATGTAGTTAAAAACTGACAAACACACACAGAAAAAAAAATTCTAGTTGGTTTAACGCGTAACT,CCTTTAGAATTAGGATTTCAAGGAGGAGATGACTTAGGTCATAAGCTTTATGTAGTTAAAAACTGACAAACACACACAGAAAAAAAAATTCTAGTTGGT,10,30,14,27,27,42,27,55,27,32,32,42,45,55,47.93,2.689367873
hek293t,10413,1,11,TCCGGTTTCCAGAAGCCAGAAGCATAAACCGGGTCATTGTGAGTTAATTCAAATCAATGTCCACTAACTAAAAAAATTCTAGTTGGTTTAACGCGTAAC,TCCGGTTTCCAGAAGCCAGAAGCATAATCATTATGTGCACCGGGTCATTGTGAGTTAATTCAAATCAATGTCCACTAACTAAAAAAATTCTAGTTGGTT,10,30,14,27,27,43,27,54,27,28,28,43,39,54,40.18,7.390225775
hek293t,10413,1,11,ATGCGTTTCCAGAAGCCAGAAGCATAAACCGGGTCATTGTGAGTTAATTCAAATCAATGTCCACTAACTTTCTAATTTCCAAAAAAAATTCTAGTTGGT,ATGCGTTTCCAGAAGCCAGAAGCATAATCATTATGTGCACCGGGTCATTGTGAGTTAATTCAAATCAATGTCCACTAACTTTCTAATTTCCAAAAAAAA,10,30,14,27,27,31,27,42,27,28,28,31,39,42,40.18,0.0
hek293t,10415,1,9,ACGTGGAATCATACTGTGAGAAGACAACTTGGTTAAATTAACCAAGTCTTTTCACAAAGGGACCAATAAAAAAATTCTAGTTGGTTTAACGCGTAACTA,ACGTGGAATCATACTGTGAGAAGACAACTTGGTTAAATTTTTGATCCGAACCAAGTCTTTTCACAAAGGGACCAATAAAAAAATTCTAGTTGGTTTAAC,10,30,14,27,27,47,27,56,27,40,40,47,49,56,52.37,0.472910927
hek293t,10416,1,10,TATAACAAAGAACCAAGGGAGGGGGGAAGTGGACATAGTAGAGTCGAACAGCTGGACATTTCACTTCAAAAAAATTCTAGTTGGTTTAACGCGTAACTA,TATAACAAAGAACCAAGGGAGGGGGGAAGTGGACATAGATCGGGAGGGTAGAGTCGAACAGCTGGACATTTCACTTCAAAAAAATTCTAGTTGGTTTAA,10,30,14,27,27,46,27,56,27,39,39,46,49,56,16.4,6.323973948
hek293t,10416,1,10,TCGTACAAAGAACCAAGGGAGGGGGGAAGTGGACATAGTAGAGTCGAACAGCTGGACATTTCACAAAAAAATTCTAGTTGGTTTAACGCGTAACTAGAT,TCGTACAAAGAACCAAGGGAGGGGGGAAGTGGACATAGATCGGGAGGGTAGAGTCGAACAGCTGGACATTTCACAAAAAAATTCTAGTTGGTTTAACGC,10,30,14,27,27,49,27,59,27,39,39,49,49,59,16.4,5.967541306
hek293t,10418,1,6,CCTACAGAGGCGGAAGTGCCTACTTTCTGTGGAGTTCAGATATGTACAAATTGCATGTACCAGCTATTAGCATGATGTTTCTGGCATAAAAAAATTCTA,CCTACAGAGGCGGAAGTGCCTACTTTCGGTCACTGTGGAGTTCAGATATGTACAAATTGCATGTACCAGCTATTAGCATGATGTTTCTGGCATAAAAAA,10,30,14,27,27,30,27,36,27,27,27,30,33,36,51.77,0.701754386
hek293t,10418,1,6,GAAGAAGAGGCGGAAGTGCCTACTTTCTGTGGAGTTCAGATATGTACAAATTGCATGTACCAGCTATTAGCATGATGTTTAAAAAAATTCTAGTTGGTT,GAAGAAGAGGCGGAAGTGCCTACTTTCGGTCACTGTGGAGTTCAGATATGTACAAATTGCATGTACCAGCTATTAGCATGATGTTTAAAAAAATTCTAG,10,30,14,27,27,37,27,43,27,27,27,37,33,43,51.77,25.03895963
hek293t,10420,1,3,GACATGGAGAACATAGTACCATTGCATTATGGTTTGCTGTGTTTGCCGGGAGGAATTCAACTTGTTTAAAAAAATTCTAGTTGGTTTAACGCGTAACTA,GACATGGAGAACATAGTACCATTGCATTATGGTTTGCGACTGTGTTTGCCGGGAGGAATTCAACTTGTTTAAAAAAATTCTAGTTGGTTTAACGCGTAA,10,30,14,27,27,53,27,56,27,38,38,53,41,56,23.0,74.10416199
hek293t,10420,1,3,TGCAAGGAGAACATAGTACCATTGCATTATGGTTTGCTGTGTTTGCCGGGAGGAATTCAACTTGTTTTTCATGTTTCAGAAAAAAATTCTAGTTGGTTT,TGCAAGGAGAACATAGTACCATTGCATTATGGTTTGCGACTGTGTTTGCCGGGAGGAATTCAACTTGTTTTTCATGTTTCAGAAAAAAATTCTAGTTGG,10,30,14,27,27,41,27,44,27,38,38,41,41,44,23.0,3.368841731
hek293t,10422,1,2,TGTTCGCGGAGTAGCTGGGGATGGAGGAAAGGGAATGGGCAAATGTAAGCATGAAGAGTGTATATGTGCACGGGAAAAAAATTCTAGTTGGTTTAACGC,TGTTCGCGGAGTAGCTGGGGATGGAGGAAAGACGGAATGGGCAAATGTAAGCATGAAGAGTGTATATGTGCACGGGAAAAAAATTCTAGTTGGTTTAAC,10,30,14,27,27,47,27,49,27,32,32,47,34,49,39.2,81.10991372
hek293t,10422,1,2,GATGAGCGGAGTAGCTGGGGATGGAGGAAAGGGAATGGGCAAATGTAAGCATGAAGAGTGTATATGTGCACGGGGATGCAAAAAAATTCTAGTTGGTTT,GATGAGCGGAGTAGCTGGGGATGGAGGAAAGACGGAATGGGCAAATGTAAGCATGAAGAGTGTATATGTGCACGGGGATGCAAAAAAATTCTAGTTGGT,10,30,14,27,27,42,27,44,27,32,32,42,34,44,39.2,81.50468934
hek293t,10426,1,7,GGGCCTAGGACCAACTGGATGCCTACCATTGGCGCTCTCGTACACCACAACATCCCTTCCAGTAATGCATGTGTAAAAAAATTCTAGTTGGTTTAACGC,GGGCCTAGGACCAACTGGATGCCTACCATTGGCGCGGTGTACTCTCGTACACCACAACATCCCTTCCAGTAATGCATGTGTAAAAAAATTCTAGTTGGT,10,30,14,27,27,42,27,49,27,35,35,42,42,49,52.73,4.674276975
hek293t,10427,1,3,GTCAACTGAGAAAACTCAGTCGATACACCAGGTATTAACACTTATCTATAGATTTATGTCATGTTCAGCAAAAAAAAATTCTAGTTGGTTTAACGCGTA,GTCAACTGAGAAAACTCAGTCGATACACCAGGTATTAAATGCACTTATCTATAGATTTATGTCATGTTCAGCAAAAAAAAATTCTAGTTGGTTTAACGC,10,30,14,27,27,49,27,52,27,39,39,49,42,52,46.34,64.58628896
hek293t,10427,1,3,TTTTCCTGAGAAAACTCAGTCGATACACCAGGTATTAACACTTATCTATAGATTTATGTCATGTTCAGCAATATAAAAAAATTCTAGTTGGTTTAACGC,TTTTCCTGAGAAAACTCAGTCGATACACCAGGTATTAAATGCACTTATCTATAGATTTATGTCATGTTCAGCAATATAAAAAAATTCTAGTTGGTTTAA,10,30,14,27,27,46,27,49,27,39,39,46,42,49,46.34,44.95019663
hek293t,10429,1,7,TCGGAATTCATTTTGTCGTGTGTCATCTCAGGACAATATTTATAAAGAAGTTTTGGGTTAACTCTGGAAAGAGTTTTGAAAAAAAATTCTAGTTGGTTT,TCGGAATTCATTTTGTCGTGTGTCATCTCGGTCAAAAGGACAATATTTATAAAGAAGTTTTGGGTTAACTCTGGAAAGAGTTTTGAAAAAAAATTCTAG,10,30,14,27,27,37,27,44,27,30,30,37,37,44,12.08,0.0
hek293t,10435,1,13,CGTAAAATCAGATAGCACCTTCCAGAAGGAGGAGAGAATTTTTCTATCCTGAGAGCAGAATGTGAAAAAAAATTCTAGTTGGTTTAACGCGTAACTAGA,CGTAAAATCAGATAGCACCTTCCAGAAGGAGGAGAAACTGTGTCATTAGAATTTTTCTATCCTGAGAGCAGAATGTGAAAAAAAATTCTAGTTGGTTTA,10,30,14,27,27,45,27,58,27,35,35,45,48,58,62.83,2.785078749
hek293t,10435,1,13,TTTGGAATCAGATAGCACCTTCCAGAAGGAGGAGAGAATTTTTCTATCCTGAGAGCAGAATGTGAACAAAAAAAATTCTAGTTGGTTTAACGCGTAACT,TTTGGAATCAGATAGCACCTTCCAGAAGGAGGAGAAACTGTGTCATTAGAATTTTTCTATCCTGAGAGCAGAATGTGAACAAAAAAAATTCTAGTTGGT,10,30,14,27,27,42,27,55,27,35,35,42,48,55,62.83,0.706299684
hek293t,10437,1,15,CGTAGCATTAACAAATGGAAAAATGGTAGAGGTCCTTTTAGGAGACATTCAACTTCCTGCAGTCTATGCAAAAAAATTCTAGTTGGTTTAACGCGTAAC,CGTAGCATTAACAAATGGAAAAATGGTAGAGGTCCTGCCTCATTATGGGTTTTTAGGAGACATTCAACTTCCTGCAGTCTATGCAAAAAAATTCTAGTT,10,30,14,27,27,39,27,54,27,36,36,39,51,54,16.68,0.0
hek293t,10438,1,14,TCCGCCGATGAGTTAAAGGTTTAAAAAGAAGGTATGTTTGATTTACAAAGTTGTCCAGCATGGTTAAAAAAATTCTAGTTGGTTTAACGCGTAACTAGA,TCCGCCGATGAGTTAAAGGTTTAAAAAGAAGGTATGCCTAGCCCATTATCTTTGATTTACAAAGTTGTCCAGCATGGTTAAAAAAATTCTAGTTGGTTT,10,30,14,27,27,44,27,58,27,37,37,44,51,58,36.65,0.0
hek293t,10439,1,7,ATACATGAATACTTCAAAAGACTTCAGGAAGGAGTTAAATAATTTCTTCATCTATAACAATGCGAAAAGTGGTATAGTCATAAAAAAAATTCTAGTTGG,ATACATGAATACTTCAAAAGACTTCAGGACCGCGGAAGGAGTTAAATAATTTCTTCATCTATAACAATGCGAAAAGTGGTATAGTCATAAAAAAAATTC,10,30,14,27,27,34,27,41,27,27,27,34,34,41,68.96,0.274957968
hek293t,10439,1,7,ACCTTTGAATACTTCAAAAGACTTCAGGAAGGAGTTAAATAATTTCTTCATCTATAACAATGCGAAAAGTGGTAAAAAAAATTCTAGTTGGTTTAACGC,ACCTTTGAATACTTCAAAAGACTTCAGGACCGCGGAAGGAGTTAAATAATTTCTTCATCTATAACAATGCGAAAAGTGGTAAAAAAAATTCTAGTTGGT,10,30,14,27,27,42,27,49,27,27,27,42,34,49,68.96,0.0
hek293t,10441,1,7,TACTGTTCATTCCAGAAGGAGCTGTACTGTGGTGGAAAGTGATGCTGCTAGTCCTACCTGTAATTTGCATAGCAAAAAAAATTCTAGTTGGTTTAACGC,TACTGTTCATTCCAGAAGGAGCTGTACTGTGCAAAGGGGTGGAAAGTGATGCTGCTAGTCCTACCTGTAATTTGCATAGCAAAAAAAATTCTAGTTGGT,10,30,14,27,27,42,27,49,27,32,32,42,39,49,62.81,7.326185867
hek293t,10441,1,7,ACGCTTTCATTCCAGAAGGAGCTGTACTGTGGTGGAAAGTGATGCTGCTAGTCCTACCTGTAATTTGCATAGCACACAAAAAAATTCTAGTTGGTTTAA,ACGCTTTCATTCCAGAAGGAGCTGTACTGTGCAAAGGGGTGGAAAGTGATGCTGCTAGTCCTACCTGTAATTTGCATAGCACACAAAAAAATTCTAGTT,10,30,14,27,27,39,27,46,27,32,32,39,39,46,62.81,50.43065944
hek293t,10443,1,15,GCAGGGTGTGATTTAGCTTACGAGGAGAAAGGTCTAGTTTGGATATGGTATAATTGCATGGCAGGCAAAAAAATTCTAGTTGGTTTAACGCGTAACTAG,GCAGGGTGTGATTTAGCTTACGAGGAGAAAGGTCTAGTAAGCCTAGTTAGTCGTTGGATATGGTATAATTGCATGGCAGGCAAAAAAATTCTAGTTGGT,10,30,14,27,27,42,27,57,27,39,39,42,54,57,45.46,0.0
hek293t,10446,1,15,TGGTTCCAACAATGGAAAGGAGAACCGAACGGTTCATAAAAATCTAGATGGCTTACTATAATCATAAAAAAATTCTAGTTGGTTTAACGCGTAACTAGA,TGGTTCCAACAATGGAAAGGAGAACCGTTGGATGGGCAGTTAAACGGTTCATAAAAATCTAGATGGCTTACTATAATCATAAAAAAATTCTAGTTGGTT,10,30,14,27,27,43,27,58,27,28,28,43,43,58,59.78,0.0
hek293t,10446,1,15,ATCTCCCAACAATGGAAAGGAGAACCGAACGGTTCATAAAAATCTAGATGGCTTACTATAATCATCCTCAAAAAAAATTCTAGTTGGTTTAACGCGTAA,ATCTCCCAACAATGGAAAGGAGAACCGTTGGATGGGCAGTTAAACGGTTCATAAAAATCTAGATGGCTTACTATAATCATCCTCAAAAAAAATTCTAGT,10,30,14,27,27,38,27,53,27,28,28,38,43,53,59.78,0.248342354
hek293t,10448,1,7,CGCGTCCCTGCAATGTTCACTTCGTCATGAGGTAAAGCTACACTGAAAATGCTAGTCTGTTTGTATTAAAAAAATTCTAGTTGGTTTAACGCGTAACTA,CGCGTCCCTGCAATGTTCACTTCGTCATGAGGTAAAGCAAATAGATACACTGAAAATGCTAGTCTGTTTGTATTAAAAAAATTCTAGTTGGTTTAACGC,10,30,14,27,27,49,27,56,27,39,39,49,46,56,38.94,1.908428604
hek293t,10449,1,2,CGGTAGAAACCACAGTTAGCCATGCACCACGGCAGTGATGCTGCATCAGTAGGTGTGCTACAAAGAAAAGGTATTCCTTTCAAAGAAGATGAAAAAAAT,CGGTAGAAACCACAGTTAGCCATGCAGGCCACGGCAGTGATGCTGCATCAGTAGGTGTGCTACAAAGAAAAGGTATTCCTTTCAAAGAAGATGAAAAAA,10,30,14,27,27,30,27,32,27,27,27,30,29,32,72.66,0.654878847
hek293t,10451,1,6,CGTCCGGGTTAAGCTACTATTATTCTGTGTGGATTGAAACTTTGTTTCAGGATAGCTTCTGTCACAAATGAACAGCCAAAAAAATTCTAGTTGGTTTAA,CGTCCGGGTTAAGCTACTATTATTCTGTGACCAAGTGGATTGAAACTTTGTTTCAGGATAGCTTCTGTCACAAATGAACAGCCAAAAAAATTCTAGTTG,10,30,14,27,27,40,27,46,27,30,30,40,36,46,64.17,33.01447775
hek293t,10453,1,14,TCGGTTTCAGCTTGCTTAAGGTACTTTACTGGAATTGTTCAGCTTTTTGTAGGATAAGGTTGTCAGTTAAAAAAAAATTCTAGTTGGTTTAACGCGTAA,TCGGTTTCAGCTTGCTTAAGGTACTTTACTGGAATCCATACTGCAGAGGTGTTCAGCTTTTTGTAGGATAAGGTTGTCAGTTAAAAAAAAATTCTAGTT,10,30,14,27,27,39,27,53,27,36,36,39,50,53,13.03,0.271688395
hek293t,10453,1,14,TAGCCTTCAGCTTGCTTAAGGTACTTTACTGGAATTGTTCAGCTTTTTGTAGGATAAGGTTGTCAGAAAAAAATTCTAGTTGGTTTAACGCGTAACTAG,TAGCCTTCAGCTTGCTTAAGGTACTTTACTGGAATCCATACTGCAGAGGTGTTCAGCTTTTTGTAGGATAAGGTTGTCAGAAAAAAATTCTAGTTGGTT,10,30,14,27,27,43,27,57,27,36,36,43,50,57,13.03,0.263157895
hek293t,10455,1,13,GCAAGTTTACGTCTGCTGAAATGCTGAAACGGTCCTTTAAAACACACATGTCTAAGTCTGTGTGAATAAAAAAATTCTAGTTGGTTTAACGCGTAACTA,GCAAGTTTACGTCTGCTGAAATGCTGAAACGGCGATTGTGGTATCTCCTTTAAAACACACATGTCTAAGTCTGTGTGAATAAAAAAATTCTAGTTGGTT,10,30,14,27,27,43,27,56,27,33,33,43,46,56,20.13,0.972333824
hek293t,10456,1,3,TGCACGACAGCCATATAGCTTCAAGGAAAAGGCAGCACTGTGCAGGAAAAGAAGTTTTTACAAGAAAAAAAATTCTAGTTGGTTTAACGCGTAACTAGA,TGCACGACAGCCATATAGCTTCAAGGAAAAGGCAGCACTTCCGTGCAGGAAAAGAAGTTTTTACAAGAAAAAAAATTCTAGTTGGTTTAACGCGTAACT,10,30,14,27,27,55,27,58,27,40,40,55,43,58,51.39,25.49544703
hek293t,10456,1,3,GCTTTGACAGCCATATAGCTTCAAGGAAAAGGCAGCACTGTGCAGGAAAAGAAGTTTTTACAAGACAGGAAAAAAAATTCTAGTTGGTTTAACGCGTAA,GCTTTGACAGCCATATAGCTTCAAGGAAAAGGCAGCACTTCCGTGCAGGAAAAGAAGTTTTTACAAGACAGGAAAAAAAATTCTAGTTGGTTTAACGCG,10,30,14,27,27,50,27,53,27,40,40,50,43,53,51.39,76.76783063
hek293t,10458,1,7,CGCTATGACAACTGACAGTGACAGGGTTGGGGATGGGGTAATACTCAGAGACCATTTAGTAAGCAAAAAGGAGGTAAAAAAAAATTCTAGTTGGTTTAA,CGCTATGACAACTGACAGTGACAGGGTTAGGCCCGGGGGATGGGGTAATACTCAGAGACCATTTAGTAAGCAAAAAGGAGGTAAAAAAAAATTCTAGTT,10,30,14,27,27,39,27,46,27,29,29,39,36,46,50.54,36.29714404
hek293t,10458,1,7,TTAGGTGACAACTGACAGTGACAGGGTTGGGGATGGGGTAATACTCAGAGACCATTTAGTAAGCAAAAAGGAAAAAAAATTCTAGTTGGTTTAACGCGT,TTAGGTGACAACTGACAGTGACAGGGTTAGGCCCGGGGGATGGGGTAATACTCAGAGACCATTTAGTAAGCAAAAAGGAAAAAAAATTCTAGTTGGTTT,10,30,14,27,27,44,27,51,27,29,29,44,36,51,50.54,25.05176341
hek293t,10462,1,15,GACAAAATCCCCTCTTGTCAAATTTATATAGGGCCTATTTACACAGATATTTCATGACGTATCACTTCCTAATAAAAAAATTCTAGTTGGTTTAACGCG,GACAAAATCCCCTCTTGTCAAATTTATATAGGTTTACTATATGGCAGGCCTATTTACACAGATATTTCATGACGTATCACTTCCTAATAAAAAAATTCT,10,30,14,27,27,35,27,50,27,32,32,35,47,50,0.28,0.0
hek293t,10463,1,1,TTTCCATTTCCCCTATTCATGGGTATCCTTGGCATGAAGTCAGCCCCTGAGTATATGGTATATCCAAAAAAAATTCTAGTTGGTTTAACGCGTAACTAG,TTTCCATTTCCCCTATTCATGGGTATCCTTGGCATGAAGTACAGCCCCTGAGTATATGGTATATCCAAAAAAAATTCTAGTTGGTTTAACGCGTAACTA,10,30,14,27,27,56,27,57,27,41,41,56,42,57,25.62,61.61927213
hek293t,10463,1,1,TTAAAATTTCCCCTATTCATGGGTATCCTTGGCATGAAGTCAGCCCCTGAGTATATGGTATATCCATGTTGTTGAAAAAAATTCTAGTTGGTTTAACGC,TTAAAATTTCCCCTATTCATGGGTATCCTTGGCATGAAGTACAGCCCCTGAGTATATGGTATATCCATGTTGTTGAAAAAAATTCTAGTTGGTTTAACG,10,30,14,27,27,48,27,49,27,41,41,48,42,49,25.62,77.4071911
hek293t,10465,1,3,CTTGACATTTTATGTTGCTGCACATACCCAGGCAGCAGGAGAGCTCGTAAAGCAACCAGTGGAATTGGTAGAAAAAAATTCTAGTTGGTTTAACGCGTA,CTTGACATTTTATGTTGCTGCACATACCCAGGCAGCAGGTGGAGAGCTCGTAAAGCAACCAGTGGAATTGGTAGAAAAAAATTCTAGTTGGTTTAACGC,10,30,14,27,27,49,27,52,27,39,39,49,42,52,58.52,5.403821342
hek293t,10465,1,3,GGCAGCATTTTATGTTGCTGCACATACCCAGGCAGCAGGAGAGCTCGTAAAGCAACCAGTGGAATTGGTAGAGCAAAAAAATTCTAGTTGGTTTAACGC,GGCAGCATTTTATGTTGCTGCACATACCCAGGCAGCAGGTGGAGAGCTCGTAAAGCAACCAGTGGAATTGGTAGAGCAAAAAAATTCTAGTTGGTTTAA,10,30,14,27,27,46,27,49,27,39,39,46,42,49,58.52,0.466982582
hek293t,10467,1,10,AATAAACTTGTCTTTACTTTTAATCAGCATGGTTGTAAACTTCAAGAAAATACTTCAGGAAAATACGAAAAAAATTCTAGTTGGTTTAACGCGTAACTA,AATAAACTTGTCTTTACTTTTAATCAGCATGGTTGTAAGGACGCCTGAACTTCAAGAAAATACTTCAGGAAAATACGAAAAAAATTCTAGTTGGTTTAA,10,30,14,27,27,46,27,56,27,39,39,46,49,56,7.35,0.0
hek293t,10469,1,7,TCCCGTCCAAAAGGAAAGTGCTAGAACTCTGGGAGCCACAGAAACAGATGGTGTGCTTCACAACTCCCATAAAAAAAAAATTCTAGTTGGTTTAACGCG,TCCCGTCCAAAAGGAAAGTGCTAGAACCAATTTATCTGGGAGCCACAGAAACAGATGGTGTGCTTCACAACTCCCATAAAAAAAAAATTCTAGTTGGTT,10,30,14,27,27,43,27,50,27,28,28,43,35,50,59.19,54.04334821
hek293t,10469,1,7,TCTGCTCCAAAAGGAAAGTGCTAGAACTCTGGGAGCCACAGAAACAGATGGTGTGCTTCACAACTCCCATAAAACTCTATATTTGAAAAAAATTCTAGT,TCTGCTCCAAAAGGAAAGTGCTAGAACCAATTTATCTGGGAGCCACAGAAACAGATGGTGTGCTTCACAACTCCCATAAAACTCTATATTTGAAAAAAA,10,30,14,27,27,31,27,38,27,28,28,31,35,38,59.19,0.952952152
hek293t,10471,1,6,AGACTCCCTGACTCACATGGTTCACGACACGGGCATTTGTACAACACAGATCATTTCTGTCTTGCTATGGAAGTCTAAAAAAAAATTCTAGTTGGTTTA,AGACTCCCTGACTCACATGGTTCACGACCAAACCACGGGCATTTGTACAACACAGATCATTTCTGTCTTGCTATGGAAGTCTAAAAAAAAATTCTAGTT,10,30,14,27,27,39,27,45,27,29,29,39,35,45,59.2,67.60505487
hek293t,10474,1,9,TCTACGGCTCAAGAATAAATATTCAAAAATGGCAATTTTCAGCTCTAAGTCACTATTCTTATCTCAGTGAAAAAAAATTCTAGTTGGTTTAACGCGTAA,TCTACGGCTCAAGAATAAATATTCAAAAATGGCAATTGTATGTGATTTCAGCTCTAAGTCACTATTCTTATCTCAGTGAAAAAAAATTCTAGTTGGTTT,10,30,14,27,27,44,27,53,27,37,37,44,46,53,3.98,0.0
hek293t,10474,1,9,CGGACGGCTCAAGAATAAATATTCAAAAATGGCAATTTTCAGCTCTAAGTCACTATTCTTATCTCAGAAAAAAATTCTAGTTGGTTTAACGCGTAACTA,CGGACGGCTCAAGAATAAATATTCAAAAATGGCAATTGTATGTGATTTCAGCTCTAAGTCACTATTCTTATCTCAGAAAAAAATTCTAGTTGGTTTAAC,10,30,14,27,27,47,27,56,27,37,37,47,46,56,3.98,0.0
hek293t,10476,1,7,GTGTCGATATTTTACTTATTTGTTCAAAGTGGATGAGCTTTAACAGGATACCTGTTATGTTTAACCTTATTGAAAAAAATTCTAGTTGGTTTAACGCGT,GTGTCGATATTTTACTTATTTGTTCAAAGTGGATGAGCTTTAATATATAACAGGATACCTGTTATGTTTAACCTTATTGAAAAAAATTCTAGTTGGTTT,10,30,14,27,27,44,27,51,27,41,41,44,48,51,-0.06,0.0
hek293t,10477,1,15,CCCCTCAATATTTGGAATTTATACCATTTTGGGTTTCTTTGACAAATGACAGAATACTCAGCTAAAAAAAAATTCTAGTTGGTTTAACGCGTAACTAGA,CCCCTCAATATTTGGAATTTATACCATTTTGGGGTGTATCTCTCAAGGTTTCTTTGACAAATGACAGAATACTCAGCTAAAAAAAAATTCTAGTTGGTT,10,30,14,27,27,43,27,58,27,33,33,43,48,58,1.67,0.827647129
hek293t,10479,1,8,TGTGAGCATTGTTATTTTAACAGGAAAATAGGAGAGCACTAAGTTTTTCACCATGATGCTTTCCTGTCAAACTAAAAAAAAATTCTAGTTGGTTTAACG,TGTGAGCATTGTTATTTTAACAGGAAAATAGGAGAGCGTCAGAGCACTAAGTTTTTCACCATGATGCTTTCCTGTCAAACTAAAAAAAAATTCTAGTTG,10,30,14,27,27,40,27,48,27,33,33,40,41,48,5.92,0.0
hek293t,10479,1,8,TGCATGCATTGTTATTTTAACAGGAAAATAGGAGAGCACTAAGTTTTTCACCATGATGCTTTCCTGTCAAACAAAAAAATTCTAGTTGGTTTAACGCGT,TGCATGCATTGTTATTTTAACAGGAAAATAGGAGAGCGTCAGAGCACTAAGTTTTTCACCATGATGCTTTCCTGTCAAACAAAAAAATTCTAGTTGGTT,10,30,14,27,27,43,27,51,27,33,33,43,41,51,5.92,0.0
hek293t,10481,1,9,GGTTTAATTTATTCAGATTAATGTGTCCGCGGAACAACAGCTCTGAAAGTGCTCAGCAGCTGCTGCTAAGATATTTTGAAAAAAAATTCTAGTTGGTTT,GGTTTAATTTATTCAGATTAATGTGTCCGCGGGAGAATATGAACAACAGCTCTGAAAGTGCTCAGCAGCTGCTGCTAAGATATTTTGAAAAAAAATTCT,10,30,14,27,27,35,27,44,27,32,32,35,41,44,41.56,0.0
hek293t,10483,1,15,CATTTAGTAATTGATACTGTGTGGTCCATTGGCTTCACAGCTGTCTGGTGCGACTCATGTCAGAGGGCAAACAAAAAAATTCTAGTTGGTTTAACGCGT,CATTTAGTAATTGATACTGTGTGGTCCATTGGCCAAGAAGATGCAAGCTTCACAGCTGTCTGGTGCGACTCATGTCAGAGGGCAAACAAAAAAATTCTA,10,30,14,27,27,36,27,51,27,33,33,36,48,51,27.68,0.0
hek293t,10484,1,11,CTAAGCATGGTAAATGTTACAAATGAAATCGGAAGAGTCTGGCAACCATGCAGTTAGTGTCCTTCATATAAAAAAAATTCTAGTTGGTTTAACGCGTAA,CTAAGCATGGTAAATGTTACAAATGAAATCGGAAGAGTTTATATCGCTCCTGGCAACCATGCAGTTAGTGTCCTTCATATAAAAAAAATTCTAGTTGGT,10,30,14,27,27,42,27,53,27,39,39,42,50,53,13.65,0.042194093
hek293t,10485,1,8,GCTCATTTTCAGTTAATTAGCATAATGCATGGCAGTCACTTTGTGAGCAAGCACTAATAGTATGTTACCATTTAAAAAAAAATTCTAGTTGGTTTAACG,GCTCATTTTCAGTTAATTAGCATAATGCATGGCTTGGCGACAGTCACTTTGTGAGCAAGCACTAATAGTATGTTACCATTTAAAAAAAAATTCTAGTTG,10,30,14,27,27,40,27,48,27,33,33,40,41,48,62.85,0.364963504
hek293t,10485,1,8,CAAGGTTTTCAGTTAATTAGCATAATGCATGGCAGTCACTTTGTGAGCAAGCACTAATAGTATGTTACCATTTAATTAGAAAAAAATTCTAGTTGGTTT,CAAGGTTTTCAGTTAATTAGCATAATGCATGGCTTGGCGACAGTCACTTTGTGAGCAAGCACTAATAGTATGTTACCATTTAATTAGAAAAAAATTCTA,10,30,14,27,27,36,27,44,27,33,33,36,41,44,62.85,0.0
hek293t,10487,1,2,TACTACACGGGATTCATGGTAACAGTGTATGGAATCAATTTATGCCTGGCAAGCAAAATAAAAGTATAAAAAAAAATTCTAGTTGGTTTAACGCGTAAC,TACTACACGGGATTCATGGTAACAGTGTATGGAATCTGAATTTATGCCTGGCAAGCAAAATAAAAGTATAAAAAAAAATTCTAGTTGGTTTAACGCGTA,10,30,14,27,27,52,27,54,27,37,37,52,39,54,46.47,33.70478946
hek293t,10487,1,2,GACGACACGGGATTCATGGTAACAGTGTATGGAATCAATTTATGCCTGGCAAGCAAAATAAAAGTATAACATTTCTTAAAAAAATTCTAGTTGGTTTAA,GACGACACGGGATTCATGGTAACAGTGTATGGAATCTGAATTTATGCCTGGCAAGCAAAATAAAAGTATAACATTTCTTAAAAAAATTCTAGTTGGTTT,10,30,14,27,27,44,27,46,27,37,37,44,39,46,46.47,70.45953214
hek293t,10489,1,4,CCAGAAGTACAAGTCCTGCAATGACTGTTTGGGTCTCAGGCAGCCGCTTCTGTCCCTAAACATCTTCTGAAAGCTCTCTGAAAAAAAATTCTAGTTGGT,CCAGAAGTACAAGTCCTGCAATGACTGTTTAAGCGGGTCTCAGGCAGCCGCTTCTGTCCCTAAACATCTTCTGAAAGCTCTCTGAAAAAAAATTCTAGT,10,30,14,27,27,38,27,42,27,31,31,38,35,42,25.48,66.06025944
hek293t,10489,1,4,AAATCAGTACAAGTCCTGCAATGACTGTTTGGGTCTCAGGCAGCCGCTTCTGTCCCTAAACATCTTCTGAAAGCTCTCAAAAAAATTCTAGTTGGTTTA,AAATCAGTACAAGTCCTGCAATGACTGTTTAAGCGGGTCTCAGGCAGCCGCTTCTGTCCCTAAACATCTTCTGAAAGCTCTCAAAAAAATTCTAGTTGG,10,30,14,27,27,41,27,45,27,31,31,41,35,45,25.48,66.58303901
hek293t,10492,1,15,AGCATTTGAGATCCCGGTGCACCAAGTTGCGGTCGTGGAGGTAGCGCACGGCCCCCACGACCTGCGCAAAAAAATTCTAGTTGGTTTAACGCGTAACTA,AGCATTTGAGATCCCGGTGCACCAAGTTGCGGTCGTGGCTTCGTGTGAGGTAGAGGTAGCGCACGGCCCCCACGACCTGCGCAAAAAAATTCTAGTTGG,10,30,14,27,27,41,27,56,27,38,38,41,53,56,62.94,0.219298246
hek293t,10493,1,7,GGCTCACTGTAGATATCTAATATTAGAAGGGGTAGATCCCAGGACAGCTTTCATCAGTAGTCCAGGGCAGGAGAAACAAAAAAAATTCTAGTTGGTTTA,GGCTCACTGTAGATATCTAATATTAGAGGCATAAAGGGGTAGATCCCAGGACAGCTTTCATCAGTAGTCCAGGGCAGGAGAAACAAAAAAAATTCTAGT,10,30,14,27,27,38,27,45,27,28,28,38,35,45,46.96,0.173481788
hek293t,10495,1,6,GCAAAGTGGATTCTGGGACATAACACAAATGGGCATCGTACTAATATGAAGATGTTTTAAGAGTGCTTGTGTTGTAAAAAAATTCTAGTTGGTTTAACG,GCAAAGTGGATTCTGGGACATAACACCATCCTAAATGGGCATCGTACTAATATGAAGATGTTTTAAGAGTGCTTGTGTTGTAAAAAAATTCTAGTTGGT,10,30,14,27,27,42,27,48,27,27,27,42,33,48,29.23,30.91703826
hek293t,10495,1,6,CACTCGTGGATTCTGGGACATAACACAAATGGGCATCGTACTAATATGAAGATGTTTTAAGAGTGCTTGTGTTGTCTTAACGAAAAAAAATTCTAGTTG,CACTCGTGGATTCTGGGACATAACACCATCCTAAATGGGCATCGTACTAATATGAAGATGTTTTAAGAGTGCTTGTGTTGTCTTAACGAAAAAAAATTC,10,30,14,27,27,34,27,40,27,27,27,34,33,40,29.23,9.637200112
hek293t,10497,1,13,CAACACACGTGATTTCGGGGAAAGGCGCCCGGGAGCCGGAACGGGCTGGCTGAGGGGAAGGCGAAAGCGAAAAAAAATTCTAGTTGGTTTAACGCGTAA,CAACACACGTGATTTCGGGGAAAGGCGCCCGGTTAGAAGAGTCCCGAGCCGGAACGGGCTGGCTGAGGGGAAGGCGAAAGCGAAAAAAAATTCTAGTTG,10,30,14,27,27,40,27,53,27,33,33,40,46,53,34.24,0.0
hek293t,10498,1,2,GGACCCTAGCTCTGTTCTGTGTAGGGTAAAGGAGCTACAAAAGGGCAGATAAACCACCCCAAAGCAATGGCTGAAAAAAATTCTAGTTGGTTTAACGCG,GGACCCTAGCTCTGTTCTGTGTAGGGTAAAGGAGCTACAATGAAGGGCAGATAAACCACCCCAAAGCAATGGCTGAAAAAAATTCTAGTTGGTTTAACG,10,30,14,27,27,48,27,50,27,41,41,48,43,50,18.54,17.10777587
hek293t,10500,1,6,CATGAGAAAAGCAGAGTTTGTGGATTTAGAGGGAAAATGACAGAAGAAATAAATATTTCATAGAAAATTATGGGAAAAAAATTCTAGTTGGTTTAACGC,CATGAGAAAAGCAGAGTTTGTGGATTTCTCCGGAGAGGGAAAATGACAGAAGAAATAAATATTTCATAGAAAATTATGGGAAAAAAATTCTAGTTGGTT,10,30,14,27,27,43,27,49,27,28,28,43,34,49,8.85,10.41557344
hek293t,10500,1,6,TTGCAGAAAAGCAGAGTTTGTGGATTTAGAGGGAAAATGACAGAAGAAATAAATATTTCATAGAAAATTATGGGAGCACAAAAAAATTCTAGTTGGTTT,TTGCAGAAAAGCAGAGTTTGTGGATTTCTCCGGAGAGGGAAAATGACAGAAGAAATAAATATTTCATAGAAAATTATGGGAGCACAAAAAAATTCTAGT,10,30,14,27,27,38,27,44,27,28,28,38,34,44,8.85,19.44891983
hek293t,10504,1,9,AGTGTCCGAAGCCACCAGGGCTGCTGTTCTGGGTCATCCTACACACGAGAGGTGCATCTTTGACTTTTCCCAAAAAAAATTCTAGTTGGTTTAACGCGT,AGTGTCCGAAGCCACCAGGGCTGCTGTTCTGGACCTCATTGGTCATCCTACACACGAGAGGTGCATCTTTGACTTTTCCCAAAAAAAATTCTAGTTGGT,10,30,14,27,27,42,27,51,27,32,32,42,41,51,12.42,20.8994709
hek293t,10504,1,9,AGGTACCGAAGCCACCAGGGCTGCTGTTCTGGGTCATCCTACACACGAGAGGTGCATCTTTGACTTTAAAAAAATTCTAGTTGGTTTAACGCGTAACTA,AGGTACCGAAGCCACCAGGGCTGCTGTTCTGGACCTCATTGGTCATCCTACACACGAGAGGTGCATCTTTGACTTTAAAAAAATTCTAGTTGGTTTAAC,10,30,14,27,27,47,27,56,27,32,32,47,41,56,12.42,12.6710486
hek293t,10506,1,9,TGCGATCAAGTAATAACGTATTATCCCACAGGAAAAAGATAATCAATGTGACACCGAAGAAGAAAGCAGATGAAATAAAAAAAATTCTAGTTGGTTTAA,TGCGATCAAGTAATAACGTATTATCCCACATGCCATGTAGGAAAAAGATAATCAATGTGACACCGAAGAAGAAAGCAGATGAAATAAAAAAAATTCTAG,10,30,14,27,27,37,27,46,27,30,30,37,39,46,48.15,0.853765795
hek293t,10506,1,9,ACACCTCAAGTAATAACGTATTATCCCACAGGAAAAAGATAATCAATGTGACACCGAAGAAGAAAGCAGATGAAATAAATAAAAAAAATTCTAGTTGGT,ACACCTCAAGTAATAACGTATTATCCCACATGCCATGTAGGAAAAAGATAATCAATGTGACACCGAAGAAGAAAGCAGATGAAATAAATAAAAAAAATT,10,30,14,27,27,33,27,42,27,30,30,33,39,42,48.15,1.200384937
hek293t,10508,1,5,AGTTGGTTAGATTGTAAAATTATTTACCAAGGGCTTAACAACTCGGTTACGTTCCCTTAGAATAGTTAGAGATGTCTATCAAAAAAATTCTAGTTGGTT,AGTTGGTTAGATTGTAAAATTATTTACCAATGATTGGGCTTAACAACTCGGTTACGTTCCCTTAGAATAGTTAGAGATGTCTATCAAAAAAATTCTAGT,10,30,14,27,27,38,27,43,27,31,31,38,36,43,19.98,0.0
hek293t,10510,1,3,CTGCGTAAGGTACAGGCCTGGACTCATTTTGGTAATGCTACCGACAGTGCCTATTTTTTGAGTTTGACTAGCCCCTGAAAAAAATTCTAGTTGGTTTAA,CTGCGTAAGGTACAGGCCTGGACTCATAGTTTTGGTAATGCTACCGACAGTGCCTATTTTTTGAGTTTGACTAGCCCCTGAAAAAAATTCTAGTTGGTT,10,30,14,27,27,43,27,46,27,28,28,43,31,46,26.1,85.06000497
hek293t,10512,1,4,ACTCAATGAATTCCTATTGTACAAGCCTCTGGGGTAGACAATACTACTTAATACAGTGAACGTATGAGTATTGATAAAAAAAATTCTAGTTGGTTTAAC,ACTCAATGAATTCCTATTGTACAAGCCGATATCTGGGGTAGACAATACTACTTAATACAGTGAACGTATGAGTATTGATAAAAAAAATTCTAGTTGGTT,10,30,14,27,27,43,27,47,27,28,28,43,32,47,42.12,82.34150821
hek293t,10512,1,4,GTTGGATGAATTCCTATTGTACAAGCCTCTGGGGTAGACAATACTACTTAATACAGTGAACGTATGAGTATTGATACCCCGTGTTCAGAAAAAAATTCT,GTTGGATGAATTCCTATTGTACAAGCCGATATCTGGGGTAGACAATACTACTTAATACAGTGAACGTATGAGTATTGATACCCCGTGTTCAGAAAAAAA,10,30,14,27,27,31,27,35,27,28,28,31,32,35,42.12,2.117098074
hek293t,10514,1,2,CTGAGTATCCAACATGTCCAAGATGGGTGTGGGGTGAATTAATACAAACTGGAATAAGGATTGAATGAATACAAATAAAAAAATTCTAGTTGGTTTAAC,CTGAGTATCCAACATGTCCAAGATGGGTGTGGGGAGTGAATTAATACAAACTGGAATAAGGATTGAATGAATACAAATAAAAAAATTCTAGTTGGTTTA,10,30,14,27,27,45,27,47,27,35,35,45,37,47,42.88,74.51699532
hek293t,10516,1,8,TGTCACATACTGGACTGTACACACATCTTTGGGGGCTACATAGCTGGGTAATGTCGCTAATAAACTGAAAAAAAAAATTCTAGTTGGTTTAACGCGTAA,TGTCACATACTGGACTGTACACACATCTTTGGGGGCTGTGCGAGTACATAGCTGGGTAATGTCGCTAATAAACTGAAAAAAAAAATTCTAGTTGGTTTA,10,30,14,27,27,45,27,53,27,38,38,45,46,53,30.69,0.964587738
hek293t,10516,1,8,GCTAGCATACTGGACTGTACACACATCTTTGGGGGCTACATAGCTGGGTAATGTCGCTAATAAACTGAAAATAAAAAAAAATTCTAGTTGGTTTAACGC,GCTAGCATACTGGACTGTACACACATCTTTGGGGGCTGTGCGAGTACATAGCTGGGTAATGTCGCTAATAAACTGAAAATAAAAAAAAATTCTAGTTGG,10,30,14,27,27,41,27,49,27,38,38,41,46,49,30.69,0.0
hek293t,10518,1,7,GGGGGCAATGCCTATCAATTGGTATTGATAGGCAGGGGATGGGATGTTTAGGAGACCCTCATGGGAGACAGTTAAAAAAATTCTAGTTGGTTTAACGCG,GGGGGCAATGCCTATCAATTGGTATTGATAGGCAGGGGACAATGCCTGGGATGTTTAGGAGACCCTCATGGGAGACAGTTAAAAAAATTCTAGTTGGTT,10,30,14,27,27,43,27,50,27,40,40,43,47,50,43.36,0.0
hek293t,10519,1,13,GTAAAGAAGCTTCTTCATGTTAAGCATGTAGGTAAGGGGCTCCGTAACGGCCTGAAACACCATCTGCAAAAAAATTCTAGTTGGTTTAACGCGTAACTA,GTAAAGAAGCTTCTTCATGTTAAGCATGTAGGGCACGTTGTGTGTTAAGGGGCTCCGTAACGGCCTGAAACACCATCTGCAAAAAAATTCTAGTTGGTT,10,30,14,27,27,43,27,56,27,33,33,43,46,56,31.94,3.071263816
hek293t,10520,1,12,GATGGTGTCTGTATATAACTCTCCTGGTAAGGGTAGCATCTGGGTACAGTTTGTTCCACCAGTTGCAAAAAAATTCTAGTTGGTTTAACGCGTAACTAG,GATGGTGTCTGTATATAACTCTCCTGGTAAGGGTAGCTGCAAAGCTCAGATCTGGGTACAGTTTGTTCCACCAGTTGCAAAAAAATTCTAGTTGGTTTA,10,30,14,27,27,45,27,57,27,38,38,45,50,57,32.13,0.787401575
hek293t,10522,1,1,GGTGAAAGACAAAGAACATTTAAAGTGTTCGGTAAGCTGGGCTGTACATTCTCAAGTATTGACATACTACTTAAAAAAAAATTCTAGTTGGTTTAACGC,GGTGAAAGACAAAGAACATTTAAAGTGTTCGGCTAAGCTGGGCTGTACATTCTCAAGTATTGACATACTACTTAAAAAAAAATTCTAGTTGGTTTAACG,10,30,14,27,27,48,27,49,27,33,33,48,34,49,9.02,0.118536817
hek293t,10522,1,1,GAGAGAAGACAAAGAACATTTAAAGTGTTCGGTAAGCTGGGCTGTACATTCTCAAGTATTGACATACTACTTAAATGCGAAAAAAATTCTAGTTGGTTT,GAGAGAAGACAAAGAACATTTAAAGTGTTCGGCTAAGCTGGGCTGTACATTCTCAAGTATTGACATACTACTTAAATGCGAAAAAAATTCTAGTTGGTT,10,30,14,27,27,43,27,44,27,33,33,43,34,44,9.02,0.23311161
hek293t,10524,1,5,CATGTATGTACAAAATAAGAAATTACTCAAGGGTAAAACTCTAACTAAAGCCCTAATCTCACCCCTATCTTGTGGGCAATACCAAAAAAATTCTAGTTG,CATGTATGTACAAAATAAGAAATTACTATGCTCAAGGGTAAAACTCTAACTAAAGCCCTAATCTCACCCCTATCTTGTGGGCAATACCAAAAAAATTCT,10,30,14,27,27,35,27,40,27,28,28,35,33,40,19.67,0.634672514
hek293t,10524,1,5,ACGAAATGTACAAAATAAGAAATTACTCAAGGGTAAAACTCTAACTAAAGCCCTAATCTCACCCCTATCTTGTGGGCAATACCCCTCAAAAAAATTCTA,ACGAAATGTACAAAATAAGAAATTACTATGCTCAAGGGTAAAACTCTAACTAAAGCCCTAATCTCACCCCTATCTTGTGGGCAATACCCCTCAAAAAAA,10,30,14,27,27,31,27,36,27,28,28,31,33,36,19.67,0.0
hek293t,10527,1,10,TTTTAGACTACACCTCCAGAAAGGAGCTCAGGAAACTGGTGCTTTCATTCCCCAGAGGTGCAACTTAAAAAAATTCTAGTTGGTTTAACGCGTAACTAG,TTTTAGACTACACCTCCAGAAAGGAGCTCAGGAAACTGGTACTAGGAGATGCTTTCATTCCCCAGAGGTGCAACTTAAAAAAATTCTAGTTGGTTTAAC,10,30,14,27,27,47,27,57,27,40,40,47,50,57,57.7,0.0
hek293t,10528,1,11,CACCGCTGCACGAAATCAGGGGCAGAGTGTGGGTGAGTCAGAAACAAAGGTGATTTTGGAAGAGAGGAAAAGATAAAAAAAAATTCTAGTTGGTTTAAC,CACCGCTGCACGAAATCAGGGGCAGAGTGTGGCGATCAACAAGGTGAGTCAGAAACAAAGGTGATTTTGGAAGAGAGGAAAAGATAAAAAAAAATTCTA,10,30,14,27,27,36,27,47,27,33,33,36,44,47,47.62,0.0
hek293t,10528,1,11,AAATACTGCACGAAATCAGGGGCAGAGTGTGGGTGAGTCAGAAACAAAGGTGATTTTGGAAGAGAGGAAAAAAAAATTCTAGTTGGTTTAACGCGTAAC,AAATACTGCACGAAATCAGGGGCAGAGTGTGGCGATCAACAAGGTGAGTCAGAAACAAAGGTGATTTTGGAAGAGAGGAAAAAAAAATTCTAGTTGGTT,10,30,14,27,27,43,27,54,27,33,33,43,44,54,47.62,1.269563421
hek293t,10530,1,1,CGGATACATGTAGTTTGGAAAGTATAAATAGGCTTCAGACAGGCATCAGAATACATGTGTCATTGGACAAATGCCAAGACACGAAAAAAAAAATTCTAG,CGGATACATGTAGTTTGGAAAGTATAAAATAGGCTTCAGACAGGCATCAGAATACATGTGTCATTGGACAAATGCCAAGACACGAAAAAAAAAATTCTA,10,30,14,27,27,36,27,37,27,29,29,36,30,37,28.41,0.374531835
hek293t,10530,1,1,CACGGACATGTAGTTTGGAAAGTATAAATAGGCTTCAGACAGGCATCAGAATACATGTGTCATTGGACAAATGCCAAGACACGAAAAATGAAAAAAATT,CACGGACATGTAGTTTGGAAAGTATAAAATAGGCTTCAGACAGGCATCAGAATACATGTGTCATTGGACAAATGCCAAGACACGAAAAATGAAAAAAAT,10,30,14,27,27,32,27,33,27,29,29,32,30,33,28.41,0.975083433
hek293t,10532,1,3,ACACCCTCTGATGTCTTCGCACAGCTCAGAGGCAATTCGTCATACTTTGCAAAGCACACCGGCACATGCAAAAAAAAATTCTAGTTGGTTTAACGCGTA,ACACCCTCTGATGTCTTCGCACAGCTCAGAGGCAATTCGTCGTCATACTTTGCAAAGCACACCGGCACATGCAAAAAAAAATTCTAGTTGGTTTAACGC,10,30,14,27,27,49,27,52,27,39,39,49,42,52,69.31,81.82755603
hek293t,10532,1,3,GGGTCCTCTGATGTCTTCGCACAGCTCAGAGGCAATTCGTCATACTTTGCAAAGCACACCGGCACAAAAAAAATTCTAGTTGGTTTAACGCGTAACTAG,GGGTCCTCTGATGTCTTCGCACAGCTCAGAGGCAATTCGTCGTCATACTTTGCAAAGCACACCGGCACAAAAAAAATTCTAGTTGGTTTAACGCGTAAC,10,30,14,27,27,54,27,57,27,39,39,54,42,57,69.31,84.81092402
hek293t,10534,1,3,GCTCAGACCATGAACAGCCGGATCTGATGTGGTATGAAGCAGCTGCAGCCTGCCCTAAAGAGGACCCTGATCCTTGTGAGTGACTAAAAAAATTCTAGT,GCTCAGACCATGAACAGCCGGATCTGATGTGTACGTATGAAGCAGCTGCAGCCTGCCCTAAAGAGGACCCTGATCCTTGTGAGTGACTAAAAAAATTCT,10,30,14,27,27,35,27,38,27,32,32,35,35,38,59.69,16.94129551
hek293t,10534,1,3,TGCCAGACCATGAACAGCCGGATCTGATGTGGTATGAAGCAGCTGCAGCCTGCCCTAAAGAGGACCCTGATCCTTGTGAGTAAAAAAATTCTAGTTGGT,TGCCAGACCATGAACAGCCGGATCTGATGTGTACGTATGAAGCAGCTGCAGCCTGCCCTAAAGAGGACCCTGATCCTTGTGAGTAAAAAAATTCTAGTT,10,30,14,27,27,39,27,42,27,32,32,39,35,42,59.69,88.26709692
hek293t,10536,1,3,AAAACCGGGGGAGGAAAGGAGGGTTGATATGGATCAGTATAATGATCCTGTATATATTTTGAAAATCAGTATTGTTTCTGAATTTTCAAAAAAATTCTA,AAAACCGGGGGAGGAAAGGAGGGTTGATATTGTGGATCAGTATAATGATCCTGTATATATTTTGAAAATCAGTATTGTTTCTGAATTTTCAAAAAAATT,10,30,14,27,27,33,27,36,27,30,30,33,33,36,34.43,0.943118184
hek293t,10536,1,3,TCATGCGGGGGAGGAAAGGAGGGTTGATATGGATCAGTATAATGATCCTGTATATATTTTGAAAATCAGTATTGTTTCTGAATAAAAAAATTCTAGTTG,TCATGCGGGGGAGGAAAGGAGGGTTGATATTGTGGATCAGTATAATGATCCTGTATATATTTTGAAAATCAGTATTGTTTCTGAATAAAAAAATTCTAG,10,30,14,27,27,37,27,40,27,30,30,37,33,40,34.43,66.77049312
hek293t,10538,1,5,TAAGTCATGTAAAAAGCAGAACCTGAAGCTGGGTGTCCATGCTGCCACCTTTGTCCCAGCCATTCAACCCTCAAACAAAAAAATTCTAGTTGGTTTAAC,TAAGTCATGTAAAAAGCAGAACCTGATCCAGAGCTGGGTGTCCATGCTGCCACCTTTGTCCCAGCCATTCAACCCTCAAACAAAAAAATTCTAGTTGGT,10,30,14,27,27,42,27,47,27,27,27,42,32,47,32.41,44.55816723
hek293t,10538,1,5,CTGTACATGTAAAAAGCAGAACCTGAAGCTGGGTGTCCATGCTGCCACCTTTGTCCCAGCCATTCAACCCTCAAACCAGGCCACAAAAAAATTCTAGTT,CTGTACATGTAAAAAGCAGAACCTGATCCAGAGCTGGGTGTCCATGCTGCCACCTTTGTCCCAGCCATTCAACCCTCAAACCAGGCCACAAAAAAATTC,10,30,14,27,27,34,27,39,27,27,27,34,32,39,32.41,29.41421042
hek293t,10540,1,7,GAACTCAGGTTAGATCTGCCTGTGACATGTGGGAAATCTCTTAGCATGTAGAACAATTACTCTGTGGAACTTCTAGAAACCAAAAAAATTCTAGTTGGT,GAACTCAGGTTAGATCTGCCTGTGACAGTACTGCTGTGGGAAATCTCTTAGCATGTAGAACAATTACTCTGTGGAACTTCTAGAAACCAAAAAAATTCT,10,30,14,27,27,35,27,42,27,28,28,35,35,42,57.83,21.28768191
hek293t,10540,1,7,TTGTTCAGGTTAGATCTGCCTGTGACATGTGGGAAATCTCTTAGCATGTAGAACAATTACTCTGTGGAACTTCAAAAAAATTCTAGTTGGTTTAACGCG,TTGTTCAGGTTAGATCTGCCTGTGACAGTACTGCTGTGGGAAATCTCTTAGCATGTAGAACAATTACTCTGTGGAACTTCAAAAAAATTCTAGTTGGTT,10,30,14,27,27,43,27,50,27,28,28,43,35,50,57.83,72.35290839
hek293t,10542,1,13,GGACAATGTCATTCCCTGCAGCTTTAACTTGGTCTGTTTGGTGTCTTTTCTTGATTTTGGCTGGACAATTAAAAAAATTCTAGTTGGTTTAACGCGTAA,GGACAATGTCATTCCCTGCAGCTTTAACTTGGTCTGAGGATCAATCATATTTGGTGTCTTTTCTTGATTTTGGCTGGACAATTAAAAAAATTCTAGTTG,10,30,14,27,27,40,27,53,27,37,37,40,50,53,29.37,0.0
hek293t,10547,1,10,ACCCCTAACAAACAGTACATTTACTGAACAGGTTTATGACTGCTTGTCAAATTCACACAACAAAGGCCAGCTAAAAAAATTCTAGTTGGTTTAACGCGT,ACCCCTAACAAACAGTACATTTACTGAACAGGTACCCTATGTTTTATGACTGCTTGTCAAATTCACACAACAAAGGCCAGCTAAAAAAATTCTAGTTGG,10,30,14,27,27,41,27,51,27,34,34,41,44,51,15.41,1.612536152
hek293t,10547,1,10,TCGGTTAACAAACAGTACATTTACTGAACAGGTTTATGACTGCTTGTCAAATTCACACAACAAAGGCCAAAAAAAATTCTAGTTGGTTTAACGCGTAAC,TCGGTTAACAAACAGTACATTTACTGAACAGGTACCCTATGTTTTATGACTGCTTGTCAAATTCACACAACAAAGGCCAAAAAAAATTCTAGTTGGTTT,10,30,14,27,27,44,27,54,27,34,34,44,44,54,15.41,3.662437539
hek293t,10549,1,8,GGGACGCAGTAGTTACAATATATAATTTTAGGCACATAGCTGCCTTGTTATGATGATATATATCGTATATGTTCTGAATCTTCAGAAAAAAATTCTAGT,GGGACGCAGTAGTTACAATATATAATTCCAGTAATTTAGGCACATAGCTGCCTTGTTATGATGATATATATCGTATATGTTCTGAATCTTCAGAAAAAA,10,30,14,27,27,30,27,38,27,27,27,30,35,38,9.97,0.0
hek293t,10551,1,12,CAAACAACCAGGAATCATTCACATATTCTAGGCGCACTTACCGTTACCAGCCACCGGCAACAGTTTTTTGTGCAAAAAAATTCTAGTTGGTTTAACGCG,CAAACAACCAGGAATCATTCACATATTCGGAATATTACTCTAGGCGCACTTACCGTTACCAGCCACCGGCAACAGTTTTTTGTGCAAAAAAATTCTAGT,10,30,14,27,27,38,27,50,27,28,28,38,40,50,15.34,31.09303148
hek293t,10553,1,11,CCGCTCCTTTATTCCGAAACAACTGGGCTAGGAGTGTCATGTCATATACTTTGGGAAGGACCCCGTTTAAAAAAATTCTAGTTGGTTTAACGCGTAACT,CCGCTCCTTTATTCCGAAACAACTGGGCTAGGAGTGTCATGGTACCGCATGGTCATATACTTTGGGAAGGACCCCGTTTAAAAAAATTCTAGTTGGTTT,10,30,14,27,27,44,27,55,27,41,41,44,52,55,30.11,0.0
hek293t,10554,1,6,GTAGGAATCTGGAAAGAATATTACAGACGCGGAAATAAAGTGAATGCTAAATTTCATAACAATGAGACACACTAAGAAATAAAAAAAAAATTCTAGTTG,GTAGGAATCTGGAAAGAATATTACAGTCCTGAACGCGGAAATAAAGTGAATGCTAAATTTCATAACAATGAGACACACTAAGAAATAAAAAAAAAATTC,10,30,14,27,27,34,27,40,27,27,27,34,33,40,48.35,3.306029495
hek293t,10554,1,6,CCGCAAATCTGGAAAGAATATTACAGACGCGGAAATAAAGTGAATGCTAAATTTCATAACAATGAGACACACTAAGAAATAAATGTCAAAAAAATTCTA,CCGCAAATCTGGAAAGAATATTACAGTCCTGAACGCGGAAATAAAGTGAATGCTAAATTTCATAACAATGAGACACACTAAGAAATAAATGTCAAAAAA,10,30,14,27,27,30,27,36,27,27,27,30,33,36,48.35,0.0
hek293t,10556,1,1,TGATATTATGCAATTCATGAAGTATCAGATGGCTTCCCATAATGGATTCAGAGAAGAAAAGAAAAAGTCTAAAAAAATTCTAGTTGGTTTAACGCGTAA,TGATATTATGCAATTCATGAAGTATCAGATGGCTTCGCCATAATGGATTCAGAGAAGAAAAGAAAAAGTCTAAAAAAATTCTAGTTGGTTTAACGCGTA,10,30,14,27,27,52,27,53,27,37,37,52,38,53,39.93,9.588009066
hek293t,10556,1,1,TTCTCTTATGCAATTCATGAAGTATCAGATGGCTTCCCATAATGGATTCAGAGAAGAAAAGAAAAAGTCTCAGCCAAAAAAATTCTAGTTGGTTTAACG,TTCTCTTATGCAATTCATGAAGTATCAGATGGCTTCGCCATAATGGATTCAGAGAAGAAAAGAAAAAGTCTCAGCCAAAAAAATTCTAGTTGGTTTAAC,10,30,14,27,27,47,27,48,27,37,37,47,38,48,39.93,62.93913674
hek293t,10558,1,3,GTCGTATGGTTCTAAGGAACAAATAATATTGGTGTTTACTGAAGCTAAGCGTTTAAAATTCCTTCATGCATACTCTGCAAGAAAAAAAATTCTAGTTGG,GTCGTATGGTTCTAAGGAACAAATAATATTGGTGAACTTTACTGAAGCTAAGCGTTTAAAATTCCTTCATGCATACTCTGCAAGAAAAAAAATTCTAGT,10,30,14,27,27,38,27,41,27,35,35,38,38,41,7.52,0.0
hek293t,10560,1,5,CGACAAGTGATTTAAGCAGGCAGGGAATGGGGCTGGGATGACGGAAGGGTCTCATGGAAAATCGTTCTCCTCGGGCTCAAAAAAATTCTAGTTGGTTTA,CGACAAGTGATTTAAGCAGGCAGGGAATGGGGCGCGTCTGGGATGACGGAAGGGTCTCATGGAAAATCGTTCTCCTCGGGCTCAAAAAAATTCTAGTTG,10,30,14,27,27,40,27,45,27,33,33,40,38,45,46.09,52.02455746
hek293t,10560,1,5,CTTGTAGTGATTTAAGCAGGCAGGGAATGGGGCTGGGATGACGGAAGGGTCTCATGGAAAATCGTTCTCCAAAAAAATTCTAGTTGGTTTAACGCGTAA,CTTGTAGTGATTTAAGCAGGCAGGGAATGGGGCGCGTCTGGGATGACGGAAGGGTCTCATGGAAAATCGTTCTCCAAAAAAATTCTAGTTGGTTTAACG,10,30,14,27,27,48,27,53,27,33,33,48,38,53,46.09,65.31008923
hek293t,10562,1,11,GATCGTCTTCTTGATCACTTTTTCTGAGGAGGGCGCACCACTCAGCTTAATTTTTTCTATCGTGCCACTAGAATTAAAAAAATTCTAGTTGGTTTAACG,GATCGTCTTCTTGATCACTTTTTCTGAGGAGGGCTGGGCCGCCACGCACCACTCAGCTTAATTTTTTCTATCGTGCCACTAGAATTAAAAAAATTCTAG,10,30,14,27,27,37,27,48,27,34,34,37,45,48,3.13,0.0
hek293t,10562,1,11,CGCATTCTTCTTGATCACTTTTTCTGAGGAGGGCGCACCACTCAGCTTAATTTTTTCTATCGTGCCACAAAAAAATTCTAGTTGGTTTAACGCGTAACT,CGCATTCTTCTTGATCACTTTTTCTGAGGAGGGCTGGGCCGCCACGCACCACTCAGCTTAATTTTTTCTATCGTGCCACAAAAAAATTCTAGTTGGTTT,10,30,14,27,27,44,27,55,27,34,34,44,45,55,3.13,3.033766758
hek293t,10564,1,10,CAGCCCAAAACAAGTAACCTTTCACAAATAGGATCCCTATTGCAGACTGATACATTGCCTCTATAGAATAGGTACCCTGTAAAAAAATTCTAGTTGGTT,CAGCCCAAAACAAGTAACCTTTCACAAATAATCATACTGAGGATCCCTATTGCAGACTGATACATTGCCTCTATAGAATAGGTACCCTGTAAAAAAATT,10,30,14,27,27,33,27,43,27,30,30,33,40,43,6.69,0.0
hek293t,10564,1,10,ACGGTCAAAACAAGTAACCTTTCACAAATAGGATCCCTATTGCAGACTGATACATTGCCTCTATAGAAAAAAAAATTCTAGTTGGTTTAACGCGTAACT,ACGGTCAAAACAAGTAACCTTTCACAAATAATCATACTGAGGATCCCTATTGCAGACTGATACATTGCCTCTATAGAAAAAAAAATTCTAGTTGGTTTA,10,30,14,27,27,45,27,55,27,30,30,45,40,55,6.69,13.04703802
hek293t,10566,1,4,GTTGATGGCAAGTGGGAGTCATAGGATGGAGGAATAACACGGAGCAGTGGAGGCTCAGTGTCAGCTGTGCTAAAAAAATTCTAGTTGGTTTAACGCGTA,GTTGATGGCAAGTGGGAGTCATAGGATGGAGGAATAACACCACGGGAGCAGTGGAGGCTCAGTGTCAGCTGTGCTAAAAAAATTCTAGTTGGTTTAACG,10,30,14,27,27,48,27,52,27,41,41,48,45,52,66.73,56.42433484
hek293t,10567,1,9,ACATTTAAATCCTGAGGATCTGGAAAGGCAGGAGTTTGTCAAATGAACATGAGCCTCTAAAGGACTGCACCGACTAAAAAAATTCTAGTTGGTTTAACG,ACATTTAAATCCTGAGGATCTGGAAAGGCAGGAGTTATAGTCGCTTGTCAAATGAACATGAGCCTCTAAAGGACTGCACCGACTAAAAAAATTCTAGTT,10,30,14,27,27,39,27,48,27,36,36,39,45,48,51.33,0.0
hek293t,10568,1,4,CGGGCTGAGAATTAAGTCATGACCATCTGTGGCACTGGAAAATTTCAGTTGTTACGTAAGTGAGAGGGAAAAAAAATTCTAGTTGGTTTAACGCGTAAC,CGGGCTGAGAATTAAGTCATGACCATCTGTGGCACTGGATCAGAAATTTCAGTTGTTACGTAAGTGAGAGGGAAAAAAAATTCTAGTTGGTTTAACGCG,10,30,14,27,27,50,27,54,27,40,40,50,44,54,47.86,32.36953855
hek293t,10568,1,4,AACTCTGAGAATTAAGTCATGACCATCTGTGGCACTGGAAAATTTCAGTTGTTACGTAAGTGAGAAAAAAATTCTAGTTGGTTTAACGCGTAACTAGAT,AACTCTGAGAATTAAGTCATGACCATCTGTGGCACTGGATCAGAAATTTCAGTTGTTACGTAAGTGAGAAAAAAATTCTAGTTGGTTTAACGCGTAACT,10,30,14,27,27,55,27,59,27,40,40,55,44,59,47.86,24.84821681
hek293t,10570,1,10,ACATAACTCAGGCCAGCTTATTTCCTGATAGGAGATCCCACCCAGGAAATCTCATGAGATTCAATCTTTCAAAAAAATTCTAGTTGGTTTAACGCGTAA,ACATAACTCAGGCCAGCTTATTTCCTGATAGGAGACAGGTCTATATCCCACCCAGGAAATCTCATGAGATTCAATCTTTCAAAAAAATTCTAGTTGGTT,10,30,14,27,27,43,27,53,27,36,36,43,46,53,22.01,21.08273471
hek293t,2566,1,10,GAAATAAGGTTTTAAGAACCATTGGTCTCTGGGGATGTGTTGGCATGCAGGGCTGCCTTTCAACCACAAATAAAAAAATTCTAGTTGGTTTAACGCGTA,GAAATAAGGTTTTAAGAACCATTGGTTGCGCGTAGGCTCTGGGGATGTGTTGGCATGCAGGGCTGCCTTTCAACCACAAATAAAAAAATTCTAGTTGGT,10,30,14,27,27,42,27,52,27,27,27,42,37,52,8.42,8.927695291
hek293t,2566,1,10,TCGCTAAGGTTTTAAGAACCATTGGTCTCTGGGGATGTGTTGGCATGCAGGGCTGCCTTTCAACCACAAATGAACTAGTGTGAAAAAAAATTCTAGTTG,TCGCTAAGGTTTTAAGAACCATTGGTTGCGCGTAGGCTCTGGGGATGTGTTGGCATGCAGGGCTGCCTTTCAACCACAAATGAACTAGTGTGAAAAAAA,10,30,14,27,27,30,27,40,27,27,27,30,37,40,8.42,0.519673348
hek293t,2745,1,2,CGATCTCTCACATTAGTTAAGAGTTGCGGTGGGAGCGCAAGCCAAGCGACTTGCTCCAGTGTCACAGAAAAAAATTCTAGTTGGTTTAACGCGTAACTA,CGATCTCTCACATTAGTTAAGAGTTGCGGTGGGAGCGCATAAGCCAAGCGACTTGCTCCAGTGTCACAGAAAAAAATTCTAGTTGGTTTAACGCGTAAC,10,30,14,27,27,54,27,56,27,39,39,54,41,56,51.33,16.71177055
hek293t,2745,1,2,CAGAATCTCACATTAGTTAAGAGTTGCGGTGGGAGCGCAAGCCAAGCGACTTGCTCCAGTGTCACAGAAATAAATAAAAAAATTCTAGTTGGTTTAACG,CAGAATCTCACATTAGTTAAGAGTTGCGGTGGGAGCGCATAAGCCAAGCGACTTGCTCCAGTGTCACAGAAATAAATAAAAAAATTCTAGTTGGTTTAA,10,30,14,27,27,46,27,48,27,39,39,46,41,48,51.33,14.21956181
hek293t,10576,1,6,GCCCAGGACGCTGTTGCATTAACCTTTATAGGATTGTTTGTTTTTAAGTCAAGAGGAGATTCACAGCAGAAAAAAAATTCTAGTTGGTTTAACGCGTAA,GCCCAGGACGCTGTTGCATTAACCTTTATAGGATTGTTTCCACGCGTTTTTAAGTCAAGAGGAGATTCACAGCAGAAAAAAAATTCTAGTTGGTTTAAC,10,30,14,27,27,47,27,53,27,40,40,47,46,53,5.89,1.01010101
hek293t,10577,1,14,CATGACTTGCATCCTGAGCTTGCGCTAGCTGGTCTGTGTGAAACTTAAAATATGTTGCCTAGTGATAAAAAAAATTCTAGTTGGTTTAACGCGTAACTA,CATGACTTGCATCCTGAGCTTGCGCTAGCTGGTCTGTGGCACATGGACGTATTGAAACTTAAAATATGTTGCCTAGTGATAAAAAAAATTCTAGTTGGT,10,30,14,27,27,42,27,56,27,39,39,42,53,56,13.45,0.0
hek293t,10578,1,15,GTGAAAGATAACATTTGAGCCATGCTTTTAGGCTAGCAATTTTGGATCTATAGTCTTGATTGACGTGCGCATCAAAAAAATTCTAGTTGGTTTAACGCG,GTGAAAGATAACATTTGAGCCATGCTTTTAGCTTTTTTATATGCTAGCTAGCAATTTTGGATCTATAGTCTTGATTGACGTGCGCATCAAAAAAATTCT,10,30,14,27,27,35,27,50,27,32,32,35,47,50,1.43,0.0
hek293t,10579,1,3,ATAACCTGTGCTGAGGAAGGGCTCCCACATGGTCTGAATTTGATAAATTCAAAACAGTAATAGGACAGTTCAACAAAAAAATTCTAGTTGGTTTAACGC,ATAACCTGTGCTGAGGAAGGGCTCCCACATGGTCTGAATTCTTTGATAAATTCAAAACAGTAATAGGACAGTTCAACAAAAAAATTCTAGTTGGTTTAA,10,30,14,27,27,46,27,49,27,39,39,46,42,49,63.63,12.13418252
hek293t,10579,1,3,ACGATCTGTGCTGAGGAAGGGCTCCCACATGGTCTGAATTTGATAAATTCAAAACAGTAATAGGACAGTTCAAAAAAATTCTAGTTGGTTTAACGCGTA,ACGATCTGTGCTGAGGAAGGGCTCCCACATGGTCTGAATTCTTTGATAAATTCAAAACAGTAATAGGACAGTTCAAAAAAATTCTAGTTGGTTTAACGC,10,30,14,27,27,49,27,52,27,39,39,49,42,52,63.63,48.32902906
hek293t,10581,1,3,GGTCATCAGTGGTATGCACTTAAATCCCATGGAAAATGTTGCTAAAGTACAAGACATTTTTTCTAAAAAAATTCTAGTTGGTTTAACGCGTAACTAGAT,GGTCATCAGTGGTATGCACTTAAATCCCATGGAAAATGTTGCTGCTAAAGTACAAGACATTTTTTCTAAAAAAATTCTAGTTGGTTTAACGCGTAACTA,10,30,14,27,27,56,27,59,27,41,41,56,44,59,55.57,5.105574746
hek293t,10583,1,15,AACACTCTAAATTTGCTGTATGTGAAGTGTGGAGAAGCTCCAGATTTAACAAAATAGCTTCTCAATCCTACAGGAGAAAAAAATTCTAGTTGGTTTAAC,AACACTCTAAATTTGCTGTATGTGAAGTGCATTGGCAAATCGTGTGGAGAAGCTCCAGATTTAACAAAATAGCTTCTCAATCCTACAGGAGAAAAAAAT,10,30,14,27,27,32,27,47,27,29,29,32,44,47,55.68,0.0
hek293t,10583,1,15,CAATCTCTAAATTTGCTGTATGTGAAGTGTGGAGAAGCTCCAGATTTAACAAAATAGCTTCTCAAAAAAAATTCTAGTTGGTTTAACGCGTAACTAGAT,CAATCTCTAAATTTGCTGTATGTGAAGTGCATTGGCAAATCGTGTGGAGAAGCTCCAGATTTAACAAAATAGCTTCTCAAAAAAAATTCTAGTTGGTTT,10,30,14,27,27,44,27,59,27,29,29,44,44,59,55.68,7.688580284
hek293t,22523,1,13,TTGAGACTATGCTATTCTACATGATTGGCTGGGTTGTGTGACAGGCATACTTGCCAACACCATACCAAAAAAATTCTAGTTGGTTTAACGCGTAACTAG,TTGAGACTATGCTATTCTACATGATTGGCTGGGTTGTGTGGATATCAAACTCGACAGGCATACTTGCCAACACCATACCAAAAAAATTCTAGTTGGTTT,10,30,14,27,27,44,27,57,27,41,41,44,54,57,17.52,0.0
hek293t,10586,1,11,GAACCCCTAAATACAGAAATGTTTGCAAACGGAGAGCTACACTCTCTAGATTCAGTTTCAGAATTTTCCGTTCTAAATTCTCAAAAAAATTCTAGTTGG,GAACCCCTAAATACAGAAATGTTTGCCAGGGACACCGAAACGGAGAGCTACACTCTCTAGATTCAGTTTCAGAATTTTCCGTTCTAAATTCTCAAAAAA,10,30,14,27,27,30,27,41,27,27,27,30,38,41,11.17,0.09905894
hek293t,10586,1,11,TCAAACCTAAATACAGAAATGTTTGCAAACGGAGAGCTACACTCTCTAGATTCAGTTTCAGAATTTTCCGAAAAAAATTCTAGTTGGTTTAACGCGTAA,TCAAACCTAAATACAGAAATGTTTGCCAGGGACACCGAAACGGAGAGCTACACTCTCTAGATTCAGTTTCAGAATTTTCCGAAAAAAATTCTAGTTGGT,10,30,14,27,27,42,27,53,27,27,27,42,38,53,11.17,1.807337979
hek293t,10588,1,5,TGTGCGCGGAGAGAACTACATAGGGCTTAAGGAGCTAGTAGTGAATAGACATATGCCTTGTGTTACTTTTTCCAGCAAAAAAATTCTAGTTGGTTTAAC,TGTGCGCGGAGAGAACTACATAGGGCCCGCGTTAAGGAGCTAGTAGTGAATAGACATATGCCTTGTGTTACTTTTTCCAGCAAAAAAATTCTAGTTGGT,10,30,14,27,27,42,27,47,27,27,27,42,32,47,45.75,79.78103094
hek293t,10588,1,5,AGCGTGCGGAGAGAACTACATAGGGCTTAAGGAGCTAGTAGTGAATAGACATATGCCTTGTGTTACTTTTTCCAGCACAATTATAAAAAAATTCTAGTT,AGCGTGCGGAGAGAACTACATAGGGCCCGCGTTAAGGAGCTAGTAGTGAATAGACATATGCCTTGTGTTACTTTTTCCAGCACAATTATAAAAAAATTC,10,30,14,27,27,34,27,39,27,27,27,34,32,39,45.75,85.98333678
hek293t,10590,1,8,CAACTGCCCCCCCCGTGTTTGTAGAGGAAAGGTTTGGAAGGGAGTAGGTTTTTGACTTCAGATCGAAGGCAGTGTGTAAAAAAATTCTAGTTGGTTTAA,CAACTGCCCCCCCCGTGTTTGTAGAGGTCAAGTAAAAAGGTTTGGAAGGGAGTAGGTTTTTGACTTCAGATCGAAGGCAGTGTGTAAAAAAATTCTAGT,10,30,14,27,27,38,27,46,27,28,28,38,36,46,40.96,0.833688049
hek293t,10590,1,8,AACTCGCCCCCCCCGTGTTTGTAGAGGAAAGGTTTGGAAGGGAGTAGGTTTTTGACTTCAGATCGAAGGCAGTGTGTTCAGTACAAAAAAATTCTAGTT,AACTCGCCCCCCCCGTGTTTGTAGAGGTCAAGTAAAAAGGTTTGGAAGGGAGTAGGTTTTTGACTTCAGATCGAAGGCAGTGTGTTCAGTACAAAAAAA,10,30,14,27,27,31,27,39,27,28,28,31,36,39,40.96,0.0
hek293t,10592,1,1,GTCTTATCTCTTATTTCATTACAGAAGATTGGAAGGAATAAATTTGAAAACTGTCTTCCACTCATTGAAAAATCCACAAGCTAGTAGCAAAAAAATTCT,GTCTTATCTCTTATTTCATTACAGAAGATTCGGAAGGAATAAATTTGAAAACTGTCTTCCACTCATTGAAAAATCCACAAGCTAGTAGCAAAAAAATTC,10,30,14,27,27,34,27,35,27,31,31,34,32,35,8.4,0.481000481
hek293t,17706,1,2,GGTTATCTTCCACATAAAAAGGACCAAGAAGGGCATAGGTTTTTGGTTGGTTTGTTTTTGCAAATACCTTGGGATCAGTAGAAAAAAAATTCTAGTTGG,GGTTATCTTCCACATAAAAAGGACCAAGAAGTTGGCATAGGTTTTTGGTTGGTTTGTTTTTGCAAATACCTTGGGATCAGTAGAAAAAAAATTCTAGTT,10,30,14,27,27,39,27,41,27,32,32,39,34,41,42.35,2.315509558
hek293t,10596,1,8,AACTATTGTAATTGAGTTTTCTGGTAAGATGGAAACAGAACAGAAATAATATGGAAGATTCCCTGAGAAAAAAATTCTAGTTGGTTTAACGCGTAACTA,AACTATTGTAATTGAGTTTTCTGGTAAGATGGAAACAGCAAGAGAGAACAGAAATAATATGGAAGATTCCCTGAGAAAAAAATTCTAGTTGGTTTAACG,10,30,14,27,27,48,27,56,27,38,38,48,46,56,13.04,1.410845969
hek293t,10599,1,6,CTGACCTTTTTGTCTTACAGTCTTTCCACAGGGGAGCACCCATCAATCCCAATCAGCGCGCAGGAACTAAGCAATCAAAAAAAATTCTAGTTGGTTTAA,CTGACCTTTTTGTCTTACAGTCTTTCCACCGATGCAGGGGAGCACCCATCAATCCCAATCAGCGCGCAGGAACTAAGCAATCAAAAAAAATTCTAGTTG,10,30,14,27,27,40,27,46,27,30,30,40,36,46,35.29,33.59410143
hek293t,10601,1,6,AATTAAGCCATCACTGGTCTGGTATCTGCTGGAGTACAGCACAGTTGGCCTCAGGCTCCGATTTCTGTACTTAGAAAAAAATTCTAGTTGGTTTAACGC,AATTAAGCCATCACTGGTCTGGTATCTGCTGGAGTATTTGCACAGCACAGTTGGCCTCAGGCTCCGATTTCTGTACTTAGAAAAAAATTCTAGTTGGTT,10,30,14,27,27,43,27,49,27,36,36,43,42,49,51.67,2.118207848
hek293t,10601,1,6,GACGCAGCCATCACTGGTCTGGTATCTGCTGGAGTACAGCACAGTTGGCCTCAGGCTCCGATTTCTAAAAAAATTCTAGTTGGTTTAACGCGTAACTAG,GACGCAGCCATCACTGGTCTGGTATCTGCTGGAGTATTTGCACAGCACAGTTGGCCTCAGGCTCCGATTTCTAAAAAAATTCTAGTTGGTTTAACGCGT,10,30,14,27,27,51,27,57,27,36,36,51,42,57,51.67,67.91875848
hek293t,10603,1,1,GCGAAATATTTTTTAATTAAGAGAGTAAGTGGTTATGAAATGTTCCTGAAATCTTCATGTAAATAGACACTGACAGCAATGACTTTGAAAAAAATTCTA,GCGAAATATTTTTTAATTAAGAGAGTAAGTGCGTTATGAAATGTTCCTGAAATCTTCATGTAAATAGACACTGACAGCAATGACTTTGAAAAAAATTCT,10,30,14,27,27,35,27,36,27,32,32,35,33,36,-1.85,0.0
hek293t,10603,1,1,ACTCTATATTTTTTAATTAAGAGAGTAAGTGGTTATGAAATGTTCCTGAAATCTTCATGTAAATAGACACTGACAGCAATAAAAAAATTCTAGTTGGTT,ACTCTATATTTTTTAATTAAGAGAGTAAGTGCGTTATGAAATGTTCCTGAAATCTTCATGTAAATAGACACTGACAGCAATAAAAAAATTCTAGTTGGT,10,30,14,27,27,42,27,43,27,32,32,42,33,43,-1.85,0.573316829
hek293t,10606,1,15,CTGAAACTAAATGTTGAATCTACTTCAGGAGGGTTGGGCCCCCCCCTTGGTTTGGTTTGGGCCCCCCCAAAAAAATTCTAGTTGGTTTAACGCGTAACT,CTGAAACTAAATGTTGAATCTACTTCAGGAGGCCGCCACCGCGGCGCGTTGGGCCCCCCCCTTGGTTTGGTTTGGGCCCCCCCAAAAAAATTCTAGTTG,10,30,14,27,27,40,27,55,27,33,33,40,48,55,48.87,34.73327578
hek293t,10607,1,10,CCATGTCCCTTTTGTGATGCATCCCTATGTGGCTAGCAAGTCAACAATTCCCTAGCAAGCAAGAGAGATGAAATACAAAAAAATTCTAGTTGGTTTAAC,CCATGTCCCTTTTGTGATGCATCCCTTTGATAATTCATGTGGCTAGCAAGTCAACAATTCCCTAGCAAGCAAGAGAGATGAAATACAAAAAAATTCTAG,10,30,14,27,27,37,27,47,27,27,27,37,37,47,21.08,2.693516138
hek293t,10607,1,10,GTATGTCCCTTTTGTGATGCATCCCTATGTGGCTAGCAAGTCAACAATTCCCTAGCAAGCAAGAGAGATGAAAAAAAATTCTAGTTGGTTTAACGCGTA,GTATGTCCCTTTTGTGATGCATCCCTTTGATAATTCATGTGGCTAGCAAGTCAACAATTCCCTAGCAAGCAAGAGAGATGAAAAAAAATTCTAGTTGGT,10,30,14,27,27,42,27,52,27,27,27,42,37,52,21.08,10.31552289
hek293t,10609,1,14,AGTGAATGGTGCTCCCAATTCCTGATGAAAGGTAGCTCTCCTTGAAACAGGGCCCTATAATCTCAAAAAAAAATTCTAGTTGGTTTAACGCGTAACTAG,AGTGAATGGTGCTCCCAATTCCTGATGAAAGGTAGACTCCCTACTTAATCTCTCCTTGAAACAGGGCCCTATAATCTCAAAAAAAAATTCTAGTTGGTT,10,30,14,27,27,43,27,57,27,36,36,43,50,57,69.36,0.060966316
hek293t,10610,1,5,TCACTTGCAGAAATGAGACAGTAGGGAAATGGGTTTGCAGCATAGTTTTTAGATGTTTGGTATGTGAGCAGAGATAAAAAAATTCTAGTTGGTTTAACG,TCACTTGCAGAAATGAGACAGTAGGGAAATGGGTTAGTTCTGCAGCATAGTTTTTAGATGTTTGGTATGTGAGCAGAGATAAAAAAATTCTAGTTGGTT,10,30,14,27,27,43,27,48,27,36,36,43,41,48,45.17,38.22157331
hek293t,10610,1,5,TGAGGTGCAGAAATGAGACAGTAGGGAAATGGGTTTGCAGCATAGTTTTTAGATGTTTGGTATGTGAGCAGAAAAAAAATTCTAGTTGGTTTAACGCGT,TGAGGTGCAGAAATGAGACAGTAGGGAAATGGGTTAGTTCTGCAGCATAGTTTTTAGATGTTTGGTATGTGAGCAGAAAAAAAATTCTAGTTGGTTTAA,10,30,14,27,27,46,27,51,27,36,36,46,41,51,45.17,54.71880264
hek293t,10612,1,15,CTCTTAACCCACTTCCTTATCGCACTTGCTGGACCATCCTCTGGTCCAAAGGAATCAAACTAATCAAAAAAATTCTAGTTGGTTTAACGCGTAACTAGA,CTCTTAACCCACTTCCTTATCGCACTTGCTGGACCAGTTGCACTTACTCAATCCTCTGGTCCAAAGGAATCAAACTAATCAAAAAAATTCTAGTTGGTT,10,30,14,27,27,43,27,58,27,36,36,43,51,58,8.99,0.0
hek293t,10613,1,8,GGGGCAGACTTGCTGGGTAAAATGCTCACTGGATGACGATTATATCTGCTCTAGTGTCTGCCTCTTCCGAAAAAAATTCTAGTTGGTTTAACGCGTAAC,GGGGCAGACTTGCTGGGTAAAATGCTCACTACAATACTGGATGACGATTATATCTGCTCTAGTGTCTGCCTCTTCCGAAAAAAATTCTAGTTGGTTTAA,10,30,14,27,27,46,27,54,27,31,31,46,39,54,45.2,10.39678163
hek293t,10613,1,8,GTCCCAGACTTGCTGGGTAAAATGCTCACTGGATGACGATTATATCTGCTCTAGTGTCTGCCTCTTCCGCACATCACAAAAAAATTCTAGTTGGTTTAA,GTCCCAGACTTGCTGGGTAAAATGCTCACTACAATACTGGATGACGATTATATCTGCTCTAGTGTCTGCCTCTTCCGCACATCACAAAAAAATTCTAGT,10,30,14,27,27,38,27,46,27,31,31,38,39,46,45.2,8.18125388
hek293t,10615,1,8,GTCTGCTGAGTGATGTGTTTTAAGGTAGAAGGTGGGAACATTTATTTAGAATTTTTTCATTAAAAAGATAAAAAAATTCTAGTTGGTTTAACGCGTAAC,GTCTGCTGAGTGATGTGTTTTAAGGTAGAAGGTGGGAATTACAGTTCATTTATTTAGAATTTTTTCATTAAAAAGATAAAAAAATTCTAGTTGGTTTAA,10,30,14,27,27,46,27,54,27,39,39,46,47,54,34.94,0.581166711
hek293t,10616,1,3,CGTTGATACTTAATGTAGGTATTTACTTGGGGTTGTGATATTTCCATACTTTAGCTGGATTTCAGTATTTCTATATGTAACATGGAAAAAAATTCTAGT,CGTTGATACTTAATGTAGGTATTTACTTGGGTTTGTTGTGATATTTCCATACTTTAGCTGGATTTCAGTATTTCTATATGTAACATGGAAAAAAATTCT,10,30,14,27,27,35,27,38,27,32,32,35,35,38,40.96,1.508129189
hek293t,10616,1,3,TAGTGATACTTAATGTAGGTATTTACTTGGGGTTGTGATATTTCCATACTTTAGCTGGATTTCAGTATTTCTATATGTAAAAAAATTCTAGTTGGTTTA,TAGTGATACTTAATGTAGGTATTTACTTGGGTTTGTTGTGATATTTCCATACTTTAGCTGGATTTCAGTATTTCTATATGTAAAAAAATTCTAGTTGGT,10,30,14,27,27,42,27,45,27,32,32,42,35,45,40.96,84.26697854
hek293t,10618,1,1,GGCGACTTGCTTTCTCAGGTGCTGGAAATCGGCCTTGAGATTTCCACTAGCCTTGGCCCCGCGCAGGGAAAAAAATTCTAGTTGGTTTAACGCGTAACT,GGCGACTTGCTTTCTCAGGTGCTGGAAATCGGCCTTGATGATTTCCACTAGCCTTGGCCCCGCGCAGGGAAAAAAATTCTAGTTGGTTTAACGCGTAAC,10,30,14,27,27,54,27,55,27,39,39,54,40,55,7.9,49.71475143
hek293t,10618,1,1,GTTCCCTTGCTTTCTCAGGTGCTGGAAATCGGCCTTGAGATTTCCACTAGCCTTGGCCCCGCGCAGGGGACGAGGCTTCCAAAAAAATTCTAGTTGGTT,GTTCCCTTGCTTTCTCAGGTGCTGGAAATCGGCCTTGATGATTTCCACTAGCCTTGGCCCCGCGCAGGGGACGAGGCTTCCAAAAAAATTCTAGTTGGT,10,30,14,27,27,42,27,43,27,39,39,42,40,43,7.9,0.289855072
hek293t,10622,1,1,ACTGAGTAGCAGAGAGAGGCGAGAGTTGCAGGACTCGCCAACTAAGCAATAGTTGTGTTAAAATGGGGATTGAAGGAAAAAAATTCTAGTTGGTTTAAC,ACTGAGTAGCAGAGAGAGGCGAGAGTTGCACGGACTCGCCAACTAAGCAATAGTTGTGTTAAAATGGGGATTGAAGGAAAAAAATTCTAGTTGGTTTAA,10,30,14,27,27,46,27,47,27,31,31,46,32,47,30.59,49.96817046
hek293t,10622,1,1,CTTACGTAGCAGAGAGAGGCGAGAGTTGCAGGACTCGCCAACTAAGCAATAGTTGTGTTAAAATGGGGATTGAAGGAGTCTAAAAAAATTCTAGTTGGT,CTTACGTAGCAGAGAGAGGCGAGAGTTGCACGGACTCGCCAACTAAGCAATAGTTGTGTTAAAATGGGGATTGAAGGAGTCTAAAAAAATTCTAGTTGG,10,30,14,27,27,41,27,42,27,31,31,41,32,42,30.59,52.31010924
hek293t,10624,1,12,CAACGGTTACATTAGTGCTTGAAAAATGTTGGCTTTGTCTTATTCAATACAGGAAGTTATTCTCTATGAAAAAAATTCTAGTTGGTTTAACGCGTAACT,CAACGGTTACATTAGTGCTTGAAAAATCCTCTCCGCTGTGTTGGCTTTGTCTTATTCAATACAGGAAGTTATTCTCTATGAAAAAAATTCTAGTTGGTT,10,30,14,27,27,43,27,55,27,28,28,43,40,55,35.9,3.09088703
hek293t,10625,1,14,CCCGGGATGAAATCATGCCCCCCCATTTATGGTAATTCTAGTAAAATGCGCATGTATAGCTAGAGGAGGAGGGAAAAAAAATTCTAGTTGGTTTAACGC,CCCGGGATGAAATCATGCCCCCCCATTACGACCCTCCCCTATATGGTAATTCTAGTAAAATGCGCATGTATAGCTAGAGGAGGAGGGAAAAAAAATTCT,10,30,14,27,27,35,27,49,27,28,28,35,42,49,10.57,0.286091902
hek293t,10627,1,7,TAGAATACCCCAAAGATCAGCAAGAAGTCAGGCGCATATATCTGACAAAGCAAATAATCTCGTACCAGAATAAAGGCAAAAGAAAAAAATTCTAGTTGG,TAGAATACCCCAAAGATCAGCAAGAATGATACAGTCAGGCGCATATATCTGACAAAGCAAATAATCTCGTACCAGAATAAAGGCAAAAGAAAAAAATTC,10,30,14,27,27,34,27,41,27,27,27,34,34,41,46.15,33.53078374
hek293t,10627,1,7,CGGCGTACCCCAAAGATCAGCAAGAAGTCAGGCGCATATATCTGACAAAGCAAATAATCTCGTACCAGAATAAAGGCAAAAGTCCAAAAAAAATTCTAG,CGGCGTACCCCAAAGATCAGCAAGAATGATACAGTCAGGCGCATATATCTGACAAAGCAAATAATCTCGTACCAGAATAAAGGCAAAAGTCCAAAAAAA,10,30,14,27,27,30,27,37,27,27,27,30,34,37,46.15,5.030911749
hek293t,10631,1,9,GAACGATATGATTGCAATTAATTTGATAGAGGTTAAGCCTACATGAACATTTATAAAAGATTGCTCTGGAAAAAAATTCTAGTTGGTTTAACGCGTAAC,GAACGATATGATTGCAATTAATTTGATAGAGGTTCAGGAGATAAAGCCTACATGAACATTTATAAAAGATTGCTCTGGAAAAAAATTCTAGTTGGTTTA,10,30,14,27,27,45,27,54,27,35,35,45,44,54,4.54,2.747805553
hek293t,10631,1,9,GCAGGATATGATTGCAATTAATTTGATAGAGGTTAAGCCTACATGAACATTTATAAAAGATTGCTCTGGCTTAGAAAAAAAAATTCTAGTTGGTTTAAC,GCAGGATATGATTGCAATTAATTTGATAGAGGTTCAGGAGATAAAGCCTACATGAACATTTATAAAAGATTGCTCTGGCTTAGAAAAAAAAATTCTAGT,10,30,14,27,27,38,27,47,27,35,35,38,44,47,4.54,0.0
hek293t,10633,1,2,GAATAAGTCTGGCAAATGAGAGGAGGAAGTGGGAGAGAGAAATTGGAAACATAAGCAAAGCCATTAATTTTTCCCACTGAAAAAAATTCTAGTTGGTTT,GAATAAGTCTGGCAAATGAGAGGAGGAAGTGGGAAGGAGAGAAATTGGAAACATAAGCAAAGCCATTAATTTTTCCCACTGAAAAAAATTCTAGTTGGT,10,30,14,27,27,42,27,44,27,35,35,42,37,44,38.95,26.52588162
hek293t,10633,1,2,AAGCAAGTCTGGCAAATGAGAGGAGGAAGTGGGAGAGAGAAATTGGAAACATAAGCAAAGCCATTAATTTTTCCCACTGTGCGAAAAAAATTCTAGTTG,AAGCAAGTCTGGCAAATGAGAGGAGGAAGTGGGAAGGAGAGAAATTGGAAACATAAGCAAAGCCATTAATTTTTCCCACTGTGCGAAAAAAATTCTAGT,10,30,14,27,27,38,27,40,27,35,35,38,37,40,38.95,3.533176801
hek293t,10635,1,2,ACGTTAGTATCATTACTATGGTTTACAGATGGAGAAACACTCACACAGAAGTGAAGGAAGAATGAAGGAAAAAAATTCTAGTTGGTTTAACGCGTAACT,ACGTTAGTATCATTACTATGGTTTACAGATGGAGAAAATCACTCACACAGAAGTGAAGGAAGAATGAAGGAAAAAAATTCTAGTTGGTTTAACGCGTAA,10,30,14,27,27,53,27,55,27,38,38,53,40,55,27.15,57.12896444
hek293t,10635,1,2,TATACAGTATCATTACTATGGTTTACAGATGGAGAAACACTCACACAGAAGTGAAGGAAGAATGAAGGGATACAGGATGTAAAAAAATTCTAGTTGGTT,TATACAGTATCATTACTATGGTTTACAGATGGAGAAAATCACTCACACAGAAGTGAAGGAAGAATGAAGGGATACAGGATGTAAAAAAATTCTAGTTGG,10,30,14,27,27,41,27,43,27,38,38,41,40,43,27.15,0.420455885
hek293t,10637,1,3,TGTTGGATATAGACTTTTGTTTAGGCATAAGGAAAATACTGACTCTGAATAAATGAAGTCTGTAGTAACTCCACTCAAAAAAAATTCTAGTTGGTTTAA,TGTTGGATATAGACTTTTGTTTAGGCATAAGGAAAATACCAATGACTCTGAATAAATGAAGTCTGTAGTAACTCCACTCAAAAAAAATTCTAGTTGGTT,10,30,14,27,27,43,27,46,27,40,40,43,43,46,5.34,0.0
hek293t,10637,1,3,TGCCTGATATAGACTTTTGTTTAGGCATAAGGAAAATACTGACTCTGAATAAATGAAGTCTGTAGTAACTCCAAAAAAAATTCTAGTTGGTTTAACGCG,TGCCTGATATAGACTTTTGTTTAGGCATAAGGAAAATACCAATGACTCTGAATAAATGAAGTCTGTAGTAACTCCAAAAAAAATTCTAGTTGGTTTAAC,10,30,14,27,27,47,27,50,27,40,40,47,43,50,5.34,7.722936238
hek293t,10639,1,1,TTCGTCCGTGTGCCCCTCTGTGGTGAGCACGGGCCTGGCAGGGAGCCCCTTCTCCAGATCACCTCCTGCCCCACAAAAAAATTCTAGTTGGTTTAACGC,TTCGTCCGTGTGCCCCTCTGTGGTGAGCACGGTGCCTGGCAGGGAGCCCCTTCTCCAGATCACCTCCTGCCCCACAAAAAAATTCTAGTTGGTTTAACG,10,30,14,27,27,48,27,49,27,33,33,48,34,49,33.77,73.9481359
hek293t,5152,1,13,GTGATCTGTAGTATGTAAAGTAGTACTGTAGGAATCAGTTTGGCATCTGTCCATAAATGAGGAAATATAAAAAAATTCTAGTTGGTTTAACGCGTAACT,GTGATCTGTAGTATGTAAAGTAGTACTGTAGCGCACCCGAAATGGAATCAGTTTGGCATCTGTCCATAAATGAGGAAATATAAAAAAATTCTAGTTGGT,10,30,14,27,27,42,27,55,27,32,32,42,45,55,66.68,16.01310229
hek293t,10642,1,15,GTTGATCTGAAAAGTTTTCATAGAATCCAAGGATCTAAGGAATATTGGGGTGCTTTTAAAGTTCAAAAAAATTCTAGTTGGTTTAACGCGTAACTAGAT,GTTGATCTGAAAAGTTTTCATAGAATCCTACTATCAACACTTGAAGGATCTAAGGAATATTGGGGTGCTTTTAAAGTTCAAAAAAATTCTAGTTGGTTT,10,30,14,27,27,44,27,59,27,29,29,44,44,59,20.97,6.144169213
hek293t,10642,1,15,TGTGCTCTGAAAAGTTTTCATAGAATCCAAGGATCTAAGGAATATTGGGGTGCTTTTAAAGTTCAGGCCACTAAAAAAATTCTAGTTGGTTTAACGCGT,TGTGCTCTGAAAAGTTTTCATAGAATCCTACTATCAACACTTGAAGGATCTAAGGAATATTGGGGTGCTTTTAAAGTTCAGGCCACTAAAAAAATTCTA,10,30,14,27,27,36,27,51,27,29,29,36,44,51,20.97,0.309871625
hek293t,10644,1,3,CGAATTATCAGCAGCTATATAAGACACCATGGTGGGCAGCCATAAATGAAAGAATAAGCACTCTTAAGCCTAAAAAAAAATTCTAGTTGGTTTAACGCG,CGAATTATCAGCAGCTATATAAGACACCATGGTGGGCCACAGCCATAAATGAAAGAATAAGCACTCTTAAGCCTAAAAAAAAATTCTAGTTGGTTTAAC,10,30,14,27,27,47,27,50,27,37,37,47,40,50,66.67,65.74668378
hek293t,10644,1,3,TCCTATATCAGCAGCTATATAAGACACCATGGTGGGCAGCCATAAATGAAAGAATAAGCACTCTTAAGCCTAAAAGAAAAAAATTCTAGTTGGTTTAAC,TCCTATATCAGCAGCTATATAAGACACCATGGTGGGCCACAGCCATAAATGAAAGAATAAGCACTCTTAAGCCTAAAAGAAAAAAATTCTAGTTGGTTT,10,30,14,27,27,44,27,47,27,37,37,44,40,47,66.67,64.1867816
hek293t,10646,1,12,ATAGATTGGTAAAATGAAAGCTAATCAGATGGCATTATTGCTATAAAAAACCCATTCACTTGTAGAAAAAAATTCTAGTTGGTTTAACGCGTAACTAGA,ATAGATTGGTAAAATGAAAGCTAATCAGATCTCTGGGAGCGAGGCATTATTGCTATAAAAAACCCATTCACTTGTAGAAAAAAATTCTAGTTGGTTTAA,10,30,14,27,27,46,27,58,27,31,31,46,43,58,43.37,0.948584801
hek293t,10646,1,12,CAAGTTTGGTAAAATGAAAGCTAATCAGATGGCATTATTGCTATAAAAAACCCATTCACTTGTAGCAGTGCAAAAAAAAATTCTAGTTGGTTTAACGCG,CAAGTTTGGTAAAATGAAAGCTAATCAGATCTCTGGGAGCGAGGCATTATTGCTATAAAAAACCCATTCACTTGTAGCAGTGCAAAAAAAAATTCTAGT,10,30,14,27,27,38,27,50,27,31,31,38,43,50,43.37,0.636826432
hek293t,10648,1,9,GGGGCATAACTGCTGCTGCTAAAGTTCCCTGGCTCCTGCAGCTGCAGCCGCCTCTCTTCTGGGCTCTCGGAAAAAAATTCTAGTTGGTTTAACGCGTAA,GGGGCATAACTGCTGCTGCTAAAGTTCCCTGGCTCCTGCAGCCGTAGCAGCTGCAGCCGCCTCTCTTCTGGGCTCTCGGAAAAAAATTCTAGTTGGTTT,10,30,14,27,27,44,27,53,27,41,41,44,50,53,42.63,1.177778775
hek293t,10649,1,4,GCGAAAAAGCTATAATGCCATCAGTTCTGTGGTTTCTGCTGACAGTGCAACTATCCAGCAGTTTTTCACTATCCAGAAGTGTAAAAAAATTCTAGTTGG,GCGAAAAAGCTATAATGCCATCAGTTCTGGTATTGGTTTCTGCTGACAGTGCAACTATCCAGCAGTTTTTCACTATCCAGAAGTGTAAAAAAATTCTAG,10,30,14,27,27,37,27,41,27,30,30,37,34,41,43.21,19.61146192
hek293t,10649,1,4,CTACGAAAGCTATAATGCCATCAGTTCTGTGGTTTCTGCTGACAGTGCAACTATCCAGCAGTTTTTCACTATCCAAAAAAATTCTAGTTGGTTTAACGC,CTACGAAAGCTATAATGCCATCAGTTCTGGTATTGGTTTCTGCTGACAGTGCAACTATCCAGCAGTTTTTCACTATCCAAAAAAATTCTAGTTGGTTTA,10,30,14,27,27,45,27,49,27,30,30,45,34,49,43.21,41.90936201
hek293t,10651,1,3,TAAACATTACCACAGTAACAATGTTTTATTGGCATCCAAAGCTTCCTGTACTTTATTTTCATAACCATAAATCAACCAAAAAAATTCTAGTTGGTTTAA,TAAACATTACCACAGTAACAATGTTTTATTGGGCACATCCAAAGCTTCCTGTACTTTATTTTCATAACCATAAATCAACCAAAAAAATTCTAGTTGGTT,10,30,14,27,27,43,27,46,27,33,33,43,36,46,4.87,16.87092319
hek293t,10654,1,5,TAAAACTTATTTATGCACTGGGTGTTAACTGGGCCTGGATATTCCTGGTGGTTAGAATAAAATTGTTTTCTACCCTTTAAAAAAAATTCTAGTTGGTTT,TAAAACTTATTTATGCACTGGGTGTTAACTGAGGGGGGCCTGGATATTCCTGGTGGTTAGAATAAAATTGTTTTCTACCCTTTAAAAAAAATTCTAGTT,10,30,14,27,27,39,27,44,27,32,32,39,37,44,10.44,28.63840891
hek293t,10654,1,5,GACGTCTTATTTATGCACTGGGTGTTAACTGGGCCTGGATATTCCTGGTGGTTAGAATAAAATTGTTTTCTAAAAAAATTCTAGTTGGTTTAACGCGTA,GACGTCTTATTTATGCACTGGGTGTTAACTGAGGGGGGCCTGGATATTCCTGGTGGTTAGAATAAAATTGTTTTCTAAAAAAATTCTAGTTGGTTTAAC,10,30,14,27,27,47,27,52,27,32,32,47,37,52,10.44,53.65112906
hek293t,10656,1,1,ATCTTGTAAGGTACAATCTAACCTAATTACGGCTTTGTAAAAATTATTTTCAAGCCATTAACTGAGATTTGGCCCCCCCAAAAAAATTCTAGTTGGTTT,ATCTTGTAAGGTACAATCTAACCTAATTACGGGCTTTGTAAAAATTATTTTCAAGCCATTAACTGAGATTTGGCCCCCCCAAAAAAATTCTAGTTGGTT,10,30,14,27,27,43,27,44,27,33,33,43,34,44,41.22,54.10123966
hek293t,10658,1,1,TACAGCAGAAATGCCATTCCAGCCCCCCCTGGAAAGTTACTTAATTTTAAACAGAGTTGCAGCCTAAAGTGGTGTCAGAAAAAAATTCTAGTTGGTTTA,TACAGCAGAAATGCCATTCCAGCCCCCCCTGGAAAGTTTACTTAATTTTAAACAGAGTTGCAGCCTAAAGTGGTGTCAGAAAAAAATTCTAGTTGGTTT,10,30,14,27,27,44,27,45,27,37,37,44,38,45,40.05,60.49085959
hek293t,10658,1,1,TATTTCAGAAATGCCATTCCAGCCCCCCCTGGAAAGTTACTTAATTTTAAACAGAGTTGCAGCCTAAAGTGGTGTAAAAAAATTCTAGTTGGTTTAACG,TATTTCAGAAATGCCATTCCAGCCCCCCCTGGAAAGTTTACTTAATTTTAAACAGAGTTGCAGCCTAAAGTGGTGTAAAAAAATTCTAGTTGGTTTAAC,10,30,14,27,27,47,27,48,27,37,37,47,38,48,40.05,60.33698259
hek293t,10660,1,1,GCTGCAGAAAGGCCAACATTATTAGTAATAGGGAGGGACATTATACCCCCCCCTTAACTGGAAACATTTTAAAAAAAATTCTAGTTGGTTTAACGCGTA,GCTGCAGAAAGGCCAACATTATTAGTAATAGGGAGCGGACATTATACCCCCCCCTTAACTGGAAACATTTTAAAAAAAATTCTAGTTGGTTTAACGCGT,10,30,14,27,27,51,27,52,27,36,36,51,37,52,14.46,64.55399011
hek293t,10662,1,11,ACGTACCAGCTCTACCTGAAAAGGTTACGTGGAAGTTAAAGTTAGTGTCGGTGCTTTGAGATCGCTTTAAAAAAATTCTAGTTGGTTTAACGCGTAACT,ACGTACCAGCTCTACCTGAAAAGGTTACGTGGAAGTGGCTTTCGCCCTAAAGTTAGTGTCGGTGCTTTGAGATCGCTTTAAAAAAATTCTAGTTGGTTT,10,30,14,27,27,44,27,55,27,37,37,44,48,55,58.22,0.0
hek293t,10662,1,11,GCTGCCCAGCTCTACCTGAAAAGGTTACGTGGAAGTTAAAGTTAGTGTCGGTGCTTTGAGATCGCAAAAAAATTCTAGTTGGTTTAACGCGTAACTAGA,GCTGCCCAGCTCTACCTGAAAAGGTTACGTGGAAGTGGCTTTCGCCCTAAAGTTAGTGTCGGTGCTTTGAGATCGCAAAAAAATTCTAGTTGGTTTAAC,10,30,14,27,27,47,27,58,27,37,37,47,48,58,58.22,0.075969735
hek293t,10664,1,10,GAGTGTTTTTATTGTAGGCTATCTACAAAAGGGCTTTGGCCATCTCGTAAAAGGGGCCATTCTAGATCAGAAATAAAAAAAAATTCTAGTTGGTTTAAC,GAGTGTTTTTATTGTAGGCTATCTACAAATTGACCAGGTAGGGCTTTGGCCATCTCGTAAAAGGGGCCATTCTAGATCAGAAATAAAAAAAAATTCTAG,10,30,14,27,27,37,27,47,27,30,30,37,40,47,4.88,1.319142514
hek293t,10664,1,10,GCCTTTTTTTATTGTAGGCTATCTACAAAAGGGCTTTGGCCATCTCGTAAAAGGGGCCATTCTAGATCAGAAAAAAAAAATTCTAGTTGGTTTAACGCG,GCCTTTTTTTATTGTAGGCTATCTACAAATTGACCAGGTAGGGCTTTGGCCATCTCGTAAAAGGGGCCATTCTAGATCAGAAAAAAAAAATTCTAGTTG,10,30,14,27,27,40,27,50,27,30,30,40,40,50,4.88,13.37588647
hek293t,10666,1,6,TCGCCTCCCCCAGGCCCAGCGATATCCTCAGGCAGAGTGGGTACTTCAGGGCCTTTCGTACAGACCATAAAAAAATTCTAGTTGGTTTAACGCGTAACT,TCGCCTCCCCCAGGCCCAGCGATATCCTCAGGCGCTTTGAGAGTGGGTACTTCAGGGCCTTTCGTACAGACCATAAAAAAATTCTAGTTGGTTTAACGC,10,30,14,27,27,49,27,55,27,34,34,49,40,55,55.23,36.73754848
hek293t,10668,1,1,TGCTATCGTATGCAAGGCCTCTCAGGTAATGGTTAAGACGTTAGGGAAAATGCAAGGAAAATAAGCAGGGTCTGAAAAAAATTCTAGTTGGTTTAACGC,TGCTATCGTATGCAAGGCCTCTCAGGTAATGGTTAAGCACGTTAGGGAAAATGCAAGGAAAATAAGCAGGGTCTGAAAAAAATTCTAGTTGGTTTAACG,10,30,14,27,27,48,27,49,27,38,38,48,39,49,20.44,80.74767227
hek293t,10668,1,1,CCTTGTCGTATGCAAGGCCTCTCAGGTAATGGTTAAGACGTTAGGGAAAATGCAAGGAAAATAAGCAGGGTCTGTTTGCTAAAAAAAATTCTAGTTGGT,CCTTGTCGTATGCAAGGCCTCTCAGGTAATGGTTAAGCACGTTAGGGAAAATGCAAGGAAAATAAGCAGGGTCTGTTTGCTAAAAAAAATTCTAGTTGG,10,30,14,27,27,41,27,42,27,38,38,41,39,42,20.44,2.110221995
hek293t,10670,1,11,TGCATAAATAGGTTTAAAATGAAAAAAGATGGAAACCTTCTGAAGAGGAATAAAAGTTTGATGGAAGAGCTGGAAAAAAATTCTAGTTGGTTTAACGCG,TGCATAAATAGGTTTAAAATGAAAAAAGATGGAAAATAAACGAGAGCCTTCTGAAGAGGAATAAAAGTTTGATGGAAGAGCTGGAAAAAAATTCTAGTT,10,30,14,27,27,39,27,50,27,36,36,39,47,50,28.86,0.0
hek293t,10670,1,11,ATAAAAAATAGGTTTAAAATGAAAAAAGATGGAAACCTTCTGAAGAGGAATAAAAGTTTGATGGAAAAAAAAATTCTAGTTGGTTTAACGCGTAACTAG,ATAAAAAATAGGTTTAAAATGAAAAAAGATGGAAAATAAACGAGAGCCTTCTGAAGAGGAATAAAAGTTTGATGGAAAAAAAAATTCTAGTTGGTTTAA,10,30,14,27,27,46,27,57,27,36,36,46,47,57,28.86,0.0
hek293t,10672,1,15,AATGTCAAAATATCTGAAAGTAAGAATTACGGATATGTTTTTCAGTTATAAAAAGGCTTTCTGTAAAAAAATTCTAGTTGGTTTAACGCGTAACTAGAT,AATGTCAAAATATCTGAAAGTAAGAATTACGGATATGTTTCTTTAATAATTTCTCTTCAGTTATAAAAAGGCTTTCTGTAAAAAAATTCTAGTTGGTTT,10,30,14,27,27,44,27,59,27,41,41,44,56,59,48.66,0.0
hek293t,10673,1,6,GATGAATTGTTAGGTAAGTGGGTAGTTGAAGGTGATCAGTGAAAGTGCTCATTGGGAGGTTATTGAGGGTTATACAGAAAGGAAGCAAAAAAATTCTAG,GATGAATTGTTAGGTAAGTGGGTAGTTAGTCCTGAAGGTGATCAGTGAAAGTGCTCATTGGGAGGTTATTGAGGGTTATACAGAAAGGAAGCAAAAAAA,10,30,14,27,27,31,27,37,27,28,28,31,34,37,54.4,0.678733032
hek293t,10673,1,6,TAATTATTGTTAGGTAAGTGGGTAGTTGAAGGTGATCAGTGAAAGTGCTCATTGGGAGGTTATTGAGGGTTATAAAAAAAATTCTAGTTGGTTTAACGC,TAATTATTGTTAGGTAAGTGGGTAGTTAGTCCTGAAGGTGATCAGTGAAAGTGCTCATTGGGAGGTTATTGAGGGTTATAAAAAAAATTCTAGTTGGTT,10,30,14,27,27,43,27,49,27,28,28,43,34,49,54.4,54.23203187
hek293t,10675,1,8,CTGCAAATGTTCAGAAGATGGGACATACCTGGCTTCATAATCTGGAAAATATGCTATAGATCAGTAATGGAATTGATGTAGAAAAAAATTCTAGTTGGT,CTGCAAATGTTCAGAAGATGGGACATACCTACCTGGCGGGCTTCATAATCTGGAAAATATGCTATAGATCAGTAATGGAATTGATGTAGAAAAAAATTC,10,30,14,27,27,34,27,42,27,31,31,34,39,42,29.4,0.0
hek293t,10675,1,8,ACTTTAATGTTCAGAAGATGGGACATACCTGGCTTCATAATCTGGAAAATATGCTATAGATCAGTAATGGAATTGATAAAAAAATTCTAGTTGGTTTAA,ACTTTAATGTTCAGAAGATGGGACATACCTACCTGGCGGGCTTCATAATCTGGAAAATATGCTATAGATCAGTAATGGAATTGATAAAAAAATTCTAGT,10,30,14,27,27,38,27,46,27,31,31,38,39,46,29.4,12.31036938
hek293t,10677,1,3,CACAGATGGTGTAATCTGGCATTGGTGTGAGGAGTGGGTGTTGGTTTCCTTATCATTGGCAATTGGCAGGGCATAGCAGGCTGTGGGCTGAAAAAAATT,CACAGATGGTGTAATCTGGCATTGGTGAGGTGAGGAGTGGGTGTTGGTTTCCTTATCATTGGCAATTGGCAGGGCATAGCAGGCTGTGGGCTGAAAAAA,10,30,14,27,27,30,27,33,27,27,27,30,30,33,49.86,0.878847407
hek293t,10677,1,3,AATGCATGGTGTAATCTGGCATTGGTGTGAGGAGTGGGTGTTGGTTTCCTTATCATTGGCAATTGGCAGGGCATAGCAGGCTGTGGAAAAAAATTCTAG,AATGCATGGTGTAATCTGGCATTGGTGAGGTGAGGAGTGGGTGTTGGTTTCCTTATCATTGGCAATTGGCAGGGCATAGCAGGCTGTGGAAAAAAATTC,10,30,14,27,27,34,27,37,27,27,27,34,30,37,49.86,70.34752224
hek293t,10679,1,12,ACCCGCTCTAATCTAAGTTGATAAAGACATGGCTGTTTATTTTTTCCTCTTCCCCCCCCTGAGCACACATACCAAAAAAATTCTAGTTGGTTTAACGCG,ACCCGCTCTAATCTAAGTTGATAAAGACATGGCTCAACGGGCCTATGTTTATTTTTTCCTCTTCCCCCCCCTGAGCACACATACCAAAAAAATTCTAGT,10,30,14,27,27,38,27,50,27,35,35,38,47,50,46.01,0.545686753
hek293t,10680,1,11,CCAGTATAGCAGGCTATGGAAATTTTATATGGTTTAGTAAGAAAGGATAATTATATGCAACAGTTCGGATATTTTATAAAAAAATTCTAGTTGGTTTAA,CCAGTATAGCAGGCTATGGAAATTTTAGTGACTACCTTTATGGTTTAGTAAGAAAGGATAATTATATGCAACAGTTCGGATATTTTATAAAAAAATTCT,10,30,14,27,27,35,27,46,27,28,28,35,39,46,9.78,0.480947647
hek293t,10680,1,11,TTCGAATAGCAGGCTATGGAAATTTTATATGGTTTAGTAAGAAAGGATAATTATATGCAACAGTTCGGATATTTAAAAAAATTCTAGTTGGTTTAACGC,TTCGAATAGCAGGCTATGGAAATTTTAGTGACTACCTTTATGGTTTAGTAAGAAAGGATAATTATATGCAACAGTTCGGATATTTAAAAAAATTCTAGT,10,30,14,27,27,38,27,49,27,28,28,38,39,49,9.78,0.702891298
hek293t,10686,1,1,CTTCCTGAGTTTAACCTGATTATCTCCTCTGGTTTTCAAGGTGACCTGAAAAGTACCTGTTTGAGTAGGTTTTAGTAAAAAAAATTCTAGTTGGTTTAA,CTTCCTGAGTTTAACCTGATTATCTCCTCTGGTTGTTCAAGGTGACCTGAAAAGTACCTGTTTGAGTAGGTTTTAGTAAAAAAAATTCTAGTTGGTTTA,10,30,14,27,27,45,27,46,27,35,35,45,36,46,29.32,32.05985041
hek293t,10688,1,12,GTTTCTGAGGGGTTTTTGTAGTTAACAAGAGGAAGAGGAATATGAGAAAAGTTGTATTTTTTCTTCCCCCCCCCAAAAAAATTCTAGTTGGTTTAACGC,GTTTCTGAGGGGTTTTTGTAGTTAACTTGAACAACCACAAGAGGAAGAGGAATATGAGAAAAGTTGTATTTTTTCTTCCCCCCCCCAAAAAAATTCTAG,10,30,14,27,27,37,27,49,27,27,27,37,39,49,46.12,3.006715507
hek293t,10690,1,13,GGATAGGACTCAAGGTGAGGAAAGGAAAGAGGCACTGGCTCCAGTCTGTTCCCTCTCTCAACTTCAAAAAAAATTCTAGTTGGTTTAACGCGTAACTAG,GGATAGGACTCAAGGTGAGGAAAGGAAAGAGGCACTGGCTGGGAGCGTCTATACCAGTCTGTTCCCTCTCTCAACTTCAAAAAAAATTCTAGTTGGTTT,10,30,14,27,27,44,27,57,27,41,41,44,54,57,68.21,0.0
hek293t,5625,1,5,GCCCGATGGTTAAGCCATGAACATGTTTATGGAGTGGAGTGATAACCTGATGGTGTTGATCAGAGGAAAAAAAATTCTAGTTGGTTTAACGCGTAACTA,GCCCGATGGTTAAGCCATGAACATGTTTATGGAGTGGAGTATACTGATAACCTGATGGTGTTGATCAGAGGAAAAAAAATTCTAGTTGGTTTAACGCGT,10,30,14,27,27,51,27,56,27,41,41,51,46,56,17.56,1.974856182
hek293t,20467,1,11,GTGATATGAGGAATTGGGAGGAATGGGAAAGGCTTTTGAGAAAGCTATTAGTCTGAAATTTGAGCTAATTAAAAAGGAAAAAAAATTCTAGTTGGTTTA,GTGATATGAGGAATTGGGAGGAATGGGGCTACATTGTGAAAGGCTTTTGAGAAAGCTATTAGTCTGAAATTTGAGCTAATTAAAAAGGAAAAAAAATTC,10,30,14,27,27,34,27,45,27,27,27,34,38,45,45.88,0.886884755
hek293t,20467,1,11,TCAGCATGAGGAATTGGGAGGAATGGGAAAGGCTTTTGAGAAAGCTATTAGTCTGAAATTTGAGCTAATTAAAAAGGAGGAGAAAAAAATTCTAGTTGG,TCAGCATGAGGAATTGGGAGGAATGGGGCTACATTGTGAAAGGCTTTTGAGAAAGCTATTAGTCTGAAATTTGAGCTAATTAAAAAGGAGGAGAAAAAA,10,30,14,27,27,30,27,41,27,27,27,30,38,41,45.88,0.708525822
hek293t,10697,1,12,CGCATCCTCAGCACTGCCTGGGCCCAGAGGGGCGCAGGCAAGTGCATGCAATCTCACCCCAGATTTCAAAAAAATTCTAGTTGGTTTAACGCGTAACTA,CGCATCCTCAGCACTGCCTGGGCCCAGAGGGGCAACCCGCTTACGGCAGGCAAGTGCATGCAATCTCACCCCAGATTTCAAAAAAATTCTAGTTGGTTT,10,30,14,27,27,44,27,56,27,34,34,44,46,56,66.74,61.04949672
hek293t,10699,1,13,CGCCGAGAAACAAAGTAAATTCAAATAATAGGAAAAATATGTGCCATTTGAGCCAGGATTCTGTGAAAAAAAAAATTCTAGTTGGTTTAACGCGTAACT,CGCCGAGAAACAAAGTAAATTCAAATAATAGGCTTTACACCCTAGAAAAATATGTGCCATTTGAGCCAGGATTCTGTGAAAAAAAAAATTCTAGTTGGT,10,30,14,27,27,42,27,55,27,32,32,42,45,55,6.77,0.027662517
hek293t,10700,1,8,AACTGAATAAATGTGTGTTAGATCCTAGCTGGTTACAAATACCCCCTACTGAATATTTCACAAGAAGGTGCTCCATAAAAAAAATTCTAGTTGGTTTAA,AACTGAATAAATGTGTGTTAGATCCTAGCTGGTTACAAGATGACAAATACCCCCTACTGAATATTTCACAAGAAGGTGCTCCATAAAAAAAATTCTAGT,10,30,14,27,27,38,27,46,27,35,35,38,43,46,37.73,0.0
hek293t,10700,1,8,CCTGGAATAAATGTGTGTTAGATCCTAGCTGGTTACAAATACCCCCTACTGAATATTTCACAAGAAGGTGCTCAAAAAAATTCTAGTTGGTTTAACGCG,CCTGGAATAAATGTGTGTTAGATCCTAGCTGGTTACAAGATGACAAATACCCCCTACTGAATATTTCACAAGAAGGTGCTCAAAAAAATTCTAGTTGGT,10,30,14,27,27,42,27,50,27,35,35,42,43,50,37.73,0.570637474
hek293t,10702,1,15,GCCGATGGTGCTAGATTTCTACTCGGGACAGGAAGTAGTAACAGTGGACTATGTAGCCAGCAGAACGAAAAAAATTCTAGTTGGTTTAACGCGTAACTA,GCCGATGGTGCTAGATTTCTACTCGGGACAGGAAGTACGGACTGTACCAGTTGTAACAGTGGACTATGTAGCCAGCAGAACGAAAAAAATTCTAGTTGG,10,30,14,27,27,41,27,56,27,38,38,41,53,56,42.93,3.452490323
hek293t,10703,1,11,AGGGATGCTGCATACCCACTTAAACTTTCAGGAATTGGTGTCTGCACCCCAGCCTGACCAGCTGATCTGGAAAAAAAATTCTAGTTGGTTTAACGCGTA,AGGGATGCTGCATACCCACTTAAACTTTCAGGAGCGAGGCAGGGATTGGTGTCTGCACCCCAGCCTGACCAGCTGATCTGGAAAAAAAATTCTAGTTGG,10,30,14,27,27,41,27,52,27,34,34,41,45,52,0.72,1.060436783
hek293t,10704,1,15,TGCAAGAAGTCCTGCTTCCTCCTAAAGGAAGGCAAACAGATTCTGTTTGGACATTGGACAAGCCTAAAAAAAATTCTAGTTGGTTTAACGCGTAACTAG,TGCAAGAAGTCCTGCTTCCTCCTAAAGGAAGGCAAACAAAGAGGGCGGCCAAAGATTCTGTTTGGACATTGGACAAGCCTAAAAAAAATTCTAGTTGGT,10,30,14,27,27,42,27,57,27,39,39,42,54,57,71.21,0.0
hek293t,10709,1,9,AATAATTCATGCTTTTGTGCTTGTGTCTTAGGTCAAGAATAAGAGTAGGCTGGCTTCCTCCCAACACTCACAAAAAAAATTCTAGTTGGTTTAACGCGT,AATAATTCATGCTTTTGTGCTTGTGTCTTAGGTCAAGAGCTATAATGATAAGAGTAGGCTGGCTTCCTCCCAACACTCACAAAAAAAATTCTAGTTGGT,10,30,14,27,27,42,27,51,27,39,39,42,48,51,4.78,0.0
hek293t,10712,1,7,TTGCACTTTTCAATGTGCGCAGAAATTTTTGGCTGTTACCTGCATCTCTCAGAAGTATTTCCACTATTTTATCAATAAACAAACAAAAAAATTCTAGTT,TTGCACTTTTCAATGTGCGCAGAAATTTGGCGGAATTGGCTGTTACCTGCATCTCTCAGAAGTATTTCCACTATTTTATCAATAAACAAACAAAAAAAT,10,30,14,27,27,32,27,39,27,29,29,32,36,39,2.2,0.0
hek293t,10714,1,10,ACGACAAATTCACTAAAAAGGGGGGAAGATGGATCATTTAAGATAAGACTTCCCTTCACAGACATCTCCAAAAAAATTCTAGTTGGTTTAACGCGTAAC,ACGACAAATTCACTAAAAAGGGGGGAAGATGGATCAGCACATTAGGTTTAAGATAAGACTTCCCTTCACAGACATCTCCAAAAAAATTCTAGTTGGTTT,10,30,14,27,27,44,27,54,27,37,37,44,47,54,32.77,0.05630095
hek293t,10716,1,1,GACGCCTTTGTGACTGACTGTGGGGGATGTGGAGGGGCAGGCTTTGATCTCAATCAGTTCTCTGGATTTTCGGGAAAAAAATTCTAGTTGGTTTAACGC,GACGCCTTTGTGACTGACTGTGGGGGATGTGGAGGGGCCAGGCTTTGATCTCAATCAGTTCTCTGGATTTTCGGGAAAAAAATTCTAGTTGGTTTAACG,10,30,14,27,27,48,27,49,27,38,38,48,39,49,44.45,72.27089428
hek293t,10716,1,1,AGGATCTTTGTGACTGACTGTGGGGGATGTGGAGGGGCAGGCTTTGATCTCAATCAGTTCTCTGGATTTTCGGGCCTTTTAAAAAAAATTCTAGTTGGT,AGGATCTTTGTGACTGACTGTGGGGGATGTGGAGGGGCCAGGCTTTGATCTCAATCAGTTCTCTGGATTTTCGGGCCTTTTAAAAAAAATTCTAGTTGG,10,30,14,27,27,41,27,42,27,38,38,41,39,42,44.45,62.31338676
hek293t,2960,1,13,CAGGCTTTTAAAACAAAAATGCTTAAAAAAGGGGCTTTCATTTCTTTTTATCTTATCTATGCTCTTAGCAAAAAAATTCTAGTTGGTTTAACGCGTAAC,CAGGCTTTTAAAACAAAAATGCTTAAAAAAGCGGAGCTGCGCAGGGGCTTTCATTTCTTTTTATCTTATCTATGCTCTTAGCAAAAAAATTCTAGTTGG,10,30,14,27,27,41,27,54,27,31,31,41,44,54,2.02,0.0
hek293t,10719,1,4,TTCGCAATACTTTAAATCTATATTGTCACTGGACAATACTAATTGTGAAATCACACTCTAAGGTCACTAAAAGAGCAAAAAAATTCTAGTTGGTTTAAC,TTCGCAATACTTTAAATCTATATTGTCACTGGACAATACGAACTAATTGTGAAATCACACTCTAAGGTCACTAAAAGAGCAAAAAAATTCTAGTTGGTT,10,30,14,27,27,43,27,47,27,40,40,43,44,47,3.71,0.0
hek293t,10719,1,4,GGTTGAATACTTTAAATCTATATTGTCACTGGACAATACTAATTGTGAAATCACACTCTAAGGTCACTAAAAAAAATTCTAGTTGGTTTAACGCGTAAC,GGTTGAATACTTTAAATCTATATTGTCACTGGACAATACGAACTAATTGTGAAATCACACTCTAAGGTCACTAAAAAAAATTCTAGTTGGTTTAACGCG,10,30,14,27,27,50,27,54,27,40,40,50,44,54,3.71,0.0
hek293t,10722,1,10,ATGTAAAATTAACTCTGCGGAGCTTCACTCGGCCTGATTCACCAAGTGTTGAACAACATGGGGTAGATTAGACTTAAAAAAATTCTAGTTGGTTTAACG,ATGTAAAATTAACTCTGCGGAGCTTCACTCGGCCAACCAGTGTCTGATTCACCAAGTGTTGAACAACATGGGGTAGATTAGACTTAAAAAAATTCTAGT,10,30,14,27,27,38,27,48,27,35,35,38,45,48,38.62,0.0
hek293t,10722,1,10,CCATAAAATTAACTCTGCGGAGCTTCACTCGGCCTGATTCACCAAGTGTTGAACAACATGGGGTAGATTAGAAAAAAATTCTAGTTGGTTTAACGCGTA,CCATAAAATTAACTCTGCGGAGCTTCACTCGGCCAACCAGTGTCTGATTCACCAAGTGTTGAACAACATGGGGTAGATTAGAAAAAAATTCTAGTTGGT,10,30,14,27,27,42,27,52,27,35,35,42,45,52,38.62,8.956349626
hek293t,10724,1,14,ACGTAATTGCTTACAGCAGTAAGTGCTCTAGGAAGTTTGTGTGAACTGCTCCCTCATGGCAGAAATAAGCCTACTGCAAAAAAATTCTAGTTGGTTTAA,ACGTAATTGCTTACAGCAGTAAGTGCTCAGGGAGGCGTATAGTAGGAAGTTTGTGTGAACTGCTCCCTCATGGCAGAAATAAGCCTACTGCAAAAAAAT,10,30,14,27,27,32,27,46,27,29,29,32,43,46,29.78,0.0
hek293t,10724,1,14,ACAGCATTGCTTACAGCAGTAAGTGCTCTAGGAAGTTTGTGTGAACTGCTCCCTCATGGCAGAAATAAGCAAAAAAATTCTAGTTGGTTTAACGCGTAA,ACAGCATTGCTTACAGCAGTAAGTGCTCAGGGAGGCGTATAGTAGGAAGTTTGTGTGAACTGCTCCCTCATGGCAGAAATAAGCAAAAAAATTCTAGTT,10,30,14,27,27,39,27,53,27,29,29,39,43,53,29.78,7.02008457
hek293t,10727,1,13,AATTTGCAGAAGCTGCCCAGACCTCAGCGAGGTCGGCATCCCAGCAGCGACAGCAGCACACCGCACTGGGCTGCCTAAAAAAATTCTAGTTGGTTTAAC,AATTTGCAGAAGCTGCCCAGACCTCAGCGAGGATCTTCAGCCGGGTCGGCATCCCAGCAGCGACAGCAGCACACCGCACTGGGCTGCCTAAAAAAATTC,10,30,14,27,27,34,27,47,27,31,31,34,44,47,73.4,2.912621359
hek293t,10727,1,13,TCAAAGCAGAAGCTGCCCAGACCTCAGCGAGGTCGGCATCCCAGCAGCGACAGCAGCACACCGCACTGGGCTAAAAAAATTCTAGTTGGTTTAACGCGT,TCAAAGCAGAAGCTGCCCAGACCTCAGCGAGGATCTTCAGCCGGGTCGGCATCCCAGCAGCGACAGCAGCACACCGCACTGGGCTAAAAAAATTCTAGT,10,30,14,27,27,38,27,51,27,31,31,38,44,51,73.4,3.583633017
hek293t,10729,1,9,GGTATCGAGTGTGACAACTTCCAGGGCTCCGGAAAGACTTAGGGCGTAAGAGAAGTCTTGGACAGGAAAAAAATTCTAGTTGGTTTAACGCGTAACTAG,GGTATCGAGTGTGACAACTTCCAGGGCTCCGGAAAGAAGTGAACGCCTTAGGGCGTAAGAGAAGTCTTGGACAGGAAAAAAATTCTAGTTGGTTTAACG,10,30,14,27,27,48,27,57,27,38,38,48,47,57,56.9,11.00577489
hek293t,10729,1,9,GTGGTCGAGTGTGACAACTTCCAGGGCTCCGGAAAGACTTAGGGCGTAAGAGAAGTCTTGGACAGGGGATGAAAAAAAAATTCTAGTTGGTTTAACGCG,GTGGTCGAGTGTGACAACTTCCAGGGCTCCGGAAAGAAGTGAACGCCTTAGGGCGTAAGAGAAGTCTTGGACAGGGGATGAAAAAAAAATTCTAGTTGG,10,30,14,27,27,41,27,50,27,38,38,41,47,50,56.9,0.261903071
hek293t,10731,1,4,TAATAAGGATCTAACCTTGGGCCTGTGCCTGGGTCACTCTGTGGCCAGTCTGCTGGATGTATTTCCTTGCTGCCTTACAAAAAAAATTCTAGTTGGTTT,TAATAAGGATCTAACCTTGGGCCTGTGCCGATATGGGTCACTCTGTGGCCAGTCTGCTGGATGTATTTCCTTGCTGCCTTACAAAAAAAATTCTAGTTG,10,30,14,27,27,40,27,44,27,30,30,40,34,44,37.91,57.69360162
hek293t,10731,1,4,CGCTTAGGATCTAACCTTGGGCCTGTGCCTGGGTCACTCTGTGGCCAGTCTGCTGGATGTATTTCCTTGCTGCCTTACAGGGAAAAAAATTCTAGTTGG,CGCTTAGGATCTAACCTTGGGCCTGTGCCGATATGGGTCACTCTGTGGCCAGTCTGCTGGATGTATTTCCTTGCTGCCTTACAGGGAAAAAAATTCTAG,10,30,14,27,27,37,27,41,27,30,30,37,34,41,37.91,29.86947393
hek293t,10733,1,7,TGTTATTTTCATAGCTGAAAGAACAGAGAAGGAACCCTCTGAGCATATGTAATAATTTCTGATGGAAAAAAATTCTAGTTGGTTTAACGCGTAACTAGA,TGTTATTTTCATAGCTGAAAGAACAGAGAAGGAACCCTCTGCCTTGAGAGCATATGTAATAATTTCTGATGGAAAAAAATTCTAGTTGGTTTAACGCGT,10,30,14,27,27,51,27,58,27,41,41,51,48,58,48.48,1.915250505
hek293t,13078,1,1,CATTTGTTTAATCTGCCACACGACAGAGCAGGAGTGAGGAAGCTGGGTGCTGCTCTGCACACAGGGCCCGCAGCCTCTCTGCTGCGCAAAAAAAATTCT,CATTTGTTTAATCTGCCACACGACAGAAGCAGGAGTGAGGAAGCTGGGTGCTGCTCTGCACACAGGGCCCGCAGCCTCTCTGCTGCGCAAAAAAAATTC,10,30,14,27,27,34,27,35,27,27,27,34,28,35,41.57,84.68630851
hek293t,10736,1,8,TGTCCTTCTGAATCTCATGACTCAACGGGAGGGTCTCCTTTGCAAAATTTGCTAAGTTACATCTCTGATAAAAAAATTCTAGTTGGTTTAACGCGTAAC,TGTCCTTCTGAATCTCATGACTCAACGGGAAGCAATAGGGGTCTCCTTTGCAAAATTTGCTAAGTTACATCTCTGATAAAAAAATTCTAGTTGGTTTAA,10,30,14,27,27,46,27,54,27,31,31,46,39,54,54.17,20.79600759
hek293t,10736,1,8,GCACGTTCTGAATCTCATGACTCAACGGGAGGGTCTCCTTTGCAAAATTTGCTAAGTTACATCTCTGATTGATTGTGAAAAAAATTCTAGTTGGTTTAA,GCACGTTCTGAATCTCATGACTCAACGGGAAGCAATAGGGGTCTCCTTTGCAAAATTTGCTAAGTTACATCTCTGATTGATTGTGAAAAAAATTCTAGT,10,30,14,27,27,38,27,46,27,31,31,38,39,46,54.17,1.975322144
hek293t,10738,1,1,GGTCTCAGTGGTATTTGCTTTGCTTCCCCTGGCCAAAATTTCCACCTGGCTCTGGCAATAATACTTGCGGTGGGCTCTCAACGCGAAAAAAAATTCTAG,GGTCTCAGTGGTATTTGCTTTGCTTCCCCTGGTCCAAAATTTCCACCTGGCTCTGGCAATAATACTTGCGGTGGGCTCTCAACGCGAAAAAAAATTCTA,10,30,14,27,27,36,27,37,27,33,33,36,34,37,46.1,1.665800866
hek293t,10740,1,3,GCCATGCAATCCATATTTGTCATTGGTTTAGGACTCGATACATCAAGCCCTGGACGTGAGAATGATTTTCAAAAAAATTCTAGTTGGTTTAACGCGTAA,GCCATGCAATCCATATTTGTCATTGGTTTAGGACTCGATCCCACATCAAGCCCTGGACGTGAGAATGATTTTCAAAAAAATTCTAGTTGGTTTAACGCG,10,30,14,27,27,50,27,53,27,40,40,50,43,53,2.21,37.91268763
hek293t,10740,1,3,CCGGCGCAATCCATATTTGTCATTGGTTTAGGACTCGATACATCAAGCCCTGGACGTGAGAATGATTTTCAGGCCCTAAAAAAATTCTAGTTGGTTTAA,CCGGCGCAATCCATATTTGTCATTGGTTTAGGACTCGATCCCACATCAAGCCCTGGACGTGAGAATGATTTTCAGGCCCTAAAAAAATTCTAGTTGGTT,10,30,14,27,27,43,27,46,27,40,40,43,43,46,2.21,0.0
hek293t,2516,1,4,GTAGCGGATTTGAGCATGTGACCGCGTTATGGATGCGGTATGAAGATTTAGCTTCTCACTACTTTTATGCATCGTCAAAGCATCAAAAAAATTCTAGTT,GTAGCGGATTTGAGCATGTGACCGCGTGTCCTATGGATGCGGTATGAAGATTTAGCTTCTCACTACTTTTATGCATCGTCAAAGCATCAAAAAAATTCT,10,30,14,27,27,35,27,39,27,28,28,35,32,39,20.66,0.512850648
hek293t,2516,1,4,CCCGAGGATTTGAGCATGTGACCGCGTTATGGATGCGGTATGAAGATTTAGCTTCTCACTACTTTTATGCATCGTCAAAGCATCACCTAAAAAAATTCT,CCCGAGGATTTGAGCATGTGACCGCGTGTCCTATGGATGCGGTATGAAGATTTAGCTTCTCACTACTTTTATGCATCGTCAAAGCATCACCTAAAAAAA,10,30,14,27,27,31,27,35,27,28,28,31,32,35,20.66,0.0
hek293t,10748,1,7,TACGATATGTTTTTGATAGATAAGAGAGCTGGAACTGGGGTTTACAAATAAAGGTTTGAACTACAAAGGCAGTCAAAAAAATTCTAGTTGGTTTAACGC,TACGATATGTTTTTGATAGATAAGAGAGCTGATCGATTGAACTGGGGTTTACAAATAAAGGTTTGAACTACAAAGGCAGTCAAAAAAATTCTAGTTGGT,10,30,14,27,27,42,27,49,27,32,32,42,39,49,23.37,12.33602229
hek293t,10750,1,8,CGTACATCTAGGATTCCTTCTTCTGCAACTGGGAGAGACTAAAGAGAAGAGCAGACAGAAAGGACTTCTGTGAAGACTGGTAAAAAAATTCTAGTTGGT,CGTACATCTAGGATTCCTTCTTCTGCAACTATTGAGCAGGGAGAGACTAAAGAGAAGAGCAGACAGAAAGGACTTCTGTGAAGACTGGTAAAAAAATTC,10,30,14,27,27,34,27,42,27,31,31,34,39,42,16.45,0.238948626
hek293t,10750,1,8,AGCATATCTAGGATTCCTTCTTCTGCAACTGGGAGAGACTAAAGAGAAGAGCAGACAGAAAGGACTTCTAAAAAAATTCTAGTTGGTTTAACGCGTAAC,AGCATATCTAGGATTCCTTCTTCTGCAACTATTGAGCAGGGAGAGACTAAAGAGAAGAGCAGACAGAAAGGACTTCTAAAAAAATTCTAGTTGGTTTAA,10,30,14,27,27,46,27,54,27,31,31,46,39,54,16.45,8.735153726
hek293t,7769,1,8,ACTGCACAATTTGAGACAGCTTGGAGTGGTGGTGGTGGGGAGATGTCAGCAGTCAAAATCATTTTCATAAAAAAATTCTAGTTGGTTTAACGCGTAACT,ACTGCACAATTTGAGACAGCTTGGAGTGGTGGTGGTGGGCCCTCTAAGAGATGTCAGCAGTCAAAATCATTTTCATAAAAAAATTCTAGTTGGTTTAAC,10,30,14,27,27,47,27,55,27,40,40,47,48,55,54.74,4.054300454
hek293t,7769,1,8,CATACACAATTTGAGACAGCTTGGAGTGGTGGTGGTGGGGAGATGTCAGCAGTCAAAATCATTTTAAAAAAATTCTAGTTGGTTTAACGCGTAACTAGA,CATACACAATTTGAGACAGCTTGGAGTGGTGGTGGTGGGCCCTCTAAGAGATGTCAGCAGTCAAAATCATTTTAAAAAAATTCTAGTTGGTTTAACGCG,10,30,14,27,27,50,27,58,27,40,40,50,48,58,54.74,4.951323505
hek293t,10754,1,12,GTTCATATAAGCCTCCTTTTCTAACATGAAGGCCTGTATGGCCCCCCCCCACAGCCTAGGTTTTAAAAAAATTCTAGTTGGTTTAACGCGTAACTAGAT,GTTCATATAAGCCTCCTTTTCTAACATGAAGGCCTGTATCGTAGGGTGAGTGGCCCCCCCCCACAGCCTAGGTTTTAAAAAAATTCTAGTTGGTTTAAC,10,30,14,27,27,47,27,59,27,40,40,47,52,59,27.45,3.615214243
hek293t,10756,1,6,TCGGGGCCATATGGCTCAGTTGTTTGATATGGATATGCAGTGTAGAGAACACTATCCTATTCCAATCATGGAATTTGATGAAAAAAATTCTAGTTGGTT,TCGGGGCCATATGGCTCAGTTGTTTGATATGGACCGTGATATGCAGTGTAGAGAACACTATCCTATTCCAATCATGGAATTTGATGAAAAAAATTCTAG,10,30,14,27,27,37,27,43,27,34,34,37,40,43,29.67,15.250602
hek293t,10756,1,6,CAGGTGCCATATGGCTCAGTTGTTTGATATGGATATGCAGTGTAGAGAACACTATCCTATTCCAATCATGGAAAAAAAAATTCTAGTTGGTTTAACGCG,CAGGTGCCATATGGCTCAGTTGTTTGATATGGACCGTGATATGCAGTGTAGAGAACACTATCCTATTCCAATCATGGAAAAAAAAATTCTAGTTGGTTT,10,30,14,27,27,44,27,50,27,34,34,44,40,50,29.67,46.69303862
hek293t,10758,1,2,GAGGCAAGGTCAGGAGAGATGTTAGCGGGTGGGAGTGCTTGACTCCATGCTGCCTTGGGCAACGTTCAAAAAAATTCTAGTTGGTTTAACGCGTAACTA,GAGGCAAGGTCAGGAGAGATGTTAGCGGGTGGGAGTGCGCTTGACTCCATGCTGCCTTGGGCAACGTTCAAAAAAATTCTAGTTGGTTTAACGCGTAAC,10,30,14,27,27,54,27,56,27,39,39,54,41,56,59.74,82.55650052
hek293t,10762,1,11,TAATGAAAGGAGTTAACGACCTTTGGTCTTGGTGGTTAAATGGGATAGCTCAGCTGTCTGTGCAGAAAAAAAATTCTAGTTGGTTTAACGCGTAACTAG,TAATGAAAGGAGTTAACGACCTTTGGTCTTGGTGGTTAAGACGGTGATGAATGGGATAGCTCAGCTGTCTGTGCAGAAAAAAAATTCTAGTTGGTTTAA,10,30,14,27,27,46,27,57,27,39,39,46,50,57,43.65,0.647696796
hek293t,10763,1,2,ATCTCGTCAGCACCATCGAATACTTGCTAAGGAACTGCTGGTGAACACATGCCAATTTTCATCTACGACAGCCTGTCTGATATCAGGTTAAAAAAAATT,ATCTCGTCAGCACCATCGAATACTTGCTATAAGGAACTGCTGGTGAACACATGCCAATTTTCATCTACGACAGCCTGTCTGATATCAGGTTAAAAAAAA,10,30,14,27,27,31,27,33,27,28,28,31,30,33,54.2,4.331989713
hek293t,10763,1,2,CCCCAGTCAGCACCATCGAATACTTGCTAAGGAACTGCTGGTGAACACATGCCAATTTTCATCTACGACAGCCTGTCTAAAAAAATTCTAGTTGGTTTA,CCCCAGTCAGCACCATCGAATACTTGCTATAAGGAACTGCTGGTGAACACATGCCAATTTTCATCTACGACAGCCTGTCTAAAAAAATTCTAGTTGGTT,10,30,14,27,27,43,27,45,27,28,28,43,30,45,54.2,49.56716083
hek293t,10765,1,8,CGATCTTTATAATAATGTATTCCTAAAGGAGGAGAAAATAGCCAAGCATTATGAATCATTATTAGCAACTGAAAAAAATTCTAGTTGGTTTAACGCGTA,CGATCTTTATAATAATGTATTCCTAAAGGAGGAGAAGTAGCGGCAATAGCCAAGCATTATGAATCATTATTAGCAACTGAAAAAAATTCTAGTTGGTTT,10,30,14,27,27,44,27,52,27,37,37,44,45,52,50.69,0.0
hek293t,10766,1,10,TTGGACAGCAAGCCTGTCCCCTCTTGGCAAGGAGCCGCGGTAGATGTCTCCTCATCTGCCTGTTCCTGCAAAAAAATTCTAGTTGGTTTAACGCGTAAC,TTGGACAGCAAGCCTGTCCCCTCTTGGCAAGGAGCCGCGGTCGTGTACCCTAGATGTCTCCTCATCTGCCTGTTCCTGCAAAAAAATTCTAGTTGGTTT,10,30,14,27,27,44,27,54,27,41,41,44,51,54,45.73,0.0
hek293t,10769,1,5,CATCAGTCAGGGCCTGGCTTTGCTGAATTTGGACATTTGCAGAGACTCCCGTTTGAGCACCTTGCAGAGAAAAAAATTCTAGTTGGTTTAACGCGTAAC,CATCAGTCAGGGCCTGGCTTTGCTGAATTTGGACATTTTTATAGCAGAGACTCCCGTTTGAGCACCTTGCAGAGAAAAAAATTCTAGTTGGTTTAACGC,10,30,14,27,27,49,27,54,27,39,39,49,44,54,12.77,52.19140723
hek293t,10774,1,5,GGAGGTTACTTTCCTCTGTAAATCCTTTCCGGGACTGTTACCAAACTGGACTACTATATTCCTTAGACCCTTGGTCACATGAAAAAAATTCTAGTTGGT,GGAGGTTACTTTCCTCTGTAAATCCTTTCGCCCACGGGACTGTTACCAAACTGGACTACTATATTCCTTAGACCCTTGGTCACATGAAAAAAATTCTAG,10,30,14,27,27,37,27,42,27,30,30,37,35,42,0.1,11.0647864
hek293t,10774,1,5,GCCATTTACTTTCCTCTGTAAATCCTTTCCGGGACTGTTACCAAACTGGACTACTATATTCCTTAGACCCTTGGTCACAAAAAAATTCTAGTTGGTTTA,GCCATTTACTTTCCTCTGTAAATCCTTTCGCCCACGGGACTGTTACCAAACTGGACTACTATATTCCTTAGACCCTTGGTCACAAAAAAATTCTAGTTG,10,30,14,27,27,40,27,45,27,30,30,40,35,45,0.1,12.53619241
hek293t,10776,1,8,TCGTTGGCTCTTTCAAAAGGCACAGTGTCTGGCCTAACTGTTGGAAGGTCAGCTTTTAATTATTATTTTAAATAATCTAAAAAAATTCTAGTTGGTTTA,TCGTTGGCTCTTTCAAAAGGCACAGTGTCTGGCCGACGGTCCTAACTGTTGGAAGGTCAGCTTTTAATTATTATTTTAAATAATCTAAAAAAATTCTAG,10,30,14,27,27,37,27,45,27,34,34,37,42,45,15.42,0.0
hek293t,10778,1,13,TATCTGTGGATGCAAGAAACAGTAAGTGCTGGTAGAATGACAATCTGTAGCAATCTTCTCTTGGGCAGTTTCAAAAAAAATTCTAGTTGGTTTAACGCG,TATCTGTGGATGCAAGAAACAGTAAGTTATGAACAGTTTTGCTGGTAGAATGACAATCTGTAGCAATCTTCTCTTGGGCAGTTTCAAAAAAAATTCTAG,10,30,14,27,27,37,27,50,27,27,27,37,40,50,69.71,1.509985359
hek293t,10778,1,13,TGAAAGTGGATGCAAGAAACAGTAAGTGCTGGTAGAATGACAATCTGTAGCAATCTTCTCTTGGGCAGTTTCATAGAAAGAAAAAAATTCTAGTTGGTT,TGAAAGTGGATGCAAGAAACAGTAAGTTATGAACAGTTTTGCTGGTAGAATGACAATCTGTAGCAATCTTCTCTTGGGCAGTTTCATAGAAAGAAAAAA,10,30,14,27,27,30,27,43,27,27,27,30,40,43,69.71,1.177474238
hek293t,10780,1,3,CTACGTGCGTGAGGGCTTTCCTTGATGGTTGGAGGAAATGTCAAACAGCAATGAAAAGGCAGGCTCTTAAAAAGTTAAAAAAATTCTAGTTGGTTTAAC,CTACGTGCGTGAGGGCTTTCCTTGATGGTTGGATCAGGAAATGTCAAACAGCAATGAAAAGGCAGGCTCTTAAAAAGTTAAAAAAATTCTAGTTGGTTT,10,30,14,27,27,44,27,47,27,34,34,44,37,47,63.33,87.32748661
hek293t,10782,1,4,GGTTCGACCGTATATTTCAAACATGCAGGTGGCTCTGAATGGAGGCCAGGATGCTGCTGCAGGTGCACCAAGTTCTTGGATAAAAAAATTCTAGTTGGT,GGTTCGACCGTATATTTCAAACATGCAGGTGGCTTGACCTGAATGGAGGCCAGGATGCTGCTGCAGGTGCACCAAGTTCTTGGATAAAAAAATTCTAGT,10,30,14,27,27,38,27,42,27,35,35,38,39,42,31.76,1.342210779
hek293t,10784,1,15,AGCTTTTTAGCAATGCAGAGTGGAGAACTAGGCCCACATTCTGTAACTTGTTATTTTTACAAAGCAAAAAAAATTCTAGTTGGTTTAACGCGTAACTAG,AGCTTTTTAGCAATGCAGAGTGGAGAACTAGGCCCGCGCGATCTTGTTGCACATTCTGTAACTTGTTATTTTTACAAAGCAAAAAAAATTCTAGTTGGT,10,30,14,27,27,42,27,57,27,35,35,42,50,57,52.56,0.169204738
hek293t,10785,1,9,AGGGCGGCATGCATTACTTTGGCAGCCTCTGGCAGTTGTGTCATAGGGAGCATGAACCTCATTAGAGGAAAAAAATTCTAGTTGGTTTAACGCGTAACT,AGGGCGGCATGCATTACTTTGGCAGCCTCTGGCAGACGAGGGTATTGTGTCATAGGGAGCATGAACCTCATTAGAGGAAAAAAATTCTAGTTGGTTTAA,10,30,14,27,27,46,27,55,27,36,36,46,45,55,32.6,5.529186891
hek293t,10787,1,6,AATTTCCATATGTCCTTAAACTGACAAAAAGGGTGATGGGCTGCTTTGGAAAAAGCCACATTGGCAGCAAAAAAATTCTAGTTGGTTTAACGCGTAACT,AATTTCCATATGTCCTTAAACTGACAAAAAGGGTGATGCAAAACGGCTGCTTTGGAAAAAGCCACATTGGCAGCAAAAAAATTCTAGTTGGTTTAACGC,10,30,14,27,27,49,27,55,27,39,39,49,45,55,24.69,0.0
hek293t,10787,1,6,GCCCCCCATATGTCCTTAAACTGACAAAAAGGGTGATGGGCTGCTTTGGAAAAAGCCACATTGGCAGCGTCAAAAAAATTCTAGTTGGTTTAACGCGTA,GCCCCCCATATGTCCTTAAACTGACAAAAAGGGTGATGCAAAACGGCTGCTTTGGAAAAAGCCACATTGGCAGCGTCAAAAAAATTCTAGTTGGTTTAA,10,30,14,27,27,46,27,52,27,39,39,46,45,52,24.69,0.344086022
hek293t,10789,1,6,ATCTTTGCTTTAGGGAAAGAAAGCATTTCAGGATCGATGTTTCTTATTAAGCCAGGAGAAAGCAAGGTAAAGAGTATAAGAAAAAAATTCTAGTTGGTT,ATCTTTGCTTTAGGGAAAGAAAGCATCGGCCCTTCAGGATCGATGTTTCTTATTAAGCCAGGAGAAAGCAAGGTAAAGAGTATAAGAAAAAAATTCTAG,10,30,14,27,27,37,27,43,27,27,27,37,33,43,10.5,11.1030134
hek293t,10789,1,6,AGACGTGCTTTAGGGAAAGAAAGCATTTCAGGATCGATGTTTCTTATTAAGCCAGGAGAAAGCAAGGTAAAGAGTAAAAAAATTCTAGTTGGTTTAACG,AGACGTGCTTTAGGGAAAGAAAGCATCGGCCCTTCAGGATCGATGTTTCTTATTAAGCCAGGAGAAAGCAAGGTAAAGAGTAAAAAAATTCTAGTTGGT,10,30,14,27,27,42,27,48,27,27,27,42,33,48,10.5,4.496278752
hek293t,10791,1,8,AATTACCAAGATAAAAGAGCTAGGCTCTGTGGCCTGCCTTCTATAGAGTAGCTGAAAAAGCCCAATGAAAAAAAATTCTAGTTGGTTTAACGCGTAACT,AATTACCAAGATAAAAGAGCTAGGCTCTGTGGCCTGCCTTAGCTATATCTATAGAGTAGCTGAAAAAGCCCAATGAAAAAAAATTCTAGTTGGTTTAAC,10,30,14,27,27,47,27,55,27,40,40,47,48,55,54.49,0.707374041
hek293t,10792,1,4,GTGTCAGCCTGTGGGTGCGGGGGACTTGGTGGTCCTCTTCCCAGGCTACCGCAGGGCCTCGGTGTCTCCTGGGCACTTACAGAAAAAAATTCTAGTTGG,GTGTCAGCCTGTGGGTGCGGGGGACTTGGGGCCTGGTCCTCTTCCCAGGCTACCGCAGGGCCTCGGTGTCTCCTGGGCACTTACAGAAAAAAATTCTAG,10,30,14,27,27,37,27,41,27,30,30,37,34,41,50.38,5.336689131
hek293t,10792,1,4,ACAGCAGCCTGTGGGTGCGGGGGACTTGGTGGTCCTCTTCCCAGGCTACCGCAGGGCCTCGGTGTCTCCTGGGCAAAAAAATTCTAGTTGGTTTAACGC,ACAGCAGCCTGTGGGTGCGGGGGACTTGGGGCCTGGTCCTCTTCCCAGGCTACCGCAGGGCCTCGGTGTCTCCTGGGCAAAAAAATTCTAGTTGGTTTA,10,30,14,27,27,45,27,49,27,30,30,45,34,49,50.38,60.53698196
hek293t,10794,1,4,ACAGTTCTAGGCATCTGAAGATACTCCAGTGGGTTAAGGCAAGTGAGATGGTATAGTGTTATTCTAGATGTTACTTAAAAAAAATTCTAGTTGGTTTAA,ACAGTTCTAGGCATCTGAAGATACTCCAGTGTAGCGGTTAAGGCAAGTGAGATGGTATAGTGTTATTCTAGATGTTACTTAAAAAAAATTCTAGTTGGT,10,30,14,27,27,42,27,46,27,32,32,42,36,46,57.55,88.77546735
hek293t,10794,1,4,TTACTTCTAGGCATCTGAAGATACTCCAGTGGGTTAAGGCAAGTGAGATGGTATAGTGTTATTCTAGATGTTACTTAGATTTTAAAAAAAATTCTAGTT,TTACTTCTAGGCATCTGAAGATACTCCAGTGTAGCGGTTAAGGCAAGTGAGATGGTATAGTGTTATTCTAGATGTTACTTAGATTTTAAAAAAAATTCT,10,30,14,27,27,35,27,39,27,32,32,35,36,39,57.55,1.160522991
hek293t,10796,1,3,AACAATGATCACCAGAGTGCTCAGTGTCCTGGTTTTGCCGCACCTAACTGAGGATTCTTAAACTAACACTGATAACAAAAAAAAATTCTAGTTGGTTTA,AACAATGATCACCAGAGTGCTCAGTGTCCTGGTTTTGCTCTCGCACCTAACTGAGGATTCTTAAACTAACACTGATAACAAAAAAAAATTCTAGTTGGT,10,30,14,27,27,42,27,45,27,39,39,42,42,45,47.39,0.424425232
hek293t,10798,1,6,ATACATTTGTCTTCGTGAGTGTAATTTGGTGGCTCAGCAACAGTTTCTTCATAAACCCATGTCTCCATGTTGAGCTGAGAAAAAAATTCTAGTTGGTTT,ATACATTTGTCTTCGTGAGTGTAATTTCAACAGGGTGGCTCAGCAACAGTTTCTTCATAAACCCATGTCTCCATGTTGAGCTGAGAAAAAAATTCTAGT,10,30,14,27,27,38,27,44,27,28,28,38,34,44,46.42,51.18765561
hek293t,10798,1,6,GCTCGTTTGTCTTCGTGAGTGTAATTTGGTGGCTCAGCAACAGTTTCTTCATAAACCCATGTCTCCATGTTGAGAAAAAAATTCTAGTTGGTTTAACGC,GCTCGTTTGTCTTCGTGAGTGTAATTTCAACAGGGTGGCTCAGCAACAGTTTCTTCATAAACCCATGTCTCCATGTTGAGAAAAAAATTCTAGTTGGTT,10,30,14,27,27,43,27,49,27,28,28,43,34,49,46.42,67.58774915
hek293t,10800,1,6,CCGCTACTTGCATTTAGATTCAAGATTATTGGCAGAACAATCAAATGCACCCTTGAAAAGTGTGCAAGAGAAAACTATGCAAAAAAATTCTAGTTGGTT,CCGCTACTTGCATTTAGATTCAAGATAGTACCTATTGGCAGAACAATCAAATGCACCCTTGAAAAGTGTGCAAGAGAAAACTATGCAAAAAAATTCTAG,10,30,14,27,27,37,27,43,27,27,27,37,33,43,7.73,42.34874587
hek293t,10800,1,6,CAGCAACTTGCATTTAGATTCAAGATTATTGGCAGAACAATCAAATGCACCCTTGAAAAGTGTGCAAGAGAAAACTATGCCATAAAAAAATTCTAGTTG,CAGCAACTTGCATTTAGATTCAAGATAGTACCTATTGGCAGAACAATCAAATGCACCCTTGAAAAGTGTGCAAGAGAAAACTATGCCATAAAAAAATTC,10,30,14,27,27,34,27,40,27,27,27,34,33,40,7.73,8.352707929
hek293t,10802,1,15,TCTCCCAAAATCCCATGGCGGGGGAGGAAAGGAGGGTTGATATGGATCAGTATAATGATCCTGTAAAAAAAATTCTAGTTGGTTTAACGCGTAACTAGA,TCTCCCAAAATCCCATGGCGGGGGAGGATCCACACCTCCACGAAAGGAGGGTTGATATGGATCAGTATAATGATCCTGTAAAAAAAATTCTAGTTGGTT,10,30,14,27,27,43,27,58,27,28,28,43,43,58,22.06,30.9023943
hek293t,10802,1,15,TTTCCCAAAATCCCATGGCGGGGGAGGAAAGGAGGGTTGATATGGATCAGTATAATGATCCTGTATATATAAAAAAATTCTAGTTGGTTTAACGCGTAA,TTTCCCAAAATCCCATGGCGGGGGAGGATCCACACCTCCACGAAAGGAGGGTTGATATGGATCAGTATAATGATCCTGTATATATAAAAAAATTCTAGT,10,30,14,27,27,38,27,53,27,28,28,38,43,53,22.06,31.06018819
hek293t,10806,1,2,TTCGGCCAGAATATGTGACATGACTTTTTTGGGTCTCTAGCATATTTCTCTCATTTAGCAGACCCAGACTGAACTTCCACAAAAAAAAATTCTAGTTGG,TTCGGCCAGAATATGTGACATGACTTTTTTGAAGGTCTCTAGCATATTTCTCTCATTTAGCAGACCCAGACTGAACTTCCACAAAAAAAAATTCTAGTT,10,30,14,27,27,39,27,41,27,32,32,39,34,41,2.55,1.666542839
hek293t,10808,1,6,TCGATCACTTACAAGCCTCTAGTTTATTTAGGATGACATACATTAGACTTTGCCCTTCTCCCTCCTAAACACCAAAAAAATTCTAGTTGGTTTAACGCG,TCGATCACTTACAAGCCTCTAGTTTATTTAGGATGAGGTGTCCATACATTAGACTTTGCCCTTCTCCCTCCTAAACACCAAAAAAATTCTAGTTGGTTT,10,30,14,27,27,44,27,50,27,37,37,44,43,50,8.18,14.51673691
hek293t,10808,1,6,CGTACCACTTACAAGCCTCTAGTTTATTTAGGATGACATACATTAGACTTTGCCCTTCTCCCTCCTAAACACCATCAAAAAAAATTCTAGTTGGTTTAA,CGTACCACTTACAAGCCTCTAGTTTATTTAGGATGAGGTGTCCATACATTAGACTTTGCCCTTCTCCCTCCTAAACACCATCAAAAAAAATTCTAGTTG,10,30,14,27,27,40,27,46,27,37,37,40,43,46,8.18,0.215768359
hek293t,10810,1,9,CGAGTTAAAAACAACATCCAGTGCACAGCAGGTTTTATGAAGTAGGTGCCAAGCACTCCCTCTTTTAGAAAAAAATTCTAGTTGGTTTAACGCGTAACT,CGAGTTAAAAACAACATCCAGTGCACAGCAGGTTTTATTTCCATTCAGAAGTAGGTGCCAAGCACTCCCTCTTTTAGAAAAAAATTCTAGTTGGTTTAA,10,30,14,27,27,46,27,55,27,39,39,46,48,55,30.02,16.42653385
hek293t,10813,1,2,CAATCCTGCTAGATATTTTAATGGCCTGCAGGATATATCTGAGTACGTAGAACAGAAGCCTTAAAGGAAATGAAATACTCAAAAAAATTCTAGTTGGTT,CAATCCTGCTAGATATTTTAATGGCCTGCACGGGATATATCTGAGTACGTAGAACAGAAGCCTTAAAGGAAATGAAATACTCAAAAAAATTCTAGTTGG,10,30,14,27,27,41,27,43,27,31,31,41,33,43,12.94,82.97649286
hek293t,10813,1,2,AAGCTCTGCTAGATATTTTAATGGCCTGCAGGATATATCTGAGTACGTAGAACAGAAGCCTTAAAGGAAATGAAAAAAAAAATTCTAGTTGGTTTAACG,AAGCTCTGCTAGATATTTTAATGGCCTGCACGGGATATATCTGAGTACGTAGAACAGAAGCCTTAAAGGAAATGAAAAAAAAAATTCTAGTTGGTTTAA,10,30,14,27,27,46,27,48,27,31,31,46,33,48,12.94,47.01689347
hek293t,10815,1,6,CTGTGGGCTGGAGGGTCTGAAAGAATGGAAGGAAGTGGTGGGAATATCTTTTAGGTATGGCAGGAAAAAAAAATTCTAGTTGGTTTAACGCGTAACTAG,CTGTGGGCTGGAGGGTCTGAAAGAATGGAAGGAAGTGGTGAACAATGGAATATCTTTTAGGTATGGCAGGAAAAAAAAATTCTAGTTGGTTTAACGCGT,10,30,14,27,27,51,27,57,27,41,41,51,47,57,73.95,0.144506666
hek293t,10816,1,11,GTCACTCACGCTTAGCGGAGTCAGTGTGCAGGTGCACATAATTGGTAAGAGCTCCATCTCTGAGAGGAGGAAAAAAAAAAATTCTAGTTGGTTTAACGC,GTCACTCACGCTTAGCGGAGTCAGTGTGCAGCCAATCAGCAGGTGCACATAATTGGTAAGAGCTCCATCTCTGAGAGGAGGAAAAAAAAAAATTCTAGT,10,30,14,27,27,38,27,49,27,28,28,38,39,49,63.47,13.68443298
hek293t,10816,1,11,AACGCTCACGCTTAGCGGAGTCAGTGTGCAGGTGCACATAATTGGTAAGAGCTCCATCTCTGAGAGGAGGAAAACGAAAAAAAATTCTAGTTGGTTTAA,AACGCTCACGCTTAGCGGAGTCAGTGTGCAGCCAATCAGCAGGTGCACATAATTGGTAAGAGCTCCATCTCTGAGAGGAGGAAAACGAAAAAAAATTCT,10,30,14,27,27,35,27,46,27,28,28,35,39,46,63.47,3.962034887
hek293t,10818,1,7,CAGGTCCTCTATCTTAAGGCCAAGTACTAAGGAGAAACACAACTTTGCTCTGCCTTGGCCTGGCAGACCAAAAAAATTCTAGTTGGTTTAACGCGTAAC,CAGGTCCTCTATCTTAAGGCCAAGTACTAAGGAGAAACAACACTTTCAACTTTGCTCTGCCTTGGCCTGGCAGACCAAAAAAATTCTAGTTGGTTTAAC,10,30,14,27,27,47,27,54,27,40,40,47,47,54,30.58,9.918761194
hek293t,10820,1,4,TTCATAGAGACACTTCACTACGGAAATTATGGTGAAAGTAGAGTAAGCTTCAGACTTCGCCTCTAAAAAAATTCTAGTTGGTTTAACGCGTAACTAGAT,TTCATAGAGACACTTCACTACGGAAATTATGGTGAAAGTATTCAGAGTAAGCTTCAGACTTCGCCTCTAAAAAAATTCTAGTTGGTTTAACGCGTAACT,10,30,14,27,27,55,27,59,27,40,40,55,44,59,25.46,73.302465
hek293t,10820,1,4,AGTGTAGAGACACTTCACTACGGAAATTATGGTGAAAGTAGAGTAAGCTTCAGACTTCGCCTCTGCTGCAATAAAAAAATTCTAGTTGGTTTAACGCGT,AGTGTAGAGACACTTCACTACGGAAATTATGGTGAAAGTATTCAGAGTAAGCTTCAGACTTCGCCTCTGCTGCAATAAAAAAATTCTAGTTGGTTTAAC,10,30,14,27,27,47,27,51,27,40,40,47,44,51,25.46,66.8821112
hek293t,2629,1,11,GATCTTGAGGACTAGGACTAAATATTGAGAGGAAATTATCCTAAGAGGAAGGAGTCCTTGACTGGGGTGGTGGTGCTCCGAAAAAAATTCTAGTTGGTT,GATCTTGAGGACTAGGACTAAATATTGATTGGGTGGCCTGAGGAAATTATCCTAAGAGGAAGGAGTCCTTGACTGGGGTGGTGGTGCTCCGAAAAAAAT,10,30,14,27,27,32,27,43,27,29,29,32,40,43,64.9,0.50102307
hek293t,2629,1,11,GATGATGAGGACTAGGACTAAATATTGAGAGGAAATTATCCTAAGAGGAAGGAGTCCTTGACTGGGGTGGTGGAAAAAAATTCTAGTTGGTTTAACGCG,GATGATGAGGACTAGGACTAAATATTGATTGGGTGGCCTGAGGAAATTATCCTAAGAGGAAGGAGTCCTTGACTGGGGTGGTGGAAAAAAATTCTAGTT,10,30,14,27,27,39,27,50,27,29,29,39,40,50,64.9,2.78143002
hek293t,10826,1,12,CGGCTGGAAAATATTTTAGTGACTAACTGTGGTTGTCTTCCCTATGGAGCACCTCATTCATTCTGTCAGAAAAAAAATTCTAGTTGGTTTAACGCGTAA,CGGCTGGAAAATATTTTAGTGACTAACTGTGGTTTGTGCCGTGTGTGTCTTCCCTATGGAGCACCTCATTCATTCTGTCAGAAAAAAAATTCTAGTTGG,10,30,14,27,27,41,27,53,27,34,34,41,46,53,40.3,0.431164633
hek293t,10826,1,12,GTGCGGGAAAATATTTTAGTGACTAACTGTGGTTGTCTTCCCTATGGAGCACCTCATTCATTCTGTCAAAAAAATTCTAGTTGGTTTAACGCGTAACTA,GTGCGGGAAAATATTTTAGTGACTAACTGTGGTTTGTGCCGTGTGTGTCTTCCCTATGGAGCACCTCATTCATTCTGTCAAAAAAATTCTAGTTGGTTT,10,30,14,27,27,44,27,56,27,34,34,44,46,56,40.3,1.650336877
hek293t,10828,1,9,CTAGTTAGTCCTCAACATTATTATTTCCCAGGCAGCAAAAGAAGCTTTATTCTGTCCTGCATTCTGGAAAAAAATTCTAGTTGGTTTAACGCGTAACTA,CTAGTTAGTCCTCAACATTATTATTTCCCAGTACAACGGGGCAGCAAAAGAAGCTTTATTCTGTCCTGCATTCTGGAAAAAAATTCTAGTTGGTTTAAC,10,30,14,27,27,47,27,56,27,32,32,47,41,56,29.65,0.0
hek293t,10828,1,9,CCCGTTAGTCCTCAACATTATTATTTCCCAGGCAGCAAAAGAAGCTTTATTCTGTCCTGCATTCTGGGCAATAAAAAAATTCTAGTTGGTTTAACGCGT,CCCGTTAGTCCTCAACATTATTATTTCCCAGTACAACGGGGCAGCAAAAGAAGCTTTATTCTGTCCTGCATTCTGGGCAATAAAAAAATTCTAGTTGGT,10,30,14,27,27,42,27,51,27,32,32,42,41,51,29.65,0.0
hek293t,10830,1,6,GAGGCGTGGGTGAGTCATGTGACCTCCTGGGGCTCAGATACCAGGAAATAAATTGCCTGGGTCTCTCTCGCTCCCGAAAAAAATTCTAGTTGGTTTAAC,GAGGCGTGGGTGAGTCATGTGACCTCCTGGTGGCGTGGCTCAGATACCAGGAAATAAATTGCCTGGGTCTCTCTCGCTCCCGAAAAAAATTCTAGTTGG,10,30,14,27,27,41,27,47,27,31,31,41,37,47,42.7,43.59017336
hek293t,10830,1,6,CAGGGGTGGGTGAGTCATGTGACCTCCTGGGGCTCAGATACCAGGAAATAAATTGCCTGGGTCTCTCTCGCTCCCGGGCTGGTAAAAAAATTCTAGTTG,CAGGGGTGGGTGAGTCATGTGACCTCCTGGTGGCGTGGCTCAGATACCAGGAAATAAATTGCCTGGGTCTCTCTCGCTCCCGGGCTGGTAAAAAAATTC,10,30,14,27,27,34,27,40,27,31,31,34,37,40,42.7,0.187265918
hek293t,10832,1,2,TACTAAAGTTTTGTGCAGCTGCCTATGTTAGGGCCGGAGAATGGAAATGTAGAAGGCACTTCAGGTTCAGGTGGCACAAAAAAATTCTAGTTGGTTTAA,TACTAAAGTTTTGTGCAGCTGCCTATGTTAGGGCCGGCGAGAATGGAAATGTAGAAGGCACTTCAGGTTCAGGTGGCACAAAAAAATTCTAGTTGGTTT,10,30,14,27,27,44,27,46,27,37,37,44,39,46,24.99,65.21633805
hek293t,10834,1,8,AGGCAATTTCATTTCACAGAACATTCTGGAGGGATAAACTGTTTTGAGTTGAAGGAGACCTAACTTCTCCCTAAAAAAAAAATTCTAGTTGGTTTAACG,AGGCAATTTCATTTCACAGAACATTCTGGCCCGCTCAAGGGATAAACTGTTTTGAGTTGAAGGAGACCTAACTTCTCCCTAAAAAAAAAATTCTAGTTG,10,30,14,27,27,40,27,48,27,30,30,40,38,48,51.12,4.829967631
hek293t,10834,1,8,TTAACATTTCATTTCACAGAACATTCTGGAGGGATAAACTGTTTTGAGTTGAAGGAGACCTAACTTCTCCAAAAAAATTCTAGTTGGTTTAACGCGTAA,TTAACATTTCATTTCACAGAACATTCTGGCCCGCTCAAGGGATAAACTGTTTTGAGTTGAAGGAGACCTAACTTCTCCAAAAAAATTCTAGTTGGTTTA,10,30,14,27,27,45,27,53,27,30,30,45,38,53,51.12,5.478176818
hek293t,10836,1,12,CATTCCTGTAACACTCCAGCAGGTGTGGCTGGATCAGGAACTTCACACGATCCCACACCACAAGCTAAGAAAAAAATTCTAGTTGGTTTAACGCGTAAC,CATTCCTGTAACACTCCAGCAGGTGTGGCTGAGATAGACTGTAGATCAGGAACTTCACACGATCCCACACCACAAGCTAAGAAAAAAATTCTAGTTGGT,10,30,14,27,27,42,27,54,27,32,32,42,44,54,50.87,8.860556002
hek293t,10836,1,12,GTCCCCTGTAACACTCCAGCAGGTGTGGCTGGATCAGGAACTTCACACGATCCCACACCACAAGCTAAGTAAAAAAAAATTCTAGTTGGTTTAACGCGT,GTCCCCTGTAACACTCCAGCAGGTGTGGCTGAGATAGACTGTAGATCAGGAACTTCACACGATCCCACACCACAAGCTAAGTAAAAAAAAATTCTAGTT,10,30,14,27,27,39,27,51,27,32,32,39,44,51,50.87,1.130922398
hek293t,10838,1,6,CGCCAGACCTGCAGTGCTTTTGCAGGCATTGGGAGACTGCCTACCAAAAACTAATTAATTGCAGAATTCATTAAAAAAAATTCTAGTTGGTTTAACGCG,CGCCAGACCTGCAGTGCTTTTGCAGGCATTGGGAGAAAATCTCTGCCTACCAAAAACTAATTAATTGCAGAATTCATTAAAAAAAATTCTAGTTGGTTT,10,30,14,27,27,44,27,50,27,37,37,44,43,50,12.21,0.219298246
hek293t,10838,1,6,AAAGAGACCTGCAGTGCTTTTGCAGGCATTGGGAGACTGCCTACCAAAAACTAATTAATTGCAGAAAAAAAATTCTAGTTGGTTTAACGCGTAACTAGA,AAAGAGACCTGCAGTGCTTTTGCAGGCATTGGGAGAAAATCTCTGCCTACCAAAAACTAATTAATTGCAGAAAAAAAATTCTAGTTGGTTTAACGCGTA,10,30,14,27,27,52,27,58,27,37,37,52,43,58,12.21,0.0
hek293t,10840,1,9,GTTCATAATCTGTGGGAATGTGATTATTAAGGTGGCTATCAGATTAGTATGAACCATCAAATGTGTATTACTAAAAAAATTCTAGTTGGTTTAACGCGT,GTTCATAATCTGTGGGAATGTGATTATTAAGCTACCTTCAGTGGCTATCAGATTAGTATGAACCATCAAATGTGTATTACTAAAAAAATTCTAGTTGGT,10,30,14,27,27,42,27,51,27,32,32,42,41,51,17.07,18.74949755
hek293t,10840,1,9,TAAATTAATCTGTGGGAATGTGATTATTAAGGTGGCTATCAGATTAGTATGAACCATCAAATGTGTAAAAAAAATTCTAGTTGGTTTAACGCGTAACTA,TAAATTAATCTGTGGGAATGTGATTATTAAGCTACCTTCAGTGGCTATCAGATTAGTATGAACCATCAAATGTGTAAAAAAAATTCTAGTTGGTTTAAC,10,30,14,27,27,47,27,56,27,32,32,47,41,56,17.07,3.500898311
hek293t,10842,1,2,CTGTGCCCCCAGGTAAAACTGCGACAAGCTGGTGCTGTGGTGATCCCAGGCTTGATGCATCTCTTGGCTCAGCAAAAAAATTCTAGTTGGTTTAACGCG,CTGTGCCCCCAGGTAAAACTGCGACAAGCTGGTGCTGGATGGTGATCCCAGGCTTGATGCATCTCTTGGCTCAGCAAAAAAATTCTAGTTGGTTTAACG,10,30,14,27,27,48,27,50,27,38,38,48,40,50,31.3,77.25000692
hek293t,10842,1,2,GTGCGCCCCCAGGTAAAACTGCGACAAGCTGGTGCTGTGGTGATCCCAGGCTTGATGCATCTCTTGGCTCAGCCCAAGAGAAAAAAATTCTAGTTGGTT,GTGCGCCCCCAGGTAAAACTGCGACAAGCTGGTGCTGGATGGTGATCCCAGGCTTGATGCATCTCTTGGCTCAGCCCAAGAGAAAAAAATTCTAGTTGG,10,30,14,27,27,41,27,43,27,38,38,41,40,43,31.3,0.0
hek293t,10844,1,3,TGCTGGGTTAAAATACAAGGTCTGCTTGGAGGCAAGTACAGTGAATAGTATCATCTAGAAAACATGAATATAAAATGTAAAAAAATTCTAGTTGGTTTA,TGCTGGGTTAAAATACAAGGTCTGCTTGGAGGCACCCAGTACAGTGAATAGTATCATCTAGAAAACATGAATATAAAATGTAAAAAAATTCTAGTTGGT,10,30,14,27,27,42,27,45,27,35,35,42,38,45,62.01,78.57151419
hek293t,10844,1,3,TGCCTGGTTAAAATACAAGGTCTGCTTGGAGGCAAGTACAGTGAATAGTATCATCTAGAAAACATGAATATAAAAAAAAAAATTCTAGTTGGTTTAACG,TGCCTGGTTAAAATACAAGGTCTGCTTGGAGGCACCCAGTACAGTGAATAGTATCATCTAGAAAACATGAATATAAAAAAAAAAATTCTAGTTGGTTTA,10,30,14,27,27,45,27,48,27,35,35,45,38,48,62.01,77.46758649
hek293t,10846,1,11,CGAGCTTAACTAGATGGAGTCTTCTTTTCTGGCTGCTATTGCAGTGTTTGCAAGGCTAGAACTGATGTGTAAAAAAATTCTAGTTGGTTTAACGCGTAA,CGAGCTTAACTAGATGGAGTCTTCTTTCGATGTAAACTTCTGGCTGCTATTGCAGTGTTTGCAAGGCTAGAACTGATGTGTAAAAAAATTCTAGTTGGT,10,30,14,27,27,42,27,53,27,27,27,42,38,53,3.23,0.713557594
hek293t,10846,1,11,GTCCATTAACTAGATGGAGTCTTCTTTTCTGGCTGCTATTGCAGTGTTTGCAAGGCTAGAACTGATGTGTCTTCCTGTGCAGAAAAAAATTCTAGTTGG,GTCCATTAACTAGATGGAGTCTTCTTTCGATGTAAACTTCTGGCTGCTATTGCAGTGTTTGCAAGGCTAGAACTGATGTGTCTTCCTGTGCAGAAAAAA,10,30,14,27,27,30,27,41,27,27,27,30,38,41,3.23,0.0
hek293t,10848,1,9,CAGCCCCACAAGTGCCTTTGTACAACAATAGGAAATGTATTGTGAAAGTCAAAGGGAAATCTTTCAGGTAGTTTATAAAAAAATTCTAGTTGGTTTAAC,CAGCCCCACAAGTGCCTTTGTACAACACTGATGGCGATAGGAAATGTATTGTGAAAGTCAAAGGGAAATCTTTCAGGTAGTTTATAAAAAAATTCTAGT,10,30,14,27,27,38,27,47,27,28,28,38,37,47,24.74,16.4800686
hek293t,10848,1,9,AAATCCCACAAGTGCCTTTGTACAACAATAGGAAATGTATTGTGAAAGTCAAAGGGAAATCTTTCAGGTAGTTTATTTAAAAAAAATTCTAGTTGGTTT,AAATCCCACAAGTGCCTTTGTACAACACTGATGGCGATAGGAAATGTATTGTGAAAGTCAAAGGGAAATCTTTCAGGTAGTTTATTTAAAAAAAATTCT,10,30,14,27,27,35,27,44,27,28,28,35,37,44,24.74,3.577521916
hek293t,10850,1,4,TCGCACTCTCAGATAATGTAAGAAATGGCTGGGGTTTATTTTCGCAGCCTGCTATTCTTCTGTTACGGTAAAAAAATTCTAGTTGGTTTAACGCGTAAC,TCGCACTCTCAGATAATGTAAGAAATGGCTGGGGCCACTTTATTTTCGCAGCCTGCTATTCTTCTGTTACGGTAAAAAAATTCTAGTTGGTTTAACGCG,10,30,14,27,27,50,27,54,27,35,35,50,39,54,36.2,23.2320741
hek293t,10852,1,8,CGAACTAAAACTAAAAAGTCCACTGAAATAGGTGAGGCAGCGCATAACTCAGGCTTCTGTCTGAACTAGTTAAAAAAATTCTAGTTGGTTTAACGCGTA,CGAACTAAAACTAAAAAGTCCACTGAAATAGGTGAGGCAGCACAACCTCGCATAACTCAGGCTTCTGTCTGAACTAGTTAAAAAAATTCTAGTTGGTTT,10,30,14,27,27,44,27,52,27,41,41,44,49,52,7.84,0.0
hek293t,10853,1,11,GCTGAATGATTTTTAGGCACATCCAGCCTTGGTAGTTATGCTTAGCAATATAGTACAATTAAGGAAAACCTGTTCTTCATCAAAAAAATTCTAGTTGGT,GCTGAATGATTTTTAGGCACATCCAGCGAACTAGAATGCTTGGTAGTTATGCTTAGCAATATAGTACAATTAAGGAAAACCTGTTCTTCATCAAAAAAA,10,30,14,27,27,31,27,42,27,28,28,31,39,42,25.47,2.244504482
hek293t,10853,1,11,ACTAAATGATTTTTAGGCACATCCAGCCTTGGTAGTTATGCTTAGCAATATAGTACAATTAAGGAAAACCTGTTCTTAAAAAAATTCTAGTTGGTTTAA,ACTAAATGATTTTTAGGCACATCCAGCGAACTAGAATGCTTGGTAGTTATGCTTAGCAATATAGTACAATTAAGGAAAACCTGTTCTTAAAAAAATTCT,10,30,14,27,27,35,27,46,27,28,28,35,39,46,25.47,2.268634549
hek293t,10858,1,4,CCAGCTTAAATAAACCAGTATGAGTAACACGGCTTTTTCCTTTTTCTATAGCTTCTGATTTACGCAGCTTTCCTGGCATTTAACCAAAAAAATTCTAGT,CCAGCTTAAATAAACCAGTATGAGTAACACGGGTGGCTTTTTCCTTTTTCTATAGCTTCTGATTTACGCAGCTTTCCTGGCATTTAACCAAAAAAATTC,10,30,14,27,27,34,27,38,27,31,31,34,35,38,61.01,0.763137769
hek293t,10862,1,13,GTTATCCCACACAAAGCTCTCTATAATCAAGGCAGCATTTCCCTTCCAAGGAGATATTAAGGTGGGAAAAAAGAAAAAAAATTCTAGTTGGTTTAACGC,GTTATCCCACACAAAGCTCTCTATAATCAAGGGTTGAAACTCTTCCAGCATTTCCCTTCCAAGGAGATATTAAGGTGGGAAAAAAGAAAAAAAATTCTA,10,30,14,27,27,36,27,49,27,33,33,36,46,49,34.47,0.092506938
hek293t,10862,1,13,TGCAACCCACACAAAGCTCTCTATAATCAAGGCAGCATTTCCCTTCCAAGGAGATATTAAGGTGGGAAAAAAAATTCTAGTTGGTTTAACGCGTAACTA,TGCAACCCACACAAAGCTCTCTATAATCAAGGGTTGAAACTCTTCCAGCATTTCCCTTCCAAGGAGATATTAAGGTGGGAAAAAAAATTCTAGTTGGTT,10,30,14,27,27,43,27,56,27,33,33,43,46,56,34.47,4.137260123
hek293t,10864,1,12,TTATTAAATTGAGACAGTCATACTGTGTAAGGCAGCTGAGTTCATGGAAAGATTTCTCAAGTACAAAAAAATTCTAGTTGGTTTAACGCGTAACTAGAT,TTATTAAATTGAGACAGTCATACTGTGTAAGGCAGCGGGAGACCGGATTGAGTTCATGGAAAGATTTCTCAAGTACAAAAAAATTCTAGTTGGTTTAAC,10,30,14,27,27,47,27,59,27,37,37,47,49,59,61.27,0.080128205
hek293t,10864,1,12,CAGGGAAATTGAGACAGTCATACTGTGTAAGGCAGCTGAGTTCATGGAAAGATTTCTCAAGTACTAGCTGGAAAAAAATTCTAGTTGGTTTAACGCGTA,CAGGGAAATTGAGACAGTCATACTGTGTAAGGCAGCGGGAGACCGGATTGAGTTCATGGAAAGATTTCTCAAGTACTAGCTGGAAAAAAATTCTAGTTG,10,30,14,27,27,40,27,52,27,37,37,40,49,52,61.27,0.0
hek293t,10868,1,12,AGACATCTGTTGCTTAGAAAATGAAGACTTGGGTTGACTGTAAGAGGACATTGAGACAGTCTTAATGAAAAGAAAAAAATTCTAGTTGGTTTAACGCGT,AGACATCTGTTGCTTAGAAAATGAAGACTCCGAATAGCGCTTGGGTTGACTGTAAGAGGACATTGAGACAGTCTTAATGAAAAGAAAAAAATTCTAGTT,10,30,14,27,27,39,27,51,27,29,29,39,41,51,29.26,0.140276595
hek293t,10868,1,12,CAGCCTCTGTTGCTTAGAAAATGAAGACTTGGGTTGACTGTAAGAGGACATTGAGACAGTCTTAATGAAAAGGGAGTCTAAAAAAATTCTAGTTGGTTT,CAGCCTCTGTTGCTTAGAAAATGAAGACTCCGAATAGCGCTTGGGTTGACTGTAAGAGGACATTGAGACAGTCTTAATGAAAAGGGAGTCTAAAAAAAT,10,30,14,27,27,32,27,44,27,29,29,32,41,44,29.26,0.0
hek293t,10870,1,8,TGCAGGAGAGATTGTTTATTTTTTAAGCCAGGGACAGTTCACATTGTTCAGCTTCTGGCCCCCCCCGTAATTAAGAAAAAAAATTCTAGTTGGTTTAAC,TGCAGGAGAGATTGTTTATTTTTTAAGCCAGGGACGCGGAGTCAGTTCACATTGTTCAGCTTCTGGCCCCCCCCGTAATTAAGAAAAAAAATTCTAGTT,10,30,14,27,27,39,27,47,27,36,36,39,44,47,1.26,0.0
hek293t,10169,1,3,TGTCCATGCATTGGTTTTGAAAACGTAGATGGATTGGAGATGCAGGGAGAAATGCTAGCTCTAAAAGAAATGGAAAGAGAGGAAAAAAAATTCTAGTTG,TGTCCATGCATTGGTTTTGAAAACGTAGATGTTGGATTGGAGATGCAGGGAGAAATGCTAGCTCTAAAAGAAATGGAAAGAGAGGAAAAAAAATTCTAG,10,30,14,27,27,37,27,40,27,30,30,37,33,40,16.68,0.391177731
hek293t,10169,1,3,AGGCAATGCATTGGTTTTGAAAACGTAGATGGATTGGAGATGCAGGGAGAAATGCTAGCTCTAAAAGAAATGGAAAGAGAGGAGAATAAAAAAATTCTA,AGGCAATGCATTGGTTTTGAAAACGTAGATGTTGGATTGGAGATGCAGGGAGAAATGCTAGCTCTAAAAGAAATGGAAAGAGAGGAGAATAAAAAAATT,10,30,14,27,27,33,27,36,27,30,30,33,33,36,16.68,0.005451077
hek293t,10874,1,5,TAGTCTCACACTCAAAACTTCTACAGAACTGGAGTTGGGACTCTCGTTTCCTACTGGAATCTATAACATCAAAAAAATTCTAGTTGGTTTAACGCGTAA,TAGTCTCACACTCAAAACTTCTACAGAACTGGAGTTGGGAAGTTCCTCTCGTTTCCTACTGGAATCTATAACATCAAAAAAATTCTAGTTGGTTTAACG,10,30,14,27,27,48,27,53,27,41,41,48,46,53,23.1,7.577539791
hek293t,10874,1,5,CCAACTCACACTCAAAACTTCTACAGAACTGGAGTTGGGACTCTCGTTTCCTACTGGAATCTATAACAAAAAAATTCTAGTTGGTTTAACGCGTAACTA,CCAACTCACACTCAAAACTTCTACAGAACTGGAGTTGGGAAGTTCCTCTCGTTTCCTACTGGAATCTATAACAAAAAAATTCTAGTTGGTTTAACGCGT,10,30,14,27,27,51,27,56,27,41,41,51,46,56,23.1,25.21831555
hek293t,10876,1,8,GCGAATTTCACACCATAAGTGATGTGATTTGGTATTAAATGTCCTCTAATGTTCACCTTAATGCAGTATAAAAAAATTCTAGTTGGTTTAACGCGTAAC,GCGAATTTCACACCATAAGTGATGTGATTTGGTATTAAGCACCAACATGTCCTCTAATGTTCACCTTAATGCAGTATAAAAAAATTCTAGTTGGTTTAA,10,30,14,27,27,46,27,54,27,39,39,46,47,54,14.07,0.848942962
hek293t,10878,1,8,CAGTAGCAGAAACAAATGCTATGCATATAAGGTCAGAAGAATGCTTCTGTTTCCGTTGATGTCCAAATATACAAAAAAAATTCTAGTTGGTTTAACGCG,CAGTAGCAGAAACAAATGCTATGCATATAAGATGCTGGTGTCAGAAGAATGCTTCTGTTTCCGTTGATGTCCAAATATACAAAAAAAATTCTAGTTGGT,10,30,14,27,27,42,27,50,27,32,32,42,40,50,14.74,50.19831313
hek293t,10878,1,8,TATCTGCAGAAACAAATGCTATGCATATAAGGTCAGAAGAATGCTTCTGTTTCCGTTGATGTCCAAATATACATCTAAAAAAATTCTAGTTGGTTTAAC,TATCTGCAGAAACAAATGCTATGCATATAAGATGCTGGTGTCAGAAGAATGCTTCTGTTTCCGTTGATGTCCAAATATACATCTAAAAAAATTCTAGTT,10,30,14,27,27,39,27,47,27,32,32,39,40,47,14.74,70.41199471
hek293t,10880,1,1,GCCAACACCAGCTGCTCAGAAAGTAACCATGGATGCTTTCATCACAAAATATTTTATATCAAAAGCTGGTGGTTTGATGAAGCCACATAAAAAAATTCT,GCCAACACCAGCTGCTCAGAAAGTAACCATGGGATGCTTTCATCACAAAATATTTTATATCAAAAGCTGGTGGTTTGATGAAGCCACATAAAAAAATTC,10,30,14,27,27,34,27,35,27,31,31,34,32,35,67.1,1.58518189
hek293t,10882,1,6,GTAGTACAGCTCCATCCAGTAGAATCTACCGGAAATCTTTAAACGTCATTATCTAATCCCATCAAAAAAAAATTCTAGTTGGTTTAACGCGTAACTAGA,GTAGTACAGCTCCATCCAGTAGAATCTACCGGAAATCCTATCCTTTAAACGTCATTATCTAATCCCATCAAAAAAAAATTCTAGTTGGTTTAACGCGTA,10,30,14,27,27,52,27,58,27,37,37,52,43,58,27.5,0.0
hek293t,10882,1,6,ATGGCACAGCTCCATCCAGTAGAATCTACCGGAAATCTTTAAACGTCATTATCTAATCCCATCAAATCTGTTGGAGGAAAAAAATTCTAGTTGGTTTAA,ATGGCACAGCTCCATCCAGTAGAATCTACCGGAAATCCTATCCTTTAAACGTCATTATCTAATCCCATCAAATCTGTTGGAGGAAAAAAATTCTAGTTG,10,30,14,27,27,40,27,46,27,37,37,40,43,46,27.5,0.0
hek293t,10886,1,8,AGAGATTTCCAGATGCAGGAGTGAAGAACTGGCTTCAAAGTCAGCCAATTGTAAAATTTAGCTTCAAAACTTGCTTCAAAAAAAATTCTAGTTGGTTTA,AGAGATTTCCAGATGCAGGAGTGAAGATATTAGAAACTGGCTTCAAAGTCAGCCAATTGTAAAATTTAGCTTCAAAACTTGCTTCAAAAAAAATTCTAG,10,30,14,27,27,37,27,45,27,27,27,37,35,45,45.69,9.103326955
hek293t,10886,1,8,AGCACTTTCCAGATGCAGGAGTGAAGAACTGGCTTCAAAGTCAGCCAATTGTAAAATTTAGCTTCAAAACTTGAAAAAAATTCTAGTTGGTTTAACGCG,AGCACTTTCCAGATGCAGGAGTGAAGATATTAGAAACTGGCTTCAAAGTCAGCCAATTGTAAAATTTAGCTTCAAAACTTGAAAAAAATTCTAGTTGGT,10,30,14,27,27,42,27,50,27,27,27,42,35,50,45.69,34.34174314
hek293t,10888,1,13,CGAGTGTTTAATAATGGCCCGTTCATAAATGGACTCAGGTTGTAACCGTTTGACCAGAGTGTAAAAAAAAATTCTAGTTGGTTTAACGCGTAACTAGAT,CGAGTGTTTAATAATGGCCCGTTCATAAATGGACTCAGCTAACGCCTATAGGTTGTAACCGTTTGACCAGAGTGTAAAAAAAAATTCTAGTTGGTTTAA,10,30,14,27,27,46,27,59,27,39,39,46,52,59,12.65,3.075008284
hek293t,10889,1,7,ATTAGAAACATTGTGGGCCAATCTTACTGTGGACCATGGTGCTACGTGTTAACTTTGCCTGACTAAAAAAATTCTAGTTGGTTTAACGCGTAACTAGAT,ATTAGAAACATTGTGGGCCAATCTTACTGTGGACCAAAGTGAATGGTGCTACGTGTTAACTTTGCCTGACTAAAAAAATTCTAGTTGGTTTAACGCGTA,10,30,14,27,27,52,27,59,27,37,37,52,44,59,60.97,6.010534056
hek293t,10889,1,7,AGTTAAAACATTGTGGGCCAATCTTACTGTGGACCATGGTGCTACGTGTTAACTTTGCCTGACTGTAACAAAAAAAAAATTCTAGTTGGTTTAACGCGT,AGTTAAAACATTGTGGGCCAATCTTACTGTGGACCAAAGTGAATGGTGCTACGTGTTAACTTTGCCTGACTGTAACAAAAAAAAAATTCTAGTTGGTTT,10,30,14,27,27,44,27,51,27,37,37,44,44,51,60.97,2.691367936
hek293t,10891,1,1,TACTTTTTACTTTTAACAGGAGTTTTTCCTGGAGGAAATCTAACCGTGTGAGCACTGAGGACTGCACATACTGGTATTATTGCAAAAAAATTCTAGTTG,TACTTTTTACTTTTAACAGGAGTTTTTCCTGGAGGAAAATCTAACCGTGTGAGCACTGAGGACTGCACATACTGGTATTATTGCAAAAAAATTCTAGTT,10,30,14,27,27,39,27,40,27,36,36,39,37,40,8.65,0.0
hek293t,5804,1,13,GTGACGTGCTAAAATATTGAGGGAACAGAAGGGAAGAAGCTCCCCATGTATTCATTTCCACAATGAAAAAAAATTCTAGTTGGTTTAACGCGTAACTAG,GTGACGTGCTAAAATATTGAGGGAACAGAAGGGCAGGCTCGAACAAAAGAAGCTCCCCATGTATTCATTTCCACAATGAAAAAAAATTCTAGTTGGTTT,10,30,14,27,27,44,27,57,27,34,34,44,47,57,16.04,0.463524903
hek293t,5804,1,13,AGGGTGTGCTAAAATATTGAGGGAACAGAAGGGAAGAAGCTCCCCATGTATTCATTTCCACAATGACAAAATGAAAAAAATTCTAGTTGGTTTAACGCG,AGGGTGTGCTAAAATATTGAGGGAACAGAAGGGCAGGCTCGAACAAAAGAAGCTCCCCATGTATTCATTTCCACAATGACAAAATGAAAAAAATTCTAG,10,30,14,27,27,37,27,50,27,34,34,37,47,50,16.04,0.0
hek293t,10899,1,10,CCTACTTTCCAAGCAATCCCACTCAGCGGAGGGTTCGGTCTCTTGCCTGGAGAGCACTGACCAGGCGCAGCAGGAAAAAAATTCTAGTTGGTTTAACGC,CCTACTTTCCAAGCAATCCCACTCAGCGGTGGAACCTAGAGGGTTCGGTCTCTTGCCTGGAGAGCACTGACCAGGCGCAGCAGGAAAAAAATTCTAGTT,10,30,14,27,27,39,27,49,27,29,29,39,39,49,67.47,10.69954287
hek293t,10899,1,10,GATCATTTCCAAGCAATCCCACTCAGCGGAGGGTTCGGTCTCTTGCCTGGAGAGCACTGACCAGGCGCAGCAGGTGAAAAAAAATTCTAGTTGGTTTAA,GATCATTTCCAAGCAATCCCACTCAGCGGTGGAACCTAGAGGGTTCGGTCTCTTGCCTGGAGAGCACTGACCAGGCGCAGCAGGTGAAAAAAAATTCTA,10,30,14,27,27,36,27,46,27,29,29,36,39,46,67.47,0.439708082
hek293t,10901,1,3,CTTACAAAGATTATTGCAGAAGTTTGGGAAGGAAAGCATGGAAACAATAACTGATCATTGCAGAACCTTTTAAAAAAAATTCTAGTTGGTTTAACGCGT,CTTACAAAGATTATTGCAGAAGTTTGGGAAGGAAAGCCTGATGGAAACAATAACTGATCATTGCAGAACCTTTTAAAAAAAATTCTAGTTGGTTTAACG,10,30,14,27,27,48,27,51,27,38,38,48,41,51,44.61,63.69692458
hek293t,10901,1,3,AAGGAAAAGATTATTGCAGAAGTTTGGGAAGGAAAGCATGGAAACAATAACTGATCATTGCAGAACCTTTTAAGCAATAAAAAAAATTCTAGTTGGTTT,AAGGAAAAGATTATTGCAGAAGTTTGGGAAGGAAAGCCTGATGGAAACAATAACTGATCATTGCAGAACCTTTTAAGCAATAAAAAAAATTCTAGTTGG,10,30,14,27,27,41,27,44,27,38,38,41,41,44,44.61,0.308469395
hek293t,10903,1,9,GAGGCAGATTATGAACTGCTAAAATAAAAAGGAATGGGAAAGAAATTTTCCAGGCTACTTGCTTAGTAAAAAAATTCTAGTTGGTTTAACGCGTAACTA,GAGGCAGATTATGAACTGCTAAAATAAAAAGGTTTCCGATGAATGGGAAAGAAATTTTCCAGGCTACTTGCTTAGTAAAAAAATTCTAGTTGGTTTAAC,10,30,14,27,27,47,27,56,27,32,32,47,41,56,7.08,0.0
hek293t,10903,1,9,TAGAAAGATTATGAACTGCTAAAATAAAAAGGAATGGGAAAGAAATTTTCCAGGCTACTTGCTTAGTAATTTCTTGCCTAAAAAAATTCTAGTTGGTTT,TAGAAAGATTATGAACTGCTAAAATAAAAAGGTTTCCGATGAATGGGAAAGAAATTTTCCAGGCTACTTGCTTAGTAATTTCTTGCCTAAAAAAATTCT,10,30,14,27,27,35,27,44,27,32,32,35,41,44,7.08,0.0
hek293t,10905,1,12,TATCTTCTCGCTTTCGGTAGCGGTGGTGGTGGGGAGGTTTATCCTGTAGCCCGCACTTTCAGCAGTTATAAAAAAATTCTAGTTGGTTTAACGCGTAAC,TATCTTCTCGCTTTCGGTAGCGGTGGAATGGGGTTTTCTGGTGGGGAGGTTTATCCTGTAGCCCGCACTTTCAGCAGTTATAAAAAAATTCTAGTTGGT,10,30,14,27,27,42,27,54,27,27,27,42,39,54,41.65,25.03159057
hek293t,10907,1,7,GATAGAATTAAATATCAAGACATATTTTGAGGCAAAGCAGTATTTTTAGCAAAATGAGAATCACCTCTAAAAAAAAATTCTAGTTGGTTTAACGCGTAA,GATAGAATTAAATATCAAGACATATTTTGAGATTGTAGGCAAAGCAGTATTTTTAGCAAAATGAGAATCACCTCTAAAAAAAAATTCTAGTTGGTTTAA,10,30,14,27,27,46,27,53,27,31,31,46,38,53,17.68,0.138600139
hek293t,10909,1,3,CGGCCCACTCACCCATCTGTGTGGTTTTCAGGTGATCAGACACAGTAAGATGCAGTGACTTCTCTCTCCCTTACAAAAAAAATTCTAGTTGGTTTAACG,CGGCCCACTCACCCATCTGTGTGGTTTTCAGGTGATCGACAGACACAGTAAGATGCAGTGACTTCTCTCTCCCTTACAAAAAAAATTCTAGTTGGTTTA,10,30,14,27,27,45,27,48,27,38,38,45,41,48,3.97,75.67827068
hek293t,10909,1,3,AAAAACACTCACCCATCTGTGTGGTTTTCAGGTGATCAGACACAGTAAGATGCAGTGACTTCTCTCTCCCTTAAAAAAATTCTAGTTGGTTTAACGCGT,AAAAACACTCACCCATCTGTGTGGTTTTCAGGTGATCGACAGACACAGTAAGATGCAGTGACTTCTCTCTCCCTTAAAAAAATTCTAGTTGGTTTAACG,10,30,14,27,27,48,27,51,27,38,38,48,41,51,3.97,65.67324325
hek293t,10911,1,2,CCTTCCCAGAACTCATGCATTCGAAACTTAGGTATGTGTTTGAGCTACCAACGGAAAATTATACGCCTTATGACATAAAAAAAATTCTAGTTGGTTTAA,CCTTCCCAGAACTCATGCATTCGAAACTTAGGTATATGTGTTTGAGCTACCAACGGAAAATTATACGCCTTATGACATAAAAAAAATTCTAGTTGGTTT,10,30,14,27,27,44,27,46,27,34,34,44,36,46,36.99,80.81700874
hek293t,10913,1,9,ACCGACACAGACTTTCATATCTGGAAAGGAGGCTGCTCATGTTAAATGGGTTGTGAAATGGCAAACGTTAATCTCATAAAAAAATTCTAGTTGGTTTAA,ACCGACACAGACTTTCATATCTGGAAAGGAGGCAGTCACTTGTGCTCATGTTAAATGGGTTGTGAAATGGCAAACGTTAATCTCATAAAAAAATTCTAG,10,30,14,27,27,37,27,46,27,34,34,37,43,46,62.63,0.646875805
hek293t,10913,1,9,AAAGGCACAGACTTTCATATCTGGAAAGGAGGCTGCTCATGTTAAATGGGTTGTGAAATGGCAAAAAAAAAATTCTAGTTGGTTTAACGCGTAACTAGA,AAAGGCACAGACTTTCATATCTGGAAAGGAGGCAGTCACTTGTGCTCATGTTAAATGGGTTGTGAAATGGCAAAAAAAAAATTCTAGTTGGTTTAACGC,10,30,14,27,27,49,27,58,27,34,34,49,43,58,62.63,4.820172759
hek293t,10915,1,15,ACTGAACAGACATCTGTTAGACATTTAAAAGGCAATAAATTACTTAACTCTATAGAAGAGATTGAAAAAAAAAAATTCTAGTTGGTTTAACGCGTAACT,ACTGAACAGACATCTGTTAGACATTTAAAAGGGAACTCGCAACAAAGCAATAAATTACTTAACTCTATAGAAGAGATTGAAAAAAAAAAATTCTAGTTG,10,30,14,27,27,40,27,55,27,33,33,40,48,55,22.96,0.0
hek293t,10915,1,15,GCCCGACAGACATCTGTTAGACATTTAAAAGGCAATAAATTACTTAACTCTATAGAAGAGATTGAAAAAAAATTCTAGTTGGTTTAACGCGTAACTAGA,GCCCGACAGACATCTGTTAGACATTTAAAAGGGAACTCGCAACAAAGCAATAAATTACTTAACTCTATAGAAGAGATTGAAAAAAAATTCTAGTTGGTT,10,30,14,27,27,43,27,58,27,33,33,43,48,58,22.96,0.035688794
hek293t,10917,1,9,ACGGTACTGATGCTGCACCTTTATCTCTAAGGATTGCACCATGTAAATTCTAATCAGCAGATATACATAAGCAGAAAAAAATTCTAGTTGGTTTAACGC,ACGGTACTGATGCTGCACCTTTATCTCTAAGGATTGAACACCATCCACCATGTAAATTCTAATCAGCAGATATACATAAGCAGAAAAAAATTCTAGTTG,10,30,14,27,27,40,27,49,27,37,37,40,46,49,10.92,1.46836061
hek293t,10920,1,2,CCCCTTCCTGAGGCCTACGCCACCCAACTAGGATATGTTTTCTTGGTCAGCGAGCCCTGCCTGTATTTGTTATACTCCTTCTAAAAAAATTCTAGTTGG,CCCCTTCCTGAGGCCTACGCCACCCAACTAGCCGATATGTTTTCTTGGTCAGCGAGCCCTGCCTGTATTTGTTATACTCCTTCTAAAAAAATTCTAGTT,10,30,14,27,27,39,27,41,27,32,32,39,34,41,34.13,88.1294851
hek293t,10922,1,9,CCTAGATGAGTGGATATACAACAGACAGGTGGTAACGTATATGTGATTTTAAATGAATGTGAATGAAAAAAATTCTAGTTGGTTTAACGCGTAACTAGA,CCTAGATGAGTGGATATACAACAGACAGGTGGTGTCGTAATAAACGTATATGTGATTTTAAATGAATGTGAATGAAAAAAATTCTAGTTGGTTTAACGC,10,30,14,27,27,49,27,58,27,34,34,49,43,58,71.47,0.0
hek293t,10922,1,9,GGAGTATGAGTGGATATACAACAGACAGGTGGTAACGTATATGTGATTTTAAATGAATGTGAATGTGCTTGGTGCTCAAAAAAATTCTAGTTGGTTTAA,GGAGTATGAGTGGATATACAACAGACAGGTGGTGTCGTAATAAACGTATATGTGATTTTAAATGAATGTGAATGTGCTTGGTGCTCAAAAAAATTCTAG,10,30,14,27,27,37,27,46,27,34,34,37,43,46,71.47,0.183486239
hek293t,10924,1,10,TGTTTTAATTAATCTTGCTTACCTACAGTAGGCAATACCATATTGCCAGTGAGTATAGCAGTGAGAATGAGCAAAAAAATTCTAGTTGGTTTAACGCGT,TGTTTTAATTAATCTTGCTTACCTACAGTAGGCAATAGGGGATAGGACCATATTGCCAGTGAGTATAGCAGTGAGAATGAGCAAAAAAATTCTAGTTGG,10,30,14,27,27,41,27,51,27,38,38,41,48,51,34.23,0.0
hek293t,10925,1,13,GATATTATGAACTTCACATCTTGACATCCTGGGAAGCCTGCAGGTATTCTCCATATTTTATAGATCAGAAGAAAAAAAATTCTAGTTGGTTTAACGCGT,GATATTATGAACTTCACATCTTGACATCCTGCGTTTAGTTGAGGGGAAGCCTGCAGGTATTCTCCATATTTTATAGATCAGAAGAAAAAAAATTCTAGT,10,30,14,27,27,38,27,51,27,31,31,38,44,51,19.73,1.653367777
hek293t,10925,1,13,GATGTTATGAACTTCACATCTTGACATCCTGGGAAGCCTGCAGGTATTCTCCATATTTTATAGAAAAAAAATTCTAGTTGGTTTAACGCGTAACTAGAT,GATGTTATGAACTTCACATCTTGACATCCTGCGTTTAGTTGAGGGGAAGCCTGCAGGTATTCTCCATATTTTATAGAAAAAAAATTCTAGTTGGTTTAA,10,30,14,27,27,46,27,59,27,31,31,46,44,59,19.73,38.6515279
hek293t,10929,1,4,ATCACTTTTTAGCAGAGTCCCTGAAACTCTGGTAGAATGAGTTGTTAAAAATTCCTAAGTGATGCAAACAATATAAAAAAAATTCTAGTTGGTTTAACG,ATCACTTTTTAGCAGAGTCCCTGAAACTCTGGTAGAATGAGCCCGTTGTTAAAAATTCCTAAGTGATGCAAACAATATAAAAAAAATTCTAGTTGGTTT,10,30,14,27,27,44,27,48,27,41,41,44,45,48,63.26,0.567566191
hek293t,10930,1,9,TCAACGGGACCCCACAGAGGAGTGTGCAGGGGCGTTTATGGAAAAACCAGTACCATTTAGTTAGAAAAAAATTCTAGTTGGTTTAACGCGTAACTAGAT,TCAACGGGACCCCACAGAGGAGTGTGCAGGGGCGTCAACTCTGTTTATGGAAAAACCAGTACCATTTAGTTAGAAAAAAATTCTAGTTGGTTTAACGCG,10,30,14,27,27,50,27,59,27,35,35,50,44,59,61.81,1.041547871
hek293t,10930,1,9,ATGGCGGGACCCCACAGAGGAGTGTGCAGGGGCGTTTATGGAAAAACCAGTACCATTTAGTTAGCACAGAAAAAAATTCTAGTTGGTTTAACGCGTAAC,ATGGCGGGACCCCACAGAGGAGTGTGCAGGGGCGTCAACTCTGTTTATGGAAAAACCAGTACCATTTAGTTAGCACAGAAAAAAATTCTAGTTGGTTTA,10,30,14,27,27,45,27,54,27,35,35,45,44,54,61.81,1.958395126
hek293t,10932,1,9,CTAAGAGCTTCTCTCACTGCAATTTTATGAGGTGTTACTACATTTTGTTAACATTTTTCACCTTTAAATCGTAAAAAAATTCTAGTTGGTTTAACGCGT,CTAAGAGCTTCTCTCACTGCAATTTTATGAGGTGTTACTGTCTTGAGTACATTTTGTTAACATTTTTCACCTTTAAATCGTAAAAAAATTCTAGTTGGT,10,30,14,27,27,42,27,51,27,39,39,42,48,51,26.5,0.0
hek293t,10932,1,9,AATATAGCTTCTCTCACTGCAATTTTATGAGGTGTTACTACATTTTGTTAACATTTTTCACCTTTAAAAAAAAAATTCTAGTTGGTTTAACGCGTAACT,AATATAGCTTCTCTCACTGCAATTTTATGAGGTGTTACTGTCTTGAGTACATTTTGTTAACATTTTTCACCTTTAAAAAAAAAATTCTAGTTGGTTTAA,10,30,14,27,27,46,27,55,27,39,39,46,48,55,26.5,0.0
hek293t,10934,1,14,GCTTTTGCTGCCATGCACAGAAACATCTCTGGTATGTTCCTAAGAAAGGAACCTAAGGTCCTGGGAAAAAAAATTCTAGTTGGTTTAACGCGTAACTAG,GCTTTTGCTGCCATGCACAGAAACATCTCTGGTATGTTCCTGATGCCGTCTATCTAAGAAAGGAACCTAAGGTCCTGGGAAAAAAAATTCTAGTTGGTT,10,30,14,27,27,43,27,57,27,40,40,43,54,57,48.05,0.0
hek293t,10937,1,4,GACGCAGAACGCAACAGCCCTTCCGATTCTGGGCTCTGAGACTGATGCTACCTTTTTGTCTCTTGACTCCAAAATAAAAAAATTCTAGTTGGTTTAACG,GACGCAGAACGCAACAGCCCTTCCGATTCTGGGCTCAAAATGAGACTGATGCTACCTTTTTGTCTCTTGACTCCAAAATAAAAAAATTCTAGTTGGTTT,10,30,14,27,27,44,27,48,27,37,37,44,41,48,6.81,2.640265625
hek293t,10937,1,4,TTAATAGAACGCAACAGCCCTTCCGATTCTGGGCTCTGAGACTGATGCTACCTTTTTGTCTCTTGACTCCAAAAAAAAATTCTAGTTGGTTTAACGCGT,TTAATAGAACGCAACAGCCCTTCCGATTCTGGGCTCAAAATGAGACTGATGCTACCTTTTTGTCTCTTGACTCCAAAAAAAAATTCTAGTTGGTTTAAC,10,30,14,27,27,47,27,51,27,37,37,47,41,51,6.81,3.494881187
hek293t,10939,1,2,GCAGGAGTTTCTTGTTTCCTTTTGTGTTGTGGACAGCCCAAAAACGCAGCAGGGGAAACTGAGCAACCACTGCTTTTCATGATGAAGAAAAAAATTCTA,GCAGGAGTTTCTTGTTTCCTTTTGTGTTGTGGGGACAGCCCAAAAACGCAGCAGGGGAAACTGAGCAACCACTGCTTTTCATGATGAAGAAAAAAATTC,10,30,14,27,27,34,27,36,27,31,31,34,33,36,5.51,0.025660765
hek293t,10939,1,2,CGCTTAGTTTCTTGTTTCCTTTTGTGTTGTGGACAGCCCAAAAACGCAGCAGGGGAAACTGAGCAACCACTGCTTTTCATAAAAAAATTCTAGTTGGTT,CGCTTAGTTTCTTGTTTCCTTTTGTGTTGTGGGGACAGCCCAAAAACGCAGCAGGGGAAACTGAGCAACCACTGCTTTTCATAAAAAAATTCTAGTTGG,10,30,14,27,27,41,27,43,27,31,31,41,33,43,5.51,0.708848383
hek293t,10941,1,1,TTGAGACTTCTACTGATTAGGATAAGAAAAGGTTTTATTCTTGACTGAAACAGCTGCGACAGAAGAAAGCTAAAAAAATTCTAGTTGGTTTAACGCGTA,TTGAGACTTCTACTGATTAGGATAAGAAAAGGTTTTATTCGTTGACTGAAACAGCTGCGACAGAAGAAAGCTAAAAAAATTCTAGTTGGTTTAACGCGT,10,30,14,27,27,51,27,52,27,41,41,51,42,52,45.09,3.064019445
hek293t,10941,1,1,CTATCACTTCTACTGATTAGGATAAGAAAAGGTTTTATTCTTGACTGAAACAGCTGCGACAGAAGAAAGCTATAATGCAAAAAAATTCTAGTTGGTTTA,CTATCACTTCTACTGATTAGGATAAGAAAAGGTTTTATTCGTTGACTGAAACAGCTGCGACAGAAGAAAGCTATAATGCAAAAAAATTCTAGTTGGTTT,10,30,14,27,27,44,27,45,27,41,41,44,42,45,45.09,0.0
hek293t,10945,1,5,GCAGTCTCCCTCACGAGCGGCCGCGTCCCCGGCGGCGCCCCTCAGACTCACCGCCTCCAAGTGCGGCGCCTGCAAAAAAATTCTAGTTGGTTTAACGCG,GCAGTCTCCCTCACGAGCGGCCGCGTCCCGTACGCGGCGGCGCCCCTCAGACTCACCGCCTCCAAGTGCGGCGCCTGCAAAAAAATTCTAGTTGGTTTA,10,30,14,27,27,45,27,50,27,30,30,45,35,50,47.4,1.414613049
hek293t,10945,1,5,CGAATCTCCCTCACGAGCGGCCGCGTCCCCGGCGGCGCCCCTCAGACTCACCGCCTCCAAGTGCGGCGCCTGCCACAAAAAAAAATTCTAGTTGGTTTA,CGAATCTCCCTCACGAGCGGCCGCGTCCCGTACGCGGCGGCGCCCCTCAGACTCACCGCCTCCAAGTGCGGCGCCTGCCACAAAAAAAAATTCTAGTTG,10,30,14,27,27,40,27,45,27,30,30,40,35,45,47.4,4.864546525
hek293t,10947,1,2,ACTATAAGTTTAAAATCGGATAGCACAGTAGGAGGACCAGTGAATCAGTGACTTCTCTTCACCTGATAAATATTTATTTCAAAAAAATTCTAGTTGGTT,ACTATAAGTTTAAAATCGGATAGCACAGTAGGATGGGACCAGTGAATCAGTGACTTCTCTTCACCTGATAAATATTTATTTCAAAAAAATTCTAGTTGG,10,30,14,27,27,41,27,43,27,34,34,41,36,43,37.43,84.84862476
hek293t,10947,1,2,GCCGAAAGTTTAAAATCGGATAGCACAGTAGGAGGACCAGTGAATCAGTGACTTCTCTTCACCTGATAAATATTTATAAAAAAATTCTAGTTGGTTTAA,GCCGAAAGTTTAAAATCGGATAGCACAGTAGGATGGGACCAGTGAATCAGTGACTTCTCTTCACCTGATAAATATTTATAAAAAAATTCTAGTTGGTTT,10,30,14,27,27,44,27,46,27,34,34,44,36,46,37.43,84.96590432
hek293t,10949,1,7,CTGAAAGACGAAAATCAATTATAGTCGTTAGGGGGTTTTGTGTAAAGAAATCCTACATTTCTCAGAAGAATTTCCAAAAAAATTCTAGTTGGTTTAACG,CTGAAAGACGAAAATCAATTATAGTCGTTAGGCCCTGGGGGGTTTTGTGTAAAGAAATCCTACATTTCTCAGAAGAATTTCCAAAAAAATTCTAGTTGG,10,30,14,27,27,41,27,48,27,31,31,41,38,48,10.22,9.439768072
hek293t,10949,1,7,GAGATAGACGAAAATCAATTATAGTCGTTAGGGGGTTTTGTGTAAAGAAATCCTACATTTCTCAGAAGAAAAAAAAATTCTAGTTGGTTTAACGCGTAA,GAGATAGACGAAAATCAATTATAGTCGTTAGGCCCTGGGGGGTTTTGTGTAAAGAAATCCTACATTTCTCAGAAGAAAAAAAAATTCTAGTTGGTTTAA,10,30,14,27,27,46,27,53,27,31,31,46,38,53,10.22,10.81315949
hek293t,10951,1,11,GGGAGCAGAGCATTTTAGTGAGTGCTACCTGGAGAAACGTCCCGGTCTGGAGTGCGAGCTGGGAAAAAAAATTCTAGTTGGTTTAACGCGTAACTAGAT,GGGAGCAGAGCATTTTAGTGAGTGCTACCTGGAGAAAGGCCACCTGCGCGTCCCGGTCTGGAGTGCGAGCTGGGAAAAAAAATTCTAGTTGGTTTAACG,10,30,14,27,27,48,27,59,27,38,38,48,49,59,37.78,9.924908084
hek293t,10952,1,6,CTTGCAGGATTTTAAAGCAGAGATACTAGAGGGTTTGCGCTGCTTCTTATGCAATTGTTAATCCAGATACTAAAAAAATTCTAGTTGGTTTAACGCGTA,CTTGCAGGATTTTAAAGCAGAGATACTAGAGACTATGGGTTTGCGCTGCTTCTTATGCAATTGTTAATCCAGATACTAAAAAAATTCTAGTTGGTTTAA,10,30,14,27,27,46,27,52,27,31,31,46,37,52,27.19,17.58551935
hek293t,10952,1,6,CGTGTAGGATTTTAAAGCAGAGATACTAGAGGGTTTGCGCTGCTTCTTATGCAATTGTTAATCCAGATACTTAATATAAGGAAAAAAAAATTCTAGTTG,CGTGTAGGATTTTAAAGCAGAGATACTAGAGACTATGGGTTTGCGCTGCTTCTTATGCAATTGTTAATCCAGATACTTAATATAAGGAAAAAAAAATTC,10,30,14,27,27,34,27,40,27,31,31,34,37,40,27.19,0.0
hek293t,10954,1,10,TTCTGGCCCCCAACTGCTCGGCAGCTGAAAGGCAGCATCAGACCAACAGCAAAAATCTACAGCCTGCAATTTCTCAAAAAAATTCTAGTTGGTTTAACG,TTCTGGCCCCCAACTGCTCGGCAGCTGCTTTCCTTTAAAAGGCAGCATCAGACCAACAGCAAAAATCTACAGCCTGCAATTTCTCAAAAAAATTCTAGT,10,30,14,27,27,38,27,48,27,28,28,38,38,48,62.03,10.06871098
hek293t,10954,1,10,GGCTGGCCCCCAACTGCTCGGCAGCTGAAAGGCAGCATCAGACCAACAGCAAAAATCTACAGCCTGCAATTTCTCACAAAAAAAATTCTAGTTGGTTTA,GGCTGGCCCCCAACTGCTCGGCAGCTGCTTTCCTTTAAAAGGCAGCATCAGACCAACAGCAAAAATCTACAGCCTGCAATTTCTCACAAAAAAAATTCT,10,30,14,27,27,35,27,45,27,28,28,35,38,45,62.03,48.86782877
hek293t,10956,1,1,GAGAAATTTTTTGAACTGCTGCCTGCATCAGGTGGGAAGGCATTATGTAGAACAGCACTTAGGCAGCTGGTTGAGTCATCCTAGCTAAAAAAATTCTAG,GAGAAATTTTTTGAACTGCTGCCTGCATCAGGCTGGGAAGGCATTATGTAGAACAGCACTTAGGCAGCTGGTTGAGTCATCCTAGCTAAAAAAATTCTA,10,30,14,27,27,36,27,37,27,33,33,36,34,37,17.08,28.59876117
hek293t,10958,1,1,TTTTTCATTTATAATTTCATGGATCAGGGAGGTAACATTCTCTTGCTGATTAGGTAAAAATTCTATTATGTAAAGGTCTTTATAAAAAAATTCTAGTTG,TTTTTCATTTATAATTTCATGGATCAGGGAGGTAATCATTCTCTTGCTGATTAGGTAAAAATTCTATTATGTAAAGGTCTTTATAAAAAAATTCTAGTT,10,30,14,27,27,39,27,40,27,36,36,39,37,40,38.13,0.0
hek293t,10958,1,1,GGTTTCATTTATAATTTCATGGATCAGGGAGGTAACATTCTCTTGCTGATTAGGTAAAAATTCTATTATGTAAAGGAAAAAAATTCTAGTTGGTTTAAC,GGTTTCATTTATAATTTCATGGATCAGGGAGGTAATCATTCTCTTGCTGATTAGGTAAAAATTCTATTATGTAAAGGAAAAAAATTCTAGTTGGTTTAA,10,30,14,27,27,46,27,47,27,36,36,46,37,47,38.13,27.95794096
hek293t,10962,1,3,GCGGCCCTGAAACATCAAATGCTTAAGTAAGGTAACTTCTATTTATTTCATCTAGATGAAATGATAGATTTATGCAAAAAAAATTCTAGTTGGTTTAAC,GCGGCCCTGAAACATCAAATGCTTAAGTACGAAGGTAACTTCTATTTATTTCATCTAGATGAAATGATAGATTTATGCAAAAAAAATTCTAGTTGGTTT,10,30,14,27,27,44,27,47,27,29,29,44,32,47,36.41,23.32761523
hek293t,10962,1,3,TTCGTCCTGAAACATCAAATGCTTAAGTAAGGTAACTTCTATTTATTTCATCTAGATGAAATGATAGATTTATGCATTTCAAAAAAAATTCTAGTTGGT,TTCGTCCTGAAACATCAAATGCTTAAGTACGAAGGTAACTTCTATTTATTTCATCTAGATGAAATGATAGATTTATGCATTTCAAAAAAAATTCTAGTT,10,30,14,27,27,39,27,42,27,29,29,39,32,42,36.41,28.02967293
hek293t,2793,1,1,GGCTATCAAAAGGTTGTACGATATTTGACTGGTTTTAGCGTCTTAATCTTGTCATCGGGATTGTAACGAACCCCACAAAAAAATTCTAGTTGGTTTAAC,GGCTATCAAAAGGTTGTACGATATTTGACTGGTTTTAGTCGTCTTAATCTTGTCATCGGGATTGTAACGAACCCCACAAAAAAATTCTAGTTGGTTTAA,10,30,14,27,27,46,27,47,27,39,39,46,40,47,37.89,47.12243469
hek293t,10966,1,11,GCATTCTGGAGTTTATAGCAATGCACTCCTGGCTGCGTTTTAAACGGCACGATAAGCTCCCCCACGCCAAAAAAATTCTAGTTGGTTTAACGCGTAACT,GCATTCTGGAGTTTATAGCAATGCACTCCTGGCTGCGTTTGTTTGATCCTCTAAACGGCACGATAAGCTCCCCCACGCCAAAAAAATTCTAGTTGGTTT,10,30,14,27,27,44,27,55,27,41,41,44,52,55,49.76,1.711481752
hek293t,22876,1,13,ACAGGAGGAAAAAATGCTTATGAAATACTAGGAACAGCAGTTTCTTGTGAGGTTTTACTAGAAGTACTGCAAAAAAATTCTAGTTGGTTTAACGCGTAA,ACAGGAGGAAAAAATGCTTATGAAATACTAGGAACATGGAATGGCACGGGCAGTTTCTTGTGAGGTTTTACTAGAAGTACTGCAAAAAAATTCTAGTTG,10,30,14,27,27,40,27,53,27,37,37,40,50,53,23.38,0.784313725
hek293t,10970,1,9,TACGCGTATGCAGCTTTCTGGTCCAGCTTTGGCTGGTAGAGAGGGTGTCTTTGTGCACCTTTTCTGTAACAAAAAAATTCTAGTTGGTTTAACGCGTAA,TACGCGTATGCAGCTTTCTGGTCCAGCTTTGGCCGCTAAATGTGGTAGAGAGGGTGTCTTTGTGCACCTTTTCTGTAACAAAAAAATTCTAGTTGGTTT,10,30,14,27,27,44,27,53,27,34,34,44,43,53,45.36,9.068799889
hek293t,10970,1,9,GCACGGTATGCAGCTTTCTGGTCCAGCTTTGGCTGGTAGAGAGGGTGTCTTTGTGCACCTTTTCTGTAACACAAAAAAAATTCTAGTTGGTTTAACGCG,GCACGGTATGCAGCTTTCTGGTCCAGCTTTGGCCGCTAAATGTGGTAGAGAGGGTGTCTTTGTGCACCTTTTCTGTAACACAAAAAAAATTCTAGTTGG,10,30,14,27,27,41,27,50,27,34,34,41,43,50,45.36,7.965366055
hek293t,10972,1,14,ACGACCTGGTTGCACCAGCTGAAGGGTAACGGTAGGAATAAAACTTCTGTAATACTGAGCCCAGAATAAAAAAAAATTCTAGTTGGTTTAACGCGTAAC,ACGACCTGGTTGCACCAGCTGAAGGGTAAAGGCAGTTTTCGAGCGGTAGGAATAAAACTTCTGTAATACTGAGCCCAGAATAAAAAAAAATTCTAGTTG,10,30,14,27,27,40,27,54,27,30,30,40,44,54,40.75,0.705352763
hek293t,10972,1,14,CAATTCTGGTTGCACCAGCTGAAGGGTAACGGTAGGAATAAAACTTCTGTAATACTGAGCCCAGAATAACAGAAAAAAATTCTAGTTGGTTTAACGCGT,CAATTCTGGTTGCACCAGCTGAAGGGTAAAGGCAGTTTTCGAGCGGTAGGAATAAAACTTCTGTAATACTGAGCCCAGAATAACAGAAAAAAATTCTAG,10,30,14,27,27,37,27,51,27,30,30,37,44,51,40.75,0.060496068
hek293t,10976,1,10,GATGGGCAAGACGTTAAAGCAATTCCAACAGGACTGATTTCTAATGTCTAACAGTCCAGCAGACTTAAAAAAATTCTAGTTGGTTTAACGCGTAACTAG,GATGGGCAAGACGTTAAAGCAATTCCAACAGGACTGATTATCCACACTCTCTAATGTCTAACAGTCCAGCAGACTTAAAAAAATTCTAGTTGGTTTAAC,10,30,14,27,27,47,27,57,27,40,40,47,50,57,18.63,0.154320988
hek293t,2691,1,7,TTACCATATTCCAAAAATACAATTTGAAATGGAAGATGAATTTTTTGTAATAAACAGGGACTTAGTCTTGGGAAAAAAATTCTAGTTGGTTTAACGCGT,TTACCATATTCCAAAAATACAATTTGAAATGGAGAGGACGAGATGAATTTTTTGTAATAAACAGGGACTTAGTCTTGGGAAAAAAATTCTAGTTGGTTT,10,30,14,27,27,44,27,51,27,34,34,44,41,51,0.22,0.0
hek293t,2691,1,7,GCCATATATTCCAAAAATACAATTTGAAATGGAAGATGAATTTTTTGTAATAAACAGGGACTTAGTCTTGGGTGAGAAAAAAAAAATTCTAGTTGGTTT,GCCATATATTCCAAAAATACAATTTGAAATGGAGAGGACGAGATGAATTTTTTGTAATAAACAGGGACTTAGTCTTGGGTGAGAAAAAAAAAATTCTAG,10,30,14,27,27,37,27,44,27,34,34,37,41,44,0.22,0.0
hek293t,20293,1,14,CTACTACTTATTAGAAAAGCAGTATTTATAGGTTCTTCAACCATCCTAGGAAACTTCACAGGGATTAAGTACAAAAAAATTCTAGTTGGTTTAACGCGT,CTACTACTTATTAGAAAAGCAGTATTATCTATTGAACATTTATAGGTTCTTCAACCATCCTAGGAAACTTCACAGGGATTAAGTACAAAAAAATTCTAG,10,30,14,27,27,37,27,51,27,27,27,37,41,51,9.37,7.990046941
hek293t,10981,1,13,AGGACCCCTTAGGGCCTATGCCATTATCCAGGTAGGGCAGGTGAGTAATAGCACTGCACCATGCCCAGCCTTAAAAAAATTCTAGTTGGTTTAACGCGT,AGGACCCCTTAGGGCCTATGCCATTATCACCAGTCAGTACCCAGGTAGGGCAGGTGAGTAATAGCACTGCACCATGCCCAGCCTTAAAAAAATTCTAGT,10,30,14,27,27,38,27,51,27,28,28,38,41,51,54.34,7.935637058
hek293t,10983,1,1,ACTTCCAGAGCAAAATTGTTCATCAGAGGAGGAACAGATACTGTAAACATTGTCTTAAAATGAATCAGGAAGGAATGTGCATCTCCAAAAAAATTCTAG,ACTTCCAGAGCAAAATTGTTCATCAGAGCGAGGAACAGATACTGTAAACATTGTCTTAAAATGAATCAGGAAGGAATGTGCATCTCCAAAAAAATTCTA,10,30,14,27,27,36,27,37,27,29,29,36,30,37,33.81,73.52453615
hek293t,10983,1,1,CGCTACAGAGCAAAATTGTTCATCAGAGGAGGAACAGATACTGTAAACATTGTCTTAAAATGAATCAGGAAGGAATGTGCATCTCCCCGAAAAAAAATT,CGCTACAGAGCAAAATTGTTCATCAGAGCGAGGAACAGATACTGTAAACATTGTCTTAAAATGAATCAGGAAGGAATGTGCATCTCCCCGAAAAAAAAT,10,30,14,27,27,32,27,33,27,29,29,32,30,33,33.81,9.698944055
hek293t,10985,1,11,GAGGTTCTGCACAAGCAAGGGAGAGCTGGAGGGAGGTGGCGATGGGGCTGAGAAGCGAGCGGCGTAAAAAAATTCTAGTTGGTTTAACGCGTAACTAGA,GAGGTTCTGCACAAGCAAGGGAGAGCTGGAGGGAGGTGGGCTGTCACGCTCGATGGGGCTGAGAAGCGAGCGGCGTAAAAAAATTCTAGTTGGTTTAAC,10,30,14,27,27,47,27,58,27,40,40,47,51,58,48.57,4.787287256
hek293t,7598,1,10,ACCAGCTTCAGAAGCGTATTTTCACCAGGCGGATTTTGCATTTTTGGGGTGGTATGAGAAGATAGATCTTTCTAGGGCAAAAAAATTCTAGTTGGTTTA,ACCAGCTTCAGAAGCGTATTTTCACCAGGCGTGAATGGGGAGATTTTGCATTTTTGGGGTGGTATGAGAAGATAGATCTTTCTAGGGCAAAAAAATTCT,10,30,14,27,27,35,27,45,27,32,32,35,42,45,20.75,0.883445948
hek293t,7598,1,10,TCCTCCTTCAGAAGCGTATTTTCACCAGGCGGATTTTGCATTTTTGGGGTGGTATGAGAAGATAGAAAAAAAATTCTAGTTGGTTTAACGCGTAACTAG,TCCTCCTTCAGAAGCGTATTTTCACCAGGCGTGAATGGGGAGATTTTGCATTTTTGGGGTGGTATGAGAAGATAGAAAAAAAATTCTAGTTGGTTTAAC,10,30,14,27,27,47,27,57,27,32,32,47,42,57,20.75,11.07398645
hek293t,10990,1,13,CGTGAGACAGCAAGATGTCCTAATACACTTGGCCCCCCTCGTATTGCACTCTGTCTCTTGCAGCAAAAAAAATTCTAGTTGGTTTAACGCGTAACTAGA,CGTGAGACAGCAAGATGTCCTAATACACTTGGCCCCCGGACATCAACACTCTCGTATTGCACTCTGTCTCTTGCAGCAAAAAAAATTCTAGTTGGTTTA,10,30,14,27,27,45,27,58,27,38,38,45,51,58,33.82,0.357605209
hek293t,10992,1,7,AGCCTATAGCTGTGCAGAGTAGACAATGATGGCAACTTGCTGAGTGAAAACCCGCACTGCTCTGTTACCTAAAAAAATTCTAGTTGGTTTAACGCGTAA,AGCCTATAGCTGTGCAGAGTAGACAATGATGGCAACTTCTCTAAAGCTGAGTGAAAACCCGCACTGCTCTGTTACCTAAAAAAATTCTAGTTGGTTTAA,10,30,14,27,27,46,27,53,27,39,39,46,46,53,67.61,2.30107343
hek293t,10993,1,6,CTGCGTTATTCTTGCATAGATTATTTTTAAGGATGAATTAATTTCCATTTAGACACAGCTACATTACAAAAGGAAATAAAAAAATTCTAGTTGGTTTAA,CTGCGTTATTCTTGCATAGATTATTTTTAAGGATGACTGGTTATTAATTTCCATTTAGACACAGCTACATTACAAAAGGAAATAAAAAAATTCTAGTTG,10,30,14,27,27,40,27,46,27,37,37,40,43,46,3.28,0.0
hek293t,10993,1,6,TCGCATTATTCTTGCATAGATTATTTTTAAGGATGAATTAATTTCCATTTAGACACAGCTACATTAAAAAAATTCTAGTTGGTTTAACGCGTAACTAGA,TCGCATTATTCTTGCATAGATTATTTTTAAGGATGACTGGTTATTAATTTCCATTTAGACACAGCTACATTAAAAAAATTCTAGTTGGTTTAACGCGTA,10,30,14,27,27,52,27,58,27,37,37,52,43,58,3.28,0.0
hek293t,20419,1,9,TATGTCCATGGGAGATAGCATGTGCATGTTGGGTGGGGGAGTTACTGGAGTAGAGAATACTTTTCCTATCTTGCCTTCAAAAAAATTCTAGTTGGTTTA,TATGTCCATGGGAGATAGCATGTGCATGTTGGAAGCGTGCCGTGGGGGAGTTACTGGAGTAGAGAATACTTTTCCTATCTTGCCTTCAAAAAAATTCTA,10,30,14,27,27,36,27,45,27,33,33,36,42,45,56.45,0.0
hek293t,10997,1,8,ACTTAAATGTCTATTCCCCTGTAAAATTAAGGGAAATTAGTTAGTCGCGTGATTTGGAAATATTCCAAGGCACCTCTAAAAAAATTCTAGTTGGTTTAA,ACTTAAATGTCTATTCCCCTGTAAAATCAGCGTATTAAGGGAAATTAGTTAGTCGCGTGATTTGGAAATATTCCAAGGCACCTCTAAAAAAATTCTAGT,10,30,14,27,27,38,27,46,27,28,28,38,36,46,14.38,1.393977178
hek293t,10997,1,8,TGGTCAATGTCTATTCCCCTGTAAAATTAAGGGAAATTAGTTAGTCGCGTGATTTGGAAATATTCCAAGGCAAAAAAAATTCTAGTTGGTTTAACGCGT,TGGTCAATGTCTATTCCCCTGTAAAATCAGCGTATTAAGGGAAATTAGTTAGTCGCGTGATTTGGAAATATTCCAAGGCAAAAAAAATTCTAGTTGGTT,10,30,14,27,27,43,27,51,27,28,28,43,36,51,14.38,1.398486551
hek293t,10999,1,4,CGTCCTGCCAAATCTTTGTTGTCAAATCAAGGCAAGGCTTAAAGAAAATAAAAGCACAGAAGATGACTGATCTGATAAAAAAATTCTAGTTGGTTTAAC,CGTCCTGCCAAATCTTTGTTGTCAAATCAAGGCAAGGCTTTTTTAAAGAAAATAAAAGCACAGAAGATGACTGATCTGATAAAAAAATTCTAGTTGGTT,10,30,14,27,27,43,27,47,27,40,40,43,44,47,13.7,0.0
hek293t,10999,1,4,GACCTTGCCAAATCTTTGTTGTCAAATCAAGGCAAGGCTTAAAGAAAATAAAAGCACAGAAGATAAAAAAATTCTAGTTGGTTTAACGCGTAACTAGAT,GACCTTGCCAAATCTTTGTTGTCAAATCAAGGCAAGGCTTTTTTAAAGAAAATAAAAGCACAGAAGATAAAAAAATTCTAGTTGGTTTAACGCGTAACT,10,30,14,27,27,55,27,59,27,40,40,55,44,59,13.7,1.117138341
hek293t,11001,1,13,TCTAACAGTGTTATTAATTGTGTAACAGTTGGATTATCTAGCTTAATTCCTTCTGAAAGATACCAGTGGGTAAAAAAATTCTAGTTGGTTTAACGCGTA,TCTAACAGTGTTATTAATTGTGTAACAGCATCTATTGTAGGTTGGATTATCTAGCTTAATTCCTTCTGAAAGATACCAGTGGGTAAAAAAATTCTAGTT,10,30,14,27,27,39,27,52,27,29,29,39,42,52,20.39,9.065543928
hek293t,11001,1,13,CCTTGCAGTGTTATTAATTGTGTAACAGTTGGATTATCTAGCTTAATTCCTTCTGAAAGATACCAGAAAAAAATTCTAGTTGGTTTAACGCGTAACTAG,CCTTGCAGTGTTATTAATTGTGTAACAGCATCTATTGTAGGTTGGATTATCTAGCTTAATTCCTTCTGAAAGATACCAGAAAAAAATTCTAGTTGGTTT,10,30,14,27,27,44,27,57,27,29,29,44,42,57,20.39,19.05167735
hek293t,11003,1,13,TCTAGGTCAGAATTTCTACTTTCATAACTAGGCCCTCTAGTCCCATGCATTTATATACTTTTGCTGTTGCACAAAAAAAATTCTAGTTGGTTTAACGCG,TCTAGGTCAGAATTTCTACTTTCATAACTAGGCACGTCCACACCAGCCTCTAGTCCCATGCATTTATATACTTTTGCTGTTGCACAAAAAAAATTCTAG,10,30,14,27,27,37,27,50,27,34,34,37,47,50,10.03,0.678294574
hek293t,11003,1,13,TTACTGTCAGAATTTCTACTTTCATAACTAGGCCCTCTAGTCCCATGCATTTATATACTTTTGCTGTTGAAAAAAATTCTAGTTGGTTTAACGCGTAAC,TTACTGTCAGAATTTCTACTTTCATAACTAGGCACGTCCACACCAGCCTCTAGTCCCATGCATTTATATACTTTTGCTGTTGAAAAAAATTCTAGTTGG,10,30,14,27,27,41,27,54,27,34,34,41,47,54,10.03,0.0
hek293t,11005,1,1,ACCTCTTGCTGAGTCTAGCTTTTTTATAAAGGTGAAAATGAAACATTCTAGCAAATTTCCAAACACAAAAAAAATTCTAGTTGGTTTAACGCGTAACTA,ACCTCTTGCTGAGTCTAGCTTTTTTATAAAGGTGAAAATCGAAACATTCTAGCAAATTTCCAAACACAAAAAAAATTCTAGTTGGTTTAACGCGTAACT,10,30,14,27,27,55,27,56,27,40,40,55,41,56,3.4,0.278675797
hek293t,11005,1,1,GAAGGTTGCTGAGTCTAGCTTTTTTATAAAGGTGAAAATGAAACATTCTAGCAAATTTCCAAACACAATTTGAAAAAAATTCTAGTTGGTTTAACGCGT,GAAGGTTGCTGAGTCTAGCTTTTTTATAAAGGTGAAAATCGAAACATTCTAGCAAATTTCCAAACACAATTTGAAAAAAATTCTAGTTGGTTTAACGCG,10,30,14,27,27,50,27,51,27,40,40,50,41,51,3.4,0.579794252
hek293t,11007,1,3,CCGAAACACTAGGAGCATTAGATCACACAAGGCTGCACCGCTGGTTTCTGTGTTTGAGCAACTAGCAAGTCTCATACACTCAAAAAAATTCTAGTTGGT,CCGAAACACTAGGAGCATTAGATCACACAAGCCGGCTGCACCGCTGGTTTCTGTGTTTGAGCAACTAGCAAGTCTCATACACTCAAAAAAATTCTAGTT,10,30,14,27,27,39,27,42,27,32,32,39,35,42,67.28,82.22634831
hek293t,11007,1,3,GACATACACTAGGAGCATTAGATCACACAAGGCTGCACCGCTGGTTTCTGTGTTTGAGCAACTAGCAAGTCTCATACAAAAAAAATTCTAGTTGGTTTA,GACATACACTAGGAGCATTAGATCACACAAGCCGGCTGCACCGCTGGTTTCTGTGTTTGAGCAACTAGCAAGTCTCATACAAAAAAAATTCTAGTTGGT,10,30,14,27,27,42,27,45,27,32,32,42,35,45,67.28,75.07863811
hek293t,11009,1,2,TATGGTATGACTTCTAAAGTGTCCAAGCCAGGAAATCTGTAGACCCATTTTAAGCATTGCCTATGGACTTGACATAAAAAAAATTCTAGTTGGTTTAAC,TATGGTATGACTTCTAAAGTGTCCAAGCCCCAGGAAATCTGTAGACCCATTTTAAGCATTGCCTATGGACTTGACATAAAAAAAATTCTAGTTGGTTTA,10,30,14,27,27,45,27,47,27,30,30,45,32,47,16.76,59.36829353
hek293t,11011,1,9,GATCCGGCATCACAGAGTATTTAGCCATTTGGTTATATGATTGTCACAACAAAAGTTTGTATTTCTCCAATCATTCACGTAAAAAAATTCTAGTTGGTT,GATCCGGCATCACAGAGTATTTAGCCTAGTTCCTGATTTGGTTATATGATTGTCACAACAAAAGTTTGTATTTCTCCAATCATTCACGTAAAAAAATTC,10,30,14,27,27,34,27,43,27,27,27,34,36,43,18.5,2.053487699
hek293t,11011,1,9,ACGACGGCATCACAGAGTATTTAGCCATTTGGTTATATGATTGTCACAACAAAAGTTTGTATTTCTCCAATCATTCAAAAAAAATTCTAGTTGGTTTAA,ACGACGGCATCACAGAGTATTTAGCCTAGTTCCTGATTTGGTTATATGATTGTCACAACAAAAGTTTGTATTTCTCCAATCATTCAAAAAAAATTCTAG,10,30,14,27,27,37,27,46,27,27,27,37,36,46,18.5,9.390098084
hek293t,11013,1,1,CGGTAGGTGTATGCAAAGACAGTGAAAACTGGACTCTTGCTCTCTTAGACTGGATGGCAATCCTTTGATGCTTTTACATGTTAAAAAAATTCTAGTTGG,CGGTAGGTGTATGCAAAGACAGTGAAAACTGGCACTCTTGCTCTCTTAGACTGGATGGCAATCCTTTGATGCTTTTACATGTTAAAAAAATTCTAGTTG,10,30,14,27,27,40,27,41,27,33,33,40,34,41,46.24,69.79161574
hek293t,11013,1,1,CTTGTGGTGTATGCAAAGACAGTGAAAACTGGACTCTTGCTCTCTTAGACTGGATGGCAATCCTTTGATGCTTTTACATAAAAAAATTCTAGTTGGTTT,CTTGTGGTGTATGCAAAGACAGTGAAAACTGGCACTCTTGCTCTCTTAGACTGGATGGCAATCCTTTGATGCTTTTACATAAAAAAATTCTAGTTGGTT,10,30,14,27,27,43,27,44,27,33,33,43,34,44,46.24,67.85274028
hek293t,11018,1,6,TTTTGTAGTCCTACTACAACACGCCAAACTGGTCATAAGGCAAAAACACAAGAGTGTCTTTTGCAGAAGGCACATAGAGTTCTTAAAAAAATTCTAGTT,TTTTGTAGTCCTACTACAACACGCCAAACCATTATTGGTCATAAGGCAAAAACACAAGAGTGTCTTTTGCAGAAGGCACATAGAGTTCTTAAAAAAATT,10,30,14,27,27,33,27,39,27,30,30,33,36,39,34.89,0.0
hek293t,11018,1,6,TAATTTAGTCCTACTACAACACGCCAAACTGGTCATAAGGCAAAAACACAAGAGTGTCTTTTGCAGAAGGCAAAAAAAATTCTAGTTGGTTTAACGCGT,TAATTTAGTCCTACTACAACACGCCAAACCATTATTGGTCATAAGGCAAAAACACAAGAGTGTCTTTTGCAGAAGGCAAAAAAAATTCTAGTTGGTTTA,10,30,14,27,27,45,27,51,27,30,30,45,36,51,34.89,3.748566436
hek293t,11020,1,1,AGGTCGGTTGGTGGAGAAGGTCACCTGCAAGGTAGAGATCACAGTCACTATAGAGGTTCATTGTACCAAAAAAATTCTAGTTGGTTTAACGCGTAACTA,AGGTCGGTTGGTGGAGAAGGTCACCTGCAAGGTAGAGATACACAGTCACTATAGAGGTTCATTGTACCAAAAAAATTCTAGTTGGTTTAACGCGTAACT,10,30,14,27,27,55,27,56,27,40,40,55,41,56,62.02,35.30565174
hek293t,11020,1,1,ATTATGGTTGGTGGAGAAGGTCACCTGCAAGGTAGAGATCACAGTCACTATAGAGGTTCATTGTACCAAGTATGAAAGAAAAAAAATTCTAGTTGGTTT,ATTATGGTTGGTGGAGAAGGTCACCTGCAAGGTAGAGATACACAGTCACTATAGAGGTTCATTGTACCAAGTATGAAAGAAAAAAAATTCTAGTTGGTT,10,30,14,27,27,43,27,44,27,40,40,43,41,44,62.02,4.863430111
hek293t,11022,1,6,ACACGAAGAACAAGCATGGTTATTCATCCAGGAGTTTTTGAAGAGCAGCATTTAAATGACTTGGAACATCTTGCAAAAAAATTCTAGTTGGTTTAACGC,ACACGAAGAACAAGCATGGTTATTCATCCAGGACAAACAGTTTTTGAAGAGCAGCATTTAAATGACTTGGAACATCTTGCAAAAAAATTCTAGTTGGTT,10,30,14,27,27,43,27,49,27,33,33,43,39,49,48.27,33.26362048
hek293t,11022,1,6,ATACTAAGAACAAGCATGGTTATTCATCCAGGAGTTTTTGAAGAGCAGCATTTAAATGACTTGGAACATCTTGCATTGAAAAAAAAAATTCTAGTTGGT,ATACTAAGAACAAGCATGGTTATTCATCCAGGACAAACAGTTTTTGAAGAGCAGCATTTAAATGACTTGGAACATCTTGCATTGAAAAAAAAAATTCTA,10,30,14,27,27,36,27,42,27,33,33,36,39,42,48.27,0.0
hek293t,11025,1,11,TTTTGATGGCAGATATCTGAGTAAGGGTTAGGACCTGCTGTACAAAACCTAGACAAGTTTGGGAGAAAAAAATTCTAGTTGGTTTAACGCGTAACTAGA,TTTTGATGGCAGATATCTGAGTAAGGGTTAGGACCTCCACAGAAATTGCTGTACAAAACCTAGACAAGTTTGGGAGAAAAAAATTCTAGTTGGTTTAAC,10,30,14,27,27,47,27,58,27,37,37,47,48,58,48.63,0.82966801
hek293t,11026,1,8,CGGCAAAGAAGTTGCTGATGAAGTAGAAATGGAAAGTGAAGAAGCAGAAGATGATTCAGATGAGGAAAGAGAGATTAAAAAAATTCTAGTTGGTTTAAC,CGGCAAAGAAGTTGCTGATGAAGTAGAAGTACCATAATGGAAAGTGAAGAAGCAGAAGATGATTCAGATGAGGAAAGAGAGATTAAAAAAATTCTAGTT,10,30,14,27,27,39,27,47,27,29,29,39,37,47,28.95,0.5781893
hek293t,11026,1,8,CTAGCAAGAAGTTGCTGATGAAGTAGAAATGGAAAGTGAAGAAGCAGAAGATGATTCAGATGAGGAAAGAGAGATTACTAAAAAAATTCTAGTTGGTTT,CTAGCAAGAAGTTGCTGATGAAGTAGAAGTACCATAATGGAAAGTGAAGAAGCAGAAGATGATTCAGATGAGGAAAGAGAGATTACTAAAAAAATTCTA,10,30,14,27,27,36,27,44,27,29,29,36,37,44,28.95,5.484526942
hek293t,11030,1,14,GCCAGTGTCTAACCAACCAGTTGTAGCAGAGGCATAAAATTAAATCTCGGTGCTATATTATTTTTTAACATATTGCATCAAAAAAATTCTAGTTGGTTT,GCCAGTGTCTAACCAACCAGTTGTAGGCTGGCATCATGTGCAGAGGCATAAAATTAAATCTCGGTGCTATATTATTTTTTAACATATTGCATCAAAAAA,10,30,14,27,27,30,27,44,27,27,27,30,41,44,58.61,0.0
hek293t,11030,1,14,TATACTGTCTAACCAACCAGTTGTAGCAGAGGCATAAAATTAAATCTCGGTGCTATATTATTTTTTAACATAAAAAAAATTCTAGTTGGTTTAACGCGT,TATACTGTCTAACCAACCAGTTGTAGGCTGGCATCATGTGCAGAGGCATAAAATTAAATCTCGGTGCTATATTATTTTTTAACATAAAAAAAATTCTAG,10,30,14,27,27,37,27,51,27,27,27,37,41,51,58.61,7.859010632
hek293t,11034,1,13,AAGACAGCTGGCTGCAACCCACTGCAAAATGGGAACCAGCAAATATGATCCTCCCGTTCACAAGCAGGTAAAAAAAAATTCTAGTTGGTTTAACGCGTA,AAGACAGCTGGCTGCAACCCACTGCAAAATGCTTGTGGCAACGTGGAACCAGCAAATATGATCCTCCCGTTCACAAGCAGGTAAAAAAAAATTCTAGTT,10,30,14,27,27,39,27,52,27,32,32,39,45,52,20.48,3.464423845
hek293t,11034,1,13,AGCATAGCTGGCTGCAACCCACTGCAAAATGGGAACCAGCAAATATGATCCTCCCGTTCACAAGCAGGAAAAAAATTCTAGTTGGTTTAACGCGTAACT,AGCATAGCTGGCTGCAACCCACTGCAAAATGCTTGTGGCAACGTGGAACCAGCAAATATGATCCTCCCGTTCACAAGCAGGAAAAAAATTCTAGTTGGT,10,30,14,27,27,42,27,55,27,32,32,42,45,55,20.48,2.392866153
hek293t,11036,1,9,GACGACCTCAGATCACTGGACACTCAGGAAGGTGTTCTGAGGAAGTATTGCTGCATGCTTTCCCAAAAAAATTCTAGTTGGTTTAACGCGTAACTAGAT,GACGACCTCAGATCACTGGACACTCAGGAAGGTGTAAATTCGGTTCTGAGGAAGTATTGCTGCATGCTTTCCCAAAAAAATTCTAGTTGGTTTAACGCG,10,30,14,27,27,50,27,59,27,35,35,50,44,59,64.24,7.700115232
hek293t,11036,1,9,TCTTGCCTCAGATCACTGGACACTCAGGAAGGTGTTCTGAGGAAGTATTGCTGCATGCTTTCCCAGTCTCTAATAGAAAAAAATTCTAGTTGGTTTAAC,TCTTGCCTCAGATCACTGGACACTCAGGAAGGTGTAAATTCGGTTCTGAGGAAGTATTGCTGCATGCTTTCCCAGTCTCTAATAGAAAAAAATTCTAGT,10,30,14,27,27,38,27,47,27,35,35,38,44,47,64.24,0.0
hek293t,11039,1,3,TCTACGCTGCACAGATCTGACAGGGCAAACGGGGTCCGCACCTAAATGCAGGTGAGGAACAGAGGTACTTCTATGTAAAGAATCAAAAAAAAATTCTAG,TCTACGCTGCACAGATCTGACAGGGCAAACCGAGGGGTCCGCACCTAAATGCAGGTGAGGAACAGAGGTACTTCTATGTAAAGAATCAAAAAAAAATTC,10,30,14,27,27,34,27,37,27,31,31,34,34,37,16.69,1.213158346
hek293t,11039,1,3,GCTTGGCTGCACAGATCTGACAGGGCAAACGGGGTCCGCACCTAAATGCAGGTGAGGAACAGAGGTACTTCTATGTAAAGAAAAAAAAATTCTAGTTGG,GCTTGGCTGCACAGATCTGACAGGGCAAACCGAGGGGTCCGCACCTAAATGCAGGTGAGGAACAGAGGTACTTCTATGTAAAGAAAAAAAAATTCTAGT,10,30,14,27,27,38,27,41,27,31,31,38,34,41,16.69,74.06819584
hek293t,11041,1,8,CCTATTACTCTTTTCAAGCTGTCTCACTTTGGTTAGACTGGCATGAGAATGGGCAAACCTTGGGTGCACAAAAAAAATTCTAGTTGGTTTAACGCGTAA,CCTATTACTCTTTTCAAGCTGTCTCACTTTGGTTAGATCCGATTGCTGGCATGAGAATGGGCAAACCTTGGGTGCACAAAAAAAATTCTAGTTGGTTTA,10,30,14,27,27,45,27,53,27,38,38,45,46,53,15.95,6.778743161
hek293t,11042,1,4,AACGCCCCTGAGGTCCCAGATTAAATTCATGGCTTTATTACAGACTATTCCCATGACTCCAGGTCCAAAAAAATTCTAGTTGGTTTAACGCGTAACTAG,AACGCCCCTGAGGTCCCAGATTAAATTCATGGCTTTAAGGTTTACAGACTATTCCCATGACTCCAGGTCCAAAAAAATTCTAGTTGGTTTAACGCGTAA,10,30,14,27,27,53,27,57,27,38,38,53,42,57,38.2,16.34160059
hek293t,11042,1,4,CGACACCCTGAGGTCCCAGATTAAATTCATGGCTTTATTACAGACTATTCCCATGACTCCAGGTCCTGTTATCTAAAAAAATTCTAGTTGGTTTAACGC,CGACACCCTGAGGTCCCAGATTAAATTCATGGCTTTAAGGTTTACAGACTATTCCCATGACTCCAGGTCCTGTTATCTAAAAAAATTCTAGTTGGTTTA,10,30,14,27,27,45,27,49,27,38,38,45,42,49,38.2,9.079345646
hek293t,11044,1,2,TACCTCCACCCCTGCCTAACCTTAACCCTAGGCTGAGACTCATGCCTTGGGACACCCTGATATCCATGGCTAAGGACTAAAAAAATTCTAGTTGGTTTA,TACCTCCACCCCTGCCTAACCTTAACCTGCTAGGCTGAGACTCATGCCTTGGGACACCCTGATATCCATGGCTAAGGACTAAAAAAATTCTAGTTGGTT,10,30,14,27,27,43,27,45,27,28,28,43,30,45,62.64,70.46795464
hek293t,11044,1,2,AGTCTCCACCCCTGCCTAACCTTAACCCTAGGCTGAGACTCATGCCTTGGGACACCCTGATATCCATGGCTAAGGACTGCACAGGGAAAAAAATTCTAG,AGTCTCCACCCCTGCCTAACCTTAACCTGCTAGGCTGAGACTCATGCCTTGGGACACCCTGATATCCATGGCTAAGGACTGCACAGGGAAAAAAATTCT,10,30,14,27,27,35,27,37,27,28,28,35,30,37,62.64,79.44968058
hek293t,11046,1,8,AAATCACACTAAGCGTTATTTAGTCTGGCAGGCACACACGTGGCAAAAACCTTGAATTAAAAAGATACAATCATCCAAAAAAAATTCTAGTTGGTTTAA,AAATCACACTAAGCGTTATTTAGTCTGTGTCATAAGCAGGCACACACGTGGCAAAAACCTTGAATTAAAAAGATACAATCATCCAAAAAAAATTCTAGT,10,30,14,27,27,38,27,46,27,28,28,38,36,46,40.04,60.11438795
hek293t,11046,1,8,GAGCCACACTAAGCGTTATTTAGTCTGGCAGGCACACACGTGGCAAAAACCTTGAATTAAAAAGATACAATCATCCAAACATCTAAAAAAATTCTAGTT,GAGCCACACTAAGCGTTATTTAGTCTGTGTCATAAGCAGGCACACACGTGGCAAAAACCTTGAATTAAAAAGATACAATCATCCAAACATCTAAAAAAA,10,30,14,27,27,31,27,39,27,28,28,31,36,39,40.04,0.280112045
hek293t,11048,1,13,TCTGCGCTGAGGAACTAAAGGAAGAGTTGGGGGATAACTGAAGCTTAATAAACCAACAAAAGCACTCCCTAAAAAAATTCTAGTTGGTTTAACGCGTAA,TCTGCGCTGAGGAACTAAAGGAAGAGTTGGGGGATAGAGAAATAGCCCTACTGAAGCTTAATAAACCAACAAAAGCACTCCCTAAAAAAATTCTAGTTG,10,30,14,27,27,40,27,53,27,37,37,40,50,53,55.45,0.0
hek293t,11050,1,7,TACCTGACAAAAACGTGTAAATGAAAGGGCGGAAAACAACACTCAGGCTTTATTACTGCGGATGCCAGGATCAAAAAAAATTCTAGTTGGTTTAACGCG,TACCTGACAAAAACGTGTAAATGAAAGGGCGGAAAAGTCTAGACAACACTCAGGCTTTATTACTGCGGATGCCAGGATCAAAAAAAATTCTAGTTGGTT,10,30,14,27,27,43,27,50,27,36,36,43,43,50,60.23,0.056353903
hek293t,11050,1,7,GCCCAGACAAAAACGTGTAAATGAAAGGGCGGAAAACAACACTCAGGCTTTATTACTGCGGATGCAAAAAAATTCTAGTTGGTTTAACGCGTAACTAGA,GCCCAGACAAAAACGTGTAAATGAAAGGGCGGAAAAGTCTAGACAACACTCAGGCTTTATTACTGCGGATGCAAAAAAATTCTAGTTGGTTTAACGCGT,10,30,14,27,27,51,27,58,27,36,36,51,43,58,60.23,0.215053763
hek293t,11052,1,5,CTCTGGGCTATGCCTGGGGTCTCACCTGCTGGACGGTGGGGCTCGGGGAGGGACGAGGCCGAGCAAAAGCAGACTTCCAGCAAAAAAATTCTAGTTGGT,CTCTGGGCTATGCCTGGGGTCTCACCTGCAGTCCTGGACGGTGGGGCTCGGGGAGGGACGAGGCCGAGCAAAAGCAGACTTCCAGCAAAAAAATTCTAG,10,30,14,27,27,37,27,42,27,30,30,37,35,42,33.11,59.83930357
hek293t,11052,1,5,CGCTCGGCTATGCCTGGGGTCTCACCTGCTGGACGGTGGGGCTCGGGGAGGGACGAGGCCGAGCAAAAGCAGAAAAAAAATTCTAGTTGGTTTAACGCG,CGCTCGGCTATGCCTGGGGTCTCACCTGCAGTCCTGGACGGTGGGGCTCGGGGAGGGACGAGGCCGAGCAAAAGCAGAAAAAAAATTCTAGTTGGTTTA,10,30,14,27,27,45,27,50,27,30,30,45,35,50,33.11,71.28557157
hek293t,11056,1,1,ACATCTCGTCTTTTTATACCAACCTGTGCTGGTCTTCTAAGGGGCTTCTTGTTGGCCACCTTTGAAGAAAAAAAATTCTAGTTGGTTTAACGCGTAACT,ACATCTCGTCTTTTTATACCAACCTGTGCTGGTCTTCTCAAGGGGCTTCTTGTTGGCCACCTTTGAAGAAAAAAAATTCTAGTTGGTTTAACGCGTAAC,10,30,14,27,27,54,27,55,27,39,39,54,40,55,9.29,3.145384621
hek293t,11058,1,4,ATAGTGCAAATTGCTATTAGCAATCTTCTCGGTGCAGCTTCATCTTTTTTCTTCCCCCTTCCTGACACAGTTGAGCCTTTGCTACAAAAAAAATTCTAG,ATAGTGCAAATTGCTATTAGCAATCTTCTGTGGCGGTGCAGCTTCATCTTTTTTCTTCCCCCTTCCTGACACAGTTGAGCCTTTGCTACAAAAAAAATT,10,30,14,27,27,33,27,37,27,30,30,33,34,37,24.68,1.54866602
hek293t,11058,1,4,CATCTGCAAATTGCTATTAGCAATCTTCTCGGTGCAGCTTCATCTTTTTTCTTCCCCCTTCCTGACACAGTTGAAAAAAAATTCTAGTTGGTTTAACGC,CATCTGCAAATTGCTATTAGCAATCTTCTGTGGCGGTGCAGCTTCATCTTTTTTCTTCCCCCTTCCTGACACAGTTGAAAAAAAATTCTAGTTGGTTTA,10,30,14,27,27,45,27,49,27,30,30,45,34,49,24.68,18.65022967
hek293t,11060,1,10,TTCGTCTATATGGCTGTGTCAAAAAAGTTTGGGAGAAAGATAAATACCAGAAACTATCAAGTTTATCTTTTTAAAAAAAATTCTAGTTGGTTTAACGCG,TTCGTCTATATGGCTGTGTCAAAAAAGTTTGGGAGAGTCGAATGGTAAGATAAATACCAGAAACTATCAAGTTTATCTTTTTAAAAAAAATTCTAGTTG,10,30,14,27,27,40,27,50,27,37,37,40,47,50,33.93,0.0
hek293t,11061,1,8,CAAACGGTAAAAAGATGTCCTGATTTTAAAGGAAAGAATTGTTTTAAATGGGAATTTATTTTACAAAAAAATTCTAGTTGGTTTAACGCGTAACTAGAT,CAAACGGTAAAAAGATGTCCTGATTTTAAAGGAAACTTTCCTCGAATTGTTTTAAATGGGAATTTATTTTACAAAAAAATTCTAGTTGGTTTAACGCGT,10,30,14,27,27,51,27,59,27,36,36,51,44,59,1.66,5.941674515
hek293t,11061,1,8,AAGATGGTAAAAAGATGTCCTGATTTTAAAGGAAAGAATTGTTTTAAATGGGAATTTATTTTACATGAGTACAAAAAAATTCTAGTTGGTTTAACGCGT,AAGATGGTAAAAAGATGTCCTGATTTTAAAGGAAACTTTCCTCGAATTGTTTTAAATGGGAATTTATTTTACATGAGTACAAAAAAATTCTAGTTGGTT,10,30,14,27,27,43,27,51,27,36,36,43,44,51,1.66,1.115189209
hek293t,11063,1,11,CGCTCGAAGAACAACCTGATAAAACCACATGGAGGTTTCGCATACACGAAGAATTACTGAGTACACTAACTAAAAAAATTCTAGTTGGTTTAACGCGTA,CGCTCGAAGAACAACCTGATAAAACCACATGGAAGCTCCCATTAGGTTTCGCATACACGAAGAATTACTGAGTACACTAACTAAAAAAATTCTAGTTGG,10,30,14,27,27,41,27,52,27,34,34,41,45,52,48.54,0.724637681
hek293t,11065,1,5,TGGCTACTGGAAACATAGGAAGGAACAATAGGACTAGAATTTCTTTCAGGACTCCCTCTTCACAGAGATGAAGCGTAAATAAAAAAATTCTAGTTGGTT,TGGCTACTGGAAACATAGGAAGGAACAATAGGACCCTCATAGAATTTCTTTCAGGACTCCCTCTTCACAGAGATGAAGCGTAAATAAAAAAATTCTAGT,10,30,14,27,27,38,27,43,27,35,35,38,40,43,38.53,0.0
hek293t,11065,1,5,GCCAGACTGGAAACATAGGAAGGAACAATAGGACTAGAATTTCTTTCAGGACTCCCTCTTCACAGAGAAAAAAAATTCTAGTTGGTTTAACGCGTAACT,GCCAGACTGGAAACATAGGAAGGAACAATAGGACCCTCATAGAATTTCTTTCAGGACTCCCTCTTCACAGAGAAAAAAAATTCTAGTTGGTTTAACGCG,10,30,14,27,27,50,27,55,27,35,35,50,40,55,38.53,31.78771137
hek293t,11067,1,10,GATAAGTTTTTAACACTAGAGTTTTTTGGAGGGAGGGTATTTTTAAATGGTTACAGTCACTTTATGAAAAAAATTCTAGTTGGTTTAACGCGTAACTAG,GATAAGTTTTTAACACTAGAGTTTTTTGGAGGGAGGGTACGTCAAATACTTTTTAAATGGTTACAGTCACTTTATGAAAAAAATTCTAGTTGGTTTAAC,10,30,14,27,27,47,27,57,27,40,40,47,50,57,29.16,0.0
hek293t,11068,1,12,TGATTAAAGGATGAAAACGCAGAGGCAAGGGGAGAGGTTCAAAACCTACCAGTGTTTAAAAATGAGAAAAAAATTCTAGTTGGTTTAACGCGTAACTAG,TGATTAAAGGATGAAAACGCAGAGGCAAGGGGAGAGGTCTTGCAGCTCTTTCAAAACCTACCAGTGTTTAAAAATGAGAAAAAAATTCTAGTTGGTTTA,10,30,14,27,27,45,27,57,27,38,38,45,50,57,53.66,0.068376068
hek293t,11069,1,6,TCAGCCATGAAAGTCAACAGATGTGGCAATGGAACAGCATCTGAGGAGACAGAAAGCCTTGGCACAGACCAGCAACCATTCAATTAAAAAAATTCTAGT,TCAGCCATGAAAGTCAACAGATGTGGCATGGACGATGGAACAGCATCTGAGGAGACAGAAAGCCTTGGCACAGACCAGCAACCATTCAATTAAAAAAAT,10,30,14,27,27,32,27,38,27,29,29,32,35,38,47.53,4.260199281
hek293t,11069,1,6,CTTAGCATGAAAGTCAACAGATGTGGCAATGGAACAGCATCTGAGGAGACAGAAAGCCTTGGCACAGACCAGCAACCATTCAAAAAAATTCTAGTTGGT,CTTAGCATGAAAGTCAACAGATGTGGCATGGACGATGGAACAGCATCTGAGGAGACAGAAAGCCTTGGCACAGACCAGCAACCATTCAAAAAAATTCTA,10,30,14,27,27,36,27,42,27,29,29,36,35,42,47.53,6.575881482
hek293t,11071,1,14,CGAATTAATATAGTACTTAAATTGACATTTGGCAGTACACAAGTTGAGCAACGTGAACACCCCCCCAGGTTAAAAAAATTCTAGTTGGTTTAACGCGTA,CGAATTAATATAGTACTTAAATTGACACTGATGTCATTTACTTTGGCAGTACACAAGTTGAGCAACGTGAACACCCCCCCAGGTTAAAAAAATTCTAGT,10,30,14,27,27,38,27,52,27,28,28,38,42,52,26.23,2.573503289
hek293t,11071,1,14,CCGGCTAATATAGTACTTAAATTGACATTTGGCAGTACACAAGTTGAGCAACGTGAACACCCCCCCAAAAAAATTCTAGTTGGTTTAACGCGTAACTAG,CCGGCTAATATAGTACTTAAATTGACACTGATGTCATTTACTTTGGCAGTACACAAGTTGAGCAACGTGAACACCCCCCCAAAAAAATTCTAGTTGGTT,10,30,14,27,27,43,27,57,27,28,28,43,42,57,26.23,7.286467677
hek293t,11073,1,5,AATAACTCATCAGGCAACTCTAAACCTGCTGGGAAATGAAACTGTGGCCAAGTACTCAGCTCCCGCACAACTGCAAAAAAATTCTAGTTGGTTTAACGC,AATAACTCATCAGGCAACTCTAAACCTGCTGGGTCGATAAATGAAACTGTGGCCAAGTACTCAGCTCCCGCACAACTGCAAAAAAATTCTAGTTGGTTT,10,30,14,27,27,44,27,49,27,34,34,44,39,49,34.11,3.282982207
hek293t,11073,1,5,ATAGTCTCATCAGGCAACTCTAAACCTGCTGGGAAATGAAACTGTGGCCAAGTACTCAGCTCCCGCACAACTGCCGAAAAAAAATTCTAGTTGGTTTAA,ATAGTCTCATCAGGCAACTCTAAACCTGCTGGGTCGATAAATGAAACTGTGGCCAAGTACTCAGCTCCCGCACAACTGCCGAAAAAAAATTCTAGTTGG,10,30,14,27,27,41,27,46,27,34,34,41,39,46,34.11,0.563968125
hek293t,11075,1,10,CTTAAGGAGACACTTGTATAATACAGTAAAGGCCTAAGATAGCTCAGATTCACCATTCTCCCCAGATTCTGCTGAAAAAAATTCTAGTTGGTTTAACGC,CTTAAGGAGACACTTGTATAATACAGTAGTTAACCCAGAAGGCCTAAGATAGCTCAGATTCACCATTCTCCCCAGATTCTGCTGAAAAAAATTCTAGTT,10,30,14,27,27,39,27,49,27,29,29,39,39,49,36.82,3.221609609
hek293t,11075,1,10,ATAGCGGAGACACTTGTATAATACAGTAAAGGCCTAAGATAGCTCAGATTCACCATTCTCCCCAGATTCAAAAAAATTCTAGTTGGTTTAACGCGTAAC,ATAGCGGAGACACTTGTATAATACAGTAGTTAACCCAGAAGGCCTAAGATAGCTCAGATTCACCATTCTCCCCAGATTCAAAAAAATTCTAGTTGGTTT,10,30,14,27,27,44,27,54,27,29,29,44,39,54,36.82,3.785495697
hek293t,11077,1,7,GGGGCGCAAACTTTTGTAGAGGATTGAAATGGGGCACAGATGAGAGCTGGCCAGAGATTATCCTAACTTGAAAAAAATTCTAGTTGGTTTAACGCGTAA,GGGGCGCAAACTTTTGTAGAGGATTGAAATGGGGCATATTAGACAGATGAGAGCTGGCCAGAGATTATCCTAACTTGAAAAAAATTCTAGTTGGTTTAA,10,30,14,27,27,46,27,53,27,36,36,46,43,53,21.64,39.90227981
hek293t,11077,1,7,ATGGCGCAAACTTTTGTAGAGGATTGAAATGGGGCACAGATGAGAGCTGGCCAGAGATTATCCTAACTTGTGCAAAAAAATTCTAGTTGGTTTAACGCG,ATGGCGCAAACTTTTGTAGAGGATTGAAATGGGGCATATTAGACAGATGAGAGCTGGCCAGAGATTATCCTAACTTGTGCAAAAAAATTCTAGTTGGTT,10,30,14,27,27,43,27,50,27,36,36,43,43,50,21.64,7.626851233
hek293t,11079,1,8,CAGCGTGTTGTAGTAGTTCACTGGGGCTTTGGTGCACTCTCTGAGCTTTCTTTCCCTTACCCCCTTTTTAAAAAAATTCTAGTTGGTTTAACGCGTAAC,CAGCGTGTTGTAGTAGTTCACTGGGGCTTTAACTGCTGGGTGCACTCTCTGAGCTTTCTTTCCCTTACCCCCTTTTTAAAAAAATTCTAGTTGGTTTAA,10,30,14,27,27,46,27,54,27,31,31,46,39,54,50.4,15.6660345
hek293t,11081,1,11,CGCTTATTCACTGCCCCATATGTAATTTCTGGAGTATGGCTAGAGAAAGAGAGAAGGCTGACATTAAAAAAATTCTAGTTGGTTTAACGCGTAACTAGA,CGCTTATTCACTGCCCCATATGTAATTTCTGGAGTATGGGTGGCAACGTTCTAGAGAAAGAGAGAAGGCTGACATTAAAAAAATTCTAGTTGGTTTAAC,10,30,14,27,27,47,27,58,27,40,40,47,51,58,14.91,0.115573873
hek293t,11082,1,9,GCTGTCAAGCCTCTCTTTCCTGCACGACCTGGGGGACCCACTGGACCTCGAGAACCCTACAAAGATCGCATAGAGAAAAAAAATTCTAGTTGGTTTAAC,GCTGTCAAGCCTCTCTTTCCTGCACGAATCGGCCGGCCTGGGGGACCCACTGGACCTCGAGAACCCTACAAAGATCGCATAGAGAAAAAAAATTCTAGT,10,30,14,27,27,38,27,47,27,28,28,38,37,47,39.18,32.41573828
hek293t,11082,1,9,CTAGGCAAGCCTCTCTTTCCTGCACGACCTGGGGGACCCACTGGACCTCGAGAACCCTACAAAGATCGCATAAAAAAATTCTAGTTGGTTTAACGCGTA,CTAGGCAAGCCTCTCTTTCCTGCACGAATCGGCCGGCCTGGGGGACCCACTGGACCTCGAGAACCCTACAAAGATCGCATAAAAAAATTCTAGTTGGTT,10,30,14,27,27,43,27,52,27,28,28,43,37,52,39.18,59.1809589
hek293t,11084,1,12,CGTTACATGGTCACTCTCACTGCCTTTACCGGTGTCAGTATATGGGCATAATAGTGAATCAGCTTCTTGTCAAAAAAAATTCTAGTTGGTTTAACGCGT,CGTTACATGGTCACTCTCACTGCCTTTACCGACACGTCATAACGTGTCAGTATATGGGCATAATAGTGAATCAGCTTCTTGTCAAAAAAAATTCTAGTT,10,30,14,27,27,39,27,51,27,32,32,39,44,51,14.39,5.705259345
hek293t,11084,1,12,ACAACCATGGTCACTCTCACTGCCTTTACCGGTGTCAGTATATGGGCATAATAGTGAATCAGCTAAAAAAATTCTAGTTGGTTTAACGCGTAACTAGAT,ACAACCATGGTCACTCTCACTGCCTTTACCGACACGTCATAACGTGTCAGTATATGGGCATAATAGTGAATCAGCTAAAAAAATTCTAGTTGGTTTAAC,10,30,14,27,27,47,27,59,27,32,32,47,44,59,14.39,24.93928813
hek293t,18359,1,5,GCATAAATATAGCCTAGTTGCCGCTGCCCAGGCAAACACAGCTTTGCTTCCACGCACAGCATCACTGCTGGCTGAAAGAAAAAAATTCTAGTTGGTTTA,GCATAAATATAGCCTAGTTGCCGCTGCCCTATTCAGGCAAACACAGCTTTGCTTCCACGCACAGCATCACTGCTGGCTGAAAGAAAAAAATTCTAGTTG,10,30,14,27,27,40,27,45,27,30,30,40,35,45,41.26,70.73381928
hek293t,11089,1,1,TACCATATACAGCACTCGGTGATATGTTATGGTTTAATGAAAAAGCTGTGTTACAGTTGTTAAAGAAGTAAAATCCCCAAAAAAATTCTAGTTGGTTTA,TACCATATACAGCACTCGGTGATATGTTTATGGTTTAATGAAAAAGCTGTGTTACAGTTGTTAAAGAAGTAAAATCCCCAAAAAAATTCTAGTTGGTTT,10,30,14,27,27,44,27,45,27,29,29,44,30,45,33.89,11.23870926
hek293t,11091,1,2,GCAAAAAAATTATTAAAGGCATGTTTCTTCGGATCATTAAGGAAACCATCAGCATTACTGCACAACTCAGTGCTAAAAAAATTCTAGTTGGTTTAACGC,GCAAAAAAATTATTAAAGGCATGTTTCTTCGGATCATTATGAGGAAACCATCAGCATTACTGCACAACTCAGTGCTAAAAAAATTCTAGTTGGTTTAAC,10,30,14,27,27,47,27,49,27,40,40,47,42,49,4.78,9.97589487
hek293t,11093,1,2,AGATATTCAAAACAAATAGAAGGCTAGAAAGGGATTTTATCTAGACAACTTATGCATATCCTTGATGGTAGTGTTAAAAAAAATTCTAGTTGGTTTAAC,AGATATTCAAAACAAATAGAAGGCTAGAAAGGGAGTTTTTATCTAGACAACTTATGCATATCCTTGATGGTAGTGTTAAAAAAAATTCTAGTTGGTTTA,10,30,14,27,27,45,27,47,27,35,35,45,37,47,23.2,28.54692678
hek293t,11093,1,2,GACGTTTCAAAACAAATAGAAGGCTAGAAAGGGATTTTATCTAGACAACTTATGCATATCCTTGATGGTAGTGTTAATTAAAAAAATTCTAGTTGGTTT,GACGTTTCAAAACAAATAGAAGGCTAGAAAGGGAGTTTTTATCTAGACAACTTATGCATATCCTTGATGGTAGTGTTAATTAAAAAAATTCTAGTTGGT,10,30,14,27,27,42,27,44,27,35,35,42,37,44,23.2,3.616291516
hek293t,11095,1,2,GCTACAGACTTTGAAATGGGCTTTCTTACAGGGCTGTGGTAGGTTACGTTTCCAATCTACAGTTCACATACAAAAAAATTCTAGTTGGTTTAACGCGTA,GCTACAGACTTTGAAATGGGCTTTCTTACAGGGCTCTGTGGTAGGTTACGTTTCCAATCTACAGTTCACATACAAAAAAATTCTAGTTGGTTTAACGCG,10,30,14,27,27,50,27,52,27,35,35,50,37,52,6.44,78.86601344
hek293t,11095,1,2,ACATTAGACTTTGAAATGGGCTTTCTTACAGGGCTGTGGTAGGTTACGTTTCCAATCTACAGTTCACATACAATGCAAAAAAATTCTAGTTGGTTTAAC,ACATTAGACTTTGAAATGGGCTTTCTTACAGGGCTCTGTGGTAGGTTACGTTTCCAATCTACAGTTCACATACAATGCAAAAAAATTCTAGTTGGTTTA,10,30,14,27,27,45,27,47,27,35,35,45,37,47,6.44,84.81217279
hek293t,11097,1,15,AACAGTTTGCCACAAAGCCCAAGGCCTTCAGGGAAGCAGCCTGGCATTCCTGTTACCCTTTTCTCCCAAAAAAATTCTAGTTGGTTTAACGCGTAACTA,AACAGTTTGCCACAAAGCCCAAGGCCTTCAGGGAAGCACCCCGACTTGTAGTAGCCTGGCATTCCTGTTACCCTTTTCTCCCAAAAAAATTCTAGTTGG,10,30,14,27,27,41,27,56,27,38,38,41,53,56,8.03,0.0
hek293t,11098,1,7,ATAGGACCATAATGTCAGTTGAAAATGTCTGGCACCACTATGTTACAGCCCTCGCTCAAATTCATTCTGCAGCCAAAAAAATTCTAGTTGGTTTAACGC,ATAGGACCATAATGTCAGTTGAAAATGTCTGGCACCACAGTATAGTATGTTACAGCCCTCGCTCAAATTCATTCTGCAGCCAAAAAAATTCTAGTTGGT,10,30,14,27,27,42,27,49,27,39,39,42,46,49,39.33,0.0
hek293t,11100,1,12,GAACCAAAGAAAATGGCCTTAAGTATGACAGGTAAATTTATTCACATTTAATACCCCCCCAAAGGTTGACAAAAAAATTCTAGTTGGTTTAACGCGTAA,GAACCAAAGAAAATGGCCTTAAGTATGACAGGTAAATGGTATCTAAAACTTATTCACATTTAATACCCCCCCAAAGGTTGACAAAAAAATTCTAGTTGG,10,30,14,27,27,41,27,53,27,38,38,41,50,53,33.93,0.0
hek293t,11101,1,6,AGGGATTTTATTTAGTTTGTTTGTTTTGGAGGGACTGGGGGAAATGTATCCTGCACTGTAACTGCTTTTGAAAAACTATTTGATGCAAAAAAATTCTAG,AGGGATTTTATTTAGTTTGTTTGTTTTCATTCGGGAGGGACTGGGGGAAATGTATCCTGCACTGTAACTGCTTTTGAAAAACTATTTGATGCAAAAAAA,10,30,14,27,27,31,27,37,27,28,28,31,34,37,0.24,0.0
hek293t,11101,1,6,GAGGATTTTATTTAGTTTGTTTGTTTTGGAGGGACTGGGGGAAATGTATCCTGCACTGTAACTGCTTTTGAAAAACTATTTGAAAAAAATTCTAGTTGG,GAGGATTTTATTTAGTTTGTTTGTTTTCATTCGGGAGGGACTGGGGGAAATGTATCCTGCACTGTAACTGCTTTTGAAAAACTATTTGAAAAAAATTCT,10,30,14,27,27,35,27,41,27,28,28,35,34,41,0.24,2.08988927
hek293t,11103,1,9,AAATTAACAGTGATTGCTGGTGAACCCAAAGGTCTCCATGGGTTTTCAAACCACCAGAGTCAACCACAGTGACAAGAACATAAAAAAATTCTAGTTGGT,AAATTAACAGTGATTGCTGGTGAACCCAAAATGTGGGGAGGTCTCCATGGGTTTTCAAACCACCAGAGTCAACCACAGTGACAAGAACATAAAAAAATT,10,30,14,27,27,33,27,42,27,30,30,33,39,42,58.06,0.0
hek293t,11103,1,9,CCTTTAACAGTGATTGCTGGTGAACCCAAAGGTCTCCATGGGTTTTCAAACCACCAGAGTCAACCACAGTGACAAAAAAAATTCTAGTTGGTTTAACGC,CCTTTAACAGTGATTGCTGGTGAACCCAAAATGTGGGGAGGTCTCCATGGGTTTTCAAACCACCAGAGTCAACCACAGTGACAAAAAAAATTCTAGTTG,10,30,14,27,27,40,27,49,27,30,30,40,39,49,58.06,9.236623621
hek293t,11105,1,13,ACGGGGCTCCAGACACAAGTATTTTAATTAGGGTTACAGTTTTGTATTTGCCAACACTTATGAGATAGAAAAAAATTCTAGTTGGTTTAACGCGTAACT,ACGGGGCTCCAGACACAAGTATTTTACAGTCTGACATTCATTAGGGTTACAGTTTTGTATTTGCCAACACTTATGAGATAGAAAAAAATTCTAGTTGGT,10,30,14,27,27,42,27,55,27,27,27,42,40,55,3.15,1.469705431
hek293t,11105,1,13,GATCAGCTCCAGACACAAGTATTTTAATTAGGGTTACAGTTTTGTATTTGCCAACACTTATGAGATAGCAGGAAAGAAGGAAAAAAATTCTAGTTGGTT,GATCAGCTCCAGACACAAGTATTTTACAGTCTGACATTCATTAGGGTTACAGTTTTGTATTTGCCAACACTTATGAGATAGCAGGAAAGAAGGAAAAAA,10,30,14,27,27,30,27,43,27,27,27,30,40,43,3.15,0.0
hek293t,11107,1,5,TATGGAGGGAAACAGCAACTCCTGTCATTTGGGGTTTATTTTTGACTCTTAACTAAAGGTGCTGAGAAGTTTGTTTTGAAAAAAATTCTAGTTGGTTTA,TATGGAGGGAAACAGCAACTCCTGTCATTTTTAGTGGGGTTTATTTTTGACTCTTAACTAAAGGTGCTGAGAAGTTTGTTTTGAAAAAAATTCTAGTTG,10,30,14,27,27,40,27,45,27,30,30,40,35,45,18.17,46.68384576
hek293t,11109,1,8,GCTGTAGTACTGTTTATTTTTCCATTCTCAGGCATTTCTTTATTCTACTATGTTGAGGCTGTGATATGCTAACATTTAAAAAAAATTCTAGTTGGTTTA,GCTGTAGTACTGTTTATTTTTCCATTCTCCCGTAAAGAGGCATTTCTTTATTCTACTATGTTGAGGCTGTGATATGCTAACATTTAAAAAAAATTCTAG,10,30,14,27,27,37,27,45,27,30,30,37,38,45,6.42,0.607164542
hek293t,11109,1,8,GCGAGAGTACTGTTTATTTTTCCATTCTCAGGCATTTCTTTATTCTACTATGTTGAGGCTGTGATATGCTAAAAAAATTCTAGTTGGTTTAACGCGTAA,GCGAGAGTACTGTTTATTTTTCCATTCTCCCGTAAAGAGGCATTTCTTTATTCTACTATGTTGAGGCTGTGATATGCTAAAAAAATTCTAGTTGGTTTA,10,30,14,27,27,45,27,53,27,30,30,45,38,53,6.42,1.004502052
hek293t,11111,1,1,TTTTGCTGTTCACTAATGAAATGCATTTCTGGCTCTAAAATACTGCCTTTTGAAGGTCTTGCAAACACGAGTCTAGCTCACAACTGAATAAAAAAATTC,TTTTGCTGTTCACTAATGAAATGCATTTCCTGGCTCTAAAATACTGCCTTTTGAAGGTCTTGCAAACACGAGTCTAGCTCACAACTGAATAAAAAAATT,10,30,14,27,27,33,27,34,27,30,30,33,31,34,5.01,3.957360222
hek293t,11111,1,1,TCTGACTGTTCACTAATGAAATGCATTTCTGGCTCTAAAATACTGCCTTTTGAAGGTCTTGCAAACACGAGTCTAGCAAAAAAATTCTAGTTGGTTTAA,TCTGACTGTTCACTAATGAAATGCATTTCCTGGCTCTAAAATACTGCCTTTTGAAGGTCTTGCAAACACGAGTCTAGCAAAAAAATTCTAGTTGGTTTA,10,30,14,27,27,45,27,46,27,30,30,45,31,46,5.01,2.025870174
hek293t,11113,1,7,CCGGTTAAGCACACAGCTCTGGGCAGCCCTGGACTCAGCTGTCGGAGTCTCCAGCACCATACAGAAAAAAAATTCTAGTTGGTTTAACGCGTAACTAGA,CCGGTTAAGCACACAGCTCTGGGCAGCCCTGGACTCAGCTATTATGGGTCGGAGTCTCCAGCACCATACAGAAAAAAAATTCTAGTTGGTTTAACGCGT,10,30,14,27,27,51,27,58,27,41,41,51,48,58,34.16,16.05065797
hek293t,11115,1,6,GCAAAGTAAAGCTTTCTTCATTTACTGTGGGGACATACCTACCTAAAAGCTGCTGCAAGAATAAAGTTATAGATGAGGCAGAGAAAAAAATTCTAGTTG,GCAAAGTAAAGCTTTCTTCATTTACTACAATTGTGGGGACATACCTACCTAAAAGCTGCTGCAAGAATAAAGTTATAGATGAGGCAGAGAAAAAAATTC,10,30,14,27,27,34,27,40,27,27,27,34,33,40,42.78,69.35043828
hek293t,11115,1,6,TCAGAGTAAAGCTTTCTTCATTTACTGTGGGGACATACCTACCTAAAAGCTGCTGCAAGAATAAAGTTATAGATGAAAAAAATTCTAGTTGGTTTAACG,TCAGAGTAAAGCTTTCTTCATTTACTACAATTGTGGGGACATACCTACCTAAAAGCTGCTGCAAGAATAAAGTTATAGATGAAAAAAATTCTAGTTGGT,10,30,14,27,27,42,27,48,27,27,27,42,33,48,42.78,54.4323612
hek293t,11117,1,11,CCCGTACCGGTAGGCTGCTAAATGTATATTGGTGTGCTGAAACACCTCAGCTTGTCATTATGGTAGTAGGCTAAAAAAATTCTAGTTGGTTTAACGCGT,CCCGTACCGGTAGGCTGCTAAATGTATATTCATCGATCCATGGTGTGCTGAAACACCTCAGCTTGTCATTATGGTAGTAGGCTAAAAAAATTCTAGTTG,10,30,14,27,27,40,27,51,27,30,30,40,41,51,22.19,2.654233452
hek293t,11117,1,11,TGTCGACCGGTAGGCTGCTAAATGTATATTGGTGTGCTGAAACACCTCAGCTTGTCATTATGGTAGTAGGCTAAGAAAAAAATTCTAGTTGGTTTAACG,TGTCGACCGGTAGGCTGCTAAATGTATATTCATCGATCCATGGTGTGCTGAAACACCTCAGCTTGTCATTATGGTAGTAGGCTAAGAAAAAAATTCTAG,10,30,14,27,27,37,27,48,27,30,30,37,41,48,22.19,0.243309002
hek293t,11119,1,10,GTAATCCCTACCTAATCCAGCAGAGACTCTGGTGTATCCCACTTCATATATTTTATTCCAGAAGTGAGTTAGCTCTTAAAAAAAATTCTAGTTGGTTTA,GTAATCCCTACCTAATCCAGCAGAGACCCTACATAACTCTGGTGTATCCCACTTCATATATTTTATTCCAGAAGTGAGTTAGCTCTTAAAAAAAATTCT,10,30,14,27,27,35,27,45,27,28,28,35,38,45,58.88,4.158090236
hek293t,11121,1,3,GAAGGCTCCATTAAAAGAGATAACCGTGTAGGAAAAACTAAAGATGACATCAATTATCAGTTCTCAACATGCAAAAAAAATTCTAGTTGGTTTAACGCG,GAAGGCTCCATTAAAAGAGATAACCGTGTAGGCCGAAAAACTAAAGATGACATCAATTATCAGTTCTCAACATGCAAAAAAAATTCTAGTTGGTTTAAC,10,30,14,27,27,47,27,50,27,32,32,47,35,50,50.6,1.401793664
hek293t,11123,1,15,AAAGGTTGTATTTGTGAGGTTAGTGGGTACGGCACAACTCGTGACTTCACTGGGAGGCCAGGTCTCACCTTAAAAAAATTCTAGTTGGTTTAACGCGTA,AAAGGTTGTATTTGTGAGGTTAGTGGGTACGGCCTTGTTGACATACGGACAACTCGTGACTTCACTGGGAGGCCAGGTCTCACCTTAAAAAAATTCTAG,10,30,14,27,27,37,27,52,27,34,34,37,49,52,28.39,0.0
hek293t,11125,1,4,GGTCCTGTGTATTAGCGATTACTAATTACTGGGTGCTGTGAAGTTTTGTGCGTGTATGATCCTTCCTGTAAAAAAAAATTCTAGTTGGTTTAACGCGTA,GGTCCTGTGTATTAGCGATTACTAATTACTGGGTGCTGTGATATAAGTTTTGTGCGTGTATGATCCTTCCTGTAAAAAAAAATTCTAGTTGGTTTAACG,10,30,14,27,27,48,27,52,27,41,41,48,45,52,12.4,7.631461805
hek293t,11126,1,1,GTGGTAAGGAGAATGTTAATGTTCCACTATGGACATACACAATTTTCCTCTGATTAATACAGTATTACATTACTGTTGTGAAACACAAATCAAAAAAAT,GTGGTAAGGAGAATGTTAATGTTCCACGTATGGACATACACAATTTTCCTCTGATTAATACAGTATTACATTACTGTTGTGAAACACAAATCAAAAAAA,10,30,14,27,27,31,27,32,27,28,28,31,29,32,57.48,12.04038961
hek293t,11126,1,1,ACCTAAAGGAGAATGTTAATGTTCCACTATGGACATACACAATTTTCCTCTGATTAATACAGTATTACATTACTGTTGTGAAACACAAAAAAAATTCTA,ACCTAAAGGAGAATGTTAATGTTCCACGTATGGACATACACAATTTTCCTCTGATTAATACAGTATTACATTACTGTTGTGAAACACAAAAAAAATTCT,10,30,14,27,27,35,27,36,27,28,28,35,29,36,57.48,56.10795712
hek293t,11130,1,4,GTAAATGGTTGTGATCACTTGCAAGAAAAAGGGAACTGCTGCATACACAAACCGATACAGGTCAAACTGATTTATGGACGGATAAAAAAAATTCTAGTT,GTAAATGGTTGTGATCACTTGCAAGAAGCCAAAAGGGAACTGCTGCATACACAAACCGATACAGGTCAAACTGATTTATGGACGGATAAAAAAAATTCT,10,30,14,27,27,35,27,39,27,28,28,35,32,39,12.64,0.64639745
hek293t,11130,1,4,TTCAATGGTTGTGATCACTTGCAAGAAAAAGGGAACTGCTGCATACACAAACCGATACAGGTCAAACTGATTTATGGACGGATATTTCAAAAAAATTCT,TTCAATGGTTGTGATCACTTGCAAGAAGCCAAAAGGGAACTGCTGCATACACAAACCGATACAGGTCAAACTGATTTATGGACGGATATTTCAAAAAAA,10,30,14,27,27,31,27,35,27,28,28,31,32,35,12.64,0.0
hek293t,11132,1,6,GCGAGACATCCGTTTTGCCAGCTGTTATGGGGAAATTGTTTTGTGGCTACAGTGTCAAAGAAAAAGAAAAATAAATAAGCCACAAAAAAATTCTAGTTG,GCGAGACATCCGTTTTGCCAGCTGTTATGGATGATAGGAAATTGTTTTGTGGCTACAGTGTCAAAGAAAAAGAAAAATAAATAAGCCACAAAAAAATTC,10,30,14,27,27,34,27,40,27,31,31,34,37,40,31.58,0.0
hek293t,11134,1,1,GGGACCTCTGCATAATGCTGCCTGTTTCTAGGAGGGCACTGAAAGTAACATCTGGCTAATGTATTTCTCAGTTTGCTCAAAAAAAATTCTAGTTGGTTT,GGGACCTCTGCATAATGCTGCCTGTTTTCTAGGAGGGCACTGAAAGTAACATCTGGCTAATGTATTTCTCAGTTTGCTCAAAAAAAATTCTAGTTGGTT,10,30,14,27,27,43,27,44,27,28,28,43,29,44,14.48,79.55744268
hek293t,11134,1,1,CTACTCTCTGCATAATGCTGCCTGTTTCTAGGAGGGCACTGAAAGTAACATCTGGCTAATGTATTTCTCAGTTTGCTCAGCATTCGGTAAGAAAAAAAT,CTACTCTCTGCATAATGCTGCCTGTTTTCTAGGAGGGCACTGAAAGTAACATCTGGCTAATGTATTTCTCAGTTTGCTCAGCATTCGGTAAGAAAAAAA,10,30,14,27,27,31,27,32,27,28,28,31,29,32,14.48,83.3908373
hek293t,11136,1,5,ACAAGGGCAATTTCTTATGAGAAATAAGAAGGGGGAAACTATTACTGAAACATTTTGAAATTATATTAGGGTTCAAAAAAAATTCTAGTTGGTTTAACG,ACAAGGGCAATTTCTTATGAGAAATAAGAAGGGGGAAACTGACTTATTACTGAAACATTTTGAAATTATATTAGGGTTCAAAAAAAATTCTAGTTGGTT,10,30,14,27,27,43,27,48,27,40,40,43,45,48,23.92,0.0
hek293t,11137,1,5,TCGGCATGCTTACAACAGGTGTCCCTGCCAGGCCCAAACCTACCTATGTACCCACCATTTGTCAATGAAAAAAATTCTAGTTGGTTTAACGCGTAACTA,TCGGCATGCTTACAACAGGTGTCCCTGCCAGGCCCAAACCGGAGTTACCTATGTACCCACCATTTGTCAATGAAAAAAATTCTAGTTGGTTTAACGCGT,10,30,14,27,27,51,27,56,27,41,41,51,46,56,30.44,6.791086819
hek293t,11138,1,8,CGAACTCTAGTATGGAGACTTCTAAAGCTAGGTTAGGTGAAACTCCTAGTTTCTGTGCGTTTTACTTCAAAAAAAATTCTAGTTGGTTTAACGCGTAAC,CGAACTCTAGTATGGAGACTTCTAAAGCTAGGTTAGGTCCAATACAGAAACTCCTAGTTTCTGTGCGTTTTACTTCAAAAAAAATTCTAGTTGGTTTAA,10,30,14,27,27,46,27,54,27,39,39,46,47,54,60.57,0.0
hek293t,11139,1,3,ATCAATATGAATTTATATTGTGAAAAGTCAGGTGTGCAGCTGTACAACTGAGCAACTGTGTCTTGGTTAGGCAGAAAAAAATTCTAGTTGGTTTAACGC,ATCAATATGAATTTATATTGTGAAAAGTCAGGTGTGACGCAGCTGTACAACTGAGCAACTGTGTCTTGGTTAGGCAGAAAAAAATTCTAGTTGGTTTAA,10,30,14,27,27,46,27,49,27,36,36,46,39,49,17.17,12.6022568
hek293t,11143,1,2,CGCCGGGGTAGTAATGGCAAAAAGGCTGTAGGTAATCTCAATCTTTACCCTGGATTGAAATGAACTTGCAAGTATTCTGTGAAAAAAAATTCTAGTTGG,CGCCGGGGTAGTAATGGCAAAAAGGCTGTAGGTAACATCTCAATCTTTACCCTGGATTGAAATGAACTTGCAAGTATTCTGTGAAAAAAAATTCTAGTT,10,30,14,27,27,39,27,41,27,36,36,39,38,41,51.7,0.0
hek293t,11143,1,2,CCGATGGGTAGTAATGGCAAAAAGGCTGTAGGTAATCTCAATCTTTACCCTGGATTGAAATGAACTTGCAAGTATAAAAAAATTCTAGTTGGTTTAACG,CCGATGGGTAGTAATGGCAAAAAGGCTGTAGGTAACATCTCAATCTTTACCCTGGATTGAAATGAACTTGCAAGTATAAAAAAATTCTAGTTGGTTTAA,10,30,14,27,27,46,27,48,27,36,36,46,38,48,51.7,44.11429393
hek293t,11145,1,8,GCACATTCCTCACTCGGCTTTTAACAACATGGAAAGGAAGGTCATAAAAACAGAACCTGAAGACACAAGATAAAAAAAATTCTAGTTGGTTTAACGCGT,GCACATTCCTCACTCGGCTTTTAACAACATGGACAAAGTGAAAGGAAGGTCATAAAAACAGAACCTGAAGACACAAGATAAAAAAAATTCTAGTTGGTT,10,30,14,27,27,43,27,51,27,33,33,43,41,51,33.1,6.721047834
hek293t,11147,1,5,TCGAATAGCAACTCTACTTGGGTCATCTGAGGTAACTTTTTGACCTTTTGGTCCATGGTCTGGTTCATATGTTTTAGGCGTAAAAAAATTCTAGTTGGT,TCGAATAGCAACTCTACTTGGGTCATGTTATCTGAGGTAACTTTTTGACCTTTTGGTCCATGGTCTGGTTCATATGTTTTAGGCGTAAAAAAATTCTAG,10,30,14,27,27,37,27,42,27,27,27,37,32,42,56.59,82.50076896
hek293t,7579,1,10,GCGTTTGGTGACCGCAAAGAGAGCTACAAAGGTTGATGCTAGCTGAACACCTAGTGCTGTATGGGAAAAAAATTCTAGTTGGTTTAACGCGTAACTAGA,GCGTTTGGTGACCGCAAAGAGAGCTACAAAGGACTGATAAACTTGATGCTAGCTGAACACCTAGTGCTGTATGGGAAAAAAATTCTAGTTGGTTTAACG,10,30,14,27,27,48,27,58,27,33,33,48,43,58,50.91,0.609913298
hek293t,7579,1,10,CATACTGGTGACCGCAAAGAGAGCTACAAAGGTTGATGCTAGCTGAACACCTAGTGCTGTATGGGCAGCGTGAAAAAAAATTCTAGTTGGTTTAACGCG,CATACTGGTGACCGCAAAGAGAGCTACAAAGGACTGATAAACTTGATGCTAGCTGAACACCTAGTGCTGTATGGGCAGCGTGAAAAAAAATTCTAGTTG,10,30,14,27,27,40,27,50,27,33,33,40,43,50,50.91,0.173611111
hek293t,11151,1,13,ACAGTCACTTTCACTGCTGCATCAAGAAATGGGAATAACAGCTCTGCAGTCCCATCTGATTCCCACAGACAAAAAAATTCTAGTTGGTTTAACGCGTAA,ACAGTCACTTTCACTGCTGCATCAAGAAATGGGAATCACGAGTGTTGAAAACAGCTCTGCAGTCCCATCTGATTCCCACAGACAAAAAAATTCTAGTTG,10,30,14,27,27,40,27,53,27,37,37,40,50,53,11.6,0.0
hek293t,11152,1,13,CGCGATATGGTCAGGTACTTGTGGCTGCACGGTAGGGCAGACACAGCTAGGCACTGAACTGAGCCTTTTAAAAAAATTCTAGTTGGTTTAACGCGTAAC,CGCGATATGGTCAGGTACTTGTGGCTGCACGGTAGGGTCTGATTTCAACCCAGACACAGCTAGGCACTGAACTGAGCCTTTTAAAAAAATTCTAGTTGG,10,30,14,27,27,41,27,54,27,38,38,41,51,54,64.35,3.823017722
hek293t,11152,1,13,TAGCTTATGGTCAGGTACTTGTGGCTGCACGGTAGGGCAGACACAGCTAGGCACTGAACTGAGCCAAAAAAATTCTAGTTGGTTTAACGCGTAACTAGA,TAGCTTATGGTCAGGTACTTGTGGCTGCACGGTAGGGTCTGATTTCAACCCAGACACAGCTAGGCACTGAACTGAGCCAAAAAAATTCTAGTTGGTTTA,10,30,14,27,27,45,27,58,27,38,38,45,51,58,64.35,1.220709115
hek293t,11154,1,2,AATATTAGCCACGCGAATGCTTTTTTGGTTGGTCCTACAGTGTGGTCTTTGTTTTATGTTGTTAGCAGTGAGCAAGGTTAAAAAAATTCTAGTTGGTTT,AATATTAGCCACGCGAATGCTTTTTTGTGGTTGGTCCTACAGTGTGGTCTTTGTTTTATGTTGTTAGCAGTGAGCAAGGTTAAAAAAATTCTAGTTGGT,10,30,14,27,27,42,27,44,27,27,27,42,29,44,18.45,4.78471113
hek293t,11154,1,2,ATACATAGCCACGCGAATGCTTTTTTGGTTGGTCCTACAGTGTGGTCTTTGTTTTATGTTGTTAGCAGTGAGCAAGGTTCATGACATAAAAAAATTCTA,ATACATAGCCACGCGAATGCTTTTTTGTGGTTGGTCCTACAGTGTGGTCTTTGTTTTATGTTGTTAGCAGTGAGCAAGGTTCATGACATAAAAAAATTC,10,30,14,27,27,34,27,36,27,27,27,34,29,36,18.45,6.388672313
hek293t,11156,1,13,GGCGAATTCTAACTTGCGACACTTATAAAAGGCCAAGTTTTCTAAGAAGTTACTATAAAAATTTGAAAGCTAAAAAAAATTCTAGTTGGTTTAACGCGT,GGCGAATTCTAACTTGCGACACTTATACAACCAAATTTAAAAAGGCCAAGTTTTCTAAGAAGTTACTATAAAAATTTGAAAGCTAAAAAAAATTCTAGT,10,30,14,27,27,38,27,51,27,28,28,38,41,51,34.79,0.0
hek293t,11158,1,2,GGCCTTTTTATCCTAGAGCAATAGAATACAGGTACAAAGTTCATCTATCATAAGAACATATCTGAACGCTTCAGAAAAAAATTCTAGTTGGTTTAACGC,GGCCTTTTTATCCTAGAGCAATAGAATACAGTCGTACAAAGTTCATCTATCATAAGAACATATCTGAACGCTTCAGAAAAAAATTCTAGTTGGTTTAAC,10,30,14,27,27,47,27,49,27,32,32,47,34,49,31.86,80.06062412
hek293t,11158,1,2,TGGCTTTTTATCCTAGAGCAATAGAATACAGGTACAAAGTTCATCTATCATAAGAACATATCTGAACGCTTCAGATATCCCAAATAAAAAAAATTCTAG,TGGCTTTTTATCCTAGAGCAATAGAATACAGTCGTACAAAGTTCATCTATCATAAGAACATATCTGAACGCTTCAGATATCCCAAATAAAAAAAATTCT,10,30,14,27,27,35,27,37,27,32,32,35,34,37,31.86,0.267569576
hek293t,11160,1,5,GGAGTTGGCCTCACTCCAAAGCACTGATCTGGAGTTCCTGAGTCCTGCTGTTCCTGCACTCGTTTTCCGATTCTGTATTCAAAAAAATTCTAGTTGGTT,GGAGTTGGCCTCACTCCAAAGCACTGATCTGTCAAGGAGTTCCTGAGTCCTGCTGTTCCTGCACTCGTTTTCCGATTCTGTATTCAAAAAAATTCTAGT,10,30,14,27,27,38,27,43,27,31,31,38,36,43,24.12,42.242131
hek293t,11160,1,5,AATCATGGCCTCACTCCAAAGCACTGATCTGGAGTTCCTGAGTCCTGCTGTTCCTGCACTCGTTTTCCGATTAAAAAAATTCTAGTTGGTTTAACGCGT,AATCATGGCCTCACTCCAAAGCACTGATCTGTCAAGGAGTTCCTGAGTCCTGCTGTTCCTGCACTCGTTTTCCGATTAAAAAAATTCTAGTTGGTTTAA,10,30,14,27,27,46,27,51,27,31,31,46,36,51,24.12,71.95539382
hek293t,11162,1,15,CCGATATAGTTTAGAACTCACAGTATTATAGGAGAGATTGTGAAGAATTTTCTTGAAGATGTAAATTGTACAAAAAAATTCTAGTTGGTTTAACGCGTA,CCGATATAGTTTAGAACTCACAGTATGTGGTCCCTGAGCCCTATAGGAGAGATTGTGAAGAATTTTCTTGAAGATGTAAATTGTACAAAAAAATTCTAG,10,30,14,27,27,37,27,52,27,27,27,37,42,52,8.46,0.100704935
hek293t,11162,1,15,AGTTTATAGTTTAGAACTCACAGTATTATAGGAGAGATTGTGAAGAATTTTCTTGAAGATGTAAATAAAAAAATTCTAGTTGGTTTAACGCGTAACTAG,AGTTTATAGTTTAGAACTCACAGTATGTGGTCCCTGAGCCCTATAGGAGAGATTGTGAAGAATTTTCTTGAAGATGTAAATAAAAAAATTCTAGTTGGT,10,30,14,27,27,42,27,57,27,27,27,42,42,57,8.46,0.373231308
hek293t,11164,1,7,AGCCTTGACAGAGCAGATACGCTGCGGCTTGGGTCGCTGGCAAAAGGGGATCTTTCATGCTTAGTAACCTTTGCAGTAAAAAAATTCTAGTTGGTTTAA,AGCCTTGACAGAGCAGATACGCTGCGGCTTGGGTCGAAACATGCTGGCAAAAGGGGATCTTTCATGCTTAGTAACCTTTGCAGTAAAAAAATTCTAGTT,10,30,14,27,27,39,27,46,27,36,36,39,43,46,54.84,2.488499234
hek293t,11164,1,7,GATATTGACAGAGCAGATACGCTGCGGCTTGGGTCGCTGGCAAAAGGGGATCTTTCATGCTTAGTAAAAAAATTCTAGTTGGTTTAACGCGTAACTAGA,GATATTGACAGAGCAGATACGCTGCGGCTTGGGTCGAAACATGCTGGCAAAAGGGGATCTTTCATGCTTAGTAAAAAAATTCTAGTTGGTTTAACGCGT,10,30,14,27,27,51,27,58,27,36,36,51,43,58,54.84,1.611446948
hek293t,11166,1,15,GAGTAGAAGTGAAAGTTAGCACACTGAGGAGGTGCCGCATCTGAGTTCCAGGCCTCTTATTTAATTCAAGAAAAAAAATTCTAGTTGGTTTAACGCGTA,GAGTAGAAGTGAAAGTTAGCACACTGAGGGAAGATTGAATCGAAAGGTGCCGCATCTGAGTTCCAGGCCTCTTATTTAATTCAAGAAAAAAAATTCTAG,10,30,14,27,27,37,27,52,27,30,30,37,45,52,53.85,19.52772194
hek293t,11167,1,12,TCACTCTTCCATGAAAAACACCCTTGATCAGGGGCATATTTTTGATCACTAGACGTCTGATTCATTTAAAAAAAAATTCTAGTTGGTTTAACGCGTAAC,TCACTCTTCCATGAAAAACACCCTTGATCAGGGGCATAGACGTAGTTGTTTTTTTGATCACTAGACGTCTGATTCATTTAAAAAAAAATTCTAGTTGGT,10,30,14,27,27,42,27,54,27,39,39,42,51,54,32.06,0.12254902
hek293t,11168,1,4,ACCATTCTAGAGATATGTTAAGGAAAGGTAGGGATATATTAAGGAAAAAATGTTTTTTCCCCCCCCCTTCTCACTAAAAAAATTCTAGTTGGTTTAACG,ACCATTCTAGAGATATGTTAAGGAAAGGTAGGGATAACACTATTAAGGAAAAAATGTTTTTTCCCCCCCCCTTCTCACTAAAAAAATTCTAGTTGGTTT,10,30,14,27,27,44,27,48,27,37,37,44,41,48,59.19,12.46811533
hek293t,11168,1,4,AGGGCTCTAGAGATATGTTAAGGAAAGGTAGGGATATATTAAGGAAAAAATGTTTTTTCCCCCCCCCTTCTCACTTTCCAAAAAAATTCTAGTTGGTTT,AGGGCTCTAGAGATATGTTAAGGAAAGGTAGGGATAACACTATTAAGGAAAAAATGTTTTTTCCCCCCCCCTTCTCACTTTCCAAAAAAATTCTAGTTG,10,30,14,27,27,40,27,44,27,37,37,40,41,44,59.19,0.0
hek293t,11170,1,13,AGCGTTGTGCCAGGATTAGGAGATTAAAAAGGCAAAATCTTTAATGTTCGCTCATGCAAGAATGTCAAAAAAAATTCTAGTTGGTTTAACGCGTAACTA,AGCGTTGTGCCAGGATTAGGAGATTAAAAAGGTAGACTCTCACGGCAAAATCTTTAATGTTCGCTCATGCAAGAATGTCAAAAAAAATTCTAGTTGGTT,10,30,14,27,27,43,27,56,27,33,33,43,46,56,31.7,0.0
hek293t,11170,1,13,TAGAATGTGCCAGGATTAGGAGATTAAAAAGGCAAAATCTTTAATGTTCGCTCATGCAAGAATGTCAAATAAAAAAATTCTAGTTGGTTTAACGCGTAA,TAGAATGTGCCAGGATTAGGAGATTAAAAAGGTAGACTCTCACGGCAAAATCTTTAATGTTCGCTCATGCAAGAATGTCAAATAAAAAAATTCTAGTTG,10,30,14,27,27,40,27,53,27,33,33,40,46,53,31.7,0.0
hek293t,11172,1,8,TCAGCATTTTCAATTCTGTCAGGTATCACAGGATGAATGAAGATTAAGATTTCATAGTTATTTCTTTACCAAAAAAAAATTCTAGTTGGTTTAACGCGT,TCAGCATTTTCAATTCTGTCAGGTATCGAAATCTTACAGGATGAATGAAGATTAAGATTTCATAGTTATTTCTTTACCAAAAAAAAATTCTAGTTGGTT,10,30,14,27,27,43,27,51,27,28,28,43,36,51,45.56,2.487369301
hek293t,11174,1,2,ATTCGGACCATTCTGGTGGCTAAACACTGTGGAAACACAGTTCACTGTGTTCAGATTTGCAGTTTGTATCATAAGGTTCACACTTGAAAAAAATTCTAG,ATTCGGACCATTCTGGTGGCTAAACACTTTGTGGAAACACAGTTCACTGTGTTCAGATTTGCAGTTTGTATCATAAGGTTCACACTTGAAAAAAATTCT,10,30,14,27,27,35,27,37,27,28,28,35,30,37,69.31,43.87981787
hek293t,11174,1,2,GAGCGGACCATTCTGGTGGCTAAACACTGTGGAAACACAGTTCACTGTGTTCAGATTTGCAGTTTGTATCATAAGGTTAAAAAAATTCTAGTTGGTTTA,GAGCGGACCATTCTGGTGGCTAAACACTTTGTGGAAACACAGTTCACTGTGTTCAGATTTGCAGTTTGTATCATAAGGTTAAAAAAATTCTAGTTGGTT,10,30,14,27,27,43,27,45,27,28,28,43,30,45,69.31,72.86989131
hek293t,11176,1,3,GTACTCACTTTAGTTAATTGAAATCTTTGAGGTCTAACAAATCAACTTTTATGTCTCAAAATGGTTAGGAGAAAACCACAAAAAAAATTCTAGTTGGTT,GTACTCACTTTAGTTAATTGAAATCTTTGCCCAGGTCTAACAAATCAACTTTTATGTCTCAAAATGGTTAGGAGAAAACCACAAAAAAAATTCTAGTTG,10,30,14,27,27,40,27,43,27,30,30,40,33,43,12.88,0.059844405
hek293t,11176,1,3,GGTCTCACTTTAGTTAATTGAAATCTTTGAGGTCTAACAAATCAACTTTTATGTCTCAAAATGGTTAGGAGAAAACCACAGAAAAAAAAATTCTAGTTG,GGTCTCACTTTAGTTAATTGAAATCTTTGCCCAGGTCTAACAAATCAACTTTTATGTCTCAAAATGGTTAGGAGAAAACCACAGAAAAAAAAATTCTAG,10,30,14,27,27,37,27,40,27,30,30,37,33,40,12.88,0.57121519
hek293t,827,1,7,AGTACGCTCCGTGCCTTGCATGGAGCTCTTGGGCTGTGTGTAATTCTACTGCCACTTTCTTCTGAGAATTCAATTTACTTTTAAAAAAATTCTAGTTGG,AGTACGCTCCGTGCCTTGCATGGAGCTCTTGAAATGTGGGCTGTGTGTAATTCTACTGCCACTTTCTTCTGAGAATTCAATTTACTTTTAAAAAAATTC,10,30,14,27,27,34,27,41,27,31,31,34,38,41,32.03,2.085369827
hek293t,827,1,7,AGAATGCTCCGTGCCTTGCATGGAGCTCTTGGGCTGTGTGTAATTCTACTGCCACTTTCTTCTGAGAATTAAAAAAATTCTAGTTGGTTTAACGCGTAA,AGAATGCTCCGTGCCTTGCATGGAGCTCTTGAAATGTGGGCTGTGTGTAATTCTACTGCCACTTTCTTCTGAGAATTAAAAAAATTCTAGTTGGTTTAA,10,30,14,27,27,46,27,53,27,31,31,46,38,53,32.03,16.50937789
hek293t,11180,1,4,ATTTCATTAGCTCATTTCATGAGCACATCAGGAAAGGAACCAAATAAACATGAAGCAGCTGTGTTTACATTAGAGCAAAAAAAAAATTCTAGTTGGTTT,ATTTCATTAGCTCATTTCATGAGCACATCAGGACTTAAAGGAACCAAATAAACATGAAGCAGCTGTGTTTACATTAGAGCAAAAAAAAAATTCTAGTTG,10,30,14,27,27,40,27,44,27,33,33,40,37,44,11.34,65.13782635
hek293t,11180,1,4,CTCCGATTAGCTCATTTCATGAGCACATCAGGAAAGGAACCAAATAAACATGAAGCAGCTGTGTTTACATTAGAGCAAACATTAAAAAAATTCTAGTTG,CTCCGATTAGCTCATTTCATGAGCACATCAGGACTTAAAGGAACCAAATAAACATGAAGCAGCTGTGTTTACATTAGAGCAAACATTAAAAAAATTCTA,10,30,14,27,27,36,27,40,27,33,33,36,37,40,11.34,0.401180898
hek293t,11182,1,5,TTTATAACCAAATCCACAATACCCACAGCAGGAAGCTCAGAGCATTATAGTGGAATTAATACACTATTTCTGTGGTAAAAAAATTCTAGTTGGTTTAAC,TTTATAACCAAATCCACAATACCCACAGCAGGAAGCTCATTGCAGAGCATTATAGTGGAATTAATACACTATTTCTGTGGTAAAAAAATTCTAGTTGGT,10,30,14,27,27,42,27,47,27,39,39,42,44,47,56.49,3.021372583
hek293t,11182,1,5,ACAGGAACCAAATCCACAATACCCACAGCAGGAAGCTCAGAGCATTATAGTGGAATTAATACACAAAAAAATTCTAGTTGGTTTAACGCGTAACTAGAT,ACAGGAACCAAATCCACAATACCCACAGCAGGAAGCTCATTGCAGAGCATTATAGTGGAATTAATACACAAAAAAATTCTAGTTGGTTTAACGCGTAAC,10,30,14,27,27,54,27,59,27,39,39,54,44,59,56.49,22.86340359
hek293t,11184,1,13,TCGATCTTGGGGCTTAATCCTATTTAGGATGGTTCCTTAAATCATTTTACATTTCCTCCTAAAAGTAGAGTAGCCCCCCAAAAAAATTCTAGTTGGTTT,TCGATCTTGGGGCTTAATCCTATTTAGAGTGAGCCATTAGGATGGTTCCTTAAATCATTTTACATTTCCTCCTAAAAGTAGAGTAGCCCCCCAAAAAAA,10,30,14,27,27,31,27,44,27,28,28,31,41,44,35.87,0.073260073
hek293t,11184,1,13,CTTCGCTTGGGGCTTAATCCTATTTAGGATGGTTCCTTAAATCATTTTACATTTCCTCCTAAAAGTAGAGTAGCCAAAAAAATTCTAGTTGGTTTAACG,CTTCGCTTGGGGCTTAATCCTATTTAGAGTGAGCCATTAGGATGGTTCCTTAAATCATTTTACATTTCCTCCTAAAAGTAGAGTAGCCAAAAAAATTCT,10,30,14,27,27,35,27,48,27,28,28,35,41,48,35.87,2.910056209
hek293t,11186,1,9,ACGAATTCTCATTATTTCCATCTTGTCAATGGGACAATGAACCACGAAGATGAAAGAATTTGCTTAGTCACATAAAAAAATTCTAGTTGGTTTAACGCG,ACGAATTCTCATTATTTCCATCTTGTCAATGGGACAAGCCATTGACTGAACCACGAAGATGAAAGAATTTGCTTAGTCACATAAAAAAATTCTAGTTGG,10,30,14,27,27,41,27,50,27,38,38,41,47,50,3.1,0.0
hek293t,11186,1,9,TTCCTTTCTCATTATTTCCATCTTGTCAATGGGACAATGAACCACGAAGATGAAAGAATTTGCTTAGTCAAAAAAATTCTAGTTGGTTTAACGCGTAAC,TTCCTTTCTCATTATTTCCATCTTGTCAATGGGACAAGCCATTGACTGAACCACGAAGATGAAAGAATTTGCTTAGTCAAAAAAATTCTAGTTGGTTTA,10,30,14,27,27,45,27,54,27,38,38,45,47,54,3.1,0.27146967
hek293t,11188,1,8,TAGGGCTGCACCGGAAGCAGAAAGCTTGTTGGGCTTTAAAAGCTTATAGTAATTTAGCTTTTTCTTCATTCAGGTCATGTAAAAAAATTCTAGTTGGTT,TAGGGCTGCACCGGAAGCAGAAAGCTTATATACGTGTTGGGCTTTAAAAGCTTATAGTAATTTAGCTTTTTCTTCATTCAGGTCATGTAAAAAAATTCT,10,30,14,27,27,35,27,43,27,28,28,35,36,43,35.84,19.64404713
hek293t,11188,1,8,AAAACCTGCACCGGAAGCAGAAAGCTTGTTGGGCTTTAAAAGCTTATAGTAATTTAGCTTTTTCTTCATTCAGGTCAAAAAAAATTCTAGTTGGTTTAA,AAAACCTGCACCGGAAGCAGAAAGCTTATATACGTGTTGGGCTTTAAAAGCTTATAGTAATTTAGCTTTTTCTTCATTCAGGTCAAAAAAAATTCTAGT,10,30,14,27,27,38,27,46,27,28,28,38,36,46,35.84,21.61203026
hek293t,11190,1,15,TAACGACTCTCTTATTAAAGCCTTGTTCCCGGAAGGAAACCCTGCCAAGATCAATCTGAAGAGACAAAAAAATTCTAGTTGGTTTAACGCGTAACTAGA,TAACGACTCTCTTATTAAAGCCTTGTTCCCGGAAGCTACCGGTTGCAGCAGAAACCCTGCCAAGATCAATCTGAAGAGACAAAAAAATTCTAGTTGGTT,10,30,14,27,27,43,27,58,27,36,36,43,51,58,39.25,7.853983131
hek293t,11191,1,13,AACATCATTTGCTGCTCCAATTTATAAATAGGCAAATTCAGCCCTAGAGAATTCGGTTAGTCCTCTGAAGCAAAAAAATTCTAGTTGGTTTAACGCGTA,AACATCATTTGCTGCTCCAATTTATAAAGCGGAAGGACACCTAGGCAAATTCAGCCCTAGAGAATTCGGTTAGTCCTCTGAAGCAAAAAAATTCTAGTT,10,30,14,27,27,39,27,52,27,29,29,39,42,52,4.34,0.342908247
hek293t,11192,1,10,GAACCAATGGTAGCAGTTGGCAGTATCTGGGGCCTTCTCTGGAGATATATATTTGCAGTCTTCTGGTTAGTGCAAAAAAATTCTAGTTGGTTTAACGCG,GAACCAATGGTAGCAGTTGGCAGTATCTGGGGCCTTCCGGTGGATTCTCTGGAGATATATATTTGCAGTCTTCTGGTTAGTGCAAAAAAATTCTAGTTG,10,30,14,27,27,40,27,50,27,37,37,40,47,50,60.14,0.920138838
hek293t,11192,1,10,GTCATAATGGTAGCAGTTGGCAGTATCTGGGGCCTTCTCTGGAGATATATATTTGCAGTCTTCTGGTTAAAAAAAATTCTAGTTGGTTTAACGCGTAAC,GTCATAATGGTAGCAGTTGGCAGTATCTGGGGCCTTCCGGTGGATTCTCTGGAGATATATATTTGCAGTCTTCTGGTTAAAAAAAATTCTAGTTGGTTT,10,30,14,27,27,44,27,54,27,37,37,44,47,54,60.14,1.667727308
hek293t,11194,1,11,GTCATTTTTCTGCCACTTATAACAATTCTAGGCTTCTGTGATTTTTTGGATGAGGTGGTGTCAAGCTACATTTACTGTTTGGAAAAAAATTCTAGTTGG,GTCATTTTTCTGCCACTTATAACAATGGAGTGGCCACTCTAGGCTTCTGTGATTTTTTGGATGAGGTGGTGTCAAGCTACATTTACTGTTTGGAAAAAA,10,30,14,27,27,30,27,41,27,27,27,30,38,41,5.7,0.0
hek293t,11194,1,11,AATGATTTTCTGCCACTTATAACAATTCTAGGCTTCTGTGATTTTTTGGATGAGGTGGTGTCAAGCTACAAAAAAAATTCTAGTTGGTTTAACGCGTAA,AATGATTTTCTGCCACTTATAACAATGGAGTGGCCACTCTAGGCTTCTGTGATTTTTTGGATGAGGTGGTGTCAAGCTACAAAAAAAATTCTAGTTGGT,10,30,14,27,27,42,27,53,27,27,27,42,38,53,5.7,0.22090852
hek293t,11196,1,8,TAGCGAATTATGTTTTGTTTCCAAACTACAGGGTATAAATTACATAATTTAATTAGAGAAACCATTACTACAATCTTAACACCCCAAAAAAATTCTAGT,TAGCGAATTATGTTTTGTTTCCAAACGTATCACTTACAGGGTATAAATTACATAATTTAATTAGAGAAACCATTACTACAATCTTAACACCCCAAAAAA,10,30,14,27,27,30,27,38,27,27,27,30,35,38,8.31,1.533050929
hek293t,20618,1,10,TGATGCATAATGACCCTTTGTGAACACGGAGGTCAGAGTACTTCGGGAAAAACCAAAGACGAGTGGCACTTTAAAAAAATTCTAGTTGGTTTAACGCGT,TGATGCATAATGACCCTTTGTGAACACGGAGGTGGGGAGGTCCCAGAGTACTTCGGGAAAAACCAAAGACGAGTGGCACTTTAAAAAAATTCTAGTTGG,10,30,14,27,27,41,27,51,27,34,34,41,44,51,71.14,0.98556313
hek293t,20618,1,10,ATAACCATAATGACCCTTTGTGAACACGGAGGTCAGAGTACTTCGGGAAAAACCAAAGACGAGTGGCACAAAAAAATTCTAGTTGGTTTAACGCGTAAC,ATAACCATAATGACCCTTTGTGAACACGGAGGTGGGGAGGTCCCAGAGTACTTCGGGAAAAACCAAAGACGAGTGGCACAAAAAAATTCTAGTTGGTTT,10,30,14,27,27,44,27,54,27,34,34,44,44,54,71.14,14.60649526
hek293t,11200,1,13,CTTATACAAACACCCTCAACTGCAGACACCGGGCTCATTGCAAAGCAGACGGAGGCAAAACCCACGAAAAAAATTCTAGTTGGTTTAACGCGTAACTAG,CTTATACAAACACCCTCAACTGCAGACACCGGGCCTTACGGTGTATCTCATTGCAAAGCAGACGGAGGCAAAACCCACGAAAAAAATTCTAGTTGGTTT,10,30,14,27,27,44,27,57,27,34,34,44,47,57,59.09,2.013156646
hek293t,11201,1,5,TCCACACCACTGTGTGCAAGGGAATTCCCAGGCAAAGACAGATTTGGTAGACCTACTAGGCTTATGAGCTGTATTAGACTTCCACAAAAAAATTCTAGT,TCCACACCACTGTGTGCAAGGGAATTCCCTGTAAAGGCAAAGACAGATTTGGTAGACCTACTAGGCTTATGAGCTGTATTAGACTTCCACAAAAAAATT,10,30,14,27,27,33,27,38,27,30,30,33,35,38,49.36,0.876776135
hek293t,11201,1,5,GCTATACCACTGTGTGCAAGGGAATTCCCAGGCAAAGACAGATTTGGTAGACCTACTAGGCTTATGAGCTGTAAAAAAAATTCTAGTTGGTTTAACGCG,GCTATACCACTGTGTGCAAGGGAATTCCCTGTAAAGGCAAAGACAGATTTGGTAGACCTACTAGGCTTATGAGCTGTAAAAAAAATTCTAGTTGGTTTA,10,30,14,27,27,45,27,50,27,30,30,45,35,50,49.36,12.3519536
hek293t,11203,1,6,TATTATACAGAAGGTGATATGAGAAGAGATGGAAACACCTCCACTAAGCATGGACTAGCACTGTCAAGAAAAAAATTCTAGTTGGTTTAACGCGTAACT,TATTATACAGAAGGTGATATGAGAAGAGATGGATTATATAACACCTCCACTAAGCATGGACTAGCACTGTCAAGAAAAAAATTCTAGTTGGTTTAACGC,10,30,14,27,27,49,27,55,27,34,34,49,40,55,59.81,18.46293395
hek293t,11203,1,6,TCCCTTACAGAAGGTGATATGAGAAGAGATGGAAACACCTCCACTAAGCATGGACTAGCACTGTCAAGTTACAGGAAAAAAAATTCTAGTTGGTTTAAC,TCCCTTACAGAAGGTGATATGAGAAGAGATGGATTATATAACACCTCCACTAAGCATGGACTAGCACTGTCAAGTTACAGGAAAAAAAATTCTAGTTGG,10,30,14,27,27,41,27,47,27,34,34,41,40,47,59.81,39.37232755
hek293t,11205,1,12,CACTTGGTGTGAATTGTGGTAACTACATGGGGAAGTCTGCAAGTTCTTCAGTGCTTGCTCCTTCCTCCAAAAAAATTCTAGTTGGTTTAACGCGTAACT,CACTTGGTGTGAATTGTGGTAACTACATGGGGCCAGGCGTAGTGAAGTCTGCAAGTTCTTCAGTGCTTGCTCCTTCCTCCAAAAAAATTCTAGTTGGTT,10,30,14,27,27,43,27,55,27,33,33,43,45,55,43.37,6.896058363
hek293t,11206,1,12,AGTGTGCCAGAAATGGCATCCCCCTTGCTAGGTTTCTAGCCCTCTTTTGTAGCAGTCTTTCCTGAGGAGACACAAAAAAATTCTAGTTGGTTTAACGCG,AGTGTGCCAGAAATGGCATCCCCCTTGCTATAGGAGCCGATGGGTTTCTAGCCCTCTTTTGTAGCAGTCTTTCCTGAGGAGACACAAAAAAATTCTAGT,10,30,14,27,27,38,27,50,27,31,31,38,43,50,46.41,3.549187883
hek293t,11206,1,12,CGCATGCCAGAAATGGCATCCCCCTTGCTAGGTTTCTAGCCCTCTTTTGTAGCAGTCTTTCCTGAGGAGACACTTCCAAAAAAATTCTAGTTGGTTTAA,CGCATGCCAGAAATGGCATCCCCCTTGCTATAGGAGCCGATGGGTTTCTAGCCCTCTTTTGTAGCAGTCTTTCCTGAGGAGACACTTCCAAAAAAATTC,10,30,14,27,27,34,27,46,27,31,31,34,43,46,46.41,1.445090124
hek293t,11211,1,9,TATCATCACACTCATAGGGAAGAAAGAAAAGGTTTCTCATGTTTTTCAGGCTTTTTGTCAGAGATTAATGTGTACAAACAAAAAAAATTCTAGTTGGTT,TATCATCACACTCATAGGGAAGAAAGCGCCCTACTAAAAGGTTTCTCATGTTTTTCAGGCTTTTTGTCAGAGATTAATGTGTACAAACAAAAAAAATTC,10,30,14,27,27,34,27,43,27,27,27,34,36,43,37.77,0.053376034
hek293t,11211,1,9,CAGGTTCACACTCATAGGGAAGAAAGAAAAGGTTTCTCATGTTTTTCAGGCTTTTTGTCAGAGATTAATGTGTACAAACAAGGGAAAAAAATTCTAGTT,CAGGTTCACACTCATAGGGAAGAAAGCGCCCTACTAAAAGGTTTCTCATGTTTTTCAGGCTTTTTGTCAGAGATTAATGTGTACAAACAAGGGAAAAAA,10,30,14,27,27,30,27,39,27,27,27,30,36,39,37.77,0.377278396
hek293t,11213,1,12,CTATAGGGAGAGCTACTGGTGACCATAGGAGGGGGCTGCAAAGTTGACATAGCCTCTCTTTAAAAAGAAACTAAAAAAAATTCTAGTTGGTTTAACGCG,CTATAGGGAGAGCTACTGGTGACCATAGGAGCCACGCCGTTAGGGGGCTGCAAAGTTGACATAGCCTCTCTTTAAAAAGAAACTAAAAAAAATTCTAGT,10,30,14,27,27,38,27,50,27,31,31,38,43,50,44.28,56.88642143
hek293t,11213,1,12,CGGGAGGGAGAGCTACTGGTGACCATAGGAGGGGGCTGCAAAGTTGACATAGCCTCTCTTTAAAAAGAAAAAAAAAATTCTAGTTGGTTTAACGCGTAA,CGGGAGGGAGAGCTACTGGTGACCATAGGAGCCACGCCGTTAGGGGGCTGCAAAGTTGACATAGCCTCTCTTTAAAAAGAAAAAAAAAATTCTAGTTGG,10,30,14,27,27,41,27,53,27,31,31,41,43,53,44.28,19.80859977
hek293t,11216,1,1,GTTGACCCCCTATTTTCCCTCTTTGAAGCTGGTTGCCACACACTGGGTTTGAATATCCATCTTGTAATGATAAAAAAAATTCTAGTTGGTTTAACGCGT,GTTGACCCCCTATTTTCCCTCTTTGAAGCTGGTTCGCCACACACTGGGTTTGAATATCCATCTTGTAATGATAAAAAAAATTCTAGTTGGTTTAACGCG,10,30,14,27,27,50,27,51,27,35,35,50,36,51,5.6,57.52633068
hek293t,11216,1,1,GAAAACCCCCTATTTTCCCTCTTTGAAGCTGGTTGCCACACACTGGGTTTGAATATCCATCTTGTAATGATATTTCATGCTTTGAAAAAAATTCTAGTT,GAAAACCCCCTATTTTCCCTCTTTGAAGCTGGTTCGCCACACACTGGGTTTGAATATCCATCTTGTAATGATATTTCATGCTTTGAAAAAAATTCTAGT,10,30,14,27,27,38,27,39,27,35,35,38,36,39,5.6,8.295313128
hek293t,11220,1,12,GCTTTCCTGCGACTTCTGAACTGCTCTGAAGGACTATGTGCAAGGCTCAGAGAGCTGGAAGAAAAAGGAGCATAAAAAAATTCTAGTTGGTTTAACGCG,GCTTTCCTGCGACTTCTGAACTGCTCTGAGCCTAAAGGGGAAGGACTATGTGCAAGGCTCAGAGAGCTGGAAGAAAAAGGAGCATAAAAAAATTCTAGT,10,30,14,27,27,38,27,50,27,28,28,38,40,50,39.92,2.031398557
hek293t,11220,1,12,GACCCCCTGCGACTTCTGAACTGCTCTGAAGGACTATGTGCAAGGCTCAGAGAGCTGGAAGAAAAAGGAGCATTAAAAAAAAATTCTAGTTGGTTTAAC,GACCCCCTGCGACTTCTGAACTGCTCTGAGCCTAAAGGGGAAGGACTATGTGCAAGGCTCAGAGAGCTGGAAGAAAAAGGAGCATTAAAAAAAAATTCT,10,30,14,27,27,35,27,47,27,28,28,35,40,47,39.92,0.180668473
hek293t,11222,1,13,TTCTACTACATGGTGGTACTTAATAAGAGTGGATTGTATTTTATTTGGGTGAAATGTATGCTAGTTAAAAAAATTCTAGTTGGTTTAACGCGTAACTAG,TTCTACTACATGGTGGTACTTAATAAGAGTGGATTGTATTGCGCGTCCCGCTGTTATTTGGGTGAAATGTATGCTAGTTAAAAAAATTCTAGTTGGTTT,10,30,14,27,27,44,27,57,27,41,41,44,54,57,61.5,0.094428706
hek293t,11223,1,9,CCGATCTCAAGAATAAATCAGTGATATGTAGGTCCAATCCCTAAAAGGACTTAGGCATGTGAATTGAACTTTATGGACAAAAAAAATTCTAGTTGGTTT,CCGATCTCAAGAATAAATCAGTGATATTCTTCCTGGGTAGGTCCAATCCCTAAAAGGACTTAGGCATGTGAATTGAACTTTATGGACAAAAAAAATTCT,10,30,14,27,27,35,27,44,27,28,28,35,37,44,46.11,4.635810413
hek293t,11223,1,9,ACGAGCTCAAGAATAAATCAGTGATATGTAGGTCCAATCCCTAAAAGGACTTAGGCATGTGAATTGAACTTTATGGAAAAAAATTCTAGTTGGTTTAAC,ACGAGCTCAAGAATAAATCAGTGATATTCTTCCTGGGTAGGTCCAATCCCTAAAAGGACTTAGGCATGTGAATTGAACTTTATGGAAAAAAATTCTAGT,10,30,14,27,27,38,27,47,27,28,28,38,37,47,46.11,21.17081825
hek293t,11225,1,5,CTTCATGACTTCACCCATGTCTAAAGGCCAGGTCTGATGGCCGGTCACTGGTGGGGCTGGTGGCGACTGCAAAAAAATTCTAGTTGGTTTAACGCGTAA,CTTCATGACTTCACCCATGTCTAAAGGCCAGGTCTGATGGTTGTGCCGGTCACTGGTGGGGCTGGTGGCGACTGCAAAAAAATTCTAGTTGGTTTAACG,10,30,14,27,27,48,27,53,27,41,41,48,46,53,37.27,15.51489358
hek293t,11226,1,11,TGCGTGTGGTCTGGCATGAATCATAGAAGTGGACTGGCCTGACATGTCAGCTTTATTACCAGATATAAATAAAAAAATTCTAGTTGGTTTAACGCGTAA,TGCGTGTGGTCTGGCATGAATCATAGAAGTGGACTTCCGTGTCAGTGGCCTGACATGTCAGCTTTATTACCAGATATAAATAAAAAAATTCTAGTTGGT,10,30,14,27,27,42,27,53,27,35,35,42,46,53,57.01,0.180212781
hek293t,11226,1,11,TTACAGTGGTCTGGCATGAATCATAGAAGTGGACTGGCCTGACATGTCAGCTTTATTACCAGATATAAATGTATAAAAAAATTCTAGTTGGTTTAACGC,TTACAGTGGTCTGGCATGAATCATAGAAGTGGACTTCCGTGTCAGTGGCCTGACATGTCAGCTTTATTACCAGATATAAATGTATAAAAAAATTCTAGT,10,30,14,27,27,38,27,49,27,35,35,38,46,49,57.01,0.0
hek293t,11228,1,6,ACCTGTTCTCCCAATTGCCACTAAAGCTATGGTTTGAGGAAGCTTAGCTGCAGTCTAATAAAAACAATTCAGGTTTCAGAATAAAAAAAATTCTAGTTG,ACCTGTTCTCCCAATTGCCACTAAAGTTATTACTATGGTTTGAGGAAGCTTAGCTGCAGTCTAATAAAAACAATTCAGGTTTCAGAATAAAAAAAATTC,10,30,14,27,27,34,27,40,27,27,27,34,33,40,48.65,1.250241021
hek293t,11228,1,6,CCTCGTTCTCCCAATTGCCACTAAAGCTATGGTTTGAGGAAGCTTAGCTGCAGTCTAATAAAAACAATTCAGGTTAAAAAAATTCTAGTTGGTTTAACG,CCTCGTTCTCCCAATTGCCACTAAAGTTATTACTATGGTTTGAGGAAGCTTAGCTGCAGTCTAATAAAAACAATTCAGGTTAAAAAAATTCTAGTTGGT,10,30,14,27,27,42,27,48,27,27,27,42,33,48,48.65,28.92074288
hek293t,11230,1,3,GAGTTCAGACTGCAAGCTAAATAGATTTGGGGTCAGAAAGACTTAAAGAATTAGACTCAACTTCTAGACTAAACTGAAAAAAAATTCTAGTTGGTTTAA,GAGTTCAGACTGCAAGCTAAATAGATTTGATGGGGTCAGAAAGACTTAAAGAATTAGACTCAACTTCTAGACTAAACTGAAAAAAAATTCTAGTTGGTT,10,30,14,27,27,43,27,46,27,28,28,43,31,46,48.82,1.018256229
hek293t,11232,1,4,CATCCTAATTTTTAGAGCGATGTTGTGCTAGGAAGGGCTAAACTCTCAGCTAATTAACGCAGGTCTGGCTGCAGAAAAAAATTCTAGTTGGTTTAACGC,CATCCTAATTTTTAGAGCGATGTTGTGCTAGGAAATACGGGCTAAACTCTCAGCTAATTAACGCAGGTCTGGCTGCAGAAAAAAATTCTAGTTGGTTTA,10,30,14,27,27,45,27,49,27,35,35,45,39,49,40.59,59.46958878
hek293t,11232,1,4,TCCAATAATTTTTAGAGCGATGTTGTGCTAGGAAGGGCTAAACTCTCAGCTAATTAACGCAGGTCTGGCTGCAGAAGAGCAAAAAAAATTCTAGTTGGT,TCCAATAATTTTTAGAGCGATGTTGTGCTAGGAAATACGGGCTAAACTCTCAGCTAATTAACGCAGGTCTGGCTGCAGAAGAGCAAAAAAAATTCTAGT,10,30,14,27,27,38,27,42,27,35,35,38,39,42,40.59,0.0
hek293t,11235,1,10,GTCTGATTTTGTCTTGGAATGACATCCACCGGAGAGCAGTGGCGTATGGATGGGGCTCAAGAGCAAAAAAAAATTCTAGTTGGTTTAACGCGTAACTAG,GTCTGATTTTGTCTTGGAATGACATCCACCGGAGAGCAGCATCACGAGCTGGCGTATGGATGGGGCTCAAGAGCAAAAAAAAATTCTAGTTGGTTTAAC,10,30,14,27,27,47,27,57,27,40,40,47,50,57,51.85,1.227735462
hek293t,11236,1,1,TGATTCTGGTGAGTGAGGCCACTGGAAAGGGGACTTGCAGCAGTAATGGGGTAGTAAAGAAAGATCGGTGCTGAGAACAGAAAAAAATTCTAGTTGGTT,TGATTCTGGTGAGTGAGGCCACTGGAAAGGGGACGTTGCAGCAGTAATGGGGTAGTAAAGAAAGATCGGTGCTGAGAACAGAAAAAAATTCTAGTTGGT,10,30,14,27,27,42,27,43,27,35,35,42,36,43,70.18,71.70650774
hek293t,11238,1,4,AGTGAAATTAAGCTTTATTAAACTACATGAGGACTTTGAGGTAAAAAGTGTTCTGAGCCAGGAAAATCTTTTCCTAAAAAAATTCTAGTTGGTTTAACG,AGTGAAATTAAGCTTTATTAAACTACATGAGGATTTGCTTTGAGGTAAAAAGTGTTCTGAGCCAGGAAAATCTTTTCCTAAAAAAATTCTAGTTGGTTT,10,30,14,27,27,44,27,48,27,34,34,44,38,48,10.01,1.848961436
hek293t,11241,1,14,ACTGTCGAAAATATTTATCTTCAGTTTCGGGGTTGTGTTTTTCCTTAATTCCTAGCCTGCGTTAGAAAAAAATTCTAGTTGGTTTAACGCGTAACTAGA,ACTGTCGAAAATATTTATCTTCAGTTTCGGGGTTGTTATGAATTCCTCACGTTTTTCCTTAATTCCTAGCCTGCGTTAGAAAAAAATTCTAGTTGGTTT,10,30,14,27,27,44,27,58,27,37,37,44,51,58,11.12,0.211382114
hek293t,11242,1,13,TATAAACATCACAGTGAGATCTGTGTTGTTGGCATAGTAAACTTTGAGTCTTACTCTGTTCTGCAAAAAAATTCTAGTTGGTTTAACGCGTAACTAGAT,TATAAACATCACAGTGAGATCTGTGTTGTTGGCATAGTCGAGGGCGAGTGCAAACTTTGAGTCTTACTCTGTTCTGCAAAAAAATTCTAGTTGGTTTAA,10,30,14,27,27,46,27,59,27,39,39,46,52,59,26.84,0.896672958
hek293t,11243,1,7,TATTGACTAATGCACATCTTCCTCATCTGTGGACTCTCCCAACAAATGCACACTCATAGGTATTTTCCAAAAAAATTCTAGTTGGTTTAACGCGTAACT,TATTGACTAATGCACATCTTCCTCATCTGTGGACTCTATTATAGCCCAACAAATGCACACTCATAGGTATTTTCCAAAAAAATTCTAGTTGGTTTAACG,10,30,14,27,27,48,27,55,27,38,38,48,45,55,58.59,57.48978705
hek293t,11243,1,7,TAGAAACTAATGCACATCTTCCTCATCTGTGGACTCTCCCAACAAATGCACACTCATAGGTATTTTCCTCCCACAAAAAAAATTCTAGTTGGTTTAACG,TAGAAACTAATGCACATCTTCCTCATCTGTGGACTCTATTATAGCCCAACAAATGCACACTCATAGGTATTTTCCTCCCACAAAAAAAATTCTAGTTGG,10,30,14,27,27,41,27,48,27,38,38,41,45,48,58.59,2.642596681
hek293t,11246,1,15,TGACGTTAAAGGAATTACTGTAGCAGGAGTGGAAAGGGAGGAAGGCTCCTTTGTCAAATGCAGAGAAAAAAATTCTAGTTGGTTTAACGCGTAACTAGA,TGACGTTAAAGGAATTACTGTAGCAGGCCTACGGTAAGCTCTAGTGGAAAGGGAGGAAGGCTCCTTTGTCAAATGCAGAGAAAAAAATTCTAGTTGGTT,10,30,14,27,27,43,27,58,27,28,28,43,43,58,39.88,2.94586586
hek293t,11246,1,15,CTGAGTTAAAGGAATTACTGTAGCAGGAGTGGAAAGGGAGGAAGGCTCCTTTGTCAAATGCAGAGTCAAAGGATGTCAAAAAAATTCTAGTTGGTTTAA,CTGAGTTAAAGGAATTACTGTAGCAGGCCTACGGTAAGCTCTAGTGGAAAGGGAGGAAGGCTCCTTTGTCAAATGCAGAGTCAAAGGATGTCAAAAAAA,10,30,14,27,27,31,27,46,27,28,28,31,43,46,39.88,0.0
hek293t,11248,1,15,GTTTAGAGCTTTCTGGGAACGGAGAAAAGTGGGCAGCAGCAGAATTTATGAATCTTGGGTGGAAAAAAAAATTCTAGTTGGTTTAACGCGTAACTAGAT,GTTTAGAGCTTTCTGGGAACGGAGAAAACATATGGCTGTTCGGGTGGGCAGCAGCAGAATTTATGAATCTTGGGTGGAAAAAAAAATTCTAGTTGGTTT,10,30,14,27,27,44,27,59,27,29,29,44,44,59,46.65,3.365570218
hek293t,11248,1,15,ATGTTGAGCTTTCTGGGAACGGAGAAAAGTGGGCAGCAGCAGAATTTATGAATCTTGGGTGGAAGGTCTATGAAAAAAATTCTAGTTGGTTTAACGCGT,ATGTTGAGCTTTCTGGGAACGGAGAAAACATATGGCTGTTCGGGTGGGCAGCAGCAGAATTTATGAATCTTGGGTGGAAGGTCTATGAAAAAAATTCTA,10,30,14,27,27,36,27,51,27,29,29,36,44,51,46.65,13.37661879
hek293t,11250,1,2,GTACGCTAATCAATCAAACAAAAATGTGTTGGTTACCATATGCTGCAGACTAGAAGGTGCTACATTTGAAAAAAATTCTAGTTGGTTTAACGCGTAACT,GTACGCTAATCAATCAAACAAAAATGTGTTGGTTACCTCATATGCTGCAGACTAGAAGGTGCTACATTTGAAAAAAATTCTAGTTGGTTTAACGCGTAA,10,30,14,27,27,53,27,55,27,38,38,53,40,55,34.85,0.018737118
hek293t,11250,1,2,AGGGGCTAATCAATCAAACAAAAATGTGTTGGTTACCATATGCTGCAGACTAGAAGGTGCTACATTTGTACTTAAGAAAAAAATTCTAGTTGGTTTAAC,AGGGGCTAATCAATCAAACAAAAATGTGTTGGTTACCTCATATGCTGCAGACTAGAAGGTGCTACATTTGTACTTAAGAAAAAAATTCTAGTTGGTTTA,10,30,14,27,27,45,27,47,27,38,38,45,40,47,34.85,0.022266756
hek293t,11252,1,7,GTGTTAGAGTTTACCATGCAACATAAACCAGGTTACATAGGACACAAAGTGTGCAGTTCCTGTCACCAGATGTGTGACAATAAAAAAATTCTAGTTGGT,GTGTTAGAGTTTACCATGCAACATAAACCAGGCGGCGCGTTACATAGGACACAAAGTGTGCAGTTCCTGTCACCAGATGTGTGACAATAAAAAAATTCT,10,30,14,27,27,35,27,42,27,32,32,35,39,42,64.16,0.0
hek293t,11252,1,7,GCAGCAGAGTTTACCATGCAACATAAACCAGGTTACATAGGACACAAAGTGTGCAGTTCCTGTCACCAGATGTGAAAAAAATTCTAGTTGGTTTAACGC,GCAGCAGAGTTTACCATGCAACATAAACCAGGCGGCGCGTTACATAGGACACAAAGTGTGCAGTTCCTGTCACCAGATGTGAAAAAAATTCTAGTTGGT,10,30,14,27,27,42,27,49,27,32,32,42,39,49,64.16,2.512138752
hek293t,5408,1,9,GTGGCCTTCTTTACATATACATATGCTCATGGGAGTACACTTACATTTGTCTCCACATGATGATGGCATATTAATAATAAAAAAATTCTAGTTGGTTTA,GTGGCCTTCTTTACATATACATATGCTCTACATGTCTATGGGAGTACACTTACATTTGTCTCCACATGATGATGGCATATTAATAATAAAAAAATTCTA,10,30,14,27,27,36,27,45,27,29,29,36,38,45,39.11,9.575727734
hek293t,11256,1,2,CCTAGATTTCGGTATGAACCTGTGTATTTTGGAACATTCCCCACTCTCCTTTGACCATCTCTAATCTTGGCATTGACATGAAAAAAAAATTCTAGTTGG,CCTAGATTTCGGTATGAACCTGTGTATTTTGGAACCGATTCCCCACTCTCCTTTGACCATCTCTAATCTTGGCATTGACATGAAAAAAAAATTCTAGTT,10,30,14,27,27,39,27,41,27,36,36,39,38,41,8.62,1.944721945
hek293t,11256,1,2,CTGTTATTTCGGTATGAACCTGTGTATTTTGGAACATTCCCCACTCTCCTTTGACCATCTCTAATCTTGGCATTGACAAAAAAAATTCTAGTTGGTTTA,CTGTTATTTCGGTATGAACCTGTGTATTTTGGAACCGATTCCCCACTCTCCTTTGACCATCTCTAATCTTGGCATTGACAAAAAAAATTCTAGTTGGTT,10,30,14,27,27,43,27,45,27,36,36,43,38,45,8.62,86.86350083
hek293t,11260,1,4,CCCTATATGAGCAATATAATTATTCTCCATGGCACAAGAAATGCAACATTTCATATAACCTGTGAATAGGTCCCAAGAAAAACTCAAAAAAATTCTAGT,CCCTATATGAGCAATATAATTATTCTCCATTCGGGGCACAAGAAATGCAACATTTCATATAACCTGTGAATAGGTCCCAAGAAAAACTCAAAAAAATTC,10,30,14,27,27,34,27,38,27,31,31,34,35,38,36.67,0.062656642
hek293t,11260,1,4,AATCATATGAGCAATATAATTATTCTCCATGGCACAAGAAATGCAACATTTCATATAACCTGTGAATAGGTCCCAAGAAAAAAAAAAATTCTAGTTGGT,AATCATATGAGCAATATAATTATTCTCCATTCGGGGCACAAGAAATGCAACATTTCATATAACCTGTGAATAGGTCCCAAGAAAAAAAAAAATTCTAGT,10,30,14,27,27,38,27,42,27,31,31,38,35,42,36.67,0.624715014
hek293t,11262,1,7,AGCATATATCAATGGAAAACAAATATCAGTGGCCCCCCCCAGGCTTCAGTTTTCTGAGGGAAGTTTAAGGCCCTGAAAAAAATTCTAGTTGGTTTAACG,AGCATATATCAATGGAAAACAAATATCAGTCGGGAACGGCCCCCCCCAGGCTTCAGTTTTCTGAGGGAAGTTTAAGGCCCTGAAAAAAATTCTAGTTGG,10,30,14,27,27,41,27,48,27,31,31,41,38,48,41.52,0.217414971
hek293t,11264,1,13,TGCGATGGAAAATGCTCCATTGTTACTGCAGGGCCTGGATCTAAAATAGATTGCAGTACGATTAAGAAAAAAATTCTAGTTGGTTTAACGCGTAACTAG,TGCGATGGAAAATGCTCCATTGTTACTGCAGGGCCTGGATACGCAAGCCTGACCTAAAATAGATTGCAGTACGATTAAGAAAAAAATTCTAGTTGGTTT,10,30,14,27,27,44,27,57,27,41,41,44,54,57,30.38,0.165425972
hek293t,11265,1,6,CACTGGTACTTCGCAAGGATATGCTACTGGGGTTTTGAACACAAGTTCTGGTGTCGCAGCAAGCTACTGGTGTGTCACATACAAAAAAAATTCTAGTTG,CACTGGTACTTCGCAAGGATATGCTACCCTAGCTGGGGTTTTGAACACAAGTTCTGGTGTCGCAGCAAGCTACTGGTGTGTCACATACAAAAAAAATTC,10,30,14,27,27,34,27,40,27,27,27,34,33,40,60.73,10.15630385
hek293t,11265,1,6,CCGGTGTACTTCGCAAGGATATGCTACTGGGGTTTTGAACACAAGTTCTGGTGTCGCAGCAAGCTACTGGTGTGTAAAAAAATTCTAGTTGGTTTAACG,CCGGTGTACTTCGCAAGGATATGCTACCCTAGCTGGGGTTTTGAACACAAGTTCTGGTGTCGCAGCAAGCTACTGGTGTGTAAAAAAATTCTAGTTGGT,10,30,14,27,27,42,27,48,27,27,27,42,33,48,60.73,28.84904956
hek293t,11267,1,8,CGGTCCTGAGGTATAACATAAATTAACACTGGGCAGAATGAGTTTTCACTTTTAACTCTGCCCATTTTAAAAAAATTCTAGTTGGTTTAACGCGTAACT,CGGTCCTGAGGTATAACATAAATTAACACTGTACATGCGGGCAGAATGAGTTTTCACTTTTAACTCTGCCCATTTTAAAAAAATTCTAGTTGGTTTAAC,10,30,14,27,27,47,27,55,27,32,32,47,40,55,46.85,0.0
hek293t,11267,1,8,CATTACTGAGGTATAACATAAATTAACACTGGGCAGAATGAGTTTTCACTTTTAACTCTGCCCATTTTTGAGATTCAAAAAAATTCTAGTTGGTTTAAC,CATTACTGAGGTATAACATAAATTAACACTGTACATGCGGGCAGAATGAGTTTTCACTTTTAACTCTGCCCATTTTTGAGATTCAAAAAAATTCTAGTT,10,30,14,27,27,39,27,47,27,32,32,39,40,47,46.85,0.054377379
hek293t,11269,1,7,TGTGTTAAGAGCTGACTCAAAGTGGCAGCAGGGGGATTGTTAAAGAAAGACAAATTCTGCAACAGAATTAATGCAAAAAAATTCTAGTTGGTTTAACGC,TGTGTTAAGAGCTGACTCAAAGTGGCAGCAGGGGTGACCGCGATTGTTAAAGAAAGACAAATTCTGCAACAGAATTAATGCAAAAAAATTCTAGTTGGT,10,30,14,27,27,42,27,49,27,35,35,42,42,49,34.08,2.369261944
hek293t,11269,1,7,GAATTTAAGAGCTGACTCAAAGTGGCAGCAGGGGGATTGTTAAAGAAAGACAAATTCTGCAACAGAATTAAAAAAAAATTCTAGTTGGTTTAACGCGTA,GAATTTAAGAGCTGACTCAAAGTGGCAGCAGGGGTGACCGCGATTGTTAAAGAAAGACAAATTCTGCAACAGAATTAAAAAAAAATTCTAGTTGGTTTA,10,30,14,27,27,45,27,52,27,35,35,45,42,52,34.08,16.48798517
hek293t,11273,1,13,TTCATCACAAATATCACTGCTGTCTTTTTTGGATGAGTCTCACGCAGTTACCATTTGAGTATGGTTTCCTGAAAAAAATTCTAGTTGGTTTAACGCGTA,TTCATCACAAATATCACTGCTGTCTTTTTTGCGTTTAACGGCGCGATGAGTCTCACGCAGTTACCATTTGAGTATGGTTTCCTGAAAAAAATTCTAGTT,10,30,14,27,27,39,27,52,27,32,32,39,45,52,6.76,0.157480315
hek293t,11274,1,9,GAGTATAGCAAGGCACCGTGATCGTTGCTTGGTATCACTGCTGTCAACGTATCTATCCCCAAACCAAATGAAAAACAAAAAAAATTCTAGTTGGTTTAA,GAGTATAGCAAGGCACCGTGATCGTTGCTCATTTAATCTGGTATCACTGCTGTCAACGTATCTATCCCCAAACCAAATGAAAAACAAAAAAAATTCTAG,10,30,14,27,27,37,27,46,27,30,30,37,39,46,56.1,9.048790933
hek293t,11276,1,13,CGGCCAGCTGTGTTTTTCCCAAACCATACAGGTATATTCAATTCTGAGTGCTACCCAAACTTTGGAGTAGCTAAAAAAATTCTAGTTGGTTTAACGCGT,CGGCCAGCTGTGTTTTTCCCAAACCATACAGGTAAGCCTCACGCTAATATTCAATTCTGAGTGCTACCCAAACTTTGGAGTAGCTAAAAAAATTCTAGT,10,30,14,27,27,38,27,51,27,35,35,38,48,51,15.38,0.282485876
hek293t,11277,1,7,AGATCCCACGAACTGCGTCATTCTTTTCCAGGTAGTTTCTTTTTCCAAAACAACAGTTCTATAACATTGCTAATATGCAAAAAAATTCTAGTTGGTTTA,AGATCCCACGAACTGCGTCATTCTTTTCCAATGATGAGGTAGTTTCTTTTTCCAAAACAACAGTTCTATAACATTGCTAATATGCAAAAAAATTCTAGT,10,30,14,27,27,38,27,45,27,31,31,38,38,45,13.43,1.39170432
hek293t,11279,1,5,CCTACAAAATATAGGGTAAATAAAAGACATGGCTTATTTCAACCAGCAAGGGCGAATTTTCTATCTAAATATGTAAAAAAATTCTAGTTGGTTTAACGC,CCTACAAAATATAGGGTAAATAAAAGACATGGCTTATTTCTTGTTAACCAGCAAGGGCGAATTTTCTATCTAAATATGTAAAAAAATTCTAGTTGGTTT,10,30,14,27,27,44,27,49,27,41,41,44,46,49,59.34,0.0
hek293t,11280,1,5,CGTGACTTTCCATTTTGGTTCCGTGAAGTTGGCAGGAAGATTCTATTTAGTTCAAAGATGTCTCTTAGTTAGGCAAAAAAATTCTAGTTGGTTTAACGC,CGTGACTTTCCATTTTGGTTCCGTGAAGTTGGCAGGAAGATAAGCTTCTATTTAGTTCAAAGATGTCTCTTAGTTAGGCAAAAAAATTCTAGTTGGTTT,10,30,14,27,27,44,27,49,27,41,41,44,46,49,16.04,0.0
hek293t,11281,1,13,GTGTACACAGCCTAATTTTGACTTTTTATAGGGTCCTGCTGGGAAGAATGGTGATGTTGGACTCCAAAAAAATTCTAGTTGGTTTAACGCGTAACTAGA,GTGTACACAGCCTAATTTTGACTTTTTATAGGGTCCTCTGAGCTCAACATGCTGGGAAGAATGGTGATGTTGGACTCCAAAAAAATTCTAGTTGGTTTA,10,30,14,27,27,45,27,58,27,38,38,45,51,58,0.29,0.167673707
hek293t,11286,1,1,GAGCTTGTCACCGGAAGACGTGCATTGTCAGGTTTTATTTCATCATGCACCAAAACCATGAGGCAATTATTCATGTTTAAAAAAAATTCTAGTTGGTTT,GAGCTTGTCACCGGAAGACGTGCATTGTTCAGGTTTTATTTCATCATGCACCAAAACCATGAGGCAATTATTCATGTTTAAAAAAAATTCTAGTTGGTT,10,30,14,27,27,43,27,44,27,28,28,43,29,44,29.66,66.75020292
hek293t,11286,1,1,TTGTATGTCACCGGAAGACGTGCATTGTCAGGTTTTATTTCATCATGCACCAAAACCATGAGGCAATTATTCATGTTTAATATCTGAACTTAAAAAAAT,TTGTATGTCACCGGAAGACGTGCATTGTTCAGGTTTTATTTCATCATGCACCAAAACCATGAGGCAATTATTCATGTTTAATATCTGAACTTAAAAAAA,10,30,14,27,27,31,27,32,27,28,28,31,29,32,29.66,5.387642975
hek293t,11288,1,4,AGAAGGGTGAGTTTTATGTTGTTTTAGTGTGGGGGACTGGCTCACTGCAGTCAGACAAGCTCTAAAACCAACACAAGGGGAGAAAAAAATTCTAGTTGG,AGAAGGGTGAGTTTTATGTTGTTTTATTTAGTGTGGGGGACTGGCTCACTGCAGTCAGACAAGCTCTAAAACCAACACAAGGGGAGAAAAAAATTCTAG,10,30,14,27,27,37,27,41,27,27,27,37,31,41,10.02,45.4790383
hek293t,11288,1,4,CGGACGGTGAGTTTTATGTTGTTTTAGTGTGGGGGACTGGCTCACTGCAGTCAGACAAGCTCTAAAACCAACACAAGAAAAAAATTCTAGTTGGTTTAA,CGGACGGTGAGTTTTATGTTGTTTTATTTAGTGTGGGGGACTGGCTCACTGCAGTCAGACAAGCTCTAAAACCAACACAAGAAAAAAATTCTAGTTGGT,10,30,14,27,27,42,27,46,27,27,27,42,31,46,10.02,26.09640693
hek293t,11290,1,5,ACATGGTGTATGTGTTTGGATATGATGTTTGGTATAAGGAGGATGTGCTTGAAAATCTTAAATGTTCCAGTAAAATAGTAAAAAAAATTCTAGTTGGTT,ACATGGTGTATGTGTTTGGATATGATGCCAAGTTTGGTATAAGGAGGATGTGCTTGAAAATCTTAAATGTTCCAGTAAAATAGTAAAAAAAATTCTAGT,10,30,14,27,27,38,27,43,27,28,28,38,33,43,38.41,83.63496364
hek293t,11292,1,3,TTCATATATCCACATACCCTAATAAGACCTGGTAACATATGGAGCCAAACAATGTTTCAGAATATGCAAATTCCAACACAAAAAAATTCTAGTTGGTTT,TTCATATATCCACATACCCTAATAAGACCTGGTAACACTCTATGGAGCCAAACAATGTTTCAGAATATGCAAATTCCAACACAAAAAAATTCTAGTTGG,10,30,14,27,27,41,27,44,27,38,38,41,41,44,50.6,0.328183918
hek293t,11294,1,7,GTGAATCTCAGTTCTTTACAGCCTATCTCTGGAGATGCACAGGAATTAACAAGACCTGTATTTATAAAAAAATTCTAGTTGGTTTAACGCGTAACTAGA,GTGAATCTCAGTTCTTTACAGCCTATCTCTGGAGAACACCATTGCACAGGAATTAACAAGACCTGTATTTATAAAAAAATTCTAGTTGGTTTAACGCGT,10,30,14,27,27,51,27,58,27,36,36,51,43,58,26.53,60.9956806
hek293t,11295,1,8,GAGTGCCTTGCCTTTTGGTATAATATATTAGGAGTTAGGGTTTGGGGATTTTGTCTGACGGTGCTCCTGTTTGGAAAAAAATTCTAGTTGGTTTAACGC,GAGTGCCTTGCCTTTTGGTATAATATATTAGGATCCCTCTGGTTAGGGTTTGGGGATTTTGTCTGACGGTGCTCCTGTTTGGAAAAAAATTCTAGTTGG,10,30,14,27,27,41,27,49,27,34,34,41,42,49,3.56,0.779863641
hek293t,11297,1,15,CGGAGATAGATCCCAAAGCCATGATTTTCTGGGAATTTATCTTCTTTTATCTGTGCAGTACAGACCAAAAAAATTCTAGTTGGTTTAACGCGTAACTAG,CGGAGATAGATCCCAAAGCCATGATTTTCTGGGAATTTCTGACCATCGATGCAATCTTCTTTTATCTGTGCAGTACAGACCAAAAAAATTCTAGTTGGT,10,30,14,27,27,42,27,57,27,39,39,42,54,57,0.75,0.0
hek293t,11298,1,2,GAAACTAATACACAATTTGAATGAAATCCAGGCATTCAGAATGTTATTATGAAGGGTTTGGATTGTGCCCATAGATGGAATCCATAAAAAAAATTCTAG,GAAACTAATACACAATTTGAATGAAATTACCAGGCATTCAGAATGTTATTATGAAGGGTTTGGATTGTGCCCATAGATGGAATCCATAAAAAAAATTCT,10,30,14,27,27,35,27,37,27,28,28,35,30,37,32.75,18.06297917
hek293t,11298,1,2,GACCCTAATACACAATTTGAATGAAATCCAGGCATTCAGAATGTTATTATGAAGGGTTTGGATTGTGCCCATAGATGGAAAAAAATTCTAGTTGGTTTA,GACCCTAATACACAATTTGAATGAAATTACCAGGCATTCAGAATGTTATTATGAAGGGTTTGGATTGTGCCCATAGATGGAAAAAAATTCTAGTTGGTT,10,30,14,27,27,43,27,45,27,28,28,43,30,45,32.75,15.99120592
hek293t,11300,1,12,TTAACCCCCCAGTGTTTTACCTGAAACTTTGGTAGCAGTGGTATAACACAAGGAGAAGGCTTCTGAAAAAAATTCTAGTTGGTTTAACGCGTAACTAGA,TTAACCCCCCAGTGTTTTACCTGAAACTTTCAATAAAGAGTCGGTAGCAGTGGTATAACACAAGGAGAAGGCTTCTGAAAAAAATTCTAGTTGGTTTAA,10,30,14,27,27,46,27,58,27,31,31,46,43,58,38.8,5.072963694
hek293t,11302,1,10,CGAGACTTTGGTCTTAAAAATGTGGCTGTTGGCAGCCACGTGTACTCAAATTGTTGTTCTGCATCACAAAAAAAATTCTAGTTGGTTTAACGCGTAACT,CGAGACTTTGGTCTTAAAAATGTGGCTGTGCACTTCTCTTGGCAGCCACGTGTACTCAAATTGTTGTTCTGCATCACAAAAAAAATTCTAGTTGGTTTA,10,30,14,27,27,45,27,55,27,30,30,45,40,55,48.43,1.487543962
hek293t,11302,1,10,AATAACTTTGGTCTTAAAAATGTGGCTGTTGGCAGCCACGTGTACTCAAATTGTTGTTCTGCATCACACAAATAAAAAAATTCTAGTTGGTTTAACGCG,AATAACTTTGGTCTTAAAAATGTGGCTGTGCACTTCTCTTGGCAGCCACGTGTACTCAAATTGTTGTTCTGCATCACACAAATAAAAAAATTCTAGTTG,10,30,14,27,27,40,27,50,27,30,30,40,40,50,48.43,1.735685364
hek293t,11304,1,12,AGTAAAAACTGGGCCCCCCCTATTCTGGGTGGTATGCTCACTCTAATGAAAAGGCAGAGCAGTCTGACCTGAAAAAAATTCTAGTTGGTTTAACGCGTA,AGTAAAAACTGGGCCCCCCCTATTCTGGGTGGTATGGACGTATTACTGCTCACTCTAATGAAAAGGCAGAGCAGTCTGACCTGAAAAAAATTCTAGTTG,10,30,14,27,27,40,27,52,27,37,37,40,49,52,68.44,0.0
hek293t,11305,1,6,ACTGTTATATGTCTTTATACCCCTTCTGTAGGGAGAGAAGATGCCAGCTTTTCCAGTATATGGACACGGAAAGGACAGGAATAAAAGAAAAAAATTCTA,ACTGTTATATGTCTTTATACCCCTTCGGGGACTGTAGGGAGAGAAGATGCCAGCTTTTCCAGTATATGGACACGGAAAGGACAGGAATAAAAGAAAAAA,10,30,14,27,27,30,27,36,27,27,27,30,33,36,36.81,0.513983041
hek293t,11307,1,10,TCGCCTCATGGTGAAACCAGTTGGAAGTGAGGGAAGCCAACCTCAGCGGCCTGATCTAACTTTGAAATTAGCACAAAAAAATTCTAGTTGGTTTAACGC,TCGCCTCATGGTGAAACCAGTTGGAAGTGAGGGAATCCGACTATAGCCAACCTCAGCGGCCTGATCTAACTTTGAAATTAGCACAAAAAAATTCTAGTT,10,30,14,27,27,39,27,49,27,36,36,39,46,49,61.52,3.757514297
hek293t,11307,1,10,TCGGGTCATGGTGAAACCAGTTGGAAGTGAGGGAAGCCAACCTCAGCGGCCTGATCTAACTTTGAAATTAAAAAAAATTCTAGTTGGTTTAACGCGTAA,TCGGGTCATGGTGAAACCAGTTGGAAGTGAGGGAATCCGACTATAGCCAACCTCAGCGGCCTGATCTAACTTTGAAATTAAAAAAAATTCTAGTTGGTT,10,30,14,27,27,43,27,53,27,36,36,43,46,53,61.52,1.954038033
hek293t,11309,1,10,AGTTTCACACAGCCTGCTGCTGAATCCACAGGCATGTTTCACACCACTTTGCCCAGAGGATTTAGGCTGGAAGAGAAAAAAAAAATTCTAGTTGGTTTA,AGTTTCACACAGCCTGCTGCTGAATCCACAGCGGTACATTCGCATGTTTCACACCACTTTGCCCAGAGGATTTAGGCTGGAAGAGAAAAAAAAAATTCT,10,30,14,27,27,35,27,45,27,32,32,35,42,45,57.41,3.330557979
hek293t,11309,1,10,CTTTCCACACAGCCTGCTGCTGAATCCACAGGCATGTTTCACACCACTTTGCCCAGAGGATTTAGGCTGGAAAAAAAATTCTAGTTGGTTTAACGCGTA,CTTTCCACACAGCCTGCTGCTGAATCCACAGCGGTACATTCGCATGTTTCACACCACTTTGCCCAGAGGATTTAGGCTGGAAAAAAAATTCTAGTTGGT,10,30,14,27,27,42,27,52,27,32,32,42,42,52,57.41,16.29900534
hek293t,11311,1,4,TCCTTAGAGAAGGAGGGGAAATCTGGGACAGGTAGGGAGATTTAACAAGTATCAACCTCTTGAACTGAAACCAAGTTCATCTCTAAAAAAATTCTAGTT,TCCTTAGAGAAGGAGGGGAAATCTGGGATAAACAGGTAGGGAGATTTAACAAGTATCAACCTCTTGAACTGAAACCAAGTTCATCTCTAAAAAAATTCT,10,30,14,27,27,35,27,39,27,28,28,35,32,39,51.44,58.35866709
hek293t,11311,1,4,ACGGTAGAGAAGGAGGGGAAATCTGGGACAGGTAGGGAGATTTAACAAGTATCAACCTCTTGAACTGAAACCAAGTAAAAAAATTCTAGTTGGTTTAAC,ACGGTAGAGAAGGAGGGGAAATCTGGGATAAACAGGTAGGGAGATTTAACAAGTATCAACCTCTTGAACTGAAACCAAGTAAAAAAATTCTAGTTGGTT,10,30,14,27,27,43,27,47,27,28,28,43,32,47,51.44,68.59329867
hek293t,11313,1,10,GCGTTGCTCGCCCCAACCAGGGAAGCACCAGGGTATCGGGAGCCGCTCCAGGGCGGCCCAGCGCTTCCCCCCCAAAAAAATTCTAGTTGGTTTAACGCG,GCGTTGCTCGCCCCAACCAGGGAAGCACCAGGAGTCAAATACGTATCGGGAGCCGCTCCAGGGCGGCCCAGCGCTTCCCCCCCAAAAAAATTCTAGTTG,10,30,14,27,27,40,27,50,27,33,33,40,43,50,65.91,13.09929367
hek293t,11315,1,2,TGGAGGATAAGTCTATTAATCATCACTCAAGGACATTTTGAGGTATTGTCATTTTCATCTAGGACTTTTATTCTGATAAACACTTTAAATAAAAAAATT,TGGAGGATAAGTCTATTAATCATCACTGTCAAGGACATTTTGAGGTATTGTCATTTTCATCTAGGACTTTTATTCTGATAAACACTTTAAATAAAAAAA,10,30,14,27,27,31,27,33,27,28,28,31,30,33,32.08,0.177856398
hek293t,11318,1,9,TTGCGATGCCTTAACACAGAGATATTTTTTGGCTGAGTGTTGCTGAAAATTTCTTTCATAGGAAGGAAGGAAAAAAAAAAATTCTAGTTGGTTTAACGC,TTGCGATGCCTTAACACAGAGATATTTTTTGGCTGATTCCACGGTGTGTTGCTGAAAATTTCTTTCATAGGAAGGAAGGAAAAAAAAAAATTCTAGTTG,10,30,14,27,27,40,27,49,27,37,37,40,46,49,5.07,0.0
hek293t,11321,1,14,AGGTGTAAATGAGTTTCTTGAACTCTGCTAGGTTTTAAGATACCATGACAACAAAAGAAAGCACAAAAAAAATTCTAGTTGGTTTAACGCGTAACTAGA,AGGTGTAAATGAGTTTCTTGAACTCTGCCCCAAGGTCAGCCATAGGTTTTAAGATACCATGACAACAAAAGAAAGCACAAAAAAAATTCTAGTTGGTTT,10,30,14,27,27,44,27,58,27,29,29,44,43,58,45.11,3.138716473
hek293t,11321,1,14,ATAGATAAATGAGTTTCTTGAACTCTGCTAGGTTTTAAGATACCATGACAACAAAAGAAAGCACATTGAATAAGCATAAAAAAATTCTAGTTGGTTTAA,ATAGATAAATGAGTTTCTTGAACTCTGCCCCAAGGTCAGCCATAGGTTTTAAGATACCATGACAACAAAAGAAAGCACATTGAATAAGCATAAAAAAAT,10,30,14,27,27,32,27,46,27,29,29,32,43,46,45.11,0.052910053
hek293t,11323,1,11,ACTGGCACTGTGCGCTCTTAAGAAACTGCTGGCAATGTTCTGAAGATTCTGCCTCATGGAAGTGTCATGGACTTTCTTAAAAAAATTCTAGTTGGTTTA,ACTGGCACTGTGCGCTCTTAAGAAACTATGGCCAAGCTGCTGGCAATGTTCTGAAGATTCTGCCTCATGGAAGTGTCATGGACTTTCTTAAAAAAATTC,10,30,14,27,27,34,27,45,27,27,27,34,38,45,50.95,13.24849909
hek293t,11325,1,4,GGGCCCGTAATGTTGTATTGATCTGATGTTGGCACCGAGGAGGTCATTTACAGTCATTTGGGTGACCTAGACATAAAAAAATTCTAGTTGGTTTAACGC,GGGCCCGTAATGTTGTATTGATCTGATGTATATTGGCACCGAGGAGGTCATTTACAGTCATTTGGGTGACCTAGACATAAAAAAATTCTAGTTGGTTTA,10,30,14,27,27,45,27,49,27,30,30,45,34,49,49.79,68.88238453
hek293t,11328,1,5,CAAACACATGCAGTGGTGGCATAACACACTGGAGACTTTTCACCATTGTGTAACAGAGGTAATTATAACACAGTGCACCGGTTAAAAAAAATTCTAGTT,CAAACACATGCAGTGGTGGCATAACACACTTCACAGGAGACTTTTCACCATTGTGTAACAGAGGTAATTATAACACAGTGCACCGGTTAAAAAAAATTC,10,30,14,27,27,34,27,39,27,31,31,34,36,39,71.23,2.982201769
hek293t,11328,1,5,ACGCGACATGCAGTGGTGGCATAACACACTGGAGACTTTTCACCATTGTGTAACAGAGGTAATTATAACACAGTGCAAAAAAAATTCTAGTTGGTTTAA,ACGCGACATGCAGTGGTGGCATAACACACTTCACAGGAGACTTTTCACCATTGTGTAACAGAGGTAATTATAACACAGTGCAAAAAAAATTCTAGTTGG,10,30,14,27,27,41,27,46,27,31,31,41,36,46,71.23,49.24031509
hek293t,11330,1,14,GGTATCACTGGCCAGTTGTGAAGTCTCTTTGGCCCCAGTTAGCCACTGGCAACTGGGGCCTGAGGGCAAAAAAATTCTAGTTGGTTTAACGCGTAACTA,GGTATCACTGGCCAGTTGTGAAGTCTCTTTGGCCGTATAGTTAGCGTTCCAGTTAGCCACTGGCAACTGGGGCCTGAGGGCAAAAAAATTCTAGTTGGT,10,30,14,27,27,42,27,56,27,35,35,42,49,56,16.08,10.48506524
hek293t,11330,1,14,GTGCTCACTGGCCAGTTGTGAAGTCTCTTTGGCCCCAGTTAGCCACTGGCAACTGGGGCCTGAGAAAAAAATTCTAGTTGGTTTAACGCGTAACTAGAT,GTGCTCACTGGCCAGTTGTGAAGTCTCTTTGGCCGTATAGTTAGCGTTCCAGTTAGCCACTGGCAACTGGGGCCTGAGAAAAAAATTCTAGTTGGTTTA,10,30,14,27,27,45,27,59,27,35,35,45,49,59,16.08,16.08955238
hek293t,11332,1,14,TGGGTGTATGGCACTGTTCTATGCCAGCAAGGCAAAGAAAGTGTAAACATGGAGGAAAGCTCACTGAAGTAAAAAAATTCTAGTTGGTTTAACGCGTAA,TGGGTGTATGGCACTGTTCTATGCCAGCCCCCACATCAACCGAAGGCAAAGAAAGTGTAAACATGGAGGAAAGCTCACTGAAGTAAAAAAATTCTAGTT,10,30,14,27,27,39,27,53,27,29,29,39,43,53,45.86,2.424607467
hek293t,11332,1,14,AACAAGTATGGCACTGTTCTATGCCAGCAAGGCAAAGAAAGTGTAAACATGGAGGAAAGCTCACTGAAGTTCAAAACAAAAAAATTCTAGTTGGTTTAA,AACAAGTATGGCACTGTTCTATGCCAGCCCCCACATCAACCGAAGGCAAAGAAAGTGTAAACATGGAGGAAAGCTCACTGAAGTTCAAAACAAAAAAAT,10,30,14,27,27,32,27,46,27,29,29,32,43,46,45.86,0.203252033
hek293t,11334,1,8,GCATATTTCATGGTTTCAAACCGCCCTTAAGGTTGACCTCCTGCCAGGAACACCACCTCACTTCTGAGTGCGGGGACAAAAAAATTCTAGTTGGTTTAA,GCATATTTCATGGTTTCAAACCGCCCTTAATTGCAGGTGGTTGACCTCCTGCCAGGAACACCACCTCACTTCTGAGTGCGGGGACAAAAAAATTCTAGT,10,30,14,27,27,38,27,46,27,31,31,38,39,46,13.84,22.23301554
hek293t,11334,1,8,GCGTATTTCATGGTTTCAAACCGCCCTTAAGGTTGACCTCCTGCCAGGAACACCACCTCACTTCTGAGTGCGGGAAAAAAATTCTAGTTGGTTTAACGC,GCGTATTTCATGGTTTCAAACCGCCCTTAATTGCAGGTGGTTGACCTCCTGCCAGGAACACCACCTCACTTCTGAGTGCGGGAAAAAAATTCTAGTTGG,10,30,14,27,27,41,27,49,27,31,31,41,39,49,13.84,46.65730859
hek293t,11336,1,10,AGGACATGTTCTCTTTGTCTCACTAAAAATGGTTTCCTCTAAAAAATAGGTAAGAGAAGGCCTCAAGGATCTTAAAAAAATTCTAGTTGGTTTAACGCG,AGGACATGTTCTCTTTGTCTCACTAAAAAAATTACGGATTGGTTTCCTCTAAAAAATAGGTAAGAGAAGGCCTCAAGGATCTTAAAAAAATTCTAGTTG,10,30,14,27,27,40,27,50,27,30,30,40,40,50,5.12,0.0
hek293t,11336,1,10,CGGTTATGTTCTCTTTGTCTCACTAAAAATGGTTTCCTCTAAAAAATAGGTAAGAGAAGGCCTCAAGGAAAAAAATTCTAGTTGGTTTAACGCGTAACT,CGGTTATGTTCTCTTTGTCTCACTAAAAAAATTACGGATTGGTTTCCTCTAAAAAATAGGTAAGAGAAGGCCTCAAGGAAAAAAATTCTAGTTGGTTTA,10,30,14,27,27,45,27,55,27,30,30,45,40,55,5.12,0.0
hek293t,11340,1,15,CGTCCTCGAATAAAATAAAAGCCTGAGGGGGGCAGAGATTTGAGTAACAGCTAGAAGAGAGCTGATCGCAGGAAAAAAAATTCTAGTTGGTTTAACGCG,CGTCCTCGAATAAAATAAAAGCCTGAGGATTCGCCGTTCCGGGGGGGCAGAGATTTGAGTAACAGCTAGAAGAGAGCTGATCGCAGGAAAAAAAATTCT,10,30,14,27,27,35,27,50,27,28,28,35,43,50,45.94,1.323959688
hek293t,11342,1,14,ATTTAATATCAAACCGAGAACCCACTCACAGGCAATACGGACACATTTGCCCAGTGAATGAAGTGCAGGACAAAAAAAATTCTAGTTGGTTTAACGCGT,ATTTAATATCAAACCGAGAACCCACTCACCCGAGTATTGTGTCAGGCAATACGGACACATTTGCCCAGTGAATGAAGTGCAGGACAAAAAAAATTCTAG,10,30,14,27,27,37,27,51,27,30,30,37,44,51,61.79,3.930519509
hek293t,11342,1,14,CGGGCATATCAAACCGAGAACCCACTCACAGGCAATACGGACACATTTGCCCAGTGAATGAAGTGCAGGACACTGGAAAAAAATTCTAGTTGGTTTAAC,CGGGCATATCAAACCGAGAACCCACTCACCCGAGTATTGTGTCAGGCAATACGGACACATTTGCCCAGTGAATGAAGTGCAGGACACTGGAAAAAAATT,10,30,14,27,27,33,27,47,27,30,30,33,44,47,61.79,0.449041168
hek293t,11344,1,3,TTTCGCAGTAGATATACAACACCAATGATTGGATGATATCTGTAATCAGATTAAATAATTCCCTCAGCATAAAAAAATTCTAGTTGGTTTAACGCGTAA,TTTCGCAGTAGATATACAACACCAATGATTGGATGATATAAGCTGTAATCAGATTAAATAATTCCCTCAGCATAAAAAAATTCTAGTTGGTTTAACGCG,10,30,14,27,27,50,27,53,27,40,40,50,43,53,60.24,31.791382
hek293t,11344,1,3,CAAACCAGTAGATATACAACACCAATGATTGGATGATATCTGTAATCAGATTAAATAATTCCCTCAAAAAAATTCTAGTTGGTTTAACGCGTAACTAGA,CAAACCAGTAGATATACAACACCAATGATTGGATGATATAAGCTGTAATCAGATTAAATAATTCCCTCAAAAAAATTCTAGTTGGTTTAACGCGTAACT,10,30,14,27,27,55,27,58,27,40,40,55,43,58,60.24,32.76953582
hek293t,11346,1,14,GACGTTCCAGCCCGGGTAAAGTCCCATTGTGGCAATGAACCATAAAATTTTCATTAAAATATGTGCTTGTAAAAAAATTCTAGTTGGTTTAACGCGTAA,GACGTTCCAGCCCGGGTAAAGTCCCATTACGCTGCCAATCCCGTGGCAATGAACCATAAAATTTTCATTAAAATATGTGCTTGTAAAAAAATTCTAGTT,10,30,14,27,27,39,27,53,27,29,29,39,43,53,57.09,25.4103439
hek293t,18393,1,2,TGACCCTCTGTCCGTCCTTGTTGTCTTTGAGGAGACAAGTCAGGAGCAGCTCTTATTTTCCGCAGTGACAAAAAAAATTCTAGTTGGTTTAACGCGTAA,TGACCCTCTGTCCGTCCTTGTTGTCTTTGAGGAGAGTCAAGTCAGGAGCAGCTCTTATTTTCCGCAGTGACAAAAAAAATTCTAGTTGGTTTAACGCGT,10,30,14,27,27,51,27,53,27,36,36,51,38,53,16.42,67.06211804
hek293t,11350,1,12,CCGCTGTAAAGCTGTAAATTTATCCCCAGGGGGACGGGATGGTGTTGTGGCTAAGGCATGGCTAAAGAGGTCTTTGTAGAAAAAAATTCTAGTTGGTTT,CCGCTGTAAAGCTGTAAATTTATCCCCAACGGCGTCGTACGGGGGACGGGATGGTGTTGTGGCTAAGGCATGGCTAAAGAGGTCTTTGTAGAAAAAAAT,10,30,14,27,27,32,27,44,27,29,29,32,41,44,24.91,2.842239349
hek293t,11350,1,12,GGAGAGTAAAGCTGTAAATTTATCCCCAGGGGGACGGGATGGTGTTGTGGCTAAGGCATGGCTAAAGAAAAAAATTCTAGTTGGTTTAACGCGTAACTA,GGAGAGTAAAGCTGTAAATTTATCCCCAACGGCGTCGTACGGGGGACGGGATGGTGTTGTGGCTAAGGCATGGCTAAAGAAAAAAATTCTAGTTGGTTT,10,30,14,27,27,44,27,56,27,29,29,44,41,56,24.91,6.453489623
hek293t,11352,1,14,CCGTCGCTGGCACTGGGTGCAATTTATTTTGGCTGTCCTGCAGTGCAGATCTAGAATGCTCCCTCAAAAAAAATTCTAGTTGGTTTAACGCGTAACTAG,CCGTCGCTGGCACTGGGTGCAATTTATTTTGGGTGTGCCCCCCTGACTGTCCTGCAGTGCAGATCTAGAATGCTCCCTCAAAAAAAATTCTAGTTGGTT,10,30,14,27,27,43,27,57,27,33,33,43,47,57,3.85,2.312348344
hek293t,11355,1,1,GATGGCTATAGAGCACATAGGTACTGAGGAGGTGTTTTTCATCAGATGAAGGGTTGCTTACTCACCCGGTCCAAAAAAATTCTAGTTGGTTTAACGCGT,GATGGCTATAGAGCACATAGGTACTGAGGAGGTGTTTTTGCATCAGATGAAGGGTTGCTTACTCACCCGGTCCAAAAAAATTCTAGTTGGTTTAACGCG,10,30,14,27,27,50,27,51,27,40,40,50,41,51,65.92,56.25462634
hek293t,11355,1,1,GTAGGCTATAGAGCACATAGGTACTGAGGAGGTGTTTTTCATCAGATGAAGGGTTGCTTACTCACCCAAAAAAATTCTAGTTGGTTTAACGCGTAACTA,GTAGGCTATAGAGCACATAGGTACTGAGGAGGTGTTTTTGCATCAGATGAAGGGTTGCTTACTCACCCAAAAAAATTCTAGTTGGTTTAACGCGTAACT,10,30,14,27,27,55,27,56,27,40,40,55,41,56,65.92,26.82773773
hek293t,5112,1,8,CTTCGTTGCAAAGTGTACTTGTGTGAGTGAGGTACATAGTAATTTTTATTAGAAATATTAGGATTAAAAAAATTCTAGTTGGTTTAACGCGTAACTAGA,CTTCGTTGCAAAGTGTACTTGTGTGAGTGAGGTAAACACTAACATAGTAATTTTTATTAGAAATATTAGGATTAAAAAAATTCTAGTTGGTTTAACGCG,10,30,14,27,27,50,27,58,27,35,35,50,43,58,53.51,13.32695004
hek293t,5112,1,8,GTTGCTTGCAAAGTGTACTTGTGTGAGTGAGGTACATAGTAATTTTTATTAGAAATATTAGGATTATATTAAAGGTTAAAAAAATTCTAGTTGGTTTAA,GTTGCTTGCAAAGTGTACTTGTGTGAGTGAGGTAAACACTAACATAGTAATTTTTATTAGAAATATTAGGATTATATTAAAGGTTAAAAAAATTCTAGT,10,30,14,27,27,38,27,46,27,35,35,38,43,46,53.51,0.119474313
hek293t,11359,1,8,TGAGTAAATGTCCTTTTAATAGATGTATGTGGTTTCCTAAAGCTTTAAAAAACCCTCAAACTCAGATTGAGAAAAAAAAAATTCTAGTTGGTTTAACGC,TGAGTAAATGTCCTTTTAATAGATGTATGTACAGAAGCGGTTTCCTAAAGCTTTAAAAAACCCTCAAACTCAGATTGAGAAAAAAAAAATTCTAGTTGG,10,30,14,27,27,41,27,49,27,31,31,41,39,49,32.8,0.85872285
hek293t,11359,1,8,GCTACAAATGTCCTTTTAATAGATGTATGTGGTTTCCTAAAGCTTTAAAAAACCCTCAAACTCAGATTGAGAAAAAGTCATAAAAAAATTCTAGTTGGT,GCTACAAATGTCCTTTTAATAGATGTATGTACAGAAGCGGTTTCCTAAAGCTTTAAAAAACCCTCAAACTCAGATTGAGAAAAAGTCATAAAAAAATTC,10,30,14,27,27,34,27,42,27,31,31,34,39,42,32.8,0.0
hek293t,11361,1,9,AGACATTTTCCCCAGGTAGCATATTTCTGTGGTGAAAAAGGCTTGTTTTTTAATTGAGACCATTTACCTTAAAAAAAAATTCTAGTTGGTTTAACGCGT,AGACATTTTCCCCAGGTAGCATATTTCTGTGCCATGAAGTGTGAAAAAGGCTTGTTTTTTAATTGAGACCATTTACCTTAAAAAAAAATTCTAGTTGGT,10,30,14,27,27,42,27,51,27,32,32,42,41,51,51.26,0.472586761
hek293t,11361,1,9,CATTATTTTCCCCAGGTAGCATATTTCTGTGGTGAAAAAGGCTTGTTTTTTAATTGAGACCATTTACCTTAATATTGGCAAAAAAATTCTAGTTGGTTT,CATTATTTTCCCCAGGTAGCATATTTCTGTGCCATGAAGTGTGAAAAAGGCTTGTTTTTTAATTGAGACCATTTACCTTAATATTGGCAAAAAAATTCT,10,30,14,27,27,35,27,44,27,32,32,35,41,44,51.26,0.0
hek293t,11363,1,4,CGCTTTGGTAAATACTAAAAATATGGACAAGGCAAATCTGTGAAACATCAAACAAAAAAGGTTATGGCATGTAAGCAGACTAAAAAAATTCTAGTTGGT,CGCTTTGGTAAATACTAAAAATATGGACAATGACGGCAAATCTGTGAAACATCAAACAAAAAAGGTTATGGCATGTAAGCAGACTAAAAAAATTCTAGT,10,30,14,27,27,38,27,42,27,31,31,38,35,42,47.93,2.987948098
hek293t,11363,1,4,GGTTATGGTAAATACTAAAAATATGGACAAGGCAAATCTGTGAAACATCAAACAAAAAAGGTTATGGCATGTAAGCAGACTTTGTAAAAAAATTCTAGT,GGTTATGGTAAATACTAAAAATATGGACAATGACGGCAAATCTGTGAAACATCAAACAAAAAAGGTTATGGCATGTAAGCAGACTTTGTAAAAAAATTC,10,30,14,27,27,34,27,38,27,31,31,34,35,38,47.93,0.0
hek293t,11365,1,14,CTTGTAAAGAAAACAATATAGGTATTATTTGGAAGATCATATAGACATGATATCATATATAATCTGCTAAAAAAATTCTAGTTGGTTTAACGCGTAACT,CTTGTAAAGAAAACAATATAGGTATTATTTGGAAGATTAAAGCTATATTCACATATAGACATGATATCATATATAATCTGCTAAAAAAATTCTAGTTGG,10,30,14,27,27,41,27,55,27,38,38,41,52,55,8.94,0.0
hek293t,11366,1,10,GACGCACTGCTACTCAGCAATCAGACCTCTGGGAAGTTATATGCCAGTGACTGAACCCATTTATCTATGAAAAAAAAATTCTAGTTGGTTTAACGCGTA,GACGCACTGCTACTCAGCAATCAGACCTCTGCGTGTACTCCGGAAGTTATATGCCAGTGACTGAACCCATTTATCTATGAAAAAAAAATTCTAGTTGGT,10,30,14,27,27,42,27,52,27,32,32,42,42,52,43.42,10.25801234
hek293t,11366,1,10,CAACGACTGCTACTCAGCAATCAGACCTCTGGGAAGTTATATGCCAGTGACTGAACCCATTTATCTATGAACCTTCCCAAAAAAATTCTAGTTGGTTTA,CAACGACTGCTACTCAGCAATCAGACCTCTGCGTGTACTCCGGAAGTTATATGCCAGTGACTGAACCCATTTATCTATGAACCTTCCCAAAAAAATTCT,10,30,14,27,27,35,27,45,27,32,32,35,42,45,43.42,0.303011691
hek293t,11368,1,12,CCCATGCTCTTGGTTCATTTAGGAATCTATGGAAATGCTTAGAGGTCTCATTTATTTACTTAATGCATTAAAAAAATTCTAGTTGGTTTAACGCGTAAC,CCCATGCTCTTGGTTCATTTAGGAATCTATGGAGTGCCGCCGTGAAATGCTTAGAGGTCTCATTTATTTACTTAATGCATTAAAAAAATTCTAGTTGGT,10,30,14,27,27,42,27,54,27,32,32,42,44,54,19.92,2.479626212
hek293t,11368,1,12,CATTAGCTCTTGGTTCATTTAGGAATCTATGGAAATGCTTAGAGGTCTCATTTATTTACTTAATGCATTGAACCTAAAAAAAATTCTAGTTGGTTTAAC,CATTAGCTCTTGGTTCATTTAGGAATCTATGGAGTGCCGCCGTGAAATGCTTAGAGGTCTCATTTATTTACTTAATGCATTGAACCTAAAAAAAATTCT,10,30,14,27,27,35,27,47,27,32,32,35,44,47,19.92,0.0
hek293t,11370,1,5,CAAGACAGACCCCAGCACCCGCCGTCACCAGGCAGCCTGAAAACGTGGCTCACTGCAGGGAGCTGCCCTGGTGGAAACGGCAAAAAAATTCTAGTTGGT,CAAGACAGACCCCAGCACCCGCCGTCACCCAGCTAGGCAGCCTGAAAACGTGGCTCACTGCAGGGAGCTGCCCTGGTGGAAACGGCAAAAAAATTCTAG,10,30,14,27,27,37,27,42,27,30,30,37,35,42,41.07,33.30017704
hek293t,11372,1,14,TAACCCTGCTATAAACCATACTGTTTCTGTGGGATGTGTTTTTAGAGTAGTTCTGAGCAGTTTGCAAAAAAAATTCTAGTTGGTTTAACGCGTAACTAG,TAACCCTGCTATAAACCATACTGTTTCTGTGGGATGTGTGTTTCAACAGAACGTTTTAGAGTAGTTCTGAGCAGTTTGCAAAAAAAATTCTAGTTGGTT,10,30,14,27,27,43,27,57,27,40,40,43,54,57,38.51,0.0
hek293t,11373,1,6,CAGGAGTCTTCCATCAAATCTTTATTTGCAGGAAAGCAGCTTTATGGATACAGCTTCTGCATAGTAAAAAAAAATTCTAGTTGGTTTAACGCGTAACTA,CAGGAGTCTTCCATCAAATCTTTATTTGCAGGAATCACACAGCAGCTTTATGGATACAGCTTCTGCATAGTAAAAAAAAATTCTAGTTGGTTTAACGCG,10,30,14,27,27,50,27,56,27,35,35,50,41,56,5.08,0.359045128
hek293t,11373,1,6,TGTACGTCTTCCATCAAATCTTTATTTGCAGGAAAGCAGCTTTATGGATACAGCTTCTGCATAGTAAAAGCCTTTCATAAAAAAAATTCTAGTTGGTTT,TGTACGTCTTCCATCAAATCTTTATTTGCAGGAATCACACAGCAGCTTTATGGATACAGCTTCTGCATAGTAAAAGCCTTTCATAAAAAAAATTCTAGT,10,30,14,27,27,38,27,44,27,35,35,38,41,44,5.08,0.0
hek293t,11377,1,2,TCAACTAGATTTTCACTTAATCCTTACTCAGGCAAAATTTCCAAGAAATTAAAGCAAGTCAAAGATTTTGAAGATTTAAAAAAATTCTAGTTGGTTTAA,TCAACTAGATTTTCACTTAATCCTTACTCAGGCCAAAAATTTCCAAGAAATTAAAGCAAGTCAAAGATTTTGAAGATTTAAAAAAATTCTAGTTGGTTT,10,30,14,27,27,44,27,46,27,34,34,44,36,46,39.83,2.632757935
hek293t,11379,1,12,CGTTGCGCTGGTGTCCGCAGATGCAGAGATGGTCCTGATCTTACCGTGTAAAACAAGAGTGTGTGCTTTAAAAAAATTCTAGTTGGTTTAACGCGTAAC,CGTTGCGCTGGTGTCCGCAGATGCAGAGATGAGGCCGGGTAGGGTCCTGATCTTACCGTGTAAAACAAGAGTGTGTGCTTTAAAAAAATTCTAGTTGGT,10,30,14,27,27,42,27,54,27,32,32,42,44,54,65.79,17.05997476
hek293t,11379,1,12,TTCATCGCTGGTGTCCGCAGATGCAGAGATGGTCCTGATCTTACCGTGTAAAACAAGAGTGTGTGCTTTTTCAAAAAAATTCTAGTTGGTTTAACGCGT,TTCATCGCTGGTGTCCGCAGATGCAGAGATGAGGCCGGGTAGGGTCCTGATCTTACCGTGTAAAACAAGAGTGTGTGCTTTTTCAAAAAAATTCTAGTT,10,30,14,27,27,39,27,51,27,32,32,39,44,51,65.79,4.925477066
hek293t,11381,1,1,ATCGGAATTCCAACAAGAGGCACTCTCAGGGGAGCACAAGACAAGAGACTCTGCCACAGTTGTAGCTATAAAGATGACTACAAAAAAATTCTAGTTGGT,ATCGGAATTCCAACAAGAGGCACTCTCAGGCGGAGCACAAGACAAGAGACTCTGCCACAGTTGTAGCTATAAAGATGACTACAAAAAAATTCTAGTTGG,10,30,14,27,27,41,27,42,27,31,31,41,32,42,65.52,75.20851747
hek293t,11383,1,2,GACTGCTGTTGGGCAAGAAGACTATGACAAGGAAAGATACTAGGAAGAGAGAAAAAATGTGTAAGGAGGAGAAAGGAGATAATTATGAAAAAAATTCTA,GACTGCTGTTGGGCAAGAAGACTATGACAAATGGAAAGATACTAGGAAGAGAGAAAAAATGTGTAAGGAGGAGAAAGGAGATAATTATGAAAAAAATTC,10,30,14,27,27,34,27,36,27,31,31,34,33,36,76.77,0.0
hek293t,11383,1,2,TTGCCCTGTTGGGCAAGAAGACTATGACAAGGAAAGATACTAGGAAGAGAGAAAAAATGTGTAAGGAGGAGAAAGGAGATAATAAAAAAATTCTAGTTG,TTGCCCTGTTGGGCAAGAAGACTATGACAAATGGAAAGATACTAGGAAGAGAGAAAAAATGTGTAAGGAGGAGAAAGGAGATAATAAAAAAATTCTAGT,10,30,14,27,27,38,27,40,27,31,31,38,33,40,76.77,9.335556378
hek293t,11387,1,4,GAAATCCCCGAGGCATCTTCTCAGCTACATGGATTATTTGGACTAAAAGCCCTTGACAAGCAATTCTGTTCCAGGATGAAAAAAAAATTCTAGTTGGTT,GAAATCCCCGAGGCATCTTCTCAGCTACATGGAGAGATTATTTGGACTAAAAGCCCTTGACAAGCAATTCTGTTCCAGGATGAAAAAAAAATTCTAGTT,10,30,14,27,27,39,27,43,27,32,32,39,36,43,56.04,5.731582221
hek293t,11389,1,6,TCGGTAATCTCCATTTAGCTGTTAATTTCAGGCAAATCCTGTGCAATTTATTCATAGAAGTAATCCCTCTGCAATTACTGAAAAAAATTCTAGTTGGTT,TCGGTAATCTCCATTTAGCTGTTAATGCAGAGTTCAGGCAAATCCTGTGCAATTTATTCATAGAAGTAATCCCTCTGCAATTACTGAAAAAAATTCTAG,10,30,14,27,27,37,27,43,27,27,27,37,33,43,6.21,31.6028816
hek293t,11391,1,15,AAGACGCAATGAAGTTAAGAAAGATTAAAAGGAATCTTCCTGATCCCCAATTATATACATTTAAATAAAAAAAATTCTAGTTGGTTTAACGCGTAACTA,AAGACGCAATGAAGTTAAGAAAGATTAAAAGGATGCAGAACGAGTACGATCTTCCTGATCCCCAATTATATACATTTAAATAAAAAAAATTCTAGTTGG,10,30,14,27,27,41,27,56,27,34,34,41,49,56,5.52,0.0
hek293t,11392,1,4,GTGGCGACTAGACAAAACAGAGCCCCACGTGGAGCTCCTGGATGCCAGATATCAAGCACTGTTGACAAAAAAAAATTCTAGTTGGTTTAACGCGTAACT,GTGGCGACTAGACAAAACAGAGCCCCACGTGGAGCTCCTGCGAAGATGCCAGATATCAAGCACTGTTGACAAAAAAAAATTCTAGTTGGTTTAACGCGT,10,30,14,27,27,51,27,55,27,41,41,51,45,55,62.87,30.16376407
hek293t,11393,1,10,AGACGCCATTAAAGGCTTCCAGGCACTACTGGGTACCCAAACTTTGAAGGAAGGAATAAGCCTTAAACTAATAGAAAAAAATTCTAGTTGGTTTAACGC,AGACGCCATTAAAGGCTTCCAGGCACTACTGATACAAGCAGGGTACCCAAACTTTGAAGGAAGGAATAAGCCTTAAACTAATAGAAAAAAATTCTAGTT,10,30,14,27,27,39,27,49,27,32,32,39,42,49,30.2,27.25428533
hek293t,11393,1,10,CAGCGCCATTAAAGGCTTCCAGGCACTACTGGGTACCCAAACTTTGAAGGAAGGAATAAGCCTTAAACTAATAGTTTCAAAAAAATTCTAGTTGGTTTA,CAGCGCCATTAAAGGCTTCCAGGCACTACTGATACAAGCAGGGTACCCAAACTTTGAAGGAAGGAATAAGCCTTAAACTAATAGTTTCAAAAAAATTCT,10,30,14,27,27,35,27,45,27,32,32,35,42,45,30.2,0.630720943
hek293t,11395,1,1,CCCATAACTGGGCTGTGCTAAAGTAGCTATGGCCTGGGGCATGCCCCCATTGTGCAGGGCCAGGGAGAGGAGTGGCTAGGGCTGAGCAGGCAAAAAAAA,CCCATAACTGGGCTGTGCTAAAGTAGTCTATGGCCTGGGGCATGCCCCCATTGTGCAGGGCCAGGGAGAGGAGTGGCTAGGGCTGAGCAGGCAAAAAAA,10,30,14,27,27,30,27,31,27,27,27,30,28,31,58.28,1.226731787
hek293t,11395,1,1,TTGAAAACTGGGCTGTGCTAAAGTAGCTATGGCCTGGGGCATGCCCCCATTGTGCAGGGCCAGGGAGAGGAGTGGCTAGGGCTGAGCAAAAAAAATTCT,TTGAAAACTGGGCTGTGCTAAAGTAGTCTATGGCCTGGGGCATGCCCCCATTGTGCAGGGCCAGGGAGAGGAGTGGCTAGGGCTGAGCAAAAAAAATTC,10,30,14,27,27,34,27,35,27,27,27,34,28,35,58.28,71.51990246
hek293t,11397,1,15,GGGTGGTGGTTTTGCTTCTCTTCAAAGCTTGGAAATGGGAGTGGTAGATTATAAATTCTTTGTTAGAAAAAAATTCTAGTTGGTTTAACGCGTAACTAG,GGGTGGTGGTTTTGCTTCTCTTCAAAGCTTGGAAATGATACGCAAGTCGATGGGAGTGGTAGATTATAAATTCTTTGTTAGAAAAAAATTCTAGTTGGT,10,30,14,27,27,42,27,57,27,35,35,42,50,57,19.14,0.0
hek293t,11397,1,15,TCAATGTGGTTTTGCTTCTCTTCAAAGCTTGGAAATGGGAGTGGTAGATTATAAATTCTTTGTTAGGTTCAAAAAAATTCTAGTTGGTTTAACGCGTAA,TCAATGTGGTTTTGCTTCTCTTCAAAGCTTGGAAATGATACGCAAGTCGATGGGAGTGGTAGATTATAAATTCTTTGTTAGGTTCAAAAAAATTCTAGT,10,30,14,27,27,38,27,53,27,35,35,38,50,53,19.14,0.0
hek293t,11399,1,1,AAAAAGCAAGGCTCTGAACTCCTCCTTTGGGGAATCAAAGCCACTTAGTAGTTTGCAGGTTTGGGCCTTTATAAGATTTATTTTTGTAAAAAAAATTCT,AAAAAGCAAGGCTCTGAACTCCTCCTCTTGGGGAATCAAAGCCACTTAGTAGTTTGCAGGTTTGGGCCTTTATAAGATTTATTTTTGTAAAAAAAATTC,10,30,14,27,27,34,27,35,27,27,27,34,28,35,41.0,72.27187332
hek293t,11401,1,13,CTTACTTGACTTGCTTTCCCCCCCCGTAAAGGATTAACAGCAATTGTAAATGTCTCCTGTCATAGGAAAAAAATTCTAGTTGGTTTAACGCGTAACTAG,CTTACTTGACTTGCTTTCCCCCCCCGTACCGTGAATTAAATAAGGATTAACAGCAATTGTAAATGTCTCCTGTCATAGGAAAAAAATTCTAGTTGGTTT,10,30,14,27,27,44,27,57,27,29,29,44,42,57,22.36,4.537705643
hek293t,11401,1,13,ACCAATTGACTTGCTTTCCCCCCCCGTAAAGGATTAACAGCAATTGTAAATGTCTCCTGTCATAGGTTGTTAAAAAAATTCTAGTTGGTTTAACGCGTA,ACCAATTGACTTGCTTTCCCCCCCCGTACCGTGAATTAAATAAGGATTAACAGCAATTGTAAATGTCTCCTGTCATAGGTTGTTAAAAAAATTCTAGTT,10,30,14,27,27,39,27,52,27,29,29,39,42,52,22.36,0.55865561
hek293t,11403,1,2,GTAGCGGGAGAGAATTTAGCTAAAGAAATTGGAACAGGATGTTCATCTTATTTCAGTACTTGTAAAAAAAAATTCTAGTTGGTTTAACGCGTAACTAGA,GTAGCGGGAGAGAATTTAGCTAAAGAAATTGGAACAGGATAAGTTCATCTTATTTCAGTACTTGTAAAAAAAAATTCTAGTTGGTTTAACGCGTAACTA,10,30,14,27,27,56,27,58,27,41,41,56,43,58,13.51,4.45812705
hek293t,11404,1,10,AGTACTCATCTGTGATTTGCTGCAAGTTGAGGACCAAGAAATACAGACATCCTGTAGCAGGGAGCATTTTGAAAAAAAAATTCTAGTTGGTTTAACGCG,AGTACTCATCTGTGATTTGCTGCAAGTTGAGGACCAGAGTTTTACCAGAAATACAGACATCCTGTAGCAGGGAGCATTTTGAAAAAAAAATTCTAGTTG,10,30,14,27,27,40,27,50,27,37,37,40,47,50,26.05,0.029669189
hek293t,11405,1,5,ACAGTAAGTTAGCTGCATTTCTTTTCCATTGGCATTCAGTTTCTACCAATTGTTTCTGCTATCAAAATGTATACAAAAAAATTCTAGTTGGTTTAACGC,ACAGTAAGTTAGCTGCATTTCTTTTCCATTGGCAAGCGATTCAGTTTCTACCAATTGTTTCTGCTATCAAAATGTATACAAAAAAATTCTAGTTGGTTT,10,30,14,27,27,44,27,49,27,34,34,44,39,49,18.15,3.145813239
hek293t,11405,1,5,CCTGTAAGTTAGCTGCATTTCTTTTCCATTGGCATTCAGTTTCTACCAATTGTTTCTGCTATCAAAATGAAAAAAATTCTAGTTGGTTTAACGCGTAAC,CCTGTAAGTTAGCTGCATTTCTTTTCCATTGGCAAGCGATTCAGTTTCTACCAATTGTTTCTGCTATCAAAATGAAAAAAATTCTAGTTGGTTTAACGC,10,30,14,27,27,49,27,54,27,34,34,49,39,54,18.15,4.651273539
hek293t,11407,1,8,GCATCCATCCAAGTCATGGAATAATCAGCAGGTTTAACAAAGCCTATTTCTTCTACTCAGCCTTTAAAAAAATTCTAGTTGGTTTAACGCGTAACTAGA,GCATCCATCCAAGTCATGGAATAATCAGCAGGTTTAACACCCTTCGTAAGCCTATTTCTTCTACTCAGCCTTTAAAAAAATTCTAGTTGGTTTAACGCG,10,30,14,27,27,50,27,58,27,40,40,50,48,58,40.92,0.527176527
hek293t,11407,1,8,CGAAGCATCCAAGTCATGGAATAATCAGCAGGTTTAACAAAGCCTATTTCTTCTACTCAGCCTTTCAGAAAAAAATTCTAGTTGGTTTAACGCGTAACT,CGAAGCATCCAAGTCATGGAATAATCAGCAGGTTTAACACCCTTCGTAAGCCTATTTCTTCTACTCAGCCTTTCAGAAAAAAATTCTAGTTGGTTTAAC,10,30,14,27,27,47,27,55,27,40,40,47,48,55,40.92,0.8207518
hek293t,11413,1,2,ACTACAGACTCCTCGTAAGTGTAATTCCCTGGCATCCAGCAGCATAATGTTGGGTCAGCGTTTGCATAAAATGTATGAAAAAAATTCTAGTTGGTTTAA,ACTACAGACTCCTCGTAAGTGTAATTCCCTGGCTAATCCAGCAGCATAATGTTGGGTCAGCGTTTGCATAAAATGTATGAAAAAAATTCTAGTTGGTTT,10,30,14,27,27,44,27,46,27,34,34,44,36,46,52.55,73.37124789
hek293t,11413,1,2,ATGTAAGACTCCTCGTAAGTGTAATTCCCTGGCATCCAGCAGCATAATGTTGGGTCAGCGTTTGCATAAAATAAAAAAATTCTAGTTGGTTTAACGCGT,ATGTAAGACTCCTCGTAAGTGTAATTCCCTGGCTAATCCAGCAGCATAATGTTGGGTCAGCGTTTGCATAAAATAAAAAAATTCTAGTTGGTTTAACGC,10,30,14,27,27,49,27,51,27,34,34,49,36,51,52.55,40.80533588
hek293t,11415,1,4,AAATACAGTGAAAGGAAACATGTTTGGTTTGGAGAATCTATGAATGGAGGCTTCCAGGTAAGAGCTCTACTACCACAATAAGAAAAAAATTCTAGTTGG,AAATACAGTGAAAGGAAACATGTTTGGTTCCGTTGGAGAATCTATGAATGGAGGCTTCCAGGTAAGAGCTCTACTACCACAATAAGAAAAAAATTCTAG,10,30,14,27,27,37,27,41,27,30,30,37,34,41,45.15,55.80756796
hek293t,11415,1,4,GGGACCAGTGAAAGGAAACATGTTTGGTTTGGAGAATCTATGAATGGAGGCTTCCAGGTAAGAGCTCTACTACCACAATAAGCAGCAAAAAAATTCTAG,GGGACCAGTGAAAGGAAACATGTTTGGTTCCGTTGGAGAATCTATGAATGGAGGCTTCCAGGTAAGAGCTCTACTACCACAATAAGCAGCAAAAAAATT,10,30,14,27,27,33,27,37,27,30,30,33,34,37,45.15,1.479181127
hek293t,11417,1,5,TAGCGAGCAAAAGTGAGTTTTAGAAATAAAGGGACTATAATGATTGTGCTAAAAATTGATATTAATAGGAAGTCGCATTAAAAAAATTCTAGTTGGTTT,TAGCGAGCAAAAGTGAGTTTTAGAAATAAAGGGCCGGGACTATAATGATTGTGCTAAAAATTGATATTAATAGGAAGTCGCATTAAAAAAATTCTAGTT,10,30,14,27,27,39,27,44,27,32,32,39,37,44,10.47,0.405377995
hek293t,11419,1,5,CTTGCTCTAAGTTAGGATTCCTGGCCCTCAGGCAGGTTGTGGTCTGACTGATACATAAGCATTTATGTCGTTCTAAAAAAATTCTAGTTGGTTTAACGC,CTTGCTCTAAGTTAGGATTCCTGGCCCTCAGGCACTGTAGGTTGTGGTCTGACTGATACATAAGCATTTATGTCGTTCTAAAAAAATTCTAGTTGGTTT,10,30,14,27,27,44,27,49,27,34,34,44,39,49,47.83,77.00051329
hek293t,11419,1,5,GCCCCTCTAAGTTAGGATTCCTGGCCCTCAGGCAGGTTGTGGTCTGACTGATACATAAGCATTTATGTCAAAAAAATTCTAGTTGGTTTAACGCGTAAC,GCCCCTCTAAGTTAGGATTCCTGGCCCTCAGGCACTGTAGGTTGTGGTCTGACTGATACATAAGCATTTATGTCAAAAAAATTCTAGTTGGTTTAACGC,10,30,14,27,27,49,27,54,27,34,34,49,39,54,47.83,72.48120584
hek293t,11421,1,9,TCCTCGGCCAGGTATGCATCTCTGTGGAAAGGATGCCTGACACTTTACACAGGACGAGGAGGCGAGCTGCAAAAAAATTCTAGTTGGTTTAACGCGTAA,TCCTCGGCCAGGTATGCATCTCTGTGGAAAGGATGCCTGATGAGTGATTCACTTTACACAGGACGAGGAGGCGAGCTGCAAAAAAATTCTAGTTGGTTT,10,30,14,27,27,44,27,53,27,41,41,44,50,53,55.38,0.0
hek293t,11422,1,5,AAACCAGTGTGGCCTGTAATTAGGATATGAGGCACACAGAGTTGGAAAGTTGATGGCAAAGCATTACAGCTATGCAGTGGATAAAAAAATTCTAGTTGG,AAACCAGTGTGGCCTGTAATTAGGATATGAGGGATAGCACACAGAGTTGGAAAGTTGATGGCAAAGCATTACAGCTATGCAGTGGATAAAAAAATTCTA,10,30,14,27,27,36,27,41,27,33,33,36,38,41,53.24,0.769588903
hek293t,11422,1,5,ATCTGAGTGTGGCCTGTAATTAGGATATGAGGCACACAGAGTTGGAAAGTTGATGGCAAAGCATTACAGCTATGCAAAAAAATTCTAGTTGGTTTAACG,ATCTGAGTGTGGCCTGTAATTAGGATATGAGGGATAGCACACAGAGTTGGAAAGTTGATGGCAAAGCATTACAGCTATGCAAAAAAATTCTAGTTGGTT,10,30,14,27,27,43,27,48,27,33,33,43,38,48,53.24,69.04869302
hek293t,11424,1,7,ATCATTTTTCTAGAAATGTATGTGATCTCAGGGTTTATAGCTGTAATCTTATATTATTAATATAGTCTCACTTATACTCAAGCCAAAAAAAAATTCTAG,ATCATTTTTCTAGAAATGTATGTGATGTTTCATCTCAGGGTTTATAGCTGTAATCTTATATTATTAATATAGTCTCACTTATACTCAAGCCAAAAAAAA,10,30,14,27,27,30,27,37,27,27,27,30,34,37,24.62,0.0
hek293t,11426,1,8,TCCGCAGCAAGGTACTGAACCCCCCCCATAGGTGAAGCACTATCATTGAGACCAGTAGGACTAACAAAAAAATTCTAGTTGGTTTAACGCGTAACTAGA,TCCGCAGCAAGGTACTGAACCCCCCCCATAGGTGAAGCATTTAGTGTCTATCATTGAGACCAGTAGGACTAACAAAAAAATTCTAGTTGGTTTAACGCG,10,30,14,27,27,50,27,58,27,40,40,50,48,58,32.56,4.14961551
hek293t,11426,1,8,GCAGGAGCAAGGTACTGAACCCCCCCCATAGGTGAAGCACTATCATTGAGACCAGTAGGACTAACGTGAATTAAAAAAATTCTAGTTGGTTTAACGCGT,GCAGGAGCAAGGTACTGAACCCCCCCCATAGGTGAAGCATTTAGTGTCTATCATTGAGACCAGTAGGACTAACGTGAATTAAAAAAATTCTAGTTGGTT,10,30,14,27,27,43,27,51,27,40,40,43,48,51,32.56,0.585949906
hek293t,11428,1,11,ACGTCGCTTGACTGTTTAAATATTTGCACAGGTAGAGCTTGTACTTTAACAGCAGTAATTAGTAAAAAAAAATTCTAGTTGGTTTAACGCGTAACTAGA,ACGTCGCTTGACTGTTTAAATATTTGCACAGGTAGATATTAGGGACTGCTTGTACTTTAACAGCAGTAATTAGTAAAAAAAAATTCTAGTTGGTTTAAC,10,30,14,27,27,47,27,58,27,37,37,47,48,58,25.66,0.128205128
hek293t,17656,1,2,ATACATTAAATTTATAACCACATTAAAGGAGGAATTCAAGGCTAGCTTCTACCTTCTGTTTATCATCATTGACAAAAAAAAAAAATTCTAGTTGGTTTA,ATACATTAAATTTATAACCACATTAAAGGAGGAATTCAATTGGCTAGCTTCTACCTTCTGTTTATCATCATTGACAAAAAAAAAAAATTCTAGTTGGTT,10,30,14,27,27,43,27,45,27,40,40,43,42,45,35.78,0.0
hek293t,11431,1,15,ATATCTGCCATTGAAACCAGTGCTGTGGCTGGGGAGAATAAAAGATCCACCATCTCATTTTCAAGCCAAGTGCAAAAAAAAATTCTAGTTGGTTTAACG,ATATCTGCCATTGAAACCAGTGCTGTGGCCCCAGAAGGAGCTTCTGGGGAGAATAAAAGATCCACCATCTCATTTTCAAGCCAAGTGCAAAAAAAAATT,10,30,14,27,27,33,27,48,27,30,30,33,45,48,49.06,0.121432908
hek293t,11431,1,15,AATCCTGCCATTGAAACCAGTGCTGTGGCTGGGGAGAATAAAAGATCCACCATCTCATTTTCAAGCCAAGTAAAAAAATTCTAGTTGGTTTAACGCGTA,AATCCTGCCATTGAAACCAGTGCTGTGGCCCCAGAAGGAGCTTCTGGGGAGAATAAAAGATCCACCATCTCATTTTCAAGCCAAGTAAAAAAATTCTAG,10,30,14,27,27,37,27,52,27,30,30,37,45,52,49.06,0.995069423
hek293t,11433,1,12,ATGAGTGGGCGTTGGATTGTGTCATTCGTAGGAGGTGAACGTCAAAGGAAGTGGGATCAACTGTTGAAAAAAATTCTAGTTGGTTTAACGCGTAACTAG,ATGAGTGGGCGTTGGATTGTGTCATTCGTAGGAGTAGCATGTTGCAGTGAACGTCAAAGGAAGTGGGATCAACTGTTGAAAAAAATTCTAGTTGGTTTA,10,30,14,27,27,45,27,57,27,35,35,45,47,57,30.6,5.757925727
hek293t,11433,1,12,TGTTTTGGGCGTTGGATTGTGTCATTCGTAGGAGGTGAACGTCAAAGGAAGTGGGATCAACTGTTGGAGGAGAAAAAAAATTCTAGTTGGTTTAACGCG,TGTTTTGGGCGTTGGATTGTGTCATTCGTAGGAGTAGCATGTTGCAGTGAACGTCAAAGGAAGTGGGATCAACTGTTGGAGGAGAAAAAAAATTCTAGT,10,30,14,27,27,38,27,50,27,35,35,38,47,50,30.6,0.0
hek293t,11435,1,1,ATAAGCCCCACTCTGAAATATGCATTCAAAGGTTACGCCTGCAATCGCCTAGGCACAGCTGCCTATTACCCGTGCCCTTGGATGGCCCCCAAAAAAATT,ATAAGCCCCACTCTGAAATATGCATTCAGAAGGTTACGCCTGCAATCGCCTAGGCACAGCTGCCTATTACCCGTGCCCTTGGATGGCCCCCAAAAAAAT,10,30,14,27,27,32,27,33,27,29,29,32,30,33,32.86,17.81766465
hek293t,11435,1,1,GCAAACCCCACTCTGAAATATGCATTCAAAGGTTACGCCTGCAATCGCCTAGGCACAGCTGCCTATTACCCGTGCCCTTGGATAAAAAAATTCTAGTTG,GCAAACCCCACTCTGAAATATGCATTCAGAAGGTTACGCCTGCAATCGCCTAGGCACAGCTGCCTATTACCCGTGCCCTTGGATAAAAAAATTCTAGTT,10,30,14,27,27,39,27,40,27,29,29,39,30,40,32.86,43.87074267
hek293t,3550,1,13,TGCACCTGTGGGATGAAATTTGGCATCAAAGGCCCTGGCATATAGTACTCTTAAAATGACACCAGTGCAGAAGAAAAAAAATTCTAGTTGGTTTAACGC,TGCACCTGTGGGATGAAATTTGGCATCAAAGGGCGAGCTGACGGTCCCTGGCATATAGTACTCTTAAAATGACACCAGTGCAGAAGAAAAAAAATTCTA,10,30,14,27,27,36,27,49,27,33,33,36,46,49,27.28,0.0
hek293t,3550,1,13,ACGACCTGTGGGATGAAATTTGGCATCAAAGGCCCTGGCATATAGTACTCTTAAAATGACACCAGTGAAAAAAATTCTAGTTGGTTTAACGCGTAACTA,ACGACCTGTGGGATGAAATTTGGCATCAAAGGGCGAGCTGACGGTCCCTGGCATATAGTACTCTTAAAATGACACCAGTGAAAAAAATTCTAGTTGGTT,10,30,14,27,27,43,27,56,27,33,33,43,46,56,27.28,2.527050213
hek293t,11439,1,13,TGGGGGGCAGGTTATTTTCTTGAACATGGAGGGTAACTTCATTGGCATTACATAATTGAGGCATGGGCTGAAAAAAATTCTAGTTGGTTTAACGCGTAA,TGGGGGGCAGGTTATTTTCTTGAACATGGAGGGTAAGGCTAGCTCTTTCCTTCATTGGCATTACATAATTGAGGCATGGGCTGAAAAAAATTCTAGTTG,10,30,14,27,27,40,27,53,27,37,37,40,50,53,40.6,0.733375704
hek293t,11440,1,2,ATCCCAGACAACCACTGCAGAAACAACCGTGGAGATTCAAGATGCAGCTGCCTCTGCCTAACCATGTGTTAGACCCCTCTGGAAAAAAAAATTCTAGTT,ATCCCAGACAACCACTGCAGAAACAACCGTGGACTGATTCAAGATGCAGCTGCCTCTGCCTAACCATGTGTTAGACCCCTCTGGAAAAAAAAATTCTAG,10,30,14,27,27,37,27,39,27,34,34,37,36,39,72.36,6.579042872
hek293t,11440,1,2,ATAGAAGACAACCACTGCAGAAACAACCGTGGAGATTCAAGATGCAGCTGCCTCTGCCTAACCATGTGTTAGACCCCTCTAAAAAAATTCTAGTTGGTT,ATAGAAGACAACCACTGCAGAAACAACCGTGGACTGATTCAAGATGCAGCTGCCTCTGCCTAACCATGTGTTAGACCCCTCTAAAAAAATTCTAGTTGG,10,30,14,27,27,41,27,43,27,34,34,41,36,43,72.36,83.68212372
hek293t,11442,1,2,GGGACGCTTTTGTAGGAGAATGCTGTGGGAGGCATGCAGCATCTTACAGAATTGAGCCCATAAAGTAAAAAAATTCTAGTTGGTTTAACGCGTAACTAG,GGGACGCTTTTGTAGGAGAATGCTGTGGGAGGCATGCAGCGCATCTTACAGAATTGAGCCCATAAAGTAAAAAAATTCTAGTTGGTTTAACGCGTAACT,10,30,14,27,27,55,27,57,27,40,40,55,42,57,59.6,40.17619229
hek293t,11444,1,9,CCTTGTCCAATCTTTGGAATCTTGCTCTCAGGGTCAGATGCTTACTTTAGCCACAGATCACTCTGGTGTTGCAAAAAAATTCTAGTTGGTTTAACGCGT,CCTTGTCCAATCTTTGGAATCTTGCTGCGTTGGTACTCAGGGTCAGATGCTTACTTTAGCCACAGATCACTCTGGTGTTGCAAAAAAATTCTAGTTGGT,10,30,14,27,27,42,27,51,27,27,27,42,36,51,5.69,32.18082332
hek293t,11444,1,9,CAGTCTCCAATCTTTGGAATCTTGCTCTCAGGGTCAGATGCTTACTTTAGCCACAGATCACTCTGGTGTTGCTGGGAAAAAAAATTCTAGTTGGTTTAA,CAGTCTCCAATCTTTGGAATCTTGCTGCGTTGGTACTCAGGGTCAGATGCTTACTTTAGCCACAGATCACTCTGGTGTTGCTGGGAAAAAAAATTCTAG,10,30,14,27,27,37,27,46,27,27,27,37,36,46,5.69,60.24799998
hek293t,11446,1,9,ACTCCCTTTCTCCTACCTGCTTCTGGCTGTGGATAATTTGGCATGCTGAATTCAAAGGGGAACTTCTGCATCTTAAAAAAATTCTAGTTGGTTTAACGC,ACTCCCTTTCTCCTACCTGCTTCTGGCTGTGGAGCCAGTTAATAATTTGGCATGCTGAATTCAAAGGGGAACTTCTGCATCTTAAAAAAATTCTAGTTG,10,30,14,27,27,40,27,49,27,33,33,40,42,49,37.47,0.262467192
hek293t,11446,1,9,AATGCCTTTCTCCTACCTGCTTCTGGCTGTGGATAATTTGGCATGCTGAATTCAAAGGGGAACTTCAAAAAAATTCTAGTTGGTTTAACGCGTAACTAG,AATGCCTTTCTCCTACCTGCTTCTGGCTGTGGAGCCAGTTAATAATTTGGCATGCTGAATTCAAAGGGGAACTTCAAAAAAATTCTAGTTGGTTTAACG,10,30,14,27,27,48,27,57,27,33,33,48,42,57,37.47,4.797835011
hek293t,11448,1,15,TTAGACCACCTGTTAAAAGCCATAGACACAGGGCATGGCAACTAGTCCACTAATCCTCAATGGCTGGTGAAAAAAAAATTCTAGTTGGTTTAACGCGTA,TTAGACCACCTGTTAAAAGCCATAGACACAGGGTTGCTCCATGGGCACCATGGCAACTAGTCCACTAATCCTCAATGGCTGGTGAAAAAAAAATTCTAG,10,30,14,27,27,37,27,52,27,34,34,37,49,52,45.46,0.0
hek293t,11449,1,6,GGTACAGGGGGACTGGGGGTGGCACAGGAAGGCGGGAGTGCTCTGCAAGGTGGGGAGCGCAGAGCATGCAGTTCTGCATGTAAAAAAATTCTAGTTGGT,GGTACAGGGGGACTGGGGGTGGCACAGGTGGTTAAAGGCGGGAGTGCTCTGCAAGGTGGGGAGCGCAGAGCATGCAGTTCTGCATGTAAAAAAATTCTA,10,30,14,27,27,36,27,42,27,29,29,36,35,42,47.83,10.32587408
hek293t,11451,1,3,AGGACTAAATCTGTTTTGTGATATTAGAGTGGTCAATATTCTCAGTACTTACAAGGATTTTTATATGTATGGGAAGGAAAAAAAATTCTAGTTGGTTTA,AGGACTAAATCTGTTTTGTGATATTACGGGAGTGGTCAATATTCTCAGTACTTACAAGGATTTTTATATGTATGGGAAGGAAAAAAAATTCTAGTTGGT,10,30,14,27,27,42,27,45,27,27,27,42,30,45,41.64,51.01685311
hek293t,11451,1,3,TGAGGTAAATCTGTTTTGTGATATTAGAGTGGTCAATATTCTCAGTACTTACAAGGATTTTTATATGTATGGGAAGGAGAGAGAAAAAAATTCTAGTTG,TGAGGTAAATCTGTTTTGTGATATTACGGGAGTGGTCAATATTCTCAGTACTTACAAGGATTTTTATATGTATGGGAAGGAGAGAGAAAAAAATTCTAG,10,30,14,27,27,37,27,40,27,27,27,37,30,40,41.64,78.61876497
hek293t,11453,1,2,TGGCAGATGGGGGATTGCTCATAACCAAGAGGCAATGTAATGCTGTTTGAGACTGTATATAATCAAAGCCAAAAAAATTCTAGTTGGTTTAACGCGTAA,TGGCAGATGGGGGATTGCTCATAACCAAGAGGCAAGGTGTAATGCTGTTTGAGACTGTATATAATCAAAGCCAAAAAAATTCTAGTTGGTTTAACGCGT,10,30,14,27,27,51,27,53,27,36,36,51,38,53,63.41,76.3748019
hek293t,11453,1,2,CCTATGATGGGGGATTGCTCATAACCAAGAGGCAATGTAATGCTGTTTGAGACTGTATATAATCAAAGCCATATACAAAAAGAAAAAAATTCTAGTTGG,CCTATGATGGGGGATTGCTCATAACCAAGAGGCAAGGTGTAATGCTGTTTGAGACTGTATATAATCAAAGCCATATACAAAAAGAAAAAAATTCTAGTT,10,30,14,27,27,39,27,41,27,36,36,39,38,41,63.41,2.269022415
hek293t,11455,1,5,GATTGTATATAGAGACATATACATTTCCTTGGGATCCTTCTATGTCACTTATTTAGCCTTTAAATAAAAGAAGTTCTAAAAAAATTCTAGTTGGTTTAA,GATTGTATATAGAGACATATACATTTCCTTGGGATCCGACCCTTCTATGTCACTTATTTAGCCTTTAAATAAAAGAAGTTCTAAAAAAATTCTAGTTGG,10,30,14,27,27,41,27,46,27,38,38,41,43,46,41.03,0.0
hek293t,11455,1,5,GCTGGTATATAGAGACATATACATTTCCTTGGGATCCTTCTATGTCACTTATTTAGCCTTTAAATAAAAAAATTCTAGTTGGTTTAACGCGTAACTAGA,GCTGGTATATAGAGACATATACATTTCCTTGGGATCCGACCCTTCTATGTCACTTATTTAGCCTTTAAATAAAAAAATTCTAGTTGGTTTAACGCGTAA,10,30,14,27,27,53,27,58,27,38,38,53,43,58,41.03,4.311605868
hek293t,11457,1,15,CCGCGTTTAGCACAAGATGTTTATTCAGAAGGATGCTTTTCTTTACGTCATCTCTTTTGTGACTTGAAATAATAGAAAAAAATTCTAGTTGGTTTAACG,CCGCGTTTAGCACAAGATGTTTATTCAGATAAAATAAAGAATCAAGGATGCTTTTCTTTACGTCATCTCTTTTGTGACTTGAAATAATAGAAAAAAATT,10,30,14,27,27,33,27,48,27,30,30,33,45,48,14.75,0.0
hek293t,11458,1,13,ACTCCTCAGCTATAAGAATTCCTTTTCTGTGGCTGCGGCTATGACAGCGCTCTCCCCTGGTTATAACGGAAAAAAATTCTAGTTGGTTTAACGCGTAAC,ACTCCTCAGCTATAAGAATTCCTTTTCTGTATGCCGAGACTGTGGCTGCGGCTATGACAGCGCTCTCCCCTGGTTATAACGGAAAAAAATTCTAGTTGG,10,30,14,27,27,41,27,54,27,31,31,41,44,54,58.21,19.40927571
hek293t,11458,1,13,GTGAATCAGCTATAAGAATTCCTTTTCTGTGGCTGCGGCTATGACAGCGCTCTCCCCTGGTTATAACGGGGCCGTCAAAAAAATTCTAGTTGGTTTAAC,GTGAATCAGCTATAAGAATTCCTTTTCTGTATGCCGAGACTGTGGCTGCGGCTATGACAGCGCTCTCCCCTGGTTATAACGGGGCCGTCAAAAAAATTC,10,30,14,27,27,34,27,47,27,31,31,34,44,47,58.21,3.699132235
hek293t,11460,1,8,CGTCTGTTAGTACTACGCTTTTCACACAAAGGACAAACAAGTCCAGAGGCCAGAGCTTCAACTGGAAATTAAGATGAGAAAAAAATTCTAGTTGGTTTA,CGTCTGTTAGTACTACGCTTTTCACACAACCTGCCTCAGGACAAACAAGTCCAGAGGCCAGAGCTTCAACTGGAAATTAAGATGAGAAAAAAATTCTAG,10,30,14,27,27,37,27,45,27,30,30,37,38,45,37.02,20.7829007
hek293t,11460,1,8,GTCTTGTTAGTACTACGCTTTTCACACAAAGGACAAACAAGTCCAGAGGCCAGAGCTTCAACTGGAAATTAAGATGAGGAAGAAAAAAATTCTAGTTGG,GTCTTGTTAGTACTACGCTTTTCACACAACCTGCCTCAGGACAAACAAGTCCAGAGGCCAGAGCTTCAACTGGAAATTAAGATGAGGAAGAAAAAAATT,10,30,14,27,27,33,27,41,27,30,30,33,38,41,37.02,0.784286528
hek293t,11462,1,1,CATAATCCTTCCCTTCCTTCTAAAGGCTGTGGTTCAAAGACTGGGTCAGACCATCCATTGTGTGCAGGTTCCACTGTGGACAAGCAAAAAAATTCTAGT,CATAATCCTTCCCTTCCTTCTAAAGGCCTGTGGTTCAAAGACTGGGTCAGACCATCCATTGTGTGCAGGTTCCACTGTGGACAAGCAAAAAAATTCTAG,10,30,14,27,27,37,27,38,27,27,27,37,28,38,54.86,70.21698053
hek293t,11464,1,10,TAGATGCATGAAGAGTGTATATGTGCACGGGGATGCTCTGAAAAGCCAAGGTTTTATGTTCATTTGCAATTTGTAAAAAAATTCTAGTTGGTTTAACGC,TAGATGCATGAAGAGTGTATATGTGCACGGGGATGCTTGTTATTGCTCTGAAAAGCCAAGGTTTTATGTTCATTTGCAATTTGTAAAAAAATTCTAGTT,10,30,14,27,27,39,27,49,27,36,36,39,46,49,61.31,5.497722572
hek293t,11464,1,10,CCTGGGCATGAAGAGTGTATATGTGCACGGGGATGCTCTGAAAAGCCAAGGTTTTATGTTCATTTGCAATAAAAAAATTCTAGTTGGTTTAACGCGTAA,CCTGGGCATGAAGAGTGTATATGTGCACGGGGATGCTTGTTATTGCTCTGAAAAGCCAAGGTTTTATGTTCATTTGCAATAAAAAAATTCTAGTTGGTT,10,30,14,27,27,43,27,53,27,36,36,43,46,53,61.31,3.346223988
hek293t,11466,1,7,CCGTCCCCCCAGTTGTACTTTCAGCAGCTTGGACAAAAGTGAGGTCAGGACACCAGCAGATACAAAAAAAAAATTCTAGTTGGTTTAACGCGTAACTAG,CCGTCCCCCCAGTTGTACTTTCAGCAGCTTGGACAAAAGGGGCGAGTGAGGTCAGGACACCAGCAGATACAAAAAAAAAATTCTAGTTGGTTTAACGCG,10,30,14,27,27,50,27,57,27,40,40,50,47,57,39.97,1.891501688
hek293t,11468,1,15,GCCCACCTTGCACCTGCAAACTGACGCCGAGGTCACCCTGGCTTCAAGGACGTGCCTTGTTCCTCTGGAAAAAAAAATTCTAGTTGGTTTAACGCGTAA,GCCCACCTTGCACCTGCAAACTGACGCCGATTATCCACGCACGTAGGTCACCCTGGCTTCAAGGACGTGCCTTGTTCCTCTGGAAAAAAAAATTCTAGT,10,30,14,27,27,38,27,53,27,31,31,38,46,53,65.34,1.303511746
hek293t,11468,1,15,AGCGACCTTGCACCTGCAAACTGACGCCGAGGTCACCCTGGCTTCAAGGACGTGCCTTGTTCCTCTGAAAAAAATTCTAGTTGGTTTAACGCGTAACTA,AGCGACCTTGCACCTGCAAACTGACGCCGATTATCCACGCACGTAGGTCACCCTGGCTTCAAGGACGTGCCTTGTTCCTCTGAAAAAAATTCTAGTTGG,10,30,14,27,27,41,27,56,27,31,31,41,46,56,65.34,18.17906836
hek293t,100,1,1,GTCGAGCTGCTGCTGGGGCTGAGGGGCAGCGGGGAATGGCGCCAGCCTTCCCGTGTCTCTGCCCTGTCTTGCAAAAAAATTCTAGTTGGTTTAACGCGT,GTCGAGCTGCTGCTGGGGCTGAGGGGCAGCGGGGAATGGACGCCAGCCTTCCCGTGTCTCTGCCCTGTCTTGCAAAAAAATTCTAGTTGGTTTAACGCG,10,30,14,27,27,50,27,51,27,40,40,50,41,51,35.89,67.09536785
hek293t,11472,1,12,CCTCCAACAGGTTACCTACCGCTGGACGGAGGTAAGCGGCCGGGAACGCGTGGGGGTCGTGGGAAAAAAAAATTCTAGTTGGTTTAACGCGTAACTAGA,CCTCCAACAGGTTACCTACCGCTGGACGGACGATTGAGAGGCGGTAAGCGGCCGGGAACGCGTGGGGGTCGTGGGAAAAAAAAATTCTAGTTGGTTTAA,10,30,14,27,27,46,27,58,27,31,31,46,43,58,69.86,44.72863502
hek293t,11472,1,12,CGGTGAACAGGTTACCTACCGCTGGACGGAGGTAAGCGGCCGGGAACGCGTGGGGGTCGTGGGAAACGGAAAAAAAATTCTAGTTGGTTTAACGCGTAA,CGGTGAACAGGTTACCTACCGCTGGACGGACGATTGAGAGGCGGTAAGCGGCCGGGAACGCGTGGGGGTCGTGGGAAACGGAAAAAAAATTCTAGTTGG,10,30,14,27,27,41,27,53,27,31,31,41,43,53,69.86,43.79393352
hek293t,11474,1,13,TTTAGCGGTCATCAAACCTATGCTAAAATAGGCCCTGTTCTTCTAGGAAACAAAATACACAGACATCAAAAAAAATTCTAGTTGGTTTAACGCGTAACT,TTTAGCGGTCATCAAACCTATGCTAACATCAAGCAATAAAATAGGCCCTGTTCTTCTAGGAAACAAAATACACAGACATCAAAAAAAATTCTAGTTGGT,10,30,14,27,27,42,27,55,27,27,27,42,40,55,9.33,0.051759834
hek293t,11474,1,13,TCCGACGGTCATCAAACCTATGCTAAAATAGGCCCTGTTCTTCTAGGAAACAAAATACACAGACATCATGGAAAAAAAAATTCTAGTTGGTTTAACGCG,TCCGACGGTCATCAAACCTATGCTAACATCAAGCAATAAAATAGGCCCTGTTCTTCTAGGAAACAAAATACACAGACATCATGGAAAAAAAAATTCTAG,10,30,14,27,27,37,27,50,27,27,27,37,40,50,9.33,0.083979731
hek293t,11476,1,10,CAGTGGACCAGAGATAAAGAAATAACATGAGGTTCAGAGGGTTCAGTGAGATGCAGAGAGTGAAGAAAGTAAAAAAAATTCTAGTTGGTTTAACGCGTA,CAGTGGACCAGAGATAAAGAAATAACATGAGGGTTCCTGCAGTTCAGAGGGTTCAGTGAGATGCAGAGAGTGAAGAAAGTAAAAAAAATTCTAGTTGGT,10,30,14,27,27,42,27,52,27,32,32,42,42,52,62.36,0.140409997
hek293t,11476,1,10,ACCTGGACCAGAGATAAAGAAATAACATGAGGTTCAGAGGGTTCAGTGAGATGCAGAGAGTGAAGAAAGTAGAAAAAAAAATTCTAGTTGGTTTAACGC,ACCTGGACCAGAGATAAAGAAATAACATGAGGGTTCCTGCAGTTCAGAGGGTTCAGTGAGATGCAGAGAGTGAAGAAAGTAGAAAAAAAAATTCTAGTT,10,30,14,27,27,39,27,49,27,32,32,39,42,49,62.36,0.010670081
hek293t,11478,1,3,TGAGGAACCTGATCTCAATTTCTTACATGAGGAATATATAAAGAATTGTGACACAGCATTAAGAGCTCTGTGACAAAAAAATTCTAGTTGGTTTAACGC,TGAGGAACCTGATCTCAATTTCTTACATGAGGAATATAATCTAAAGAATTGTGACACAGCATTAAGAGCTCTGTGACAAAAAAATTCTAGTTGGTTTAA,10,30,14,27,27,46,27,49,27,39,39,46,42,49,33.25,1.955658273
hek293t,11480,1,4,TTGTGTGTTAATCTATGCCTAGTTCAAACTGGCAGGACACAGCAGCGGTAGCAGGTTCACTGCTTTCTAAAAAAAATTCTAGTTGGTTTAACGCGTAAC,TTGTGTGTTAATCTATGCCTAGTTCAAACTGGCAGGACAGATCCAGCAGCGGTAGCAGGTTCACTGCTTTCTAAAAAAAATTCTAGTTGGTTTAACGCG,10,30,14,27,27,50,27,54,27,40,40,50,44,54,26.58,79.94234892
hek293t,11480,1,4,GTAATTGTTAATCTATGCCTAGTTCAAACTGGCAGGACACAGCAGCGGTAGCAGGTTCACTGCTAAAAAAATTCTAGTTGGTTTAACGCGTAACTAGAT,GTAATTGTTAATCTATGCCTAGTTCAAACTGGCAGGACAGATCCAGCAGCGGTAGCAGGTTCACTGCTAAAAAAATTCTAGTTGGTTTAACGCGTAACT,10,30,14,27,27,55,27,59,27,40,40,55,44,59,26.58,78.67096815
hek293t,11484,1,1,TCCAATTCACTTTGTACGATTCCAGGTTTCGGTGCCCAAACCAAGTGTGGGAACTAGGATCTCCTCTTTTTTGCTGTTGGACTTACCTGTAAAAAAATT,TCCAATTCACTTTGTACGATTCCAGGTTTTCGGTGCCCAAACCAAGTGTGGGAACTAGGATCTCCTCTTTTTTGCTGTTGGACTTACCTGTAAAAAAAT,10,30,14,27,27,32,27,33,27,29,29,32,30,33,16.12,9.304311057
hek293t,11486,1,14,GCACCGGTCTAGGGAATTAAAGCAGGATCTGGTGAGCAACAGGTGTCTGGCAAACAACCCTCCCCAAAAAAATTCTAGTTGGTTTAACGCGTAACTAGA,GCACCGGTCTAGGGAATTAAAGCAGGATCTGGTGAGCAACTAAGCACAAGTTGGAGGTGTCTGGCAAACAACCCTCCCCAAAAAAATTCTAGTTGGTTT,10,30,14,27,27,44,27,58,27,41,41,44,55,58,40.82,0.056416025
hek293t,11487,1,5,ATTGTCAGAGAAGTGAGAGAATTGAGCAGTGGCATCCCTCTGAAATATAATATATTGGGGCTCCTTTATGTCTGGAAAAAAATTCTAGTTGGTTTAACG,ATTGTCAGAGAAGTGAGAGAATTGAGCAGTGGAAGGTCATCCCTCTGAAATATAATATATTGGGGCTCCTTTATGTCTGGAAAAAAATTCTAGTTGGTT,10,30,14,27,27,43,27,48,27,33,33,43,38,48,67.02,43.20239431
hek293t,11487,1,5,GAAGACAGAGAAGTGAGAGAATTGAGCAGTGGCATCCCTCTGAAATATAATATATTGGGGCTCCTTTATGTCTGGTAACTTTAAAAAAATTCTAGTTGG,GAAGACAGAGAAGTGAGAGAATTGAGCAGTGGAAGGTCATCCCTCTGAAATATAATATATTGGGGCTCCTTTATGTCTGGTAACTTTAAAAAAATTCTA,10,30,14,27,27,36,27,41,27,33,33,36,38,41,67.02,3.61413515
hek293t,11489,1,8,CGTTATTATAATCTCCAAACTTAAGCAGTAGGAAAATTGTTGGAGGTGAACAAGGAGGTGATTTCAGGCTGGCCAGAGAAGAAAAAAATTCTAGTTGGT,CGTTATTATAATCTCCAAACTTAAGCAGTAACCGTCAGGGAAAATTGTTGGAGGTGAACAAGGAGGTGATTTCAGGCTGGCCAGAGAAGAAAAAAATTC,10,30,14,27,27,34,27,42,27,31,31,34,39,42,37.45,0.0
hek293t,11489,1,8,TACGATTATAATCTCCAAACTTAAGCAGTAGGAAAATTGTTGGAGGTGAACAAGGAGGTGATTTCAGGCAAAAAAATTCTAGTTGGTTTAACGCGTAAC,TACGATTATAATCTCCAAACTTAAGCAGTAACCGTCAGGGAAAATTGTTGGAGGTGAACAAGGAGGTGATTTCAGGCAAAAAAATTCTAGTTGGTTTAA,10,30,14,27,27,46,27,54,27,31,31,46,39,54,37.45,0.740213294
hek293t,11491,1,2,CCCATTCTTAAAGGTTTTTAAGTAAGCAGAGGCAAAAGTGTATATCAGAGAACAGATTTTGTGTACAATCTAAAGAAAAAAATTCTAGTTGGTTTAACG,CCCATTCTTAAAGGTTTTTAAGTAAGCAGATGGGCAAAAGTGTATATCAGAGAACAGATTTTGTGTACAATCTAAAGAAAAAAATTCTAGTTGGTTTAA,10,30,14,27,27,46,27,48,27,31,31,46,33,48,36.47,0.113790617
hek293t,11491,1,2,TGATATCTTAAAGGTTTTTAAGTAAGCAGAGGCAAAAGTGTATATCAGAGAACAGATTTTGTGTACAATCTAAAGGCAGTTTGAAAAAAATTCTAGTTG,TGATATCTTAAAGGTTTTTAAGTAAGCAGATGGGCAAAAGTGTATATCAGAGAACAGATTTTGTGTACAATCTAAAGGCAGTTTGAAAAAAATTCTAGT,10,30,14,27,27,38,27,40,27,31,31,38,33,40,36.47,3.469293166
hek293t,11493,1,12,TCCATGAGAAATGCGCTGCTCCGGGAAGCAGGTCCTGACTTGAACCCAAGTCTACACACTGTAAAACTAAAAAAAATTCTAGTTGGTTTAACGCGTAAC,TCCATGAGAAATGCGCTGCTCCGGGACCAGTAGATAGTAGCAGGTCCTGACTTGAACCCAAGTCTACACACTGTAAAACTAAAAAAAATTCTAGTTGGT,10,30,14,27,27,42,27,54,27,27,27,42,39,54,41.39,31.58457569
hek293t,11493,1,12,TTACTGAGAAATGCGCTGCTCCGGGAAGCAGGTCCTGACTTGAACCCAAGTCTACACACTGTAAAACTAAAGCAGATAAAAAAATTCTAGTTGGTTTAA,TTACTGAGAAATGCGCTGCTCCGGGACCAGTAGATAGTAGCAGGTCCTGACTTGAACCCAAGTCTACACACTGTAAAACTAAAGCAGATAAAAAAATTC,10,30,14,27,27,34,27,46,27,27,27,34,39,46,41.39,11.48102122
hek293t,11495,1,9,TCTCGATGTTTTGCAGTTAAAGAAATTTGAGGCCAAACATAGTGAATTCATCAATAATTAAATTTAGACAAAAAACATTAAAAAAATTCTAGTTGGTTT,TCTCGATGTTTTGCAGTTAAAGAAATTCGTCCATACTGAGGCCAAACATAGTGAATTCATCAATAATTAAATTTAGACAAAAAACATTAAAAAAATTCT,10,30,14,27,27,35,27,44,27,28,28,35,37,44,29.74,0.0
hek293t,11495,1,9,AAATAATGTTTTGCAGTTAAAGAAATTTGAGGCCAAACATAGTGAATTCATCAATAATTAAATTTAGACAAAAAACAAAAAAATTCTAGTTGGTTTAAC,AAATAATGTTTTGCAGTTAAAGAAATTCGTCCATACTGAGGCCAAACATAGTGAATTCATCAATAATTAAATTTAGACAAAAAACAAAAAAATTCTAGT,10,30,14,27,27,38,27,47,27,28,28,38,37,47,29.74,0.311455784
hek293t,11497,1,5,GTTTCAAGCTCGTAACTGTGGTGGGAAGGTGGGATTTCCTACTGCTCCCAACCCAGTAGTTCATGCAATTCACTGAGCAAAAAAATTCTAGTTGGTTTA,GTTTCAAGCTCGTAACTGTGGTGGGAAGGTGGGTCATGATTTCCTACTGCTCCCAACCCAGTAGTTCATGCAATTCACTGAGCAAAAAAATTCTAGTTG,10,30,14,27,27,40,27,45,27,33,33,40,38,45,41.74,20.9569992
hek293t,11497,1,5,AGGACAAGCTCGTAACTGTGGTGGGAAGGTGGGATTTCCTACTGCTCCCAACCCAGTAGTTCATGCAATTCACTGAGCGCCAAAAAAAATTCTAGTTGG,AGGACAAGCTCGTAACTGTGGTGGGAAGGTGGGTCATGATTTCCTACTGCTCCCAACCCAGTAGTTCATGCAATTCACTGAGCGCCAAAAAAAATTCTA,10,30,14,27,27,36,27,41,27,33,33,36,38,41,41.74,0.108225108
hek293t,11500,1,9,ACGATAGCAACCCCCAAGCGCCCCTGCACTGGGATCTCCCTCTTTGCCCCAAACCCCTGAACGCACAGACAAAAAAATTCTAGTTGGTTTAACGCGTAA,ACGATAGCAACCCCCAAGCGCCCCTGCACTGGGTTCGAGTGTATCTCCCTCTTTGCCCCAAACCCCTGAACGCACAGACAAAAAAATTCTAGTTGGTTT,10,30,14,27,27,44,27,53,27,34,34,44,43,53,35.76,5.387571366
hek293t,11502,1,1,AGGATTGAGATTCTGCTTTGCCTGTATAGAGGGAGTAGCCTGAGAAACAGCTTTGCAGGCTAGAAAACAAAACCTAGAAAAAAAAATTCTAGTTGGTTT,AGGATTGAGATTCTGCTTTGCCTGTATAGAGGGAGGTAGCCTGAGAAACAGCTTTGCAGGCTAGAAAACAAAACCTAGAAAAAAAAATTCTAGTTGGTT,10,30,14,27,27,43,27,44,27,36,36,43,37,44,41.88,71.84199596
hek293t,11502,1,1,AGCAGTGAGATTCTGCTTTGCCTGTATAGAGGGAGTAGCCTGAGAAACAGCTTTGCAGGCTAGAAAACAAAACCTAAAAAAAATTCTAGTTGGTTTAAC,AGCAGTGAGATTCTGCTTTGCCTGTATAGAGGGAGGTAGCCTGAGAAACAGCTTTGCAGGCTAGAAAACAAAACCTAAAAAAAATTCTAGTTGGTTTAA,10,30,14,27,27,46,27,47,27,36,36,46,37,47,41.88,78.85110626
hek293t,11504,1,7,TATATATTATGGCCAAAATGAAAAGAAAATGGTCTACTGTACCAACAATAAATCCAGATTCTGACATGAAAAAAATTCTAGTTGGTTTAACGCGTAACT,TATATATTATGGCCAAAATGAAAAGAAAATGGACAGTAGTCTACTGTACCAACAATAAATCCAGATTCTGACATGAAAAAAATTCTAGTTGGTTTAACG,10,30,14,27,27,48,27,55,27,33,33,48,40,55,13.54,0.0
hek293t,11504,1,7,GTCTTATTATGGCCAAAATGAAAAGAAAATGGTCTACTGTACCAACAATAAATCCAGATTCTGACATGTCTTGTTCTGCTAAAAAAATTCTAGTTGGTT,GTCTTATTATGGCCAAAATGAAAAGAAAATGGACAGTAGTCTACTGTACCAACAATAAATCCAGATTCTGACATGTCTTGTTCTGCTAAAAAAATTCTA,10,30,14,27,27,36,27,43,27,33,33,36,40,43,13.54,0.0
hek293t,7467,1,5,TGGATGTCCAGTTACCCTGGCTAGACTGATGGTGTTTGACAAGTCTCGACCAAAGCTTCGTGGTGCTGTTCCGCAAAAAAATTCTAGTTGGTTTAACGC,TGGATGTCCAGTTACCCTGGCTAGACTGATGGTTAATGGTTTGACAAGTCTCGACCAAAGCTTCGTGGTGCTGTTCCGCAAAAAAATTCTAGTTGGTTT,10,30,14,27,27,44,27,49,27,34,34,44,39,49,63.43,25.1277285
hek293t,7467,1,5,TTATAGTCCAGTTACCCTGGCTAGACTGATGGTGTTTGACAAGTCTCGACCAAAGCTTCGTGGTGCTGTTCCGCCTCGAGGAAAAAAATTCTAGTTGGT,TTATAGTCCAGTTACCCTGGCTAGACTGATGGTTAATGGTTTGACAAGTCTCGACCAAAGCTTCGTGGTGCTGTTCCGCCTCGAGGAAAAAAATTCTAG,10,30,14,27,27,37,27,42,27,34,34,37,39,42,63.43,3.683342963
hek293t,11508,1,15,CCATATGTTATATTTTCTGCCTTTGATAGGGGCTTTCCAGAGCTGTCAGCTGAACTGCAGAATTAGAAACCTGAAAAAAATTCTAGTTGGTTTAACGCG,CCATATGTTATATTTTCTGCCTTTGATAGGGAGCCGAATAGGGTGGGCTTTCCAGAGCTGTCAGCTGAACTGCAGAATTAGAAACCTGAAAAAAATTCT,10,30,14,27,27,35,27,50,27,32,32,35,47,50,8.16,1.386108522
hek293t,11509,1,8,TACAGTCCCTAGAAAGATTAAAGGAACCATGGTGTGCTCCAGAGCACCTTGTTACCTCTACCACACGTTAGGGTGACTGTAGAAAAAAATTCTAGTTGG,TACAGTCCCTAGAAAGATTAAAGGAACCACGCTGTCATGGTGTGCTCCAGAGCACCTTGTTACCTCTACCACACGTTAGGGTGACTGTAGAAAAAAATT,10,30,14,27,27,33,27,41,27,30,30,33,38,41,64.3,0.0
hek293t,11511,1,13,GGTCTCTTGAGTGGTCCCTAACCACCAAATGGTTTGACATTTATACTGTAAAGTAGGAAGAAATCAAAAAAATTCTAGTTGGTTTAACGCGTAACTAGA,GGTCTCTTGAGTGGTCCCTAACCACCAAATGGTTTGAATGTGCCACCCCGCATTTATACTGTAAAGTAGGAAGAAATCAAAAAAATTCTAGTTGGTTTA,10,30,14,27,27,45,27,58,27,38,38,45,51,58,34.76,0.397575277
hek293t,11511,1,13,TCAATCTTGAGTGGTCCCTAACCACCAAATGGTTTGACATTTATACTGTAAAGTAGGAAGAAATCCCAGAAAAAAATTCTAGTTGGTTTAACGCGTAAC,TCAATCTTGAGTGGTCCCTAACCACCAAATGGTTTGAATGTGCCACCCCGCATTTATACTGTAAAGTAGGAAGAAATCCCAGAAAAAAATTCTAGTTGG,10,30,14,27,27,41,27,54,27,38,38,41,51,54,34.76,0.0
hek293t,11513,1,4,ACGGCTTTATCAGTGATATGATAAAAGACAGGAAAGAACATAGATTCTCTTCTTCATTTTCCAAATAAAGTAAACAGTCATTGTTAAAAAAATTCTAGT,ACGGCTTTATCAGTGATATGATAAAATATCGACAGGAAAGAACATAGATTCTCTTCTTCATTTTCCAAATAAAGTAAACAGTCATTGTTAAAAAAATTC,10,30,14,27,27,34,27,38,27,27,27,34,31,38,51.52,2.016093599
hek293t,11513,1,4,TACGGTTTATCAGTGATATGATAAAAGACAGGAAAGAACATAGATTCTCTTCTTCATTTTCCAAATAAAGTAAACAGAAAAAAATTCTAGTTGGTTTAA,TACGGTTTATCAGTGATATGATAAAATATCGACAGGAAAGAACATAGATTCTCTTCTTCATTTTCCAAATAAAGTAAACAGAAAAAAATTCTAGTTGGT,10,30,14,27,27,42,27,46,27,27,27,42,31,46,51.52,1.273479029
hek293t,11515,1,6,TTGAGGCCTAATGCCTCCCAAAACATAGCAGGATCCACCATCTGTTTATTAATGCTTGCCACATCTTGTTCCACTGCTCAAAAAAATTCTAGTTGGTTT,TTGAGGCCTAATGCCTCCCAAAACATAGCATATGATGGATCCACCATCTGTTTATTAATGCTTGCCACATCTTGTTCCACTGCTCAAAAAAATTCTAGT,10,30,14,27,27,38,27,44,27,31,31,38,37,44,32.61,23.3508557
hek293t,11515,1,6,CCTGCGCCTAATGCCTCCCAAAACATAGCAGGATCCACCATCTGTTTATTAATGCTTGCCACATCTTGTTCAAAAAAATTCTAGTTGGTTTAACGCGTA,CCTGCGCCTAATGCCTCCCAAAACATAGCATATGATGGATCCACCATCTGTTTATTAATGCTTGCCACATCTTGTTCAAAAAAATTCTAGTTGGTTTAA,10,30,14,27,27,46,27,52,27,31,31,46,37,52,32.61,26.69455691
hek293t,11517,1,14,GTGTGGGTAAAGCAGCACCTGTGATAAAGAGGAAAAGTAGCATAATTACTATAAAATTAGTTTGCTAAAAAAATTCTAGTTGGTTTAACGCGTAACTAG,GTGTGGGTAAAGCAGCACCTGTGATAAAAAGAGATGGGGAGAGAGGAAAAGTAGCATAATTACTATAAAATTAGTTTGCTAAAAAAATTCTAGTTGGTT,10,30,14,27,27,43,27,57,27,28,28,43,42,57,43.17,0.533807829
hek293t,11517,1,14,TCTGCGGTAAAGCAGCACCTGTGATAAAGAGGAAAAGTAGCATAATTACTATAAAATTAGTTTGCTTCACTGCAAAAAAAATTCTAGTTGGTTTAACGC,TCTGCGGTAAAGCAGCACCTGTGATAAAAAGAGATGGGGAGAGAGGAAAAGTAGCATAATTACTATAAAATTAGTTTGCTTCACTGCAAAAAAAATTCT,10,30,14,27,27,35,27,49,27,28,28,35,42,49,43.17,0.0
hek293t,11519,1,12,CGGTGAGCTGATAGGTCTTTTAGCTCTCTTGGTGAAGCCCATGTTGTAACTGCACATAATTCTCTTTCCAAAAAAATTCTAGTTGGTTTAACGCGTAAC,CGGTGAGCTGATAGGTCTTTTAGCTCTCTTGGTGATCTGATTATGTAAGCCCATGTTGTAACTGCACATAATTCTCTTTCCAAAAAAATTCTAGTTGGT,10,30,14,27,27,42,27,54,27,35,35,42,47,54,20.73,0.338243027
hek293t,11519,1,12,CCTCCAGCTGATAGGTCTTTTAGCTCTCTTGGTGAAGCCCATGTTGTAACTGCACATAATTCTCTTAAAAAAATTCTAGTTGGTTTAACGCGTAACTAG,CCTCCAGCTGATAGGTCTTTTAGCTCTCTTGGTGATCTGATTATGTAAGCCCATGTTGTAACTGCACATAATTCTCTTAAAAAAATTCTAGTTGGTTTA,10,30,14,27,27,45,27,57,27,35,35,45,47,57,20.73,2.766284827
hek293t,11521,1,4,GAAGAACCTAGCTGACAGTGTAGGTAAACTGGGCAGAACACTCCCAGCATGGAATATTTTAGCAAAACTGTGCTTTCAAAAAAATTCTAGTTGGTTTAA,GAAGAACCTAGCTGACAGTGTAGGTACCAAAACTGGGCAGAACACTCCCAGCATGGAATATTTTAGCAAAACTGTGCTTTCAAAAAAATTCTAGTTGGT,10,30,14,27,27,42,27,46,27,27,27,42,31,46,18.06,51.75470734
hek293t,11523,1,4,TACCAAATGAAAGATGTCTCCTTTTTGTATGGATTATGGAAGAATATTTGTGATACTGTGGTTAAGAGCCTGCAAGAACTTAAAAAAATTCTAGTTGGT,TACCAAATGAAAGATGTCTCCTTTTTGTATATCGGGATTATGGAAGAATATTTGTGATACTGTGGTTAAGAGCCTGCAAGAACTTAAAAAAATTCTAGT,10,30,14,27,27,38,27,42,27,31,31,38,35,42,11.39,19.14978297
hek293t,11523,1,4,ACAAGAATGAAAGATGTCTCCTTTTTGTATGGATTATGGAAGAATATTTGTGATACTGTGGTTAAGAGCCTGCAAAAAAATTCTAGTTGGTTTAACGCG,ACAAGAATGAAAGATGTCTCCTTTTTGTATATCGGGATTATGGAAGAATATTTGTGATACTGTGGTTAAGAGCCTGCAAAAAAATTCTAGTTGGTTTAA,10,30,14,27,27,46,27,50,27,31,31,46,35,50,11.39,19.95919958
hek293t,11525,1,10,CATCGTCTTTTTTAGGAACCGCTTCCTAATGGATAGCTTCACTTACTGCTGTCAAAGCGTTTGGCCAGCATCCCAAAAAAATTCTAGTTGGTTTAACGC,CATCGTCTTTTTTAGGAACCGCTTCCTAATGGATAGCCTGACTTCGCTTCACTTACTGCTGTCAAAGCGTTTGGCCAGCATCCCAAAAAAATTCTAGTT,10,30,14,27,27,39,27,49,27,36,36,39,46,49,9.09,34.13978957
hek293t,11526,1,3,GAAATACAGGTTGCTCCTAGAGAAATGGAAGGCAGAACCTAAGTTTTTATTACATCATGTCTTCATGTGTGATAATACTAAAAAAATTCTAGTTGGTTT,GAAATACAGGTTGCTCCTAGAGAAATGGAACTAGGCAGAACCTAAGTTTTTATTACATCATGTCTTCATGTGTGATAATACTAAAAAAATTCTAGTTGG,10,30,14,27,27,41,27,44,27,31,31,41,34,44,81.5,67.12830395
hek293t,11526,1,3,TAGGCACAGGTTGCTCCTAGAGAAATGGAAGGCAGAACCTAAGTTTTTATTACATCATGTCTTCATGTGTGATAAAAAAAATTCTAGTTGGTTTAACGC,TAGGCACAGGTTGCTCCTAGAGAAATGGAACTAGGCAGAACCTAAGTTTTTATTACATCATGTCTTCATGTGTGATAAAAAAAATTCTAGTTGGTTTAA,10,30,14,27,27,46,27,49,27,31,31,46,34,49,81.5,69.4104959
hek293t,11528,1,14,ATGATACAAACAGAAAGAGGGTCTGTTCTAGGGTGTGAAGAAAGGCCCCCCCGCCTCTGCTTCAATTATAAAAAAATTCTAGTTGGTTTAACGCGTAAC,ATGATACAAACAGAAAGAGGGTCTGTTCTAGGGGAAGAATGTGTTTGTGTGAAGAAAGGCCCCCCCGCCTCTGCTTCAATTATAAAAAAATTCTAGTTG,10,30,14,27,27,40,27,54,27,33,33,40,47,54,34.08,0.429821325
hek293t,11528,1,14,GCCTCACAAACAGAAAGAGGGTCTGTTCTAGGGTGTGAAGAAAGGCCCCCCCGCCTCTGCTTCAATAAAAAAATTCTAGTTGGTTTAACGCGTAACTAG,GCCTCACAAACAGAAAGAGGGTCTGTTCTAGGGGAAGAATGTGTTTGTGTGAAGAAAGGCCCCCCCGCCTCTGCTTCAATAAAAAAATTCTAGTTGGTT,10,30,14,27,27,43,27,57,27,33,33,43,47,57,34.08,0.220825486
hek293t,11530,1,4,GAACGTATGCTATTCAATGACAATTCTTATGGTTGCAACTTTTGAAAAAAGTAACTATGTTCTGAACAAGGGTCCATTCAAAAAAAATTCTAGTTGGTT,GAACGTATGCTATTCAATGACAATTCTTATGTAGCGTTGCAACTTTTGAAAAAAGTAACTATGTTCTGAACAAGGGTCCATTCAAAAAAAATTCTAGTT,10,30,14,27,27,39,27,43,27,32,32,39,36,43,10.49,10.15831782
hek293t,11530,1,4,CCAGGTATGCTATTCAATGACAATTCTTATGGTTGCAACTTTTGAAAAAAGTAACTATGTTCTGAACAAGGGTCCATTCAAAACAAAAAAATTCTAGTT,CCAGGTATGCTATTCAATGACAATTCTTATGTAGCGTTGCAACTTTTGAAAAAAGTAACTATGTTCTGAACAAGGGTCCATTCAAAACAAAAAAATTCT,10,30,14,27,27,35,27,39,27,32,32,35,36,39,10.49,1.355652244
hek293t,11532,1,8,CGAAGCCTACCAGTACCAGGAGACCCAAGTGGAAGGCGAGCTAGGTAACTTGGTACTTGTCACAACTGCAGAAGCCGACCAAAAAAATTCTAGTTGGTT,CGAAGCCTACCAGTACCAGGAGACCCAAGTGCATCTATGGAAGGCGAGCTAGGTAACTTGGTACTTGTCACAACTGCAGAAGCCGACCAAAAAAATTCT,10,30,14,27,27,35,27,43,27,32,32,35,40,43,63.68,5.140562946
hek293t,11534,1,14,CCTCTATTAAGAACTGGTTAGATAATCCTAGGGCTCAGGCATTGATTTAAGCTCAGAATATTTGAAAAAAATTCTAGTTGGTTTAACGCGTAACTAGAT,CCTCTATTAAGAACTGGTTAGATAATCCTAGGGCTCATGATGGCCTATTATGGCATTGATTTAAGCTCAGAATATTTGAAAAAAATTCTAGTTGGTTTA,10,30,14,27,27,45,27,59,27,38,38,45,52,59,62.36,0.0
hek293t,11535,1,3,ATAGGACTGACAGTCACCAAAGAGAGTAGAGGCCTGGCACACTAGCGTGGACTGGGATGGAAGGAAGGGCATGCCCTTACAAAAAAATTCTAGTTGGTT,ATAGGACTGACAGTCACCAAAGAGAGTAGTGCAGGCCTGGCACACTAGCGTGGACTGGGATGGAAGGAAGGGCATGCCCTTACAAAAAAATTCTAGTTG,10,30,14,27,27,40,27,43,27,30,30,40,33,43,61.88,73.71349741
hek293t,11535,1,3,AATAGACTGACAGTCACCAAAGAGAGTAGAGGCCTGGCACACTAGCGTGGACTGGGATGGAAGGAAGGGCATGCCAAAAAAATTCTAGTTGGTTTAACG,AATAGACTGACAGTCACCAAAGAGAGTAGTGCAGGCCTGGCACACTAGCGTGGACTGGGATGGAAGGAAGGGCATGCCAAAAAAATTCTAGTTGGTTTA,10,30,14,27,27,45,27,48,27,30,30,45,33,48,61.88,70.39596971
hek293t,11537,1,7,CTTAGTTGTTGTTTATTCCCTGACAGCACAGGCATCCATATGACTTTTCCCAAGCAACTGATACAGAGGCATCAAAAAAATTCTAGTTGGTTTAACGCG,CTTAGTTGTTGTTTATTCCCTGACAGCACAGGCATTTACTTTCCATATGACTTTTCCCAAGCAACTGATACAGAGGCATCAAAAAAATTCTAGTTGGTT,10,30,14,27,27,43,27,50,27,36,36,43,43,50,50.78,30.30678351
hek293t,11537,1,7,TCTCGTTGTTGTTTATTCCCTGACAGCACAGGCATCCATATGACTTTTCCCAAGCAACTGATACAAAAAAAATTCTAGTTGGTTTAACGCGTAACTAGA,TCTCGTTGTTGTTTATTCCCTGACAGCACAGGCATTTACTTTCCATATGACTTTTCCCAAGCAACTGATACAAAAAAAATTCTAGTTGGTTTAACGCGT,10,30,14,27,27,51,27,58,27,36,36,51,43,58,50.78,45.95637709
hek293t,11539,1,15,CACCTCAGGAAACGACCCAGACAATCCATTGGACCCAGGGCCAATCGATCCGGAACAGGAGCCGGACAAAAAAATTCTAGTTGGTTTAACGCGTAACTA,CACCTCAGGAAACGACCCAGACAATCCATTGGAGCTCTATCCAGTCTGCCCAGGGCCAATCGATCCGGAACAGGAGCCGGACAAAAAAATTCTAGTTGG,10,30,14,27,27,41,27,56,27,34,34,41,49,56,55.41,2.027852028
hek293t,11540,1,4,GACGGTGAAGATTTACTCAACTTTTTCGCTGGCTGTTAATGATAGCTCTTCTTCCTTCAATAAGAAATAATGTAGTTATATATCTAAAAAAAAATTCTA,GACGGTGAAGATTTACTCAACTTTTTCGAGTTCTGGCTGTTAATGATAGCTCTTCTTCCTTCAATAAGAAATAATGTAGTTATATATCTAAAAAAAAAT,10,30,14,27,27,32,27,36,27,29,29,32,33,36,11.49,0.086430424
hek293t,11540,1,4,TAGCGTGAAGATTTACTCAACTTTTTCGCTGGCTGTTAATGATAGCTCTTCTTCCTTCAATAAGAAATAATGTAGTTATATATAAAAAAATTCTAGTTG,TAGCGTGAAGATTTACTCAACTTTTTCGAGTTCTGGCTGTTAATGATAGCTCTTCTTCCTTCAATAAGAAATAATGTAGTTATATATAAAAAAATTCTA,10,30,14,27,27,36,27,40,27,29,29,36,33,40,11.49,0.0
hek293t,11544,1,2,ACTATAAGTTACTCATCTGACACCTTGCATGGATAGTATTTTTCACTTGAAAAGTTCTACATTTGGTTTAAAAAAAAATTCTAGTTGGTTTAACGCGTA,ACTATAAGTTACTCATCTGACACCTTGCATGGATAAAGTATTTTTCACTTGAAAAGTTCTACATTTGGTTTAAAAAAAAATTCTAGTTGGTTTAACGCG,10,30,14,27,27,50,27,52,27,35,35,50,37,52,53.1,12.14358974
hek293t,11544,1,2,CAACGAAGTTACTCATCTGACACCTTGCATGGATAGTATTTTTCACTTGAAAAGTTCTACATTTGGTTTAAAAACTCAATATTAAAAAAATTCTAGTTG,CAACGAAGTTACTCATCTGACACCTTGCATGGATAAAGTATTTTTCACTTGAAAAGTTCTACATTTGGTTTAAAAACTCAATATTAAAAAAATTCTAGT,10,30,14,27,27,38,27,40,27,35,35,38,37,40,53.1,0.0
hek293t,11546,1,12,TAACTCAAATAGGTGGCAGGCTATAAGAGTGGAAGCCTATAGCAATTTCATGTCTTTGCTCGCAGAAAAAAATTCTAGTTGGTTTAACGCGTAACTAGA,TAACTCAAATAGGTGGCAGGCTATAAGAGTGGAAGCCTTTCCCAGCCAAAATAGCAATTTCATGTCTTTGCTCGCAGAAAAAAATTCTAGTTGGTTTAA,10,30,14,27,27,46,27,58,27,39,39,46,51,58,73.91,0.0
hek293t,16287,1,2,GTCGTTCCTGCCCTGGGCAGTTTGTCCTGAGGATCCCACCTGATGTTTTGCCGCACATAATGTGGCTGAAAAGGAAACTACTGCACCTGAAAAAAATTC,GTCGTTCCTGCCCTGGGCAGTTTGTCCTACGAGGATCCCACCTGATGTTTTGCCGCACATAATGTGGCTGAAAAGGAAACTACTGCACCTGAAAAAAAT,10,30,14,27,27,32,27,34,27,29,29,32,31,34,50.35,7.885903338
hek293t,11551,1,3,CATTTTGCTTTGCAGAAACCATTTTTTAAAGGCTTAATAAAGTAATTGTAGGCCTTGGTAGAATTAAAAAAATTCTAGTTGGTTTAACGCGTAACTAGA,CATTTTGCTTTGCAGAAACCATTTTTTAAAGGCTTAATAGATAAGTAATTGTAGGCCTTGGTAGAATTAAAAAAATTCTAGTTGGTTTAACGCGTAACT,10,30,14,27,27,55,27,58,27,40,40,55,43,58,-0.39,0.0
hek293t,11551,1,3,ATAAGTGCTTTGCAGAAACCATTTTTTAAAGGCTTAATAAAGTAATTGTAGGCCTTGGTAGAATTTGGTTAATAAAAAAATTCTAGTTGGTTTAACGCG,ATAAGTGCTTTGCAGAAACCATTTTTTAAAGGCTTAATAGATAAGTAATTGTAGGCCTTGGTAGAATTTGGTTAATAAAAAAATTCTAGTTGGTTTAAC,10,30,14,27,27,47,27,50,27,40,40,47,43,50,-0.39,0.0
hek293t,11553,1,4,CCACATGTTACACAGCCTTGGAGAAATACAGGCTAGAATCTGTAGACACACCACCACCAGCAAGCGCTCTGTGGGGAGAAAAAAATTCTAGTTGGTTTA,CCACATGTTACACAGCCTTGGAGAAATACAGGCTAGACATCATCTGTAGACACACCACCACCAGCAAGCGCTCTGTGGGGAGAAAAAAATTCTAGTTGG,10,30,14,27,27,41,27,45,27,38,38,41,42,45,31.66,0.481953915
hek293t,11553,1,4,GGGGATGTTACACAGCCTTGGAGAAATACAGGCTAGAATCTGTAGACACACCACCACCAGCAAGCGCTCTGAAAAAAATTCTAGTTGGTTTAACGCGTA,GGGGATGTTACACAGCCTTGGAGAAATACAGGCTAGACATCATCTGTAGACACACCACCACCAGCAAGCGCTCTGAAAAAAATTCTAGTTGGTTTAACG,10,30,14,27,27,48,27,52,27,38,38,48,42,52,31.66,79.22405351
hek293t,11555,1,12,CCGGAAGTCCTCTGAGATCCGGCCAGCCTCGGCCAAACCACATCCGCAGCTGGACCTTCCCCTGCAGGAAAAAAATTCTAGTTGGTTTAACGCGTAACT,CCGGAAGTCCTCTGAGATCCGGCCAGCCTCGGCCAAAGGGTTCGACGAACCACATCCGCAGCTGGACCTTCCCCTGCAGGAAAAAAATTCTAGTTGGTT,10,30,14,27,27,43,27,55,27,36,36,43,48,55,29.56,0.11820331
hek293t,17812,1,10,AGAGACATACACAATTTTGGAGTTGTTTCTGGAATGCCCAAGCACTTGTACTTAGAAGAATTGACTAGATAGAAAAAAATTCTAGTTGGTTTAACGCGT,AGAGACATACACAATTTTGGAGTTGTTTCTTCAGGACTGCGGAATGCCCAAGCACTTGTACTTAGAAGAATTGACTAGATAGAAAAAAATTCTAGTTGG,10,30,14,27,27,41,27,51,27,31,31,41,41,51,1.09,10.39738979
hek293t,17812,1,10,TACACCATACACAATTTTGGAGTTGTTTCTGGAATGCCCAAGCACTTGTACTTAGAAGAATTGACTAGATAGTAAGGTTAAAAAAATTCTAGTTGGTTT,TACACCATACACAATTTTGGAGTTGTTTCTTCAGGACTGCGGAATGCCCAAGCACTTGTACTTAGAAGAATTGACTAGATAGTAAGGTTAAAAAAATTC,10,30,14,27,27,34,27,44,27,31,31,34,41,44,1.09,0.607115471
hek293t,11559,1,9,AAATTTTTAACCAGCTGCCAACACCAAACCGGGACCAAAGACAGGAACCTGATGTTCTCTGTAGATACCCTAAGATAAAAAAATTCTAGTTGGTTTAAC,AAATTTTTAACCAGCTGCCAACACCAATAAACATGCACCGGGACCAAAGACAGGAACCTGATGTTCTCTGTAGATACCCTAAGATAAAAAAATTCTAGT,10,30,14,27,27,38,27,47,27,28,28,38,37,47,22.5,14.27124884
hek293t,11559,1,9,TATAATTTAACCAGCTGCCAACACCAAACCGGGACCAAAGACAGGAACCTGATGTTCTCTGTAGATACCCTAAGATCTCAAAAAAATTCTAGTTGGTTT,TATAATTTAACCAGCTGCCAACACCAATAAACATGCACCGGGACCAAAGACAGGAACCTGATGTTCTCTGTAGATACCCTAAGATCTCAAAAAAATTCT,10,30,14,27,27,35,27,44,27,28,28,35,37,44,22.5,15.3218265
hek293t,11561,1,14,GGCTATTGAAGAGATGCCCCACACTTCTGAGGACAGGTATTCCGTAATTCTTGATGCAGCCTTTAGCCAAAAAAAATTCTAGTTGGTTTAACGCGTAAC,GGCTATTGAAGAGATGCCCCACACTTCTGAGGACAGCCGCAGAACCTCTAGTATTCCGTAATTCTTGATGCAGCCTTTAGCCAAAAAAAATTCTAGTTG,10,30,14,27,27,40,27,54,27,37,37,40,51,54,52.64,0.0
hek293t,11561,1,14,TTTACTTGAAGAGATGCCCCACACTTCTGAGGACAGGTATTCCGTAATTCTTGATGCAGCCTTTAAAAAAAATTCTAGTTGGTTTAACGCGTAACTAGA,TTTACTTGAAGAGATGCCCCACACTTCTGAGGACAGCCGCAGAACCTCTAGTATTCCGTAATTCTTGATGCAGCCTTTAAAAAAAATTCTAGTTGGTTT,10,30,14,27,27,44,27,58,27,37,37,44,51,58,52.64,2.051711947
hek293t,11563,1,13,CATAATAATGACAATTGCTACGTCATATTTGGAAGAAACTAATCTGTATGCATGCTTTAGTTTCCTGAAAAAAATTCTAGTTGGTTTAACGCGTAACTA,CATAATAATGACAATTGCTACGTCATATTTGGAAGAAACTGAAGGCCCACGATAATCTGTATGCATGCTTTAGTTTCCTGAAAAAAATTCTAGTTGGTT,10,30,14,27,27,43,27,56,27,40,40,43,53,56,8.91,0.0
hek293t,11564,1,9,TAAATTACAGCCGCAGGAGATGCTGGAGCAGGGGGATTTGGGGTGCTTTAACTGCTAACATCAACCAAAAAAATTCTAGTTGGTTTAACGCGTAACTAG,TAAATTACAGCCGCAGGAGATGCTGGAGCAGGGGGATTTGCTCTACTGAGGGTGCTTTAACTGCTAACATCAACCAAAAAAATTCTAGTTGGTTTAACG,10,30,14,27,27,48,27,57,27,41,41,48,50,57,56.69,1.195229891
hek293t,5982,1,12,CCTGAGAACTTTTGTATGGCTGTGAGCTGTGGTGTGCTTGAGTAACTCTCTATGTGAAAAAACAAGAAAAAAATTCTAGTTGGTTTAACGCGTAACTAG,CCTGAGAACTTTTGTATGGCTGTGAGCTGTGGTGTCTGCTTTTTGTTGCTTGAGTAACTCTCTATGTGAAAAAACAAGAAAAAAATTCTAGTTGGTTTA,10,30,14,27,27,45,27,57,27,35,35,45,47,57,37.77,1.63335435
hek293t,5982,1,12,AACGAGAACTTTTGTATGGCTGTGAGCTGTGGTGTGCTTGAGTAACTCTCTATGTGAAAAAACAAGTCAGTAAAAAAAAATTCTAGTTGGTTTAACGCG,AACGAGAACTTTTGTATGGCTGTGAGCTGTGGTGTCTGCTTTTTGTTGCTTGAGTAACTCTCTATGTGAAAAAACAAGTCAGTAAAAAAAAATTCTAGT,10,30,14,27,27,38,27,50,27,35,35,38,47,50,37.77,0.0
hek293t,11567,1,8,CTCTTATTTCTTAGCATTTTGACAGATACAGGTTCATTTTTTCATTTTCTAGTCTTCTAACAAGCCAAAAAAAATTCTAGTTGGTTTAACGCGTAACTA,CTCTTATTTCTTAGCATTTTGACAGATACAGGTTCATCGTTACCCTTTTTCATTTTCTAGTCTTCTAACAAGCCAAAAAAAATTCTAGTTGGTTTAACG,10,30,14,27,27,48,27,56,27,38,38,48,46,56,0.01,0.0
hek293t,11568,1,11,AAGGCGAATCTGCTGGGCTGTTACTTTCATGGACTGAAGATGATCTGGGAAGTGTTCTGTTTCCCTAGGACTAAAAAAATTCTAGTTGGTTTAACGCGT,AAGGCGAATCTGCTGGGCTGTTACTTTCATGGACTGGGCGCGATCTCAAGATGATCTGGGAAGTGTTCTGTTTCCCTAGGACTAAAAAAATTCTAGTTG,10,30,14,27,27,40,27,51,27,37,37,40,48,51,12.67,0.0
hek293t,11569,1,10,TGTGTGGGCACAGCAGATTGTGTTGTAAGGGGAATGTAGGAAACAGCCACAAAAAGTCATATAATCTCCTGTGATAATCAAAAAAATTCTAGTTGGTTT,TGTGTGGGCACAGCAGATTGTGTTGTATTATTAGTAAAGGGGAATGTAGGAAACAGCCACAAAAAGTCATATAATCTCCTGTGATAATCAAAAAAATTC,10,30,14,27,27,34,27,44,27,27,27,34,37,44,64.73,15.04596611
hek293t,11569,1,10,TACCGGGGCACAGCAGATTGTGTTGTAAGGGGAATGTAGGAAACAGCCACAAAAAGTCATATAATCTCCTGAAAAAAATTCTAGTTGGTTTAACGCGTA,TACCGGGGCACAGCAGATTGTGTTGTATTATTAGTAAAGGGGAATGTAGGAAACAGCCACAAAAAGTCATATAATCTCCTGAAAAAAATTCTAGTTGGT,10,30,14,27,27,42,27,52,27,27,27,42,37,52,64.73,12.470755
hek293t,11571,1,2,GAAGGAGTCCTGCTCCCTTCAATCCAGCTTGGCTGATAGCTTGGGAGAACTTCTAGCCAGAGATAAAAATGGAGATTTTTCCCAAAAAAATTCTAGTTG,GAAGGAGTCCTGCTCCCTTCAATCCAGCTTGGCTCGGATAGCTTGGGAGAACTTCTAGCCAGAGATAAAAATGGAGATTTTTCCCAAAAAAATTCTAGT,10,30,14,27,27,38,27,40,27,35,35,38,37,40,45.91,0.154359869
hek293t,11571,1,2,ATCCGAGTCCTGCTCCCTTCAATCCAGCTTGGCTGATAGCTTGGGAGAACTTCTAGCCAGAGATAAAAATGGAGATTTTAAAAAAATTCTAGTTGGTTT,ATCCGAGTCCTGCTCCCTTCAATCCAGCTTGGCTCGGATAGCTTGGGAGAACTTCTAGCCAGAGATAAAAATGGAGATTTTAAAAAAATTCTAGTTGGT,10,30,14,27,27,42,27,44,27,35,35,42,37,44,45.91,65.99456251
hek293t,11573,1,12,TTCGTTTGCTTTGCCCAATGTCAAGACACTGGAAGACTTTTGAATTATGTTTTGTCATGCTTTTCAATGTTAACTAAAAAAATTCTAGTTGGTTTAACG,TTCGTTTGCTTTGCCCAATGTCAAGACACTGGTGTATTAGGCAGAAGACTTTTGAATTATGTTTTGTCATGCTTTTCAATGTTAACTAAAAAAATTCTA,10,30,14,27,27,36,27,48,27,33,33,36,45,48,57.29,0.0
hek293t,11576,1,11,GTGGTGAAGCTGTAAGAAAATTCATGTTTAGGTGAAGATGGGAGGCTTTTCAGCCTGGCAGTCCCTGTCTAAAAAAAATTCTAGTTGGTTTAACGCGTA,GTGGTGAAGCTGTAAGAAAATTCATGTTTAAACCCTACTAGGGTGAAGATGGGAGGCTTTTCAGCCTGGCAGTCCCTGTCTAAAAAAAATTCTAGTTGG,10,30,14,27,27,41,27,52,27,31,31,41,42,52,15.61,0.452791287
hek293t,11576,1,11,ACATTGAAGCTGTAAGAAAATTCATGTTTAGGTGAAGATGGGAGGCTTTTCAGCCTGGCAGTCCCTAAAAAAATTCTAGTTGGTTTAACGCGTAACTAG,ACATTGAAGCTGTAAGAAAATTCATGTTTAAACCCTACTAGGGTGAAGATGGGAGGCTTTTCAGCCTGGCAGTCCCTAAAAAAATTCTAGTTGGTTTAA,10,30,14,27,27,46,27,57,27,31,31,46,42,57,15.61,0.539205016
hek293t,3933,1,12,TAGCGACAAAATAAATCACTGCTGGATAGAGGACACAAAAGAACCAGGGATCTTGGGGTTTGACTCTGATGAAATAAAAAAATTCTAGTTGGTTTAACG,TAGCGACAAAATAAATCACTGCTGGATAGAGGTCACCCGTCCCGACACAAAAGAACCAGGGATCTTGGGGTTTGACTCTGATGAAATAAAAAAATTCTA,10,30,14,27,27,36,27,48,27,33,33,36,45,48,43.49,0.0
hek293t,11579,1,15,GATAAATTGGGATTTGGCCCTTTGTGGATAGGTGAATGGTTCTTCGGTTGTATTCCCAGTGGGGAAAAAAATTCTAGTTGGTTTAACGCGTAACTAGAT,GATAAATTGGGATTTGGCCCTTTGTGGATGATGGTCCGACCAATAGGTGAATGGTTCTTCGGTTGTATTCCCAGTGGGGAAAAAAATTCTAGTTGGTTT,10,30,14,27,27,44,27,59,27,29,29,44,44,59,26.14,36.04503669
hek293t,11579,1,15,ATCTCATTGGGATTTGGCCCTTTGTGGATAGGTGAATGGTTCTTCGGTTGTATTCCCAGTGGGGTATTTAAAAAAATTCTAGTTGGTTTAACGCGTAAC,ATCTCATTGGGATTTGGCCCTTTGTGGATGATGGTCCGACCAATAGGTGAATGGTTCTTCGGTTGTATTCCCAGTGGGGTATTTAAAAAAATTCTAGTT,10,30,14,27,27,39,27,54,27,29,29,39,44,54,26.14,1.308466834
hek293t,11581,1,7,ACAGGCACTGAAGTCAAAGCAGTCACCAAAGGAAGTATTCGCCTGCGTGTTTTACTCTGTTTTTATGAACAGTTGTCCCAGAAAAAAATTCTAGTTGGT,ACAGGCACTGAAGTCAAAGCAGTCACCGGCGTCCAAAGGAAGTATTCGCCTGCGTGTTTTACTCTGTTTTTATGAACAGTTGTCCCAGAAAAAAATTCT,10,30,14,27,27,35,27,42,27,28,28,35,35,42,65.86,39.79199011
hek293t,11583,1,2,GTGTTCATTTGCAGATTTCAAATGCATCAAGGGAGGTGTTCAGTAAGTCGTATGAGAGGTGTGACCTGTTTTACAAAAAAATTCTAGTTGGTTTAACGC,GTGTTCATTTGCAGATTTCAAATGCATCAAGGGAGGACTGTTCAGTAAGTCGTATGAGAGGTGTGACCTGTTTTACAAAAAAATTCTAGTTGGTTTAAC,10,30,14,27,27,47,27,49,27,37,37,47,39,49,16.99,41.30126537
hek293t,11583,1,2,ATGTCCATTTGCAGATTTCAAATGCATCAAGGGAGGTGTTCAGTAAGTCGTATGAGAGGTGTGACCTGTAAAAAAATTCTAGTTGGTTTAACGCGTAAC,ATGTCCATTTGCAGATTTCAAATGCATCAAGGGAGGACTGTTCAGTAAGTCGTATGAGAGGTGTGACCTGTAAAAAAATTCTAGTTGGTTTAACGCGTA,10,30,14,27,27,52,27,54,27,37,37,52,39,54,16.99,34.3873936
hek293t,11585,1,2,GCCTCTTTTAAAGGCACTGGGCTATTACCTGGAACAAAATATTTCTAGCAGATAGGAGTGACATTTAACTCAGCTAGTATAAAAAAAAATTCTAGTTGG,GCCTCTTTTAAAGGCACTGGGCTATTACTGCTGGAACAAAATATTTCTAGCAGATAGGAGTGACATTTAACTCAGCTAGTATAAAAAAAAATTCTAGTT,10,30,14,27,27,39,27,41,27,29,29,39,31,41,39.66,65.79729325
hek293t,11585,1,2,CTATTTTTTAAAGGCACTGGGCTATTACCTGGAACAAAATATTTCTAGCAGATAGGAGTGACATTTAACTCAGCTAGTATAAGTAAAAAAAATTCTAGT,CTATTTTTTAAAGGCACTGGGCTATTACTGCTGGAACAAAATATTTCTAGCAGATAGGAGTGACATTTAACTCAGCTAGTATAAGTAAAAAAAATTCTA,10,30,14,27,27,36,27,38,27,29,29,36,31,38,39.66,58.84067299
hek293t,11587,1,1,ATTCACTCCACCTGCATTGCCTTTCATGGAGGACTTCTAGAGACTGAGGTGAGAACTAAATCAGGCCTCTAAAGGTAAAAAAATTCTAGTTGGTTTAAC,ATTCACTCCACCTGCATTGCCTTTCATGGAGGACTTCTCAGAGACTGAGGTGAGAACTAAATCAGGCCTCTAAAGGTAAAAAAATTCTAGTTGGTTTAA,10,30,14,27,27,46,27,47,27,39,39,46,40,47,62.03,83.51765506
hek293t,11587,1,1,AAGCACTCCACCTGCATTGCCTTTCATGGAGGACTTCTAGAGACTGAGGTGAGAACTAAATCAGGCCTCTAAAAAAAAAATTCTAGTTGGTTTAACGCG,AAGCACTCCACCTGCATTGCCTTTCATGGAGGACTTCTCAGAGACTGAGGTGAGAACTAAATCAGGCCTCTAAAAAAAAAATTCTAGTTGGTTTAACGC,10,30,14,27,27,49,27,50,27,39,39,49,40,50,62.03,75.2129774
hek293t,11589,1,7,TAACGGAATGGTCCAGAATGTTTCAGTTAAGGACCTCAAGTCATCCAAACCACAAAGGTATCTGTAAACATTATTTATCAAAAAAAATTCTAGTTGGTT,TAACGGAATGGTCCAGAATGTTTCAGTTAAGGTCATTTGACCTCAAGTCATCCAAACCACAAAGGTATCTGTAAACATTATTTATCAAAAAAAATTCTA,10,30,14,27,27,36,27,43,27,33,33,36,40,43,23.75,0.148367953
hek293t,11589,1,7,CAGCTGAATGGTCCAGAATGTTTCAGTTAAGGACCTCAAGTCATCCAAACCACAAAGGTATCTGTAAAAAAAAAATTCTAGTTGGTTTAACGCGTAACT,CAGCTGAATGGTCCAGAATGTTTCAGTTAAGGTCATTTGACCTCAAGTCATCCAAACCACAAAGGTATCTGTAAAAAAAAAATTCTAGTTGGTTTAACG,10,30,14,27,27,48,27,55,27,33,33,48,40,55,23.75,21.67899295
hek293t,18815,1,1,TTATCATGTAGGAAAAAAGATTCACTGTAAGGTCACTTTATTCCTAGACAGGCCTGAAATTTGCTCATATTGCAGGACTGGCAAAAAAATTCTAGTTGG,TTATCATGTAGGAAAAAAGATTCACTGTAAGGGTCACTTTATTCCTAGACAGGCCTGAAATTTGCTCATATTGCAGGACTGGCAAAAAAATTCTAGTTG,10,30,14,27,27,40,27,41,27,33,33,40,34,41,46.3,47.32037424
hek293t,18815,1,1,CTTGAATGTAGGAAAAAAGATTCACTGTAAGGTCACTTTATTCCTAGACAGGCCTGAAATTTGCTCATATTGCAGGACTAAAAAAATTCTAGTTGGTTT,CTTGAATGTAGGAAAAAAGATTCACTGTAAGGGTCACTTTATTCCTAGACAGGCCTGAAATTTGCTCATATTGCAGGACTAAAAAAATTCTAGTTGGTT,10,30,14,27,27,43,27,44,27,33,33,43,34,44,46.3,49.00608195
hek293t,11595,1,14,GGCTCATGCTCTAATTTGAGTCCAAACCTTGGAAAAAATTAAATCCTTACCACATATTATCAGTATTTTCATAAAAAAATTCTAGTTGGTTTAACGCGT,GGCTCATGCTCTAATTTGAGTCCAAACTCCCAGCGGTTTCCCTTGGAAAAAATTAAATCCTTACCACATATTATCAGTATTTTCATAAAAAAATTCTAG,10,30,14,27,27,37,27,51,27,27,27,37,41,51,55.72,0.72507989
hek293t,11597,1,6,GGAGGGCTCCTTTAGGAAGTTGTGAAATATGGCATAGAAAAAAGGTAAGAAATGTTAATACCATTAGATAAGCAAAGAAAAAAAATTCTAGTTGGTTTA,GGAGGGCTCCTTTAGGAAGTTGTGAAATATGGCATTAGGGCAGAAAAAAGGTAAGAAATGTTAATACCATTAGATAAGCAAAGAAAAAAAATTCTAGTT,10,30,14,27,27,39,27,45,27,36,36,39,42,45,18.19,0.043575578
hek293t,11597,1,6,ATCGAGCTCCTTTAGGAAGTTGTGAAATATGGCATAGAAAAAAGGTAAGAAATGTTAATACCATTAAAAAAAATTCTAGTTGGTTTAACGCGTAACTAG,ATCGAGCTCCTTTAGGAAGTTGTGAAATATGGCATTAGGGCAGAAAAAAGGTAAGAAATGTTAATACCATTAAAAAAAATTCTAGTTGGTTTAACGCGT,10,30,14,27,27,51,27,57,27,36,36,51,42,57,18.19,0.599214007
hek293t,11599,1,13,AGCGGGCCAATCTGTGGCTCTTGAGCTCCAGGCAGCTCAAATATATAGCTCAAATATGGCTCAGACAGCAAAAAAAATTCTAGTTGGTTTAACGCGTAA,AGCGGGCCAATCTGTGGCTCTTGAGCTCCAGGAATTAAAAATATACAGCTCAAATATATAGCTCAAATATGGCTCAGACAGCAAAAAAAATTCTAGTTG,10,30,14,27,27,40,27,53,27,33,33,40,46,53,40.85,0.502093802
hek293t,11600,1,10,TCATAAAATCAAAAATGGGCACATTGATTTGGGAGAATCTAAACATATTTGTAAGCATAACTGCACTGTAAAAAAATTCTAGTTGGTTTAACGCGTAAC,TCATAAAATCAAAAATGGGCACATTGATACGATCCCTGTTGGGAGAATCTAAACATATTTGTAAGCATAACTGCACTGTAAAAAAATTCTAGTTGGTTT,10,30,14,27,27,44,27,54,27,29,29,44,39,54,-0.51,4.359429899
hek293t,11600,1,10,GTGAGAAATCAAAAATGGGCACATTGATTTGGGAGAATCTAAACATATTTGTAAGCATAACTGCACTGTAATGTGCAAAAAAAATTCTAGTTGGTTTAA,GTGAGAAATCAAAAATGGGCACATTGATACGATCCCTGTTGGGAGAATCTAAACATATTTGTAAGCATAACTGCACTGTAATGTGCAAAAAAAATTCTA,10,30,14,27,27,36,27,46,27,29,29,36,39,46,-0.51,0.330939617
hek293t,21507,1,2,CTCGGAGAAATTGGATATCAAATAAGATGTGGGGAAAATTGTTCCACTGTCAATGTATTTTTTAGGGCATAAAAAAATTCTAGTTGGTTTAACGCGTAA,CTCGGAGAAATTGGATATCAAATAAGATGTGGGGAAAATTGAGTTCCACTGTCAATGTATTTTTTAGGGCATAAAAAAATTCTAGTTGGTTTAACGCGT,10,30,14,27,27,51,27,53,27,41,41,51,43,53,46.47,2.313467326
hek293t,21507,1,2,TTTGCAGAAATTGGATATCAAATAAGATGTGGGGAAAATTGTTCCACTGTCAATGTATTTTTTAGGGCATAGTAGTTAAAAAAATTCTAGTTGGTTTAA,TTTGCAGAAATTGGATATCAAATAAGATGTGGGGAAAATTGAGTTCCACTGTCAATGTATTTTTTAGGGCATAGTAGTTAAAAAAATTCTAGTTGGTTT,10,30,14,27,27,44,27,46,27,41,41,44,43,46,46.47,0.0
hek293t,11604,1,5,TTCGCCCAGGTCTGATGGCCGGTCACTGGTGGGGCTGGTGGCGACTGCTGCGAGTGAGCAGGCCGATGCTGAAGGCAGGAAAAAAAATTCTAGTTGGTT,TTCGCCCAGGTCTGATGGCCGGTCACTCGGATGGTGGGGCTGGTGGCGACTGCTGCGAGTGAGCAGGCCGATGCTGAAGGCAGGAAAAAAAATTCTAGT,10,30,14,27,27,38,27,43,27,28,28,38,33,43,60.19,82.77853638
hek293t,11604,1,5,GCCTGCCAGGTCTGATGGCCGGTCACTGGTGGGGCTGGTGGCGACTGCTGCGAGTGAGCAGGCCGATGCTGAAGGAAAAAAATTCTAGTTGGTTTAACG,GCCTGCCAGGTCTGATGGCCGGTCACTCGGATGGTGGGGCTGGTGGCGACTGCTGCGAGTGAGCAGGCCGATGCTGAAGGAAAAAAATTCTAGTTGGTT,10,30,14,27,27,43,27,48,27,28,28,43,33,48,60.19,82.49376527
hek293t,11606,1,15,CGACTCAACTAAACAATGTCAAGTCTAAGTGGAGCAACTGCATTTCTGTATTTGTGTACATGTCCAAAAAAATTCTAGTTGGTTTAACGCGTAACTAGA,CGACTCAACTAAACAATGTCAAGTCTAAGTGGAGCAACTCCCGACTATTCATCCGCATTTCTGTATTTGTGTACATGTCCAAAAAAATTCTAGTTGGTT,10,30,14,27,27,43,27,58,27,40,40,43,55,58,28.19,0.0
hek293t,11607,1,10,CTGGTAATAATCATTATTAGCTTCAGTCCTGGGGAAGGCTGTCCCAGAAAACCTACTCTGTTCATTTCCATTCTGCAAAAAAATTCTAGTTGGTTTAAC,CTGGTAATAATCATTATTAGCTTCAGTCCTGGGATGCACACCGGAAGGCTGTCCCAGAAAACCTACTCTGTTCATTTCCATTCTGCAAAAAAATTCTAG,10,30,14,27,27,37,27,47,27,34,34,37,44,47,35.52,2.436664979
hek293t,11607,1,10,CACATAATAATCATTATTAGCTTCAGTCCTGGGGAAGGCTGTCCCAGAAAACCTACTCTGTTCAAAAAAAATTCTAGTTGGTTTAACGCGTAACTAGAT,CACATAATAATCATTATTAGCTTCAGTCCTGGGATGCACACCGGAAGGCTGTCCCAGAAAACCTACTCTGTTCAAAAAAAATTCTAGTTGGTTTAACGC,10,30,14,27,27,49,27,59,27,34,34,49,44,59,35.52,19.64475012
hek293t,11610,1,6,TGACGCTTTGCGCTGAAGACTCTGAGCTCTGGAAATTAACAGGCCTTCTGTTTAAGAATACATTGAGATCAATCATGGATAAAAAAATTCTAGTTGGTT,TGACGCTTTGCGCTGAAGACTCTGAGCTCCACAAGTGGAAATTAACAGGCCTTCTGTTTAAGAATACATTGAGATCAATCATGGATAAAAAAATTCTAG,10,30,14,27,27,37,27,43,27,30,30,37,36,43,56.62,10.76360651
hek293t,11610,1,6,ACCCACTTTGCGCTGAAGACTCTGAGCTCTGGAAATTAACAGGCCTTCTGTTTAAGAATACATTGAGATCAAAAAAAAATTCTAGTTGGTTTAACGCGT,ACCCACTTTGCGCTGAAGACTCTGAGCTCCACAAGTGGAAATTAACAGGCCTTCTGTTTAAGAATACATTGAGATCAAAAAAAAATTCTAGTTGGTTTA,10,30,14,27,27,45,27,51,27,30,30,45,36,51,56.62,47.05115673
hek293t,11612,1,7,ACGCGTTGGCCAAATGCTATGTATATGTTTGGCTCAACATAGTCTCTCTCAGGTGGCCAAACACATACCTAACCTTTCAAAAAAATTCTAGTTGGTTTA,ACGCGTTGGCCAAATGCTATGTATATGTTTGGCTTTCCCAACAACATAGTCTCTCTCAGGTGGCCAAACACATACCTAACCTTTCAAAAAAATTCTAGT,10,30,14,27,27,38,27,45,27,35,35,38,42,45,20.88,0.0
hek293t,11612,1,7,GTTCATTGGCCAAATGCTATGTATATGTTTGGCTCAACATAGTCTCTCTCAGGTGGCCAAACACATAAAAAAATTCTAGTTGGTTTAACGCGTAACTAG,GTTCATTGGCCAAATGCTATGTATATGTTTGGCTTTCCCAACAACATAGTCTCTCTCAGGTGGCCAAACACATAAAAAAATTCTAGTTGGTTTAACGCG,10,30,14,27,27,50,27,57,27,35,35,50,42,57,20.88,3.510198671
hek293t,11614,1,6,GACCCAAACACCTTTTCTGCAAGATGTATTGGGAAGAGATGTATGTCTGCCTGCGGAAAGCTAGAGCTGGCGTCTTGTACTACTGTCAAAAAAATTCTA,GACCCAAACACCTTTTCTGCAAGATGGCGGCGTATTGGGAAGAGATGTATGTCTGCCTGCGGAAAGCTAGAGCTGGCGTCTTGTACTACTGTCAAAAAA,10,30,14,27,27,30,27,36,27,27,27,30,33,36,4.28,0.310992264
hek293t,11614,1,6,GCCGTAAACACCTTTTCTGCAAGATGTATTGGGAAGAGATGTATGTCTGCCTGCGGAAAGCTAGAGCTGGCGTCTTGTACTACAAAAAAATTCTAGTTG,GCCGTAAACACCTTTTCTGCAAGATGGCGGCGTATTGGGAAGAGATGTATGTCTGCCTGCGGAAAGCTAGAGCTGGCGTCTTGTACTACAAAAAAATTC,10,30,14,27,27,34,27,40,27,27,27,34,33,40,4.28,29.85874636
hek293t,11616,1,9,TCGACTACTTAGCTACTAAATGACCCCAATGGTTATTTGAGAATTAAAGGAGGTATTAAAGTGTTTCTGAATCCTAAAAAAAATTCTAGTTGGTTTAAC,TCGACTACTTAGCTACTAAATGACCCCAATGGTTAAGCCGTCCATTTGAGAATTAAAGGAGGTATTAAAGTGTTTCTGAATCCTAAAAAAAATTCTAGT,10,30,14,27,27,38,27,47,27,35,35,38,44,47,55.87,0.533333333
hek293t,11618,1,3,ATTGGGACTACACCTTTGAGATAGCTTTCAGGGAAGGAAATAGAGTGCACCTGGGTGTCAGTGCATGAAAAAAATTCTAGTTGGTTTAACGCGTAACTA,ATTGGGACTACACCTTTGAGATAGCTTTCAGGGAAGGCGGAAATAGAGTGCACCTGGGTGTCAGTGCATGAAAAAAATTCTAGTTGGTTTAACGCGTAA,10,30,14,27,27,53,27,56,27,38,38,53,41,56,8.5,69.98209291
hek293t,11618,1,3,ACGTGGACTACACCTTTGAGATAGCTTTCAGGGAAGGAAATAGAGTGCACCTGGGTGTCAGTGCATGAAATAGCGTGAGAAAAAAATTCTAGTTGGTTT,ACGTGGACTACACCTTTGAGATAGCTTTCAGGGAAGGCGGAAATAGAGTGCACCTGGGTGTCAGTGCATGAAATAGCGTGAGAAAAAAATTCTAGTTGG,10,30,14,27,27,41,27,44,27,38,38,41,41,44,8.5,1.199150097
hek293t,11620,1,7,ATTACATATTGAATAAGAAAATATTTCCTTGGAGTTGGAGCTTTGAGGGAAAGCTCTTAATTGAGTTAAAAAAAAATTCTAGTTGGTTTAACGCGTAAC,ATTACATATTGAATAAGAAAATATTTCCTTGGGCAAACGAGTTGGAGCTTTGAGGGAAAGCTCTTAATTGAGTTAAAAAAAAATTCTAGTTGGTTTAAC,10,30,14,27,27,47,27,54,27,32,32,47,39,54,30.33,0.417390283
hek293t,11622,1,9,TTGTAAGCTAGTGCTTGATTGCACTGAGAAGGCTGCCATTTCCCTTTTCAGAGGTATAAAGCAGTTCAAAGCAAAAAAAAAATTCTAGTTGGTTTAACG,TTGTAAGCTAGTGCTTGATTGCACTGAGGGAAGATCAAAGGCTGCCATTTCCCTTTTCAGAGGTATAAAGCAGTTCAAAGCAAAAAAAAAATTCTAGTT,10,30,14,27,27,39,27,48,27,29,29,39,38,48,60.43,6.188167006
hek293t,11624,1,10,AGAGCGTCAGTCATCTTGCCCCCATAAATAGGGGACAGCCCAGAGCCCATCGAGCTCTCCTGCACAGCAAAAAAATTCTAGTTGGTTTAACGCGTAACT,AGAGCGTCAGTCATCTTGCCCCCATAAATAGGGGACAGCCCCACTCGGCCCAGAGCCCATCGAGCTCTCCTGCACAGCAAAAAAATTCTAGTTGGTTTA,10,30,14,27,27,45,27,55,27,38,38,45,48,55,16.87,0.188323917
hek293t,11625,1,12,TTAGTGTTGAATTATTTGGTATGTGCTATAGGAACAATGCCATCTAATTTTGAGATAAATACAACCTGCAAAAAAAATTCTAGTTGGTTTAACGCGTAA,TTAGTGTTGAATTATTTGGTATGTGCTATAGTTGAGCCGAAAGGAACAATGCCATCTAATTTTGAGATAAATACAACCTGCAAAAAAAATTCTAGTTGG,10,30,14,27,27,41,27,53,27,31,31,41,43,53,7.58,32.30380891
hek293t,11625,1,12,TGTCAGTTGAATTATTTGGTATGTGCTATAGGAACAATGCCATCTAATTTTGAGATAAATACAACCTGCAACCAAAAAAATTCTAGTTGGTTTAACGCG,TGTCAGTTGAATTATTTGGTATGTGCTATAGTTGAGCCGAAAGGAACAATGCCATCTAATTTTGAGATAAATACAACCTGCAACCAAAAAAATTCTAGT,10,30,14,27,27,38,27,50,27,31,31,38,43,50,7.58,0.335849902
hek293t,11627,1,14,CCGGAGCAGATCCATACAGTGTTTAAACAAGGTTTTATTTTGCAAAGCCCTGCAATACAGCTGTTTCTCATTTAAAAAAATTCTAGTTGGTTTAACGCG,CCGGAGCAGATCCATACAGTGTTTAAACCCGCAATAGGGCGCAAGGTTTTATTTTGCAAAGCCCTGCAATACAGCTGTTTCTCATTTAAAAAAATTCTA,10,30,14,27,27,36,27,50,27,29,29,36,43,50,28.07,0.577983499
hek293t,11627,1,14,CAGAAGCAGATCCATACAGTGTTTAAACAAGGTTTTATTTTGCAAAGCCCTGCAATACAGCTGTTTCTCAAAAAAAATTCTAGTTGGTTTAACGCGTAA,CAGAAGCAGATCCATACAGTGTTTAAACCCGCAATAGGGCGCAAGGTTTTATTTTGCAAAGCCCTGCAATACAGCTGTTTCTCAAAAAAAATTCTAGTT,10,30,14,27,27,39,27,53,27,29,29,39,43,53,28.07,1.066032569
hek293t,11629,1,3,ATGTAATAAAAATTTTACTGGACATTTGAAGGAGAATTGACTTTTCAGTAAAATCTGAGGGTGCATAATTTGTTTTGATGAAAAAAATTCTAGTTGGTT,ATGTAATAAAAATTTTACTGGACATTTGAGATAGGAGAATTGACTTTTCAGTAAAATCTGAGGGTGCATAATTTGTTTTGATGAAAAAAATTCTAGTTG,10,30,14,27,27,40,27,43,27,30,30,40,33,43,7.2,2.633345894
hek293t,11629,1,3,ACTAGATAAAAATTTTACTGGACATTTGAAGGAGAATTGACTTTTCAGTAAAATCTGAGGGTGCATAATTTGTTTTGATGTGCAAAAAAATTCTAGTTG,ACTAGATAAAAATTTTACTGGACATTTGAGATAGGAGAATTGACTTTTCAGTAAAATCTGAGGGTGCATAATTTGTTTTGATGTGCAAAAAAATTCTAG,10,30,14,27,27,37,27,40,27,30,30,37,33,40,7.2,5.707614521
hek293t,11631,1,4,GTTAGGCAGGAAGTGATGGGTGGGGAGGTAGGAGGTATATGTCTCAGGGAGAAGTTCAGAAGGAGACTAGTGGTTTTAAAAAAAATTCTAGTTGGTTTA,GTTAGGCAGGAAGTGATGGGTGGGGAGGTAGGAGTTAGGTATATGTCTCAGGGAGAAGTTCAGAAGGAGACTAGTGGTTTTAAAAAAAATTCTAGTTGG,10,30,14,27,27,41,27,45,27,34,34,41,38,45,33.85,64.04286727
hek293t,18953,1,3,TAGATTTTCCACAAAAGCAGGAGCAGACCAGGAAGAATGGAAACCCCTGCCTTGCTCTGAGACTGAAAAAAATTCTAGTTGGTTTAACGCGTAACTAGA,TAGATTTTCCACAAAAGCAGGAGCAGACCAGGAAGAATGCTGGAAACCCCTGCCTTGCTCTGAGACTGAAAAAAATTCTAGTTGGTTTAACGCGTAACT,10,30,14,27,27,55,27,58,27,40,40,55,43,58,38.91,21.3243061
hek293t,18953,1,3,CGTAGTTTCCACAAAAGCAGGAGCAGACCAGGAAGAATGGAAACCCCTGCCTTGCTCTGAGACTGCTCATAAAAAAATTCTAGTTGGTTTAACGCGTAA,CGTAGTTTCCACAAAAGCAGGAGCAGACCAGGAAGAATGCTGGAAACCCCTGCCTTGCTCTGAGACTGCTCATAAAAAAATTCTAGTTGGTTTAACGCG,10,30,14,27,27,50,27,53,27,40,40,50,43,53,38.91,62.60864844
hek293t,11635,1,9,ATCCCTTTTTTAAGTAGCAACTTCGTATTTGGGTATCATCTTTATATGCACAACTGCCAACTTTCAGAACCAAAAAAATTCTAGTTGGTTTAACGCGTA,ATCCCTTTTTTAAGTAGCAACTTCGTATTTGGGTACTAGTTTGCTCATCTTTATATGCACAACTGCCAACTTTCAGAACCAAAAAAATTCTAGTTGGTT,10,30,14,27,27,43,27,52,27,36,36,43,45,52,1.47,0.488892719
hek293t,11636,1,8,AGCCGAGTTTCAAGAGGAGCTTAGCTAAAAGGTAACTGCAAGGTGCTGTAAAATCTTATCGCCATTACAAAAAAAATTCTAGTTGGTTTAACGCGTAAC,AGCCGAGTTTCAAGAGGAGCTTAGCTAAAAGGTAATACAATCTCTGCAAGGTGCTGTAAAATCTTATCGCCATTACAAAAAAAATTCTAGTTGGTTTAA,10,30,14,27,27,46,27,54,27,36,36,46,44,54,20.05,0.163398693
hek293t,11636,1,8,GATGTAGTTTCAAGAGGAGCTTAGCTAAAAGGTAACTGCAAGGTGCTGTAAAATCTTATCGCCAAAAAAAATTCTAGTTGGTTTAACGCGTAACTAGAT,GATGTAGTTTCAAGAGGAGCTTAGCTAAAAGGTAATACAATCTCTGCAAGGTGCTGTAAAATCTTATCGCCAAAAAAAATTCTAGTTGGTTTAACGCGT,10,30,14,27,27,51,27,59,27,36,36,51,44,59,20.05,0.846250359
hek293t,16549,1,12,TCTAGAACTAAGGATTGGCTTCAGCTTAAAGGCATGAGATTAATATCCCTGCCAGACTTTGATGTTAAAAAAATTCTAGTTGGTTTAACGCGTAACTAG,TCTAGAACTAAGGATTGGCTTCAGCTTAAAGGCAGCTTGTAATCGTTGAGATTAATATCCCTGCCAGACTTTGATGTTAAAAAAATTCTAGTTGGTTTA,10,30,14,27,27,45,27,57,27,35,35,45,47,57,17.47,43.84740353
hek293t,11639,1,10,ATATGATTTTGATGCACAAAGGTTGCTTTTGGTTTTATTCTTGATTGTTTTGGGCTGAGTCCAATTCCTAGTAAAAAAATTCTAGTTGGTTTAACGCGT,ATATGATTTTGATGCACAAAGGTTGCTTTTTGAAGATGTCGGTTTTATTCTTGATTGTTTTGGGCTGAGTCCAATTCCTAGTAAAAAAATTCTAGTTGG,10,30,14,27,27,41,27,51,27,31,31,41,41,51,9.39,3.761846035
hek293t,18351,1,14,AGACACCCATTTAGCAATTTTGCTCAAGGCGGCTCCTTTACGAACATTCTGGACTCTGCAAAATATGCTTGAAATAAAAAAATTCTAGTTGGTTTAACG,AGACACCCATTTAGCAATTTTGCTCAAGGCTCCTGTGATTGACAGGCTCCTTTACGAACATTCTGGACTCTGCAAAATATGCTTGAAATAAAAAAATTC,10,30,14,27,27,34,27,48,27,31,31,34,45,48,31.46,0.0
hek293t,11643,1,14,CCTGGCTGGCACACAACCGGTCACACTGGTGGTTTTAACTTTCCCAGATTAAATGCATAGCTGGGGAAAAAAATTCTAGTTGGTTTAACGCGTAACTAG,CCTGGCTGGCACACAACCGGTCACACTGGTGGTTTATACAGTAGACTTGTAACTTTCCCAGATTAAATGCATAGCTGGGGAAAAAAATTCTAGTTGGTT,10,30,14,27,27,43,27,57,27,36,36,43,50,57,58.54,0.0
hek293t,11644,1,9,ACTCTAATAAATAGCAGTTTTACAATCCAAGGTATGTGGCCATGTAGTAACATCTACAGCCCTGATACAAACAAAAAAATTCTAGTTGGTTTAACGCGT,ACTCTAATAAATAGCAGTTTTACAATCCAAGGTATGTGGAATACCCGGCCATGTAGTAACATCTACAGCCCTGATACAAACAAAAAAATTCTAGTTGGT,10,30,14,27,27,42,27,51,27,39,39,42,48,51,34.7,0.0
hek293t,11644,1,9,TCTCAAATAAATAGCAGTTTTACAATCCAAGGTATGTGGCCATGTAGTAACATCTACAGCCCTGAAAAAAAATTCTAGTTGGTTTAACGCGTAACTAGA,TCTCAAATAAATAGCAGTTTTACAATCCAAGGTATGTGGAATACCCGGCCATGTAGTAACATCTACAGCCCTGAAAAAAAATTCTAGTTGGTTTAACGC,10,30,14,27,27,49,27,58,27,39,39,49,48,58,34.7,11.258989
hek293t,3528,1,9,GAGCGCCACAGAGGACAGGCTTCGAAACGTGGAGGTTTTCAGTAATAGGGAGTCCAGGAGAAGAGAAAGTGATCCATAAATAAAAAAAAATTCTAGTTG,GAGCGCCACAGAGGACAGGCTTCGAAAAGATGGCCACGTGGAGGTTTTCAGTAATAGGGAGTCCAGGAGAAGAGAAAGTGATCCATAAATAAAAAAAAA,10,30,14,27,27,31,27,40,27,28,28,31,37,40,68.53,0.532481363
hek293t,3528,1,9,GACAACCACAGAGGACAGGCTTCGAAACGTGGAGGTTTTCAGTAATAGGGAGTCCAGGAGAAGAGAAAGTGAAAAAAATTCTAGTTGGTTTAACGCGTA,GACAACCACAGAGGACAGGCTTCGAAAAGATGGCCACGTGGAGGTTTTCAGTAATAGGGAGTCCAGGAGAAGAGAAAGTGAAAAAAATTCTAGTTGGTT,10,30,14,27,27,43,27,52,27,28,28,43,37,52,68.53,12.73608378
hek293t,11648,1,9,AGGTATTAATCACGCGTTTGGAACAAGCTCGGCCCTTTGCTCAGATTAGGCTAGCTTCAGGGGTCACTAAAAAAATTCTAGTTGGTTTAACGCGTAACT,AGGTATTAATCACGCGTTTGGAACAAGCTCGGCCCAAAGAATAGTTTGCTCAGATTAGGCTAGCTTCAGGGGTCACTAAAAAAATTCTAGTTGGTTTAA,10,30,14,27,27,46,27,55,27,36,36,46,45,55,22.62,4.654050243
hek293t,11649,1,7,GTGCATCTTACAGACTTAGTTCTATATGTAGGCAGAGGCAGATTCTGGACTGAAGCCATTCATTTAAAAAAATTCTAGTTGGTTTAACGCGTAACTAGA,GTGCATCTTACAGACTTAGTTCTATATGTAGGCAGAGGCACGGATAGGATTCTGGACTGAAGCCATTCATTTAAAAAAATTCTAGTTGGTTTAACGCGT,10,30,14,27,27,51,27,58,27,41,41,51,48,58,65.3,2.482708511
hek293t,12551,1,11,CAGTTGCATTTCCCTAGTTCAGTCCAAGGAGGGTTAGGTGATACATGGAAGTAGAAAGTTTTCAGGAGTGAAAAAAAATTCTAGTTGGTTTAACGCGTA,CAGTTGCATTTCCCTAGTTCAGTCCAAGGAGGGTTAGATGGAACGACGGTGATACATGGAAGTAGAAAGTTTTCAGGAGTGAAAAAAAATTCTAGTTGG,10,30,14,27,27,41,27,52,27,38,38,41,49,52,70.52,0.0
hek293t,22644,1,14,GCGGTGTCTCAACTTCTCTGGTGCAGGGGTGGGTTAGCAATACAGCCACATTTATCAAGTCAGCATAGTGTGTTTCAGCAAAAAAATTCTAGTTGGTTT,GCGGTGTCTCAACTTCTCTGGTGCAGACCACGGCAGAAGTGGGTGGGTTAGCAATACAGCCACATTTATCAAGTCAGCATAGTGTGTTTCAGCAAAAAA,10,30,14,27,27,30,27,44,27,27,27,30,41,44,29.99,0.67001675
hek293t,22644,1,14,CGTTTGTCTCAACTTCTCTGGTGCAGGGGTGGGTTAGCAATACAGCCACATTTATCAAGTCAGCATAAAAAAAATTCTAGTTGGTTTAACGCGTAACTA,CGTTTGTCTCAACTTCTCTGGTGCAGACCACGGCAGAAGTGGGTGGGTTAGCAATACAGCCACATTTATCAAGTCAGCATAAAAAAAATTCTAGTTGGT,10,30,14,27,27,42,27,56,27,27,27,42,41,56,29.99,35.06008399
hek293t,284,1,12,GCTCAAGCTTTTTGATTACAGCAAGGAACTGGTTTTTAGTATTCTTATCCCAGTCTCTGTTCTTCAAAAAAATTCTAGTTGGTTTAACGCGTAACTAGA,GCTCAAGCTTTTTGATTACAGCAAGGAACTGGTTTGAATGAGGTCCGTTAGTATTCTTATCCCAGTCTCTGTTCTTCAAAAAAATTCTAGTTGGTTTAA,10,30,14,27,27,46,27,58,27,36,36,46,48,58,10.18,0.309290596
hek293t,284,1,12,ATACCAGCTTTTTGATTACAGCAAGGAACTGGTTTTTAGTATTCTTATCCCAGTCTCTGTTCTTCTTACTCTAAAAAAATTCTAGTTGGTTTAACGCGT,ATACCAGCTTTTTGATTACAGCAAGGAACTGGTTTGAATGAGGTCCGTTAGTATTCTTATCCCAGTCTCTGTTCTTCTTACTCTAAAAAAATTCTAGTT,10,30,14,27,27,39,27,51,27,36,36,39,48,51,10.18,0.0
hek293t,11655,1,10,CGCATGGTTCTCAGAAGAGGCCATTGCCATGGCAGATGACTGATCTTTCCATTCATCCCTTTTGGTCTCTACAAAAAAATTCTAGTTGGTTTAACGCGT,CGCATGGTTCTCAGAAGAGGCCATTGCCATATGTGCTGGGGGCAGATGACTGATCTTTCCATTCATCCCTTTTGGTCTCTACAAAAAAATTCTAGTTGG,10,30,14,27,27,41,27,51,27,31,31,41,41,51,63.02,53.20880216
hek293t,11655,1,10,CTGTCGGTTCTCAGAAGAGGCCATTGCCATGGCAGATGACTGATCTTTCCATTCATCCCTTTTGGTCAAAAAAATTCTAGTTGGTTTAACGCGTAACTA,CTGTCGGTTCTCAGAAGAGGCCATTGCCATATGTGCTGGGGGCAGATGACTGATCTTTCCATTCATCCCTTTTGGTCAAAAAAATTCTAGTTGGTTTAA,10,30,14,27,27,46,27,56,27,31,31,46,41,56,63.02,40.81899339
hek293t,11657,1,3,CGATATGCAGTTTGTCAAGGCAATAGGAAAGGGATTTTCAGCTTTTGGAAATGAGGATGAGTGTTGGTAAAAAAATTCTAGTTGGTTTAACGCGTAACT,CGATATGCAGTTTGTCAAGGCAATAGGAAAGGGATTTGGTTCAGCTTTTGGAAATGAGGATGAGTGTTGGTAAAAAAATTCTAGTTGGTTTAACGCGTA,10,30,14,27,27,52,27,55,27,37,37,52,40,55,34.91,30.48745164
hek293t,11659,1,14,ACGCGGGACTGCAATTGATTTGCTTCCAGTGGGTCTGTATGATAAAAATGAAGCAATAATGGCTATTTAAATGAAAAAAATTCTAGTTGGTTTAACGCG,ACGCGGGACTGCAATTGATTTGCTTCCATGGCTATCGCAGATGTGGGTCTGTATGATAAAAATGAAGCAATAATGGCTATTTAAATGAAAAAAATTCTA,10,30,14,27,27,36,27,50,27,29,29,36,43,50,16.75,0.331446046
hek293t,11659,1,14,GGAGTGGACTGCAATTGATTTGCTTCCAGTGGGTCTGTATGATAAAAATGAAGCAATAATGGCTAAAAAAAATTCTAGTTGGTTTAACGCGTAACTAGA,GGAGTGGACTGCAATTGATTTGCTTCCATGGCTATCGCAGATGTGGGTCTGTATGATAAAAATGAAGCAATAATGGCTAAAAAAAATTCTAGTTGGTTT,10,30,14,27,27,44,27,58,27,29,29,44,43,58,16.75,4.451053564
hek293t,11661,1,10,TACCAGGAAGAAAAGGGGAGTGTTAAGCAAGGCTTGAAGCTCTTGCCATGAATTGCAAGTAACAGGAGAAGACATAAAAAAATTCTAGTTGGTTTAACG,TACCAGGAAGAAAAGGGGAGTGTTAAGGCACTCCTGCCAAGGCTTGAAGCTCTTGCCATGAATTGCAAGTAACAGGAGAAGACATAAAAAAATTCTAGT,10,30,14,27,27,38,27,48,27,28,28,38,38,48,58.85,8.043443908
hek293t,11661,1,10,TTTTAGGAAGAAAAGGGGAGTGTTAAGCAAGGCTTGAAGCTCTTGCCATGAATTGCAAGTAACAGGAGAAGACATCGTACAGAAAAAAATTCTAGTTGG,TTTTAGGAAGAAAAGGGGAGTGTTAAGGCACTCCTGCCAAGGCTTGAAGCTCTTGCCATGAATTGCAAGTAACAGGAGAAGACATCGTACAGAAAAAAA,10,30,14,27,27,31,27,41,27,28,28,31,38,41,58.85,0.0
hek293t,11663,1,3,GGGGATGGATGATGCAACAGATGATTCTGGGGTGTCACTGCGGCTGGAAGTCAGGAGGCCCCCCCCCCAAAAAAATTCTAGTTGGTTTAACGCGTAACT,GGGGATGGATGATGCAACAGATGATTCTGGGGTGTCAAGACTGCGGCTGGAAGTCAGGAGGCCCCCCCCCCAAAAAAATTCTAGTTGGTTTAACGCGTA,10,30,14,27,27,52,27,55,27,37,37,52,40,55,56.03,54.79686118
hek293t,11665,1,3,GGTGCTTACTTCTAGTACAACCGTAAAAAAGGCAGGAAAACTACTAGGTAAGTCCTTGGCCTGTGCTAAAAAAATTCTAGTTGGTTTAACGCGTAACTA,GGTGCTTACTTCTAGTACAACCGTAAAAAAGGCAGGAGACAAACTACTAGGTAAGTCCTTGGCCTGTGCTAAAAAAATTCTAGTTGGTTTAACGCGTAA,10,30,14,27,27,53,27,56,27,38,38,53,41,56,32.92,3.841315963
hek293t,11665,1,3,TCCTTTTACTTCTAGTACAACCGTAAAAAAGGCAGGAAAACTACTAGGTAAGTCCTTGGCCTGTGCTTATATCCCATAAAAAAAAATTCTAGTTGGTTT,TCCTTTTACTTCTAGTACAACCGTAAAAAAGGCAGGAGACAAACTACTAGGTAAGTCCTTGGCCTGTGCTTATATCCCATAAAAAAAAATTCTAGTTGG,10,30,14,27,27,41,27,44,27,38,38,41,41,44,32.92,0.0
hek293t,11669,1,8,GAAGGATTGGGCTTGACCAGAAAATCTACAGGGTCATGAATCTTTTTAGATCAGTGAAAACGAGGCTTAAAACATTCTGCAAAAAAATTCTAGTTGGTT,GAAGGATTGGGCTTGACCAGAAAATCTACAGGCACAAGCGGTCATGAATCTTTTTAGATCAGTGAAAACGAGGCTTAAAACATTCTGCAAAAAAATTCT,10,30,14,27,27,35,27,43,27,32,32,35,40,43,34.04,0.270124257
hek293t,11669,1,8,GATGAATTGGGCTTGACCAGAAAATCTACAGGGTCATGAATCTTTTTAGATCAGTGAAAACGAGGCTTAAAACAAAAAAATTCTAGTTGGTTTAACGCG,GATGAATTGGGCTTGACCAGAAAATCTACAGGCACAAGCGGTCATGAATCTTTTTAGATCAGTGAAAACGAGGCTTAAAACAAAAAAATTCTAGTTGGT,10,30,14,27,27,42,27,50,27,32,32,42,40,50,34.04,6.353603849
hek293t,11671,1,10,GCAACTGCTCGCATCAGAACAAACTGAGAAGGCATTTCACACATAGGGGCTTTCGCTCTGGTTTAACACGGACATCCAAAAAAAAATTCTAGTTGGTTT,GCAACTGCTCGCATCAGAACAAACTGAGAAATTACTTGCGGGCATTTCACACATAGGGGCTTTCGCTCTGGTTTAACACGGACATCCAAAAAAAAATTC,10,30,14,27,27,34,27,44,27,31,31,34,41,44,36.75,0.0
hek293t,11671,1,10,AGATATGCTCGCATCAGAACAAACTGAGAAGGCATTTCACACATAGGGGCTTTCGCTCTGGTTTAACACGGACATAAAAAAATTCTAGTTGGTTTAACG,AGATATGCTCGCATCAGAACAAACTGAGAAATTACTTGCGGGCATTTCACACATAGGGGCTTTCGCTCTGGTTTAACACGGACATAAAAAAATTCTAGT,10,30,14,27,27,38,27,48,27,31,31,38,41,48,36.75,1.146961451
hek293t,11673,1,4,AATACTATAATTTGTTTTACAGTGATGAGCGGATCCTTTAGACGGATACATTAAGGCCTTCTCCTCAAACTGGATTGATTTTTCAAAAAAATTCTAGTT,AATACTATAATTTGTTTTACAGTGATGAGCGCGTTGATCCTTTAGACGGATACATTAAGGCCTTCTCCTCAAACTGGATTGATTTTTCAAAAAAATTCT,10,30,14,27,27,35,27,39,27,32,32,35,36,39,38.68,0.375375375
hek293t,11673,1,4,TTGAATATAATTTGTTTTACAGTGATGAGCGGATCCTTTAGACGGATACATTAAGGCCTTCTCCTCAAACTGGATTGAAAAAAATTCTAGTTGGTTTAA,TTGAATATAATTTGTTTTACAGTGATGAGCGCGTTGATCCTTTAGACGGATACATTAAGGCCTTCTCCTCAAACTGGATTGAAAAAAATTCTAGTTGGT,10,30,14,27,27,42,27,46,27,32,32,42,36,46,38.68,71.61219084
hek293t,11675,1,8,GGCGTCCATTGTTTTAGTACAGGCTATTTAGGGACAAACAGTCCTTGGCAATGACTTTAATAGTAAAAAAAATTCTAGTTGGTTTAACGCGTAACTAGA,GGCGTCCATTGTTTTAGTACAGGCTATTTAGGGACAAACGCAGCAAGAGTCCTTGGCAATGACTTTAATAGTAAAAAAAATTCTAGTTGGTTTAACGCG,10,30,14,27,27,50,27,58,27,40,40,50,48,58,5.35,8.759905024
hek293t,11675,1,8,AAGGTCCATTGTTTTAGTACAGGCTATTTAGGGACAAACAGTCCTTGGCAATGACTTTAATAGTACATAAAAAAATTCTAGTTGGTTTAACGCGTAACT,AAGGTCCATTGTTTTAGTACAGGCTATTTAGGGACAAACGCAGCAAGAGTCCTTGGCAATGACTTTAATAGTACATAAAAAAATTCTAGTTGGTTTAAC,10,30,14,27,27,47,27,55,27,40,40,47,48,55,5.35,1.437672437
hek293t,4155,1,2,CCCTGCCCCCCCCTAAAGTTGTCTGTAGCTGGTGGAAGCCCAGGAGAATCAATCATGCTATAAAGGTGAGGAAAAAAAAATTCTAGTTGGTTTAACGCG,CCCTGCCCCCCCCTAAAGTTGTCTGTAGCTGGTTTGGAAGCCCAGGAGAATCAATCATGCTATAAAGGTGAGGAAAAAAAAATTCTAGTTGGTTTAACG,10,30,14,27,27,48,27,50,27,33,33,48,35,50,14.13,47.62347599
hek293t,11679,1,2,CGAGCCAAACCTCACTTTCAGGCATTCCATGGATGTCAACACTTGAAGAATATAAACAACCTGGTTGTTTCAGGGCAAAAAAATTCTAGTTGGTTTAAC,CGAGCCAAACCTCACTTTCAGGCATTCCATGGATGTGTCAACACTTGAAGAATATAAACAACCTGGTTGTTTCAGGGCAAAAAAATTCTAGTTGGTTTA,10,30,14,27,27,45,27,47,27,35,35,45,37,47,42.06,85.87520809
hek293t,11679,1,2,TGATTCAAACCTCACTTTCAGGCATTCCATGGATGTCAACACTTGAAGAATATAAACAACCTGGTTGTTTCAAAAAAATTCTAGTTGGTTTAACGCGTA,TGATTCAAACCTCACTTTCAGGCATTCCATGGATGTGTCAACACTTGAAGAATATAAACAACCTGGTTGTTTCAAAAAAATTCTAGTTGGTTTAACGCG,10,30,14,27,27,50,27,52,27,35,35,50,37,52,42.06,82.86081907
hek293t,11681,1,15,GAGCGGGCTGTTTCAAGCATACCCAAGACAGGAAGAAACCTGAGATAAACATGTACAAATTGCGTATTGTAGAAAAAAAATTCTAGTTGGTTTAACGCG,GAGCGGGCTGTTTCAAGCATACCCAAGACAGCGTATACTCTTACTCGAAGAAACCTGAGATAAACATGTACAAATTGCGTATTGTAGAAAAAAAATTCT,10,30,14,27,27,35,27,50,27,32,32,35,47,50,59.45,0.553250346
hek293t,11682,1,4,TTCCCTATATTTGTTTTACCTATACCATTTGGCTGCCTAGCTTCAGAGAAAGCTTTTTTGTGGATGTGTCAATAAAAAAATTCTAGTTGGTTTAACGCG,TTCCCTATATTTGTTTTACCTATACCATTTGGCTGCCTGACCAGCTTCAGAGAAAGCTTTTTTGTGGATGTGTCAATAAAAAAATTCTAGTTGGTTTAA,10,30,14,27,27,46,27,50,27,39,39,46,43,50,13.65,50.85859452
hek293t,11682,1,4,TGAATTATATTTGTTTTACCTATACCATTTGGCTGCCTAGCTTCAGAGAAAGCTTTTTTGTGGATGTGTCAATACTAAAAAAAATTCTAGTTGGTTTAA,TGAATTATATTTGTTTTACCTATACCATTTGGCTGCCTGACCAGCTTCAGAGAAAGCTTTTTTGTGGATGTGTCAATACTAAAAAAAATTCTAGTTGGT,10,30,14,27,27,42,27,46,27,39,39,42,43,46,13.65,0.0
hek293t,11684,1,14,CATCATTTAACTGTTCTTTATGTTTGTGAAGGGGAAAAAAGGAAAGGTTAAGGACAGCAAACTTTGAAAAAAATTCTAGTTGGTTTAACGCGTAACTAG,CATCATTTAACTGTTCTTTATGTTTGTGAAGGGGATCCTTCTTATGCGAAAAAAGGAAAGGTTAAGGACAGCAAACTTTGAAAAAAATTCTAGTTGGTT,10,30,14,27,27,43,27,57,27,36,36,43,50,57,14.21,0.0
hek293t,11685,1,12,CTTGCGTACTGCAGCAGATGTTTAAGTAAAGGTTGCACATTTTTCCTCTTTGGATCAGGGTGGAAAAAAAAAATTCTAGTTGGTTTAACGCGTAACTAG,CTTGCGTACTGCAGCAGATGTTTAAGTAAAGGTTTCTTGATCACTGGCACATTTTTCCTCTTTGGATCAGGGTGGAAAAAAAAAATTCTAGTTGGTTTA,10,30,14,27,27,45,27,57,27,35,35,45,47,57,22.04,1.194846161
hek293t,11685,1,12,GTTAAGTACTGCAGCAGATGTTTAAGTAAAGGTTGCACATTTTTCCTCTTTGGATCAGGGTGGAAAATTAAAAAAATTCTAGTTGGTTTAACGCGTAAC,GTTAAGTACTGCAGCAGATGTTTAAGTAAAGGTTTCTTGATCACTGGCACATTTTTCCTCTTTGGATCAGGGTGGAAAATTAAAAAAATTCTAGTTGGT,10,30,14,27,27,42,27,54,27,35,35,42,47,54,22.04,0.29739429
hek293t,11687,1,10,AATCACTCTCAAAGTAAATTTTTGACCAAAGGATGTATTCCTATTTAACTGCATAACCTTGCCAGAAACCTTGGCTTAAAAAAATTCTAGTTGGTTTAA,AATCACTCTCAAAGTAAATTTTTGACCAAAGGTGTGCATTATATGTATTCCTATTTAACTGCATAACCTTGCCAGAAACCTTGGCTTAAAAAAATTCTA,10,30,14,27,27,36,27,46,27,33,33,36,43,46,-0.18,0.0
hek293t,11687,1,10,CGCACCTCTCAAAGTAAATTTTTGACCAAAGGATGTATTCCTATTTAACTGCATAACCTTGCCAGAAACCAAAAAAATTCTAGTTGGTTTAACGCGTAA,CGCACCTCTCAAAGTAAATTTTTGACCAAAGGTGTGCATTATATGTATTCCTATTTAACTGCATAACCTTGCCAGAAACCAAAAAAATTCTAGTTGGTT,10,30,14,27,27,43,27,53,27,33,33,43,43,53,-0.18,0.0
hek293t,11689,1,5,GAGACTTCTTACTTCTAATAGTAATACAAAGGGCTTTTTCTCATAGACAATTGGTTGAATCAGGACTAACAGAACATGAAAAAAAAATTCTAGTTGGTT,GAGACTTCTTACTTCTAATAGTAATACCTGCCAAAGGGCTTTTTCTCATAGACAATTGGTTGAATCAGGACTAACAGAACATGAAAAAAAAATTCTAGT,10,30,14,27,27,38,27,43,27,28,28,38,33,43,45.65,2.936770335
hek293t,11689,1,5,CGACATTCTTACTTCTAATAGTAATACAAAGGGCTTTTTCTCATAGACAATTGGTTGAATCAGGACTAACAGAACAAAAAAATTCTAGTTGGTTTAACG,CGACATTCTTACTTCTAATAGTAATACCTGCCAAAGGGCTTTTTCTCATAGACAATTGGTTGAATCAGGACTAACAGAACAAAAAAATTCTAGTTGGTT,10,30,14,27,27,43,27,48,27,28,28,43,33,48,45.65,2.178750468
hek293t,11693,1,12,GGTCAAAGAACAGTAATTGCACGTTTGCCAGGAAGGATCTTCACAATGGGATTAGGAATGTAACTTCAGAAGAAAAAAATTCTAGTTGGTTTAACGCGT,GGTCAAAGAACAGTAATTGCACGTTTGCACGACAGCAACACAGGAAGGATCTTCACAATGGGATTAGGAATGTAACTTCAGAAGAAAAAAATTCTAGTT,10,30,14,27,27,39,27,51,27,29,29,39,41,51,30.38,3.094902314
hek293t,11693,1,12,TTCACAAGAACAGTAATTGCACGTTTGCCAGGAAGGATCTTCACAATGGGATTAGGAATGTAACTTCAAAAAAATTCTAGTTGGTTTAACGCGTAACTA,TTCACAAGAACAGTAATTGCACGTTTGCACGACAGCAACACAGGAAGGATCTTCACAATGGGATTAGGAATGTAACTTCAAAAAAATTCTAGTTGGTTT,10,30,14,27,27,44,27,56,27,29,29,44,41,56,30.38,9.210034683
hek293t,11695,1,5,ACACGGGTGACTGCAAGGCACAGGGCACACGGAGGAACAGTTCAGCAGCCTGGCTTCCATAGAGGATTATAATCAAAAAAAATTCTAGTTGGTTTAACG,ACACGGGTGACTGCAAGGCACAGGGCACACGGAGGAACAAGGCGGTTCAGCAGCCTGGCTTCCATAGAGGATTATAATCAAAAAAAATTCTAGTTGGTT,10,30,14,27,27,43,27,48,27,40,40,43,45,48,63.62,3.551784849
hek293t,11698,1,3,GGCGTCATACTAACATAGCACTGGAAGGGAGGGAAATTCATCACTTTGATTTCTGTTGTGCCATTTCTGTTTCAGAAAAAAATTCTAGTTGGTTTAACG,GGCGTCATACTAACATAGCACTGGAAGGGAATAGGGAAATTCATCACTTTGATTTCTGTTGTGCCATTTCTGTTTCAGAAAAAAATTCTAGTTGGTTTA,10,30,14,27,27,45,27,48,27,30,30,45,33,48,59.9,41.96611917
hek293t,11698,1,3,AGTGTCATACTAACATAGCACTGGAAGGGAGGGAAATTCATCACTTTGATTTCTGTTGTGCCATTTCTGTTTCAGGATCTTTACAATAAAAAAATTCTA,AGTGTCATACTAACATAGCACTGGAAGGGAATAGGGAAATTCATCACTTTGATTTCTGTTGTGCCATTTCTGTTTCAGGATCTTTACAATAAAAAAATT,10,30,14,27,27,33,27,36,27,30,30,33,33,36,59.9,0.838926174
hek293t,11702,1,13,TGCGAAGTGGCATTCAATGGCAGAAAGATTGGGCAATCAATGAAACAAAACAGGAGCTTCGTTTTGAGACAAAAAAATTCTAGTTGGTTTAACGCGTAA,TGCGAAGTGGCATTCAATGGCAGAAAGATTGGGCAACTCTTGCACGCTCTCAATGAAACAAAACAGGAGCTTCGTTTTGAGACAAAAAAATTCTAGTTG,10,30,14,27,27,40,27,53,27,37,37,40,50,53,25.04,0.0
hek293t,11704,1,2,CATTCAAAGCCATAGTTATTTGTTCCTTGAGGAATGTTTATTATAAAGAAGTATTGGAAACAGATGATTTACATCCTAAAAAAAATTCTAGTTGGTTTA,CATTCAAAGCCATAGTTATTTGTTCCTTGAGGAATCTGTTTATTATAAAGAAGTATTGGAAACAGATGATTTACATCCTAAAAAAAATTCTAGTTGGTT,10,30,14,27,27,43,27,45,27,36,36,43,38,45,24.33,68.19496181
hek293t,11704,1,2,ACACCAAAGCCATAGTTATTTGTTCCTTGAGGAATGTTTATTATAAAGAAGTATTGGAAACAGATGATTTACATCAAAAAAATTCTAGTTGGTTTAACG,ACACCAAAGCCATAGTTATTTGTTCCTTGAGGAATCTGTTTATTATAAAGAAGTATTGGAAACAGATGATTTACATCAAAAAAATTCTAGTTGGTTTAA,10,30,14,27,27,46,27,48,27,36,36,46,38,48,24.33,63.64990213
hek293t,11706,1,15,CTGTATAGCAGATAATCTCCAGTACTATGTGGTTCAACATTAATTTGGTGAAAAATTGATTAATTACCAACAGTGCTAAAAAAATTCTAGTTGGTTTAA,CTGTATAGCAGATAATCTCCAGTACTACGTCCAGCTTCAGGTTGTGGTTCAACATTAATTTGGTGAAAAATTGATTAATTACCAACAGTGCTAAAAAAA,10,30,14,27,27,31,27,46,27,28,28,31,43,46,67.41,2.061416255
hek293t,11706,1,15,TGCTATAGCAGATAATCTCCAGTACTATGTGGTTCAACATTAATTTGGTGAAAAATTGATTAATTACCAACAGAAAAAAATTCTAGTTGGTTTAACGCG,TGCTATAGCAGATAATCTCCAGTACTACGTCCAGCTTCAGGTTGTGGTTCAACATTAATTTGGTGAAAAATTGATTAATTACCAACAGAAAAAAATTCT,10,30,14,27,27,35,27,50,27,28,28,35,43,50,67.41,3.482474009
hek293t,11708,1,8,TCATACTGATGCTATTAGTACAGACCTTGAGGCCCTCAAATACTAGGTGGTGATTTAATGTTCTTAGGACAGGAAAAAAATTCTAGTTGGTTTAACGCG,TCATACTGATGCTATTAGTACAGACCGTTGACTTTTGAGGCCCTCAAATACTAGGTGGTGATTTAATGTTCTTAGGACAGGAAAAAAATTCTAGTTGGT,10,30,14,27,27,42,27,50,27,27,27,42,35,50,30.71,15.69379487
hek293t,11708,1,8,TGGCCCTGATGCTATTAGTACAGACCTTGAGGCCCTCAAATACTAGGTGGTGATTTAATGTTCTTAGGACAGGATTCAAAAAAAATTCTAGTTGGTTTA,TGGCCCTGATGCTATTAGTACAGACCGTTGACTTTTGAGGCCCTCAAATACTAGGTGGTGATTTAATGTTCTTAGGACAGGATTCAAAAAAAATTCTAG,10,30,14,27,27,37,27,45,27,27,27,37,35,45,30.71,7.40346034
hek293t,11710,1,15,TGATACCAAGGTCCCTCAGAGTCTTTTCCAGGTGAAAGGAATGAGTAGAAATAACAGGGAGCCCCCCCGCAAGCAAAAAAAAATTCTAGTTGGTTTAAC,TGATACCAAGGTCCCTCAGAGTCTTTTCGGTTTATGAAGCCATCAGGTGAAAGGAATGAGTAGAAATAACAGGGAGCCCCCCCGCAAGCAAAAAAAAAT,10,30,14,27,27,32,27,47,27,29,29,32,44,47,18.74,0.0
hek293t,11710,1,15,TGTCTCCAAGGTCCCTCAGAGTCTTTTCCAGGTGAAAGGAATGAGTAGAAATAACAGGGAGCCCAAAAAAATTCTAGTTGGTTTAACGCGTAACTAGAT,TGTCTCCAAGGTCCCTCAGAGTCTTTTCGGTTTATGAAGCCATCAGGTGAAAGGAATGAGTAGAAATAACAGGGAGCCCAAAAAAATTCTAGTTGGTTT,10,30,14,27,27,44,27,59,27,29,29,44,44,59,18.74,2.747810098
hek293t,11712,1,2,CATCAAAAGCTGAACATTAGGAGGCTATCAGGTTGCCACGCAGCTCTGGAAATTATATGCCCGAGTTGGACAGTAAAAAAATTCTAGTTGGTTTAACGC,CATCAAAAGCTGAACATTAGGAGGCTATCAGCGGTTGCCACGCAGCTCTGGAAATTATATGCCCGAGTTGGACAGTAAAAAAATTCTAGTTGGTTTAAC,10,30,14,27,27,47,27,49,27,32,32,47,34,49,27.0,83.65233844
hek293t,11712,1,2,AGGTAAAAGCTGAACATTAGGAGGCTATCAGGTTGCCACGCAGCTCTGGAAATTATATGCCCGAGTTGGACAGTCACTCAAAAAAATTCTAGTTGGTTT,AGGTAAAAGCTGAACATTAGGAGGCTATCAGCGGTTGCCACGCAGCTCTGGAAATTATATGCCCGAGTTGGACAGTCACTCAAAAAAATTCTAGTTGGT,10,30,14,27,27,42,27,44,27,32,32,42,34,44,27.0,88.44262529
hek293t,11714,1,1,TCACAAACAATAAAACTGCCTTATTTTTAAGGGACAAAATCAAAGCCTCTGTGAGGAGCCCTGGGCTTTGGCCCCTCTCCAAAAAAATTCTAGTTGGTT,TCACAAACAATAAAACTGCCTTATTTTTAAGCGGACAAAATCAAAGCCTCTGTGAGGAGCCCTGGGCTTTGGCCCCTCTCCAAAAAAATTCTAGTTGGT,10,30,14,27,27,42,27,43,27,32,32,42,33,43,-0.06,0.216450216
hek293t,11714,1,1,TCTTCAACAATAAAACTGCCTTATTTTTAAGGGACAAAATCAAAGCCTCTGTGAGGAGCCCTGGGCTTTGGCCCCTCTCCGCCGGGGAAAAAAATTCTA,TCTTCAACAATAAAACTGCCTTATTTTTAAGCGGACAAAATCAAAGCCTCTGTGAGGAGCCCTGGGCTTTGGCCCCTCTCCGCCGGGGAAAAAAATTCT,10,30,14,27,27,35,27,36,27,32,32,35,33,36,-0.06,0.0
hek293t,11716,1,3,TCAATACCCTCGCAGGGTCAAAATCTTTGGGGCTGTCGGATACTTTTCGACCTGCCCCGGCATGGCACAAGTGAAAAAAAAATTCTAGTTGGTTTAACG,TCAATACCCTCGCAGGGTCAAAATCTTTGGGGCTTTCGTCGGATACTTTTCGACCTGCCCCGGCATGGCACAAGTGAAAAAAAAATTCTAGTTGGTTTA,10,30,14,27,27,45,27,48,27,35,35,45,38,48,36.97,9.053961613
hek293t,6312,1,9,TATACTCTATTTTCCTGCCCTGTTTAATCAGGCTGGAAGGAAAGCCACTCTGGTAATCTTATCTTTTGTTAAAAAAATTCTAGTTGGTTTAACGCGTAA,TATACTCTATTTTCCTGCCCTGTTTAATCAGGCTGGTCCTCGTACAAGGAAAGCCACTCTGGTAATCTTATCTTTTGTTAAAAAAATTCTAGTTGGTTT,10,30,14,27,27,44,27,53,27,37,37,44,46,53,7.58,13.16579181
hek293t,11720,1,14,CGCCGGCACTGGGGTAATTTTAAGTGCTTTGGCTCTGCCTGTGCTGTTTTTCGGAGGCCGCCCTGGGGCCAGTCAAAAAAATTCTAGTTGGTTTAACGC,CGCCGGCACTGGGGTAATTTTAAGTGCTTTGGTTCAAATCAGCCAGCTCTGCCTGTGCTGTTTTTCGGAGGCCGCCCTGGGGCCAGTCAAAAAAATTCT,10,30,14,27,27,35,27,49,27,32,32,35,46,49,11.11,0.0
hek293t,11721,1,10,GCCGCACTTTTTCGCTTGATCTGCCATTTCGGTTGTTCAAAAGACAGTGCACAATAAAGGCATACTAAAAAAATTCTAGTTGGTTTAACGCGTAACTAG,GCCGCACTTTTTCGCTTGATCTGCCATTTCGGTTGTTCAGTACCTATGAAAAGACAGTGCACAATAAAGGCATACTAAAAAAATTCTAGTTGGTTTAAC,10,30,14,27,27,47,27,57,27,40,40,47,50,57,5.5,0.509456751
hek293t,11724,1,4,GCGCTCATATAAGAAATGTGTAGTGGAGCAGGACACTGAATGTAATTTGCAGGAATCCAAAGAATTTGTCAAAAAAATTCTAGTTGGTTTAACGCGTAA,GCGCTCATATAAGAAATGTGTAGTGGAGCAGGACACTGAAGAAATGTAATTTGCAGGAATCCAAAGAATTTGTCAAAAAAATTCTAGTTGGTTTAACGC,10,30,14,27,27,49,27,53,27,39,39,49,43,53,37.83,6.836362597
hek293t,11724,1,4,CTACGCATATAAGAAATGTGTAGTGGAGCAGGACACTGAATGTAATTTGCAGGAATCCAAAGAATAAAAAAATTCTAGTTGGTTTAACGCGTAACTAGA,CTACGCATATAAGAAATGTGTAGTGGAGCAGGACACTGAAGAAATGTAATTTGCAGGAATCCAAAGAATAAAAAAATTCTAGTTGGTTTAACGCGTAAC,10,30,14,27,27,54,27,58,27,39,39,54,43,58,37.83,2.246838934
hek293t,11731,1,3,TCCACCTTAAATACTTGAAATGAATGGTCAGGAACATTAAATTAGCAACCAGCTATATTTCTTTTACTAATATCACAGATACAAAAAAATTCTAGTTGG,TCCACCTTAAATACTTGAAATGAATGGTCAGGAAAGGCATTAAATTAGCAACCAGCTATATTTCTTTTACTAATATCACAGATACAAAAAAATTCTAGT,10,30,14,27,27,38,27,41,27,35,35,38,38,41,46.67,0.024654832
hek293t,11731,1,3,AAGTGCTTAAATACTTGAAATGAATGGTCAGGAACATTAAATTAGCAACCAGCTATATTTCTTTTACTAATATCACAGAAAAAAATTCTAGTTGGTTTA,AAGTGCTTAAATACTTGAAATGAATGGTCAGGAAAGGCATTAAATTAGCAACCAGCTATATTTCTTTTACTAATATCACAGAAAAAAATTCTAGTTGGT,10,30,14,27,27,42,27,45,27,35,35,42,38,45,46.67,23.40835845
hek293t,7816,1,5,TTCGCAACTTTATGTTGGACAAAGGTACAAGGGAGTAGGAAGAAAGCTTCTTCCTCCTTGGGAAACAGCTGAGAACATGGAGTCCAAAAAAATTCTAGT,TTCGCAACTTTATGTTGGACAAAGGTACACTGGGAGGGAGTAGGAAGAAAGCTTCTTCCTCCTTGGGAAACAGCTGAGAACATGGAGTCCAAAAAAATT,10,30,14,27,27,33,27,38,27,30,30,33,35,38,45.19,0.53020347
hek293t,7816,1,5,AAGATAACTTTATGTTGGACAAAGGTACAAGGGAGTAGGAAGAAAGCTTCTTCCTCCTTGGGAAACAGCTGAGAAAAAAATTCTAGTTGGTTTAACGCG,AAGATAACTTTATGTTGGACAAAGGTACACTGGGAGGGAGTAGGAAGAAAGCTTCTTCCTCCTTGGGAAACAGCTGAGAAAAAAATTCTAGTTGGTTTA,10,30,14,27,27,45,27,50,27,30,30,45,35,50,45.19,48.81618905
hek293t,11737,1,6,GGAACCATCCAAGATTTTGAAGAACAGAAAGGAAAATGAGTGCTGATAGACACTTCTAGTGAAGTGTCAAATAACAGAAATGAAAAAAAATTCTAGTTG,GGAACCATCCAAGATTTTGAAGAACATACGTTGAAAGGAAAATGAGTGCTGATAGACACTTCTAGTGAAGTGTCAAATAACAGAAATGAAAAAAAATTC,10,30,14,27,27,34,27,40,27,27,27,34,33,40,21.25,4.177700568
hek293t,11737,1,6,ATACTCATCCAAGATTTTGAAGAACAGAAAGGAAAATGAGTGCTGATAGACACTTCTAGTGAAGTGTCAAATAACAGAAAAAAAAAATTCTAGTTGGTT,ATACTCATCCAAGATTTTGAAGAACATACGTTGAAAGGAAAATGAGTGCTGATAGACACTTCTAGTGAAGTGTCAAATAACAGAAAAAAAAAATTCTAG,10,30,14,27,27,37,27,43,27,27,27,37,33,43,21.25,4.495077232
hek293t,11739,1,9,GTATTTGCCAGATCTCCACTCAATTGTTTTGGCCTCTTATTTTTACTTTGAACATTTCCCTGATTCTGGACAGAAGTTACATTAAAAAAATTCTAGTTG,GTATTTGCCAGATCTCCACTCAATTGTGCTAGGGTTTTTGGCCTCTTATTTTTACTTTGAACATTTCCCTGATTCTGGACAGAAGTTACATTAAAAAAA,10,30,14,27,27,31,27,40,27,28,28,31,37,40,9.16,0.98774256
hek293t,11741,1,10,TAAAGGACTGAATTAAATGACTTCTCTTGGGGTTTCCTTGATTTGTTTTAAACTCCTTCCTGCAAAAAAAATTCTAGTTGGTTTAACGCGTAACTAGAT,TAAAGGACTGAATTAAATGACTTCTCTTGGGGTTTCCTGAGGTGCCGGTGATTTGTTTTAAACTCCTTCCTGCAAAAAAAATTCTAGTTGGTTTAACGC,10,30,14,27,27,49,27,59,27,39,39,49,49,59,30.97,0.996167441
hek293t,11741,1,10,CGCGTGACTGAATTAAATGACTTCTCTTGGGGTTTCCTTGATTTGTTTTAAACTCCTTCCTGCAAAGGACTAAAAAAATTCTAGTTGGTTTAACGCGTA,CGCGTGACTGAATTAAATGACTTCTCTTGGGGTTTCCTGAGGTGCCGGTGATTTGTTTTAAACTCCTTCCTGCAAAGGACTAAAAAAATTCTAGTTGGT,10,30,14,27,27,42,27,52,27,39,39,42,49,52,30.97,1.924659702
hek293t,11743,1,13,ACAGTATTGCTTGTTCTCGTAGGAGGAAGAGGGAAAGGTTTAACCTCCTCTAAACAGAAATTAAGCTTTGCAACAAAAAAATTCTAGTTGGTTTAACGC,ACAGTATTGCTTGTTCTCGTAGGAGGAACAGAGCTTGCGCGGAGGGAAAGGTTTAACCTCCTCTAAACAGAAATTAAGCTTTGCAACAAAAAAATTCTA,10,30,14,27,27,36,27,49,27,29,29,36,42,49,32.34,0.245098039
hek293t,11743,1,13,TCCTGATTGCTTGTTCTCGTAGGAGGAAGAGGGAAAGGTTTAACCTCCTCTAAACAGAAATTAAGCTTTGCAACTCTCAAAAAAATTCTAGTTGGTTTA,TCCTGATTGCTTGTTCTCGTAGGAGGAACAGAGCTTGCGCGGAGGGAAAGGTTTAACCTCCTCTAAACAGAAATTAAGCTTTGCAACTCTCAAAAAAAT,10,30,14,27,27,32,27,45,27,29,29,32,42,45,32.34,0.0
hek293t,11745,1,1,AGTACTCCTGAGTTAGCCAGACAAGCATGGGGGGAGTGGACACGGCTCAGCCCAACACAGAGTATAAAACCGAACAATGAACAGAAAAAAAAAAAATTC,AGTACTCCTGAGTTAGCCAGACAAGCATGAGGGGGAGTGGACACGGCTCAGCCCAACACAGAGTATAAAACCGAACAATGAACAGAAAAAAAAAAAATT,10,30,14,27,27,33,27,34,27,30,30,33,31,34,62.79,65.99729952
hek293t,11745,1,1,GGTACTCCTGAGTTAGCCAGACAAGCATGGGGGGAGTGGACACGGCTCAGCCCAACACAGAGTATAAAACCGAACAATGAACAGAAAAAAAATTCTAGT,GGTACTCCTGAGTTAGCCAGACAAGCATGAGGGGGAGTGGACACGGCTCAGCCCAACACAGAGTATAAAACCGAACAATGAACAGAAAAAAAATTCTAG,10,30,14,27,27,37,27,38,27,30,30,37,31,38,62.79,64.56419029
hek293t,11747,1,6,CGGGAAAATCACAGACCTCTGAGAACGATAGGAGACTCCCCGCTACCTATCGCAGCTTATCTCCTTCGTGTTAGGTAGCTGTAAAAAAATTCTAGTTGG,CGGGAAAATCACAGACCTCTGAGAACGTCTTGAATAGGAGACTCCCCGCTACCTATCGCAGCTTATCTCCTTCGTGTTAGGTAGCTGTAAAAAAATTCT,10,30,14,27,27,35,27,41,27,28,28,35,34,41,30.55,19.1812093
hek293t,11747,1,6,CGGCTAAATCACAGACCTCTGAGAACGATAGGAGACTCCCCGCTACCTATCGCAGCTTATCTCCTTCGTGTTAGGTAGCAAAAAAATTCTAGTTGGTTT,CGGCTAAATCACAGACCTCTGAGAACGTCTTGAATAGGAGACTCCCCGCTACCTATCGCAGCTTATCTCCTTCGTGTTAGGTAGCAAAAAAATTCTAGT,10,30,14,27,27,38,27,44,27,28,28,38,34,44,30.55,47.44297095
hek293t,19166,1,6,GAACCGCTTGTGTTAAATATGCTTTCAACAGGTGTTCAAGAAACAAAATAGTGTACTATTTTTCTCCCTGACTCCAGTAAAAAAATTCTAGTTGGTTTA,GAACCGCTTGTGTTAAATATGCTTTCAAAGAATGCAGGTGTTCAAGAAACAAAATAGTGTACTATTTTTCTCCCTGACTCCAGTAAAAAAATTCTAGTT,10,30,14,27,27,39,27,45,27,29,29,39,35,45,18.83,18.67010044
hek293t,19166,1,6,TCTAAGCTTGTGTTAAATATGCTTTCAACAGGTGTTCAAGAAACAAAATAGTGTACTATTTTTCTCCCTGACTAAAAAAATTCTAGTTGGTTTAACGCG,TCTAAGCTTGTGTTAAATATGCTTTCAAAGAATGCAGGTGTTCAAGAAACAAAATAGTGTACTATTTTTCTCCCTGACTAAAAAAATTCTAGTTGGTTT,10,30,14,27,27,44,27,50,27,29,29,44,35,50,18.83,8.989626531
hek293t,11757,1,9,GTGTTCATCAGTAGAAGAGAATGACCTCCAGGGAGGGAGTCAGAGCTCCTCAGTTAGGAACTACCTAGTTAAAAAAATTCTAGTTGGTTTAACGCGTAA,GTGTTCATCAGTAGAAGAGAATGACCTCCAGGGAGGCGAGGACCTGAGTCAGAGCTCCTCAGTTAGGAACTACCTAGTTAAAAAAATTCTAGTTGGTTT,10,30,14,27,27,44,27,53,27,37,37,44,46,53,43.01,0.327892965
hek293t,11758,1,2,TCGCCGCAGTTTGTCCTCAACAAACTTCTAGGCCAAAAGTAGTATCTGAGCAGGGTTTCTAGTCCTGGCTGAAACTCTGAACCATCTACGAAAAAAATT,TCGCCGCAGTTTGTCCTCAACAAACTTTCCTAGGCCAAAAGTAGTATCTGAGCAGGGTTTCTAGTCCTGGCTGAAACTCTGAACCATCTACGAAAAAAA,10,30,14,27,27,31,27,33,27,28,28,31,30,33,8.92,0.179372197
hek293t,11758,1,2,TGCCAGCAGTTTGTCCTCAACAAACTTCTAGGCCAAAAGTAGTATCTGAGCAGGGTTTCTAGTCCTGGCTGAAACTCTGAACCAAAAAAATTCTAGTTG,TGCCAGCAGTTTGTCCTCAACAAACTTTCCTAGGCCAAAAGTAGTATCTGAGCAGGGTTTCTAGTCCTGGCTGAAACTCTGAACCAAAAAAATTCTAGT,10,30,14,27,27,38,27,40,27,28,28,38,30,40,8.92,54.94212195
hek293t,11760,1,11,CATGTCATCCAACATTTTGGTATGAGCTTTGGGAAAATGCTGAACAAATCGAGCCCCAGATTTCGTAAAAAAATTCTAGTTGGTTTAACGCGTAACTAG,CATGTCATCCAACATTTTGGTATGAGCTTTGTCTTGCTCGGGGGAAAATGCTGAACAAATCGAGCCCCAGATTTCGTAAAAAAATTCTAGTTGGTTTAA,10,30,14,27,27,46,27,57,27,31,31,46,42,57,13.46,0.893004648
hek293t,11760,1,11,GCGTTCATCCAACATTTTGGTATGAGCTTTGGGAAAATGCTGAACAAATCGAGCCCCAGATTTCGTTCCTGTGCACATAAAAAAATTCTAGTTGGTTTA,GCGTTCATCCAACATTTTGGTATGAGCTTTGTCTTGCTCGGGGGAAAATGCTGAACAAATCGAGCCCCAGATTTCGTTCCTGTGCACATAAAAAAATTC,10,30,14,27,27,34,27,45,27,31,31,34,42,45,13.46,0.0
hek293t,15925,1,15,CGATCTGCAGATGCTCAAACATGATTTTCTGGAGGTGAAATTATTTTCATTCCCACCACAACCAAAAAAAATTCTAGTTGGTTTAACGCGTAACTAGAT,CGATCTGCAGATGCTCAAACATGATTTTACGGTTTTCAGTAAGCTGGAGGTGAAATTATTTTCATTCCCACCACAACCAAAAAAAATTCTAGTTGGTTT,10,30,14,27,27,44,27,59,27,29,29,44,44,59,4.74,4.399836886
hek293t,15925,1,15,ACGCGTGCAGATGCTCAAACATGATTTTCTGGAGGTGAAATTATTTTCATTCCCACCACAACCACTGTAAAAAAAATTCTAGTTGGTTTAACGCGTAAC,ACGCGTGCAGATGCTCAAACATGATTTTACGGTTTTCAGTAAGCTGGAGGTGAAATTATTTTCATTCCCACCACAACCACTGTAAAAAAAATTCTAGTT,10,30,14,27,27,39,27,54,27,29,29,39,44,54,4.74,1.246276096
hek293t,11764,1,7,ATTAGTAATCCTTATTTTGTTATTTTATTTGGCAGGGATCCCCTGGTTTCCGTGGCTTGCCGGGTAGCAAAAAAAATTCTAGTTGGTTTAACGCGTAAC,ATTAGTAATCCTTATTTTGTTATTTTATTTGCAGAGGAGCAGGGATCCCCTGGTTTCCGTGGCTTGCCGGGTAGCAAAAAAAATTCTAGTTGGTTTAAC,10,30,14,27,27,47,27,54,27,32,32,47,39,54,-0.82,0.0
hek293t,11764,1,7,AGTAGTAATCCTTATTTTGTTATTTTATTTGGCAGGGATCCCCTGGTTTCCGTGGCTTGCCGGGTAGCAATGGACTTAAAAAAATTCTAGTTGGTTTAA,AGTAGTAATCCTTATTTTGTTATTTTATTTGCAGAGGAGCAGGGATCCCCTGGTTTCCGTGGCTTGCCGGGTAGCAATGGACTTAAAAAAATTCTAGTT,10,30,14,27,27,39,27,46,27,32,32,39,39,46,-0.82,0.0
hek293t,11766,1,3,TTTGGAAAGGTTCAGGCTGATTAACAAAATGGCAGTAAGCGGCTGCATGGGGGCAGGTGGCTGCAGGACGGACAAAGAAAAAAATTCTAGTTGGTTTAA,TTTGGAAAGGTTCAGGCTGATTAACAAAATGGCAGTAAGCTTCGGCTGCATGGGGGCAGGTGGCTGCAGGACGGACAAAGAAAAAAATTCTAGTTGGTT,10,30,14,27,27,43,27,46,27,40,40,43,43,46,50.32,0.015089784
hek293t,11766,1,3,CTGAGAAAGGTTCAGGCTGATTAACAAAATGGCAGTAAGCGGCTGCATGGGGGCAGGTGGCTGCAAAAAAAATTCTAGTTGGTTTAACGCGTAACTAGA,CTGAGAAAGGTTCAGGCTGATTAACAAAATGGCAGTAAGCTTCGGCTGCATGGGGGCAGGTGGCTGCAAAAAAAATTCTAGTTGGTTTAACGCGTAACT,10,30,14,27,27,55,27,58,27,40,40,55,43,58,50.32,19.8156463
hek293t,11768,1,7,ACCCACCCACACGAGAGAAAAGGTGACCAAGGAACGATGTATGCAGCTGAGTAAAGAGCTTAACAGAGTGATTTAAAAAAATTCTAGTTGGTTTAACGC,ACCCACCCACACGAGAGAAAAGGTGACCAAGGAACGATCTACGTTGTATGCAGCTGAGTAAAGAGCTTAACAGAGTGATTTAAAAAAATTCTAGTTGGT,10,30,14,27,27,42,27,49,27,39,39,42,46,49,70.82,0.0
hek293t,11768,1,7,ACAACCCCACACGAGAGAAAAGGTGACCAAGGAACGATGTATGCAGCTGAGTAAAGAGCTTAACAGAAAAAAAATTCTAGTTGGTTTAACGCGTAACTA,ACAACCCCACACGAGAGAAAAGGTGACCAAGGAACGATCTACGTTGTATGCAGCTGAGTAAAGAGCTTAACAGAAAAAAAATTCTAGTTGGTTTAACGC,10,30,14,27,27,49,27,56,27,39,39,49,46,56,70.82,0.316770889
hek293t,11770,1,10,TTACTCAACAAATGGGAATCTGTCAGAGGAGGAGAGGCATCACTGGCCATACAACCCTGGGAATTCAATAAAAAAATTCTAGTTGGTTTAACGCGTAAC,TTACTCAACAAATGGGAATCTGTCAGAGGAGGAGAGGGTGATTCTGGCATCACTGGCCATACAACCCTGGGAATTCAATAAAAAAATTCTAGTTGGTTT,10,30,14,27,27,44,27,54,27,37,37,44,47,54,61.42,2.532949681
hek293t,11770,1,10,GTGGGCAACAAATGGGAATCTGTCAGAGGAGGAGAGGCATCACTGGCCATACAACCCTGGGAATTCAAAAAAATTCTAGTTGGTTTAACGCGTAACTAG,GTGGGCAACAAATGGGAATCTGTCAGAGGAGGAGAGGGTGATTCTGGCATCACTGGCCATACAACCCTGGGAATTCAAAAAAATTCTAGTTGGTTTAAC,10,30,14,27,27,47,27,57,27,37,37,47,47,57,61.42,13.65869542
hek293t,11772,1,8,TAGTATTCTCTCTGACTAAAATAAGTATTTGGTATTTGATAGAAGTCACAAAGTGTTTTACTATTCTGGTTGCTAAAAAAATTCTAGTTGGTTTAACGC,TAGTATTCTCTCTGACTAAAATAAGTATTTGGTATTTGCTGCTCTGATAGAAGTCACAAAGTGTTTTACTATTCTGGTTGCTAAAAAAATTCTAGTTGG,10,30,14,27,27,41,27,49,27,38,38,41,46,49,4.5,0.0
hek293t,11772,1,8,GTTCATTCTCTCTGACTAAAATAAGTATTTGGTATTTGATAGAAGTCACAAAGTGTTTTACTATTCTGGTAAAAAAATTCTAGTTGGTTTAACGCGTAA,GTTCATTCTCTCTGACTAAAATAAGTATTTGGTATTTGCTGCTCTGATAGAAGTCACAAAGTGTTTTACTATTCTGGTAAAAAAATTCTAGTTGGTTTA,10,30,14,27,27,45,27,53,27,38,38,45,46,53,4.5,0.0
hek293t,18571,1,12,CCTGCAGAAGATTTAATTAGGATACACTTTGGGTTACCAAATTGACGTAAAAGAAGTGAGAGAGGAAGAAAAAAAAAAATTCTAGTTGGTTTAACGCGT,CCTGCAGAAGATTTAATTAGGATACACTTTGACTGACGCTATTGGTTACCAAATTGACGTAAAAGAAGTGAGAGAGGAAGAAAAAAAAAAATTCTAGTT,10,30,14,27,27,39,27,51,27,32,32,39,44,51,39.3,0.306749519
hek293t,11781,1,10,AAAAGTGCCAGAAGATTGAAGAGCTTGGTTGGTTGTTTTTCAAACCACTGACGTTTTCCCCTCTCAAAAAAATTCTAGTTGGTTTAACGCGTAACTAGA,AAAAGTGCCAGAAGATTGAAGAGCTTGGTTGGTTGTTATTCCCATGATTTCAAACCACTGACGTTTTCCCCTCTCAAAAAAATTCTAGTTGGTTTAACG,10,30,14,27,27,48,27,58,27,38,38,48,48,58,49.41,0.969732407
hek293t,11782,1,12,TTGTGACATGAAAGCAATAACGTGGCCCCAGGGAATGCTTCCCCCTGGACCCTAATAATCACTACTGGAAAAAAATTCTAGTTGGTTTAACGCGTAACT,TTGTGACATGAAAGCAATAACGTGGCCCCAGGACTCAGCTTTCTGAATGCTTCCCCCTGGACCCTAATAATCACTACTGGAAAAAAATTCTAGTTGGTT,10,30,14,27,27,43,27,55,27,33,33,43,45,55,54.94,39.59436164
hek293t,11782,1,12,GTTCCACATGAAAGCAATAACGTGGCCCCAGGGAATGCTTCCCCCTGGACCCTAATAATCACTACTGGTCCTTAAAAAAAAATTCTAGTTGGTTTAACG,GTTCCACATGAAAGCAATAACGTGGCCCCAGGACTCAGCTTTCTGAATGCTTCCCCCTGGACCCTAATAATCACTACTGGTCCTTAAAAAAAAATTCTA,10,30,14,27,27,36,27,48,27,33,33,36,45,48,54.94,1.445018194
hek293t,11784,1,15,TTAAAGAATCCTAAGTCTGCTACAGTATATGGAGGAATTATAACATTTCCATTGAAATTGAATAATGTAAAAAAATTCTAGTTGGTTTAACGCGTAACT,TTAAAGAATCCTAAGTCTGCTACAGTATATGCAGAAGGGCGAGCTGGAGGAATTATAACATTTCCATTGAAATTGAATAATGTAAAAAAATTCTAGTTG,10,30,14,27,27,40,27,55,27,30,30,40,45,55,28.46,1.162018095
hek293t,4051,1,12,AGTACCTTCATGTGAGAACACTTACAACCTGGCAAGGAGGAAATCATCGCATTTAGACATGAACTGTCTGTCATCCCTAAAAAAATTCTAGTTGGTTTA,AGTACCTTCATGTGAGAACACTTACAACCTTCCGCGCTGCTTGGCAAGGAGGAAATCATCGCATTTAGACATGAACTGTCTGTCATCCCTAAAAAAATT,10,30,14,27,27,33,27,45,27,30,30,33,42,45,61.42,0.700017031
hek293t,4051,1,12,GTGCCCTTCATGTGAGAACACTTACAACCTGGCAAGGAGGAAATCATCGCATTTAGACATGAACTGTCTGTCATAAAAAAATTCTAGTTGGTTTAACGC,GTGCCCTTCATGTGAGAACACTTACAACCTTCCGCGCTGCTTGGCAAGGAGGAAATCATCGCATTTAGACATGAACTGTCTGTCATAAAAAAATTCTAG,10,30,14,27,27,37,27,49,27,30,30,37,42,49,61.42,4.141531332
hek293t,11788,1,12,CCGGATATAGTAATCTAAATAAACTGAATTGGACTCTTGCAGTTCAAAAATACAAGTTTAAGAGTACAAAAAAATTCTAGTTGGTTTAACGCGTAACTA,CCGGATATAGTAATCTAAATAAACTGAATTGGACTCTTGCGGCCGAAGTTGTAGTTCAAAAATACAAGTTTAAGAGTACAAAAAAATTCTAGTTGGTTT,10,30,14,27,27,44,27,56,27,41,41,44,53,56,5.15,0.0
hek293t,21753,1,3,TACTGTGCACTGATTAATCACAGAAACACAGGACTGGAAAGTACCTCCTGCATTATGTTCTGAGGTAGAGAGCATAAAAAAATTCTAGTTGGTTTAACG,TACTGTGCACTGATTAATCACAGAAACACATTAGGACTGGAAAGTACCTCCTGCATTATGTTCTGAGGTAGAGAGCATAAAAAAATTCTAGTTGGTTTA,10,30,14,27,27,45,27,48,27,30,30,45,33,48,56.31,5.966512966
hek293t,21753,1,3,TCGACTGCACTGATTAATCACAGAAACACAGGACTGGAAAGTACCTCCTGCATTATGTTCTGAGGTAGAGAGCATTACCTTCCAAAAAAATTCTAGTTG,TCGACTGCACTGATTAATCACAGAAACACATTAGGACTGGAAAGTACCTCCTGCATTATGTTCTGAGGTAGAGAGCATTACCTTCCAAAAAAATTCTAG,10,30,14,27,27,37,27,40,27,30,30,37,33,40,56.31,7.493601862
hek293t,11791,1,3,AATGCACTGCACTACCCTCAGCTTACATGTGGCAGAAGAAAAACTGTACTACTGCCTGGCAGATAATTTCCTTGACTAAAAAAATTCTAGTTGGTTTAA,AATGCACTGCACTACCCTCAGCTTACATGTGGTAACAGAAGAAAAACTGTACTACTGCCTGGCAGATAATTTCCTTGACTAAAAAAATTCTAGTTGGTT,10,30,14,27,27,43,27,46,27,33,33,43,36,46,63.19,69.73775882
hek293t,11791,1,3,GATTAACTGCACTACCCTCAGCTTACATGTGGCAGAAGAAAAACTGTACTACTGCCTGGCAGATAATTTCCTTGACTTGGGAAAAAAAAAATTCTAGTT,GATTAACTGCACTACCCTCAGCTTACATGTGGTAACAGAAGAAAAACTGTACTACTGCCTGGCAGATAATTTCCTTGACTTGGGAAAAAAAAAATTCTA,10,30,14,27,27,36,27,39,27,33,33,36,36,39,63.19,0.228248004
hek293t,11793,1,15,GCTGCAAATCTTTCAAAGAGAATCTCAGTAGGGAATAAGTATAGTTGTCCAGTATCTCCTGGAACACAAAAAAATTCTAGTTGGTTTAACGCGTAACTA,GCTGCAAATCTTTCAAAGAGAATCTCAGTATGCCCTTACAAGAATGGGAATAAGTATAGTTGTCCAGTATCTCCTGGAACACAAAAAAATTCTAGTTGG,10,30,14,27,27,41,27,56,27,31,31,41,46,56,14.47,0.553737934
hek293t,11794,1,6,AATGACTTCTCCAGCCAGCTGTGGAAGGCTGGACTGCGCTGGCTGCCGAATTCCGTATCGCTGTTCTGTAACCAAAAAAATTCTAGTTGGTTTAACGCG,AATGACTTCTCCAGCCAGCTGTGGAAGGCTGGACTGCGCTGATTGGGGCTGCCGAATTCCGTATCGCTGTTCTGTAACCAAAAAAATTCTAGTTGGTTT,10,30,14,27,27,44,27,50,27,41,41,44,47,50,41.69,0.0
hek293t,11795,1,3,CGATGCCTTTTAATATTTGTGACAAAACAAGGACAGTGTTAAAGATGGTGTAGTTTATAAAACACAGAAGAAAAAAAAAAATTCTAGTTGGTTTAACGC,CGATGCCTTTTAATATTTGTGACAAAACAAGGACATAAGTGTTAAAGATGGTGTAGTTTATAAAACACAGAAGAAAAAAAAAAATTCTAGTTGGTTTAA,10,30,14,27,27,46,27,49,27,36,36,46,39,49,2.9,0.292344116
hek293t,11795,1,3,TACCACCTTTTAATATTTGTGACAAAACAAGGACAGTGTTAAAGATGGTGTAGTTTATAAAACACAGAAGAAAAAGGGAAAAAAAAAATTCTAGTTGGT,TACCACCTTTTAATATTTGTGACAAAACAAGGACATAAGTGTTAAAGATGGTGTAGTTTATAAAACACAGAAGAAAAAGGGAAAAAAAAAATTCTAGTT,10,30,14,27,27,39,27,42,27,36,36,39,39,42,2.9,0.0
hek293t,11797,1,8,ATGACTTCAGTCCTCTTCTGCTAAGCAAAAGGAAATGCTGGTCAGATTTAATTCTAATGGAAGAACCATTCTAAAAAAATTCTAGTTGGTTTAACGCGT,ATGACTTCAGTCCTCTTCTGCTAAGCAAAAGGAAATGCTCACAAAACGGTCAGATTTAATTCTAATGGAAGAACCATTCTAAAAAAATTCTAGTTGGTT,10,30,14,27,27,43,27,51,27,40,40,43,48,51,35.12,0.0
hek293t,11797,1,8,CTCCATTCAGTCCTCTTCTGCTAAGCAAAAGGAAATGCTGGTCAGATTTAATTCTAATGGAAGAAAAAAAAATTCTAGTTGGTTTAACGCGTAACTAGA,CTCCATTCAGTCCTCTTCTGCTAAGCAAAAGGAAATGCTCACAAAACGGTCAGATTTAATTCTAATGGAAGAAAAAAAAATTCTAGTTGGTTTAACGCG,10,30,14,27,27,50,27,58,27,40,40,50,48,58,35.12,0.0
hek293t,11799,1,9,CTAATAGTGATATTTTGCTCGTATATGAGAGGCACAGTTTGTATCTGTAAGGGGAGTACATATTGCATATCAAAAAAAATTCTAGTTGGTTTAACGCGT,CTAATAGTGATATTTTGCTCGTATATGAGAGGCAAGGTAACAACAGTTTGTATCTGTAAGGGGAGTACATATTGCATATCAAAAAAAATTCTAGTTGGT,10,30,14,27,27,42,27,51,27,35,35,42,44,51,58.28,0.0
hek293t,11799,1,9,TTCGTAGTGATATTTTGCTCGTATATGAGAGGCACAGTTTGTATCTGTAAGGGGAGTACATATTAAAAAAATTCTAGTTGGTTTAACGCGTAACTAGAT,TTCGTAGTGATATTTTGCTCGTATATGAGAGGCAAGGTAACAACAGTTTGTATCTGTAAGGGGAGTACATATTAAAAAAATTCTAGTTGGTTTAACGCG,10,30,14,27,27,50,27,59,27,35,35,50,44,59,58.28,3.049248514
hek293t,11803,1,13,GAACGATGATGTAAACTGATTCATCTTTAAGGTGGATGTATTATTCCTGAGGAGTTTCTTCTAGTATGTTCAGGGAGAGAAAAAAATTCTAGTTGGTTT,GAACGATGATGTAAACTGATTCATCTTTACCATTTTGATCTAAGGTGGATGTATTATTCCTGAGGAGTTTCTTCTAGTATGTTCAGGGAGAGAAAAAAA,10,30,14,27,27,31,27,44,27,28,28,31,41,44,7.94,0.0
hek293t,11803,1,13,AGCAGATGATGTAAACTGATTCATCTTTAAGGTGGATGTATTATTCCTGAGGAGTTTCTTCTAGTATGTTCAGGGAAAAAAATTCTAGTTGGTTTAACG,AGCAGATGATGTAAACTGATTCATCTTTACCATTTTGATCTAAGGTGGATGTATTATTCCTGAGGAGTTTCTTCTAGTATGTTCAGGGAAAAAAATTCT,10,30,14,27,27,35,27,48,27,28,28,35,41,48,7.94,0.506189213
hek293t,11805,1,5,CCAGCCTGGACACTCAGGAAGGTGTTCTGAGGAAGTATTGCTGCATGCTTTCCCAGTCTCTAATAGGCCCCCCCCCCCCCAAAAAAATTCTAGTTGGTT,CCAGCCTGGACACTCAGGAAGGTGTTCTGAAGCCTGGAAGTATTGCTGCATGCTTTCCCAGTCTCTAATAGGCCCCCCCCCCCCCAAAAAAATTCTAGT,10,30,14,27,27,38,27,43,27,31,31,38,36,43,60.89,42.97991038
hek293t,18881,1,6,CCTGTTATAAAGCCACCACAGCCTCTCCTTGGAAGAGTAAGGCTGTTCATTACTGCTGCCATTTTATTTCCAAAAAAATTCTAGTTGGTTTAACGCGTA,CCTGTTATAAAGCCACCACAGCCTCTCCTTGGAAGCAACGGAGTAAGGCTGTTCATTACTGCTGCCATTTTATTTCCAAAAAAATTCTAGTTGGTTTAA,10,30,14,27,27,46,27,52,27,36,36,46,42,52,44.62,8.589857377
hek293t,6712,1,12,GTAGTACGGAAGATTACAGATCAAGGACTCGGTATGTAAAGCAAGTTGGTGCTGTCCTTTCGGACAAAAAAAAATTCTAGTTGGTTTAACGCGTAACTA,GTAGTACGGAAGATTACAGATCAAGGACTCGGTAAGGATGAGCCAATGTAAAGCAAGTTGGTGCTGTCCTTTCGGACAAAAAAAAATTCTAGTTGGTTT,10,30,14,27,27,44,27,56,27,34,34,44,46,56,53.73,2.284391805
hek293t,11810,1,5,CGGCAAATCCCTCTGCTTCTGTGCAACTGAGGAATTTTTCTGCATAGCTTCCACCCTGAATGGCAGGAGATGATTGTTTTAAAAAAAATTCTAGTTGGT,CGGCAAATCCCTCTGCTTCTGTGCAACTGTCTCGAGGAATTTTTCTGCATAGCTTCCACCCTGAATGGCAGGAGATGATTGTTTTAAAAAAAATTCTAG,10,30,14,27,27,37,27,42,27,30,30,37,35,42,53.85,40.79736016
hek293t,11810,1,5,CTTCCAATCCCTCTGCTTCTGTGCAACTGAGGAATTTTTCTGCATAGCTTCCACCCTGAATGGCAGGAGATGATTGTTTTAGTCAAAAAAAATTCTAGT,CTTCCAATCCCTCTGCTTCTGTGCAACTGTCTCGAGGAATTTTTCTGCATAGCTTCCACCCTGAATGGCAGGAGATGATTGTTTTAGTCAAAAAAAATT,10,30,14,27,27,33,27,38,27,30,30,33,35,38,53.85,0.371722704
hek293t,11812,1,3,GAATGTGTGCTCTTAAAGGAAGTCAACACTGGATTTTCAAATGCTTGGTACTGACAGGGGCAGATTTTAAAAAAATTCTAGTTGGTTTAACGCGTAACT,GAATGTGTGCTCTTAAAGGAAGTCAACACTGGATTTCGCTCAAATGCTTGGTACTGACAGGGGCAGATTTTAAAAAAATTCTAGTTGGTTTAACGCGTA,10,30,14,27,27,52,27,55,27,37,37,52,40,55,41.18,34.93058087
hek293t,17818,1,13,ATCTAGGCTACAGCCCCCTCTGAACGGAGGGGAAGGGAGGATGCTCAGAGACTTTGTGCAGTGCAATTGAAAAAAATTCTAGTTGGTTTAACGCGTAAC,ATCTAGGCTACAGCCCCCTCTGAACGGAGGGGATGGAGGCTCCGCAAGGGAGGATGCTCAGAGACTTTGTGCAGTGCAATTGAAAAAAATTCTAGTTGG,10,30,14,27,27,41,27,54,27,34,34,41,47,54,72.24,1.110009613
hek293t,11815,1,9,GCCCATTTACAGGTTATATTAGATTATGCTGGTTTTAGTTCAGCACTAGGCTTTTAGCATCACTTAAAAAAATTCTAGTTGGTTTAACGCGTAACTAGA,GCCCATTTACAGGTTATATTAGATTATGCTGGTTTTAGCGGACAATTTTCAGCACTAGGCTTTTAGCATCACTTAAAAAAATTCTAGTTGGTTTAACGC,10,30,14,27,27,49,27,58,27,39,39,49,48,58,36.88,0.771846281
hek293t,11815,1,9,CACCGTTTACAGGTTATATTAGATTATGCTGGTTTTAGTTCAGCACTAGGCTTTTAGCATCACTTGAAAAAAAAATTCTAGTTGGTTTAACGCGTAACT,CACCGTTTACAGGTTATATTAGATTATGCTGGTTTTAGCGGACAATTTTCAGCACTAGGCTTTTAGCATCACTTGAAAAAAAAATTCTAGTTGGTTTAA,10,30,14,27,27,46,27,55,27,39,39,46,48,55,36.88,0.15910899
hek293t,11817,1,8,CGATCGCAATATTTATTCAGACTTCTTTGTGGTGGCCGTACAATGGGTCTTTCAATGTGTTAGGGTCTGAAAAATATTGCAAAAAAATTCTAGTTGGTT,CGATCGCAATATTTATTCAGACTTCTTTCCGCTGATGTGGTGGCCGTACAATGGGTCTTTCAATGTGTTAGGGTCTGAAAAATATTGCAAAAAAATTCT,10,30,14,27,27,35,27,43,27,28,28,35,36,43,37.73,15.30747039
hek293t,11817,1,8,TCAGGGCAATATTTATTCAGACTTCTTTGTGGTGGCCGTACAATGGGTCTTTCAATGTGTTAGGGTCTGAAAAATATTGCTGAAAAAAAAATTCTAGTT,TCAGGGCAATATTTATTCAGACTTCTTTCCGCTGATGTGGTGGCCGTACAATGGGTCTTTCAATGTGTTAGGGTCTGAAAAATATTGCTGAAAAAAAAA,10,30,14,27,27,31,27,39,27,28,28,31,36,39,37.73,0.0
hek293t,11819,1,12,AACATTTTTCTGATGCTAATTTCAGTTTGGGGAAGAGCAAATTGAAGAAAGAGAGAGAAAATTTAAAAAAAATTCTAGTTGGTTTAACGCGTAACTAGA,AACATTTTTCTGATGCTAATTTCAGTTTGGGGAAGAGCCAGTGTGATGCTAAATTGAAGAAAGAGAGAGAAAATTTAAAAAAAATTCTAGTTGGTTTAA,10,30,14,27,27,46,27,58,27,39,39,46,51,58,20.64,0.0
hek293t,11821,1,15,TCTTAATAAGGTCTTTCACATTTGAGCCAAGGGTCTGACATTCTGACTTCTGCTCTGACCAACAGTCAGTAAAAAAATTCTAGTTGGTTTAACGCGTAA,TCTTAATAAGGTCTTTCACATTTGAGCCAAAAGTTGCATGTAACTGGGTCTGACATTCTGACTTCTGCTCTGACCAACAGTCAGTAAAAAAATTCTAGT,10,30,14,27,27,38,27,53,27,31,31,38,46,53,28.46,0.080515298
hek293t,11823,1,8,TACACCTGTAGACTTCTTTTAAACACCAAAGGGGAAAATATCTAAGCTTCTGCAACTTGTGGTATAAAAAAATTCTAGTTGGTTTAACGCGTAACTAGA,TACACCTGTAGACTTCTTTTAAACACCAAAGGGGGTCCCTTCAAAATATCTAAGCTTCTGCAACTTGTGGTATAAAAAAATTCTAGTTGGTTTAACGCG,10,30,14,27,27,50,27,58,27,35,35,50,43,58,4.59,0.155848292
hek293t,11823,1,8,ACTTTCTGTAGACTTCTTTTAAACACCAAAGGGGAAAATATCTAAGCTTCTGCAACTTGTGGTATGAAGTCGGATTGAAAAAAATTCTAGTTGGTTTAA,ACTTTCTGTAGACTTCTTTTAAACACCAAAGGGGGTCCCTTCAAAATATCTAAGCTTCTGCAACTTGTGGTATGAAGTCGGATTGAAAAAAATTCTAGT,10,30,14,27,27,38,27,46,27,35,35,38,43,46,4.59,0.104986877
hek293t,23073,1,3,CTGATTTGTGAGTGTGAGTGATTGCACGATGGTGTCCATAGCATTGCTCATGTATTTGGGAAGGCTCACAAGCACTGTGAAAGTCAAGAAAAAAATTCT,CTGATTTGTGAGTGTGAGTGATTGCACGAGCATGGTGTCCATAGCATTGCTCATGTATTTGGGAAGGCTCACAAGCACTGTGAAAGTCAAGAAAAAAAT,10,30,14,27,27,32,27,35,27,29,29,32,32,35,68.16,0.930313061
hek293t,23073,1,3,GATAGTTGTGAGTGTGAGTGATTGCACGATGGTGTCCATAGCATTGCTCATGTATTTGGGAAGGCTCACAAGCACTGTGAAAAAAAAATTCTAGTTGGT,GATAGTTGTGAGTGTGAGTGATTGCACGAGCATGGTGTCCATAGCATTGCTCATGTATTTGGGAAGGCTCACAAGCACTGTGAAAAAAAAATTCTAGTT,10,30,14,27,27,39,27,42,27,29,29,39,32,42,68.16,78.0373205
hek293t,11827,1,13,AGCTATAACCCTGGCCTCAATGGTTGCCGTGGGTAGGTGTGTGTCAAAGACACGTTGGAAACATGGTTAAAAAAAATTCTAGTTGGTTTAACGCGTAAC,AGCTATAACCCTGGCCTCAATGGTTGCCGTGGGGATAACTCCAGAATAGGTGTGTGTCAAAGACACGTTGGAAACATGGTTAAAAAAAATTCTAGTTGG,10,30,14,27,27,41,27,54,27,34,34,41,47,54,49.75,0.98366393
hek293t,11828,1,11,ACATTCCCAGCAGTTCCCAAACAAATGTCAGGAAATCGCTCCATTGCTTGCACTTTCCCAGTGTGCATGTCTAAAAAAAAATTCTAGTTGGTTTAACGC,ACATTCCCAGCAGTTCCCAAACAAATGTCAGGAAGGTCCTGAGGTATCGCTCCATTGCTTGCACTTTCCCAGTGTGCATGTCTAAAAAAAAATTCTAGT,10,30,14,27,27,38,27,49,27,35,35,38,46,49,50.01,0.0
hek293t,11828,1,11,GGAGCCCCAGCAGTTCCCAAACAAATGTCAGGAAATCGCTCCATTGCTTGCACTTTCCCAGTGTGCATGTAAAAAAATTCTAGTTGGTTTAACGCGTAA,GGAGCCCCAGCAGTTCCCAAACAAATGTCAGGAAGGTCCTGAGGTATCGCTCCATTGCTTGCACTTTCCCAGTGTGCATGTAAAAAAATTCTAGTTGGT,10,30,14,27,27,42,27,53,27,35,35,42,46,53,50.01,1.713259751
hek293t,11830,1,6,ACCGTACCTGAAAGTAAGGAATTAATGGAAGGTACTTATCAACGGCAGAAAGGTTTACAATGGCTTGTTTGTTTCAGTTTGTAAAAAAATTCTAGTTGG,ACCGTACCTGAAAGTAAGGAATTAATGATAGTCGAAGGTACTTATCAACGGCAGAAAGGTTTACAATGGCTTGTTTGTTTCAGTTTGTAAAAAAATTCT,10,30,14,27,27,35,27,41,27,28,28,35,34,41,61.49,5.066804525
hek293t,11830,1,6,TCCAAACCTGAAAGTAAGGAATTAATGGAAGGTACTTATCAACGGCAGAAAGGTTTACAATGGCTTGTTTGTTTCAGTTTGTTTTCAAAAAAATTCTAG,TCCAAACCTGAAAGTAAGGAATTAATGATAGTCGAAGGTACTTATCAACGGCAGAAAGGTTTACAATGGCTTGTTTGTTTCAGTTTGTTTTCAAAAAAA,10,30,14,27,27,31,27,37,27,28,28,31,34,37,61.49,0.0
hek293t,11832,1,10,GTTTCTCACTGTAGAATGAACATAGGCATAGGGAATTCCTGAACATACTGCTTGTGAAATTCAGATTATGAAAAAAATTCTAGTTGGTTTAACGCGTAA,GTTTCTCACTGTAGAATGAACATAGGCATAGGGAATGTTGCCATGTTCCTGAACATACTGCTTGTGAAATTCAGATTATGAAAAAAATTCTAGTTGGTT,10,30,14,27,27,43,27,53,27,36,36,43,46,53,44.65,0.0
hek293t,11832,1,10,TGACCTCACTGTAGAATGAACATAGGCATAGGGAATTCCTGAACATACTGCTTGTGAAATTCAGATTAAAAAAATTCTAGTTGGTTTAACGCGTAACTA,TGACCTCACTGTAGAATGAACATAGGCATAGGGAATGTTGCCATGTTCCTGAACATACTGCTTGTGAAATTCAGATTAAAAAAATTCTAGTTGGTTTAA,10,30,14,27,27,46,27,56,27,36,36,46,46,56,44.65,0.43741824
hek293t,11834,1,4,TAAAATTTCCTCTTCCGGAAAGCAATGACAGGGGTCAGGGCAGGGCGGAGGAGGGAATCTGAAGTACTACTCACCAGAGGCAAAAAAAATTCTAGTTGG,TAAAATTTCCTCTTCCGGAAAGCAATGCTTGACAGGGGTCAGGGCAGGGCGGAGGAGGGAATCTGAAGTACTACTCACCAGAGGCAAAAAAAATTCTAG,10,30,14,27,27,37,27,41,27,27,27,37,31,41,50.64,85.09468072
hek293t,11834,1,4,AGTAATTTCCTCTTCCGGAAAGCAATGACAGGGGTCAGGGCAGGGCGGAGGAGGGAATCTGAAGTACTACTCACCAGAAAAAAATTCTAGTTGGTTTAA,AGTAATTTCCTCTTCCGGAAAGCAATGCTTGACAGGGGTCAGGGCAGGGCGGAGGAGGGAATCTGAAGTACTACTCACCAGAAAAAAATTCTAGTTGGT,10,30,14,27,27,42,27,46,27,27,27,42,31,46,50.64,76.76025145
hek293t,11836,1,10,GGAAAAAAAACACATTCTGAGCTCTCTCATGGTGACTTTAGTTATAGTTTTGGGAATTGAGTGCCCCCCCAATTGAAGGCAAAAAAATTCTAGTTGGTT,GGAAAAAAAACACATTCTGAGCTCTCTCAGTGTATTGCGTGGTGACTTTAGTTATAGTTTTGGGAATTGAGTGCCCCCCCAATTGAAGGCAAAAAAATT,10,30,14,27,27,33,27,43,27,30,30,33,40,43,52.88,0.0
hek293t,11836,1,10,TCCGCAAAAACACATTCTGAGCTCTCTCATGGTGACTTTAGTTATAGTTTTGGGAATTGAGTGCCCCCCCAATAAAAAAATTCTAGTTGGTTTAACGCG,TCCGCAAAAACACATTCTGAGCTCTCTCAGTGTATTGCGTGGTGACTTTAGTTATAGTTTTGGGAATTGAGTGCCCCCCCAATAAAAAAATTCTAGTTG,10,30,14,27,27,40,27,50,27,30,30,40,40,50,52.88,1.747583507
hek293t,11838,1,9,TCGAAGATAACAGATAAGGTGCCAGCAGATGGCTCTCAAGATGTGAGGCCTACAGCTTCCATAGGCCTGAAAAAAAATTCTAGTTGGTTTAACGCGTAA,TCGAAGATAACAGATAAGGTGCCAGCAGATGGCTCTCAAGGGGTTCTTAATGTGAGGCCTACAGCTTCCATAGGCCTGAAAAAAAATTCTAGTTGGTTT,10,30,14,27,27,44,27,53,27,41,41,44,50,53,42.85,0.901960784
hek293t,11839,1,2,TATCAAAGAAAAGAAATACCAACATCTCATGGTGCCAACATTCACAAATATCTTGCACCCCCCCCGAATTATACACCCTAATAAAAAAATTCTAGTTGG,TATCAAAGAAAAGAAATACCAACATCTCTGATGGTGCCAACATTCACAAATATCTTGCACCCCCCCCGAATTATACACCCTAATAAAAAAATTCTAGTT,10,30,14,27,27,39,27,41,27,29,29,39,31,41,46.29,28.24429566
hek293t,11842,1,2,ATACATACCATAATGGTTTTGAATTTGGCAGGGTAACGTAGCTCTTACAGTAACTAATTGGTTATGGTTTCATGCTCATTTTAAAAAAAATTCTAGTTG,ATACATACCATAATGGTTTTGAATTTGGCAGCGGGTAACGTAGCTCTTACAGTAACTAATTGGTTATGGTTTCATGCTCATTTTAAAAAAAATTCTAGT,10,30,14,27,27,38,27,40,27,31,31,38,33,40,18.15,47.8366794
hek293t,11842,1,2,CGCGATACCATAATGGTTTTGAATTTGGCAGGGTAACGTAGCTCTTACAGTAACTAATTGGTTATGGTTTCATGCAAAAAAATTCTAGTTGGTTTAACG,CGCGATACCATAATGGTTTTGAATTTGGCAGCGGGTAACGTAGCTCTTACAGTAACTAATTGGTTATGGTTTCATGCAAAAAAATTCTAGTTGGTTTAA,10,30,14,27,27,46,27,48,27,31,31,46,33,48,18.15,24.8703588
hek293t,3046,1,4,TGACTTCAGTGGGAATCTTTCTCTGGATGTGGTTGGGCACTAAATCACTTTTCTACCTGGGTTAGTTTTAAGTTCAAGCTGCCTGCTGAAAAAAAATTC,TGACTTCAGTGGGAATCTTTCTCTGGAGCCATGTGGTTGGGCACTAAATCACTTTTCTACCTGGGTTAGTTTTAAGTTCAAGCTGCCTGCTGAAAAAAA,10,30,14,27,27,30,27,34,27,27,27,30,31,34,39.34,0.631911532
hek293t,3046,1,4,ACGACTCAGTGGGAATCTTTCTCTGGATGTGGTTGGGCACTAAATCACTTTTCTACCTGGGTTAGTTTTAAGTTCAAAAAAAAATTCTAGTTGGTTTAA,ACGACTCAGTGGGAATCTTTCTCTGGAGCCATGTGGTTGGGCACTAAATCACTTTTCTACCTGGGTTAGTTTTAAGTTCAAAAAAAAATTCTAGTTGGT,10,30,14,27,27,42,27,46,27,27,27,42,31,46,39.34,82.48676404
hek293t,11846,1,2,CGTGGAAGCCACAAGGAATAAATGGAATATGGCAGATGTGAGCTCCTTGTCTTTCTGTAGCAAATATGTTTTCAAAAAAATTCTAGTTGGTTTAACGCG,CGTGGAAGCCACAAGGAATAAATGGAATATGGCAGATGTGTAAGCTCCTTGTCTTTCTGTAGCAAATATGTTTTCAAAAAAATTCTAGTTGGTTTAACG,10,30,14,27,27,48,27,50,27,41,41,48,43,50,25.77,36.21081209
hek293t,11846,1,2,GCTGGAAGCCACAAGGAATAAATGGAATATGGCAGATGTGAGCTCCTTGTCTTTCTGTAGCAAATATGTTAAAAAAATTCTAGTTGGTTTAACGCGTAA,GCTGGAAGCCACAAGGAATAAATGGAATATGGCAGATGTGTAAGCTCCTTGTCTTTCTGTAGCAAATATGTTAAAAAAATTCTAGTTGGTTTAACGCGT,10,30,14,27,27,51,27,53,27,41,41,51,43,53,25.77,31.15518834
hek293t,11848,1,4,CCTACACATTCTCTCCAAGAAAAGCTTGGAGGTTAAAAAGAACTAAAATTAAATTCTTGAAGAAGGTCAAGAAGGTATGAAAAAAATTCTAGTTGGTTT,CCTACACATTCTCTCCAAGAAAAGCTTGGAGGTTAAAAGAAAAGAACTAAAATTAAATTCTTGAAGAAGGTCAAGAAGGTATGAAAAAAATTCTAGTTG,10,30,14,27,27,40,27,44,27,37,37,40,41,44,62.7,0.0
hek293t,11850,1,5,TTAAGCTCAGAACAAAAACAAATAGCGGCTGGCATTTTAAAAGATCTGCATGTTCAATGGTACAAGCAAGGATTATATGGAAAAAAATTCTAGTTGGTT,TTAAGCTCAGAACAAAAACAAATAGCGCGTGCGCTGGCATTTTAAAAGATCTGCATGTTCAATGGTACAAGCAAGGATTATATGGAAAAAAATTCTAGT,10,30,14,27,27,38,27,43,27,28,28,38,33,43,29.13,2.513489216
hek293t,11850,1,5,CCGATCTCAGAACAAAAACAAATAGCGGCTGGCATTTTAAAAGATCTGCATGTTCAATGGTACAAGCAAGGATTATATGGCACATCCAAAAAAATTCTA,CCGATCTCAGAACAAAAACAAATAGCGCGTGCGCTGGCATTTTAAAAGATCTGCATGTTCAATGGTACAAGCAAGGATTATATGGCACATCCAAAAAAA,10,30,14,27,27,31,27,36,27,28,28,31,33,36,29.13,0.0
hek293t,11852,1,2,TATTTGACTGAACTGCATTCAACAGTGGTTGGACATTATGTTTAGAAACCCATAAGCGTATACGATTTGTTATCTGAAGTAACAACCAAAAAAATTCTA,TATTTGACTGAACTGCATTCAACAGTGGTTGTGGACATTATGTTTAGAAACCCATAAGCGTATACGATTTGTTATCTGAAGTAACAACCAAAAAAATTC,10,30,14,27,27,34,27,36,27,31,31,34,33,36,53.53,2.579545455
hek293t,11852,1,2,ACCAAGACTGAACTGCATTCAACAGTGGTTGGACATTATGTTTAGAAACCCATAAGCGTATACGATTTGTTATCTGAAGTAAAAAAATTCTAGTTGGTT,ACCAAGACTGAACTGCATTCAACAGTGGTTGTGGACATTATGTTTAGAAACCCATAAGCGTATACGATTTGTTATCTGAAGTAAAAAAATTCTAGTTGG,10,30,14,27,27,41,27,43,27,31,31,41,33,43,53.53,71.02795898
hek293t,11854,1,13,TGGGATAAACATTAAATCTGGCTAGGGGATGGAATGAAAGACTAACAAGTTCATCTCCAGGAGTTACTTGGAAAAAAAATTCTAGTTGGTTTAACGCGT,TGGGATAAACATTAAATCTGGCTAGGGGTACGGAGATTAAGATGGAATGAAAGACTAACAAGTTCATCTCCAGGAGTTACTTGGAAAAAAAATTCTAGT,10,30,14,27,27,38,27,51,27,28,28,38,41,51,30.9,1.681133988
hek293t,11854,1,13,ATAGCTAAACATTAAATCTGGCTAGGGGATGGAATGAAAGACTAACAAGTTCATCTCCAGGAGTTACTTGGAAATCTTTAAAAAAATTCTAGTTGGTTT,ATAGCTAAACATTAAATCTGGCTAGGGGTACGGAGATTAAGATGGAATGAAAGACTAACAAGTTCATCTCCAGGAGTTACTTGGAAATCTTTAAAAAAA,10,30,14,27,27,31,27,44,27,28,28,31,41,44,30.9,0.0
hek293t,11856,1,14,ATCGATATTCTGAATCCAATTGGGAGAAATGGATTTACCAGACAATTTCCAAAGCAGGCAGACAACCTTTTGCAGTAAAAAAATTCTAGTTGGTTTAAC,ATCGATATTCTGAATCCAATTGGGAGAAACTCATTAAGAACTATGGATTTACCAGACAATTTCCAAAGCAGGCAGACAACCTTTTGCAGTAAAAAAATT,10,30,14,27,27,33,27,47,27,30,30,33,44,47,9.23,0.0
hek293t,11856,1,14,AGCATTATTCTGAATCCAATTGGGAGAAATGGATTTACCAGACAATTTCCAAAGCAGGCAGACAACCTTTTGAAAAAAATTCTAGTTGGTTTAACGCGT,AGCATTATTCTGAATCCAATTGGGAGAAACTCATTAAGAACTATGGATTTACCAGACAATTTCCAAAGCAGGCAGACAACCTTTTGAAAAAAATTCTAG,10,30,14,27,27,37,27,51,27,30,30,37,44,51,9.23,0.038358266
hek293t,11858,1,5,ATGGTGATTTGCTAATCCGTGATCTCGTTTGGCAGTAAAACCTACTTTGGCTACTTGCTCTGTAGTGTTCTCGGTTACAAAAAAAATTCTAGTTGGTTT,ATGGTGATTTGCTAATCCGTGATCTCGTTTGGGCAGGCAGTAAAACCTACTTTGGCTACTTGCTCTGTAGTGTTCTCGGTTACAAAAAAAATTCTAGTT,10,30,14,27,27,39,27,44,27,32,32,39,37,44,10.12,0.0
hek293t,11858,1,5,TGCCCGATTTGCTAATCCGTGATCTCGTTTGGCAGTAAAACCTACTTTGGCTACTTGCTCTGTAGTGTTCTCGGTTAAAAAAATTCTAGTTGGTTTAAC,TGCCCGATTTGCTAATCCGTGATCTCGTTTGGGCAGGCAGTAAAACCTACTTTGGCTACTTGCTCTGTAGTGTTCTCGGTTAAAAAAATTCTAGTTGGT,10,30,14,27,27,42,27,47,27,32,32,42,37,47,10.12,0.0
hek293t,22870,1,10,GTCCGTAGACTGGGCTGATAGCAGTAGAGGGGTCTACATATGACAACAGAGAGGCCCAGTTAACTGTAGCTAAAAAAATTCTAGTTGGTTTAACGCGTA,GTCCGTAGACTGGGCTGATAGCAGTAGAGGGGTCGCGTAGTGACTACATATGACAACAGAGAGGCCCAGTTAACTGTAGCTAAAAAAATTCTAGTTGGT,10,30,14,27,27,42,27,52,27,35,35,42,45,52,65.69,1.282532814
hek293t,11863,1,7,TAGTCCAGTACAAAAATCATAAAACATAATGGCAGCGTGGCTGGTAATCTTAGCAGAAAGGCAAGGGTTTAATGAAAAAAATTCTAGTTGGTTTAACGC,TAGTCCAGTACAAAAATCATAAAACATAATGAACTCATGCAGCGTGGCTGGTAATCTTAGCAGAAAGGCAAGGGTTTAATGAAAAAAATTCTAGTTGGT,10,30,14,27,27,42,27,49,27,32,32,42,39,49,8.8,0.125667609
hek293t,11863,1,7,CGCGGCAGTACAAAAATCATAAAACATAATGGCAGCGTGGCTGGTAATCTTAGCAGAAAGGCAAGGGTTTAATGAGTGGCAAAAAAAATTCTAGTTGGT,CGCGGCAGTACAAAAATCATAAAACATAATGAACTCATGCAGCGTGGCTGGTAATCTTAGCAGAAAGGCAAGGGTTTAATGAGTGGCAAAAAAAATTCT,10,30,14,27,27,35,27,42,27,32,32,35,39,42,8.8,0.0
hek293t,11865,1,15,GCTCGACTTAAATGTAAATAGAAATATGTTGGCCTACATAATTATAAGGGCTTTGTCATTCTGAAAGCAAACACAAAAAAATTCTAGTTGGTTTAACGC,GCTCGACTTAAATGTAAATAGAAATATGTTCGCGGTTTGGTTGGTGGCCTACATAATTATAAGGGCTTTGTCATTCTGAAAGCAAACACAAAAAAATTC,10,30,14,27,27,34,27,49,27,31,31,34,46,49,19.62,0.0
hek293t,11866,1,8,GCACTTGAATTGCTACAGATCCATATGAAAGGCTTTAATGCACCCTTCTCAGTCTAAAGGGCACCCATTTTTCCATCTTTAAAAAAATTCTAGTTGGTT,GCACTTGAATTGCTACAGATCCATATGAAAGATTAAGTGGCTTTAATGCACCCTTCTCAGTCTAAAGGGCACCCATTTTTCCATCTTTAAAAAAATTCT,10,30,14,27,27,35,27,43,27,32,32,35,40,43,62.48,1.367373254
hek293t,11866,1,8,GCACTTGAATTGCTACAGATCCATATGAAAGGCTTTAATGCACCCTTCTCAGTCTAAAGGGCACCCATTTTTCCATAAAAAAATTCTAGTTGGTTTAAC,GCACTTGAATTGCTACAGATCCATATGAAAGATTAAGTGGCTTTAATGCACCCTTCTCAGTCTAAAGGGCACCCATTTTTCCATAAAAAAATTCTAGTT,10,30,14,27,27,39,27,47,27,32,32,39,40,47,62.48,4.413858442
hek293t,11868,1,12,CGCGTTTTCATGAGATCTTTGTGCCACAAAGGGTTTTTCCAAATCTATTCTTAGTCATACATTTTTCAGTTTAGAAAAAAATTCTAGTTGGTTTAACGC,CGCGTTTTCATGAGATCTTTGTGCCACAAAGGGGTGGGTTTTGCTTTTTTCCAAATCTATTCTTAGTCATACATTTTTCAGTTTAGAAAAAAATTCTAG,10,30,14,27,27,37,27,49,27,34,34,37,46,49,13.94,0.0
hek293t,11869,1,15,GCTGAGGCTAGGTGCAATTACTTCATCTCAGGGAGAGCTGTTTTAACCCCCCCAAAAAACCTTACAAAAAAATTCTAGTTGGTTTAACGCGTAACTAGA,GCTGAGGCTAGGTGCAATTACTTCATCGGATGTGGTGCGCCCTCAGGGAGAGCTGTTTTAACCCCCCCAAAAAACCTTACAAAAAAATTCTAGTTGGTT,10,30,14,27,27,43,27,58,27,28,28,43,43,58,37.53,66.671441
hek293t,11871,1,8,CGTCTATGTACATGCTGCTACATACAGGGAGGCTGGCTACTCTGATACCATATGCCTTTTTGGACATAATTCTAAAAAAATTCTAGTTGGTTTAACGCG,CGTCTATGTACATGCTGCTACATACAGGGAGACACCTAGGCTGGCTACTCTGATACCATATGCCTTTTTGGACATAATTCTAAAAAAATTCTAGTTGGT,10,30,14,27,27,42,27,50,27,32,32,42,40,50,77.22,28.10510017
hek293t,11871,1,8,GGTTAATGTACATGCTGCTACATACAGGGAGGCTGGCTACTCTGATACCATATGCCTTTTTGGACATAATTCTCAAAAAAAAATTCTAGTTGGTTTAAC,GGTTAATGTACATGCTGCTACATACAGGGAGACACCTAGGCTGGCTACTCTGATACCATATGCCTTTTTGGACATAATTCTCAAAAAAAAATTCTAGTT,10,30,14,27,27,39,27,47,27,32,32,39,40,47,77.22,23.5875206
hek293t,11873,1,8,TGTGAGCAGTGATTTCAAAGTTCTCTTTTTGGAAAGTCACTTTTAGATTCCAATATTAGTTGGTACTTCAAAAAAATTCTAGTTGGTTTAACGCGTAAC,TGTGAGCAGTGATTTCAAAGTTCTCTTTTTGGAAAGTCGTGCTCAAACTTTTAGATTCCAATATTAGTTGGTACTTCAAAAAAATTCTAGTTGGTTTAA,10,30,14,27,27,46,27,54,27,39,39,46,47,54,2.51,0.0
hek293t,11874,1,11,TCCCTTACAAAAGCACTGAAATTCTTTAGAGGGTGACAGATGTTGTTCCCTTCCAGTCAATACGACCTTAGGGAAAAAAATTCTAGTTGGTTTAACGCG,TCCCTTACAAAAGCACTGAAATTCTTTAGAGGGTGGCTGGCCTAATACAGATGTTGTTCCCTTCCAGTCAATACGACCTTAGGGAAAAAAATTCTAGTT,10,30,14,27,27,39,27,50,27,36,36,39,47,50,26.43,0.580720093
hek293t,11875,1,3,TTGGGAGCAGAAACTAATTTTAGAGAATCAGGCCTCTTATTGAGCTGTTTAATGTATATGCGTTTTCAGGGTCCACAAAAAAAATTCTAGTTGGTTTAA,TTGGGAGCAGAAACTAATTTTAGAGAATCAGGATACCTCTTATTGAGCTGTTTAATGTATATGCGTTTTCAGGGTCCACAAAAAAAATTCTAGTTGGTT,10,30,14,27,27,43,27,46,27,33,33,43,36,46,1.79,14.94827182
hek293t,11875,1,3,AGGATAGCAGAAACTAATTTTAGAGAATCAGGCCTCTTATTGAGCTGTTTAATGTATATGCGTTTTCAGGGTCCACAATGCACTAAAAAAATTCTAGTT,AGGATAGCAGAAACTAATTTTAGAGAATCAGGATACCTCTTATTGAGCTGTTTAATGTATATGCGTTTTCAGGGTCCACAATGCACTAAAAAAATTCTA,10,30,14,27,27,36,27,39,27,33,33,36,36,39,1.79,0.069589422
hek293t,11877,1,15,TGATCCAGCAAGTCCTAGAAGAGCACCTGAGGACTGCCTCTGCAGTAGCAACCAGGGCACTTGCAGCTCCAAAAAAATTCTAGTTGGTTTAACGCGTAA,TGATCCAGCAAGTCCTAGAAGAGCACCGTGATGTTCAAGCTCTGAGGACTGCCTCTGCAGTAGCAACCAGGGCACTTGCAGCTCCAAAAAAATTCTAGT,10,30,14,27,27,38,27,53,27,28,28,38,43,53,59.09,25.46655267
hek293t,11879,1,5,AGTAGCCCCTATGTCCAGATGGCACAGGAAGGTAATACAGCATTAATAATCCTGCGTTAATGTTTATGAGATAGAAAAAAATTCTAGTTGGTTTAACGC,AGTAGCCCCTATGTCCAGATGGCACAGGAAGGTAATACAGTGGAACATTAATAATCCTGCGTTAATGTTTATGAGATAGAAAAAAATTCTAGTTGGTTT,10,30,14,27,27,44,27,49,27,41,41,44,46,49,72.88,0.219918316
hek293t,11882,1,10,ACGATCCAGAAAACGCAACTCTATTGCCTTGGCATTTTGTTTGGAGTATAAACGTTATTTTGGTTCTTGCCTGGAAAAAAATTCTAGTTGGTTTAACGC,ACGATCCAGAAAACGCAACTCTATTGCCGTAGAACCTGTTGGCATTTTGTTTGGAGTATAAACGTTATTTTGGTTCTTGCCTGGAAAAAAATTCTAGTT,10,30,14,27,27,39,27,49,27,29,29,39,39,49,47.39,3.589799592
hek293t,11882,1,10,ATATGCCAGAAAACGCAACTCTATTGCCTTGGCATTTTGTTTGGAGTATAAACGTTATTTTGGTTCTTGCCTGGCGAAGGGAAAAAAATTCTAGTTGGT,ATATGCCAGAAAACGCAACTCTATTGCCGTAGAACCTGTTGGCATTTTGTTTGGAGTATAAACGTTATTTTGGTTCTTGCCTGGCGAAGGGAAAAAAAT,10,30,14,27,27,32,27,42,27,29,29,32,39,42,47.39,0.0
hek293t,11884,1,12,CAGAGTTTGCCCTTTAAAACAGAACTGCTTGGAGACCGAGACTGTCGTAAAATAGAGGTACTTAATAAAAAAAATTCTAGTTGGTTTAACGCGTAACTA,CAGAGTTTGCCCTTTAAAACAGAACTGCTTGGAGACCGAGGCACACACATGGACTGTCGTAAAATAGAGGTACTTAATAAAAAAAATTCTAGTTGGTTT,10,30,14,27,27,44,27,56,27,41,41,44,53,56,41.85,0.0
hek293t,11885,1,6,TTTACGCTATCCTAGTGAGCGTTAGTGTGAGGGGTATTGCAGAAGTCTGCTGCACTGTTAGCCCCCCCCCCCCCTAAAAAAATTCTAGTTGGTTTAACG,TTTACGCTATCCTAGTGAGCGTTAGTGTGAGGATCACGGGTATTGCAGAAGTCTGCTGCACTGTTAGCCCCCCCCCCCCCTAAAAAAATTCTAGTTGGT,10,30,14,27,27,42,27,48,27,32,32,42,38,48,68.54,64.53708632
hek293t,19990,1,7,TTAAACCATATCATGTTGAAATTAGCAGTAGGTGGCTATAGCTCAATGTAATTAGCTGTGTATATTGCATGCACAGAAATAAAAAAATTCTAGTTGGTT,TTAAACCATATCATGTTGAAATTAGCAGTAGGTTACGACTGGCTATAGCTCAATGTAATTAGCTGTGTATATTGCATGCACAGAAATAAAAAAATTCTA,10,30,14,27,27,36,27,43,27,33,33,36,40,43,46.25,0.357931074
hek293t,19990,1,7,AACGCCCATATCATGTTGAAATTAGCAGTAGGTGGCTATAGCTCAATGTAATTAGCTGTGTATATTGCAAAAAAATTCTAGTTGGTTTAACGCGTAACT,AACGCCCATATCATGTTGAAATTAGCAGTAGGTTACGACTGGCTATAGCTCAATGTAATTAGCTGTGTATATTGCAAAAAAATTCTAGTTGGTTTAACG,10,30,14,27,27,48,27,55,27,33,33,48,40,55,46.25,17.81545267
hek293t,11889,1,15,AGCTATTCATAAATTCTCTTTCCAATACGGGGATTTGAACTGACATTTCCTATTACCTGGTAAAGAGGAAAAAAATTCTAGTTGGTTTAACGCGTAACT,AGCTATTCATAAATTCTCTTTCCAATACGGGGATTTAACTCAACTGGTTTAGAACTGACATTTCCTATTACCTGGTAAAGAGGAAAAAAATTCTAGTTG,10,30,14,27,27,40,27,55,27,37,37,40,52,55,46.74,0.0
hek293t,11890,1,6,TGCCCAGGGGGAAAAAACAGTGCAGAGGCAGGCTTGTTCTCCTCTTATCTTGGCTGGAACAGCAATTCTTTCACTTAAAAAAAATTCTAGTTGGTTTAA,TGCCCAGGGGGAAAAAACAGTGCAGAGGCACGGAGAGGCTTGTTCTCCTCTTATCTTGGCTGGAACAGCAATTCTTTCACTTAAAAAAAATTCTAGTTG,10,30,14,27,27,40,27,46,27,30,30,40,36,46,45.13,29.30099991
hek293t,11890,1,6,GATCTAGGGGGAAAAAACAGTGCAGAGGCAGGCTTGTTCTCCTCTTATCTTGGCTGGAACAGCAATTCTTTCAAAAAAATTCTAGTTGGTTTAACGCGT,GATCTAGGGGGAAAAAACAGTGCAGAGGCACGGAGAGGCTTGTTCTCCTCTTATCTTGGCTGGAACAGCAATTCTTTCAAAAAAATTCTAGTTGGTTTA,10,30,14,27,27,45,27,51,27,30,30,45,36,51,45.13,63.24618195
hek293t,11892,1,13,AGTCCACTACTTCTGACATGTAATTTAATAGGTAAAAATAATATTAGAAGCAGGAAACTCCACGAAACAAAAAAAATTCTAGTTGGTTTAACGCGTAAC,AGTCCACTACTTCTGACATGTAATTTAATAGGTCTTTTAATTGCGCAAAAATAATATTAGAAGCAGGAAACTCCACGAAACAAAAAAAATTCTAGTTGG,10,30,14,27,27,41,27,54,27,34,34,41,47,54,7.39,0.0
hek293t,11893,1,13,GTGTGCTTTCTGTCTAACTTTTGCTCAGAAGGGATCAGGCTTCAGTAAGATCATAAACCAGCGAGTTTCTAAAAAAATTCTAGTTGGTTTAACGCGTAA,GTGTGCTTTCTGTCTAACTTTTGCTCAGAGAATGACCCAGACAGGGATCAGGCTTCAGTAAGATCATAAACCAGCGAGTTTCTAAAAAAATTCTAGTTG,10,30,14,27,27,40,27,53,27,30,30,40,43,53,5.59,0.0
hek293t,11893,1,13,TTAGTCTTTCTGTCTAACTTTTGCTCAGAAGGGATCAGGCTTCAGTAAGATCATAAACCAGCGAGTTTCTTTTAAAAAAATTCTAGTTGGTTTAACGCG,TTAGTCTTTCTGTCTAACTTTTGCTCAGAGAATGACCCAGACAGGGATCAGGCTTCAGTAAGATCATAAACCAGCGAGTTTCTTTTAAAAAAATTCTAG,10,30,14,27,27,37,27,50,27,30,30,37,43,50,5.59,0.384615385
hek293t,11895,1,7,CAACATGGCTCAGGAGGCAGACGTAACTTTGGCAGTAGGAGCCTGAAATTAAAGGTGATGCCTGTAGAATAAAAAAAATTCTAGTTGGTTTAACGCGTA,CAACATGGCTCAGGAGGCAGACGTAACTTTGGCACCGATCTGTAGGAGCCTGAAATTAAAGGTGATGCCTGTAGAATAAAAAAAATTCTAGTTGGTTTA,10,30,14,27,27,45,27,52,27,35,35,45,42,52,57.67,13.83822255
hek293t,11895,1,7,CGTTGTGGCTCAGGAGGCAGACGTAACTTTGGCAGTAGGAGCCTGAAATTAAAGGTGATGCCTGTAAAAAAAATTCTAGTTGGTTTAACGCGTAACTAG,CGTTGTGGCTCAGGAGGCAGACGTAACTTTGGCACCGATCTGTAGGAGCCTGAAATTAAAGGTGATGCCTGTAAAAAAAATTCTAGTTGGTTTAACGCG,10,30,14,27,27,50,27,57,27,35,35,50,42,57,57.67,0.986409563
hek293t,11897,1,5,GGGGGAGGCACCTCCGCGAGGCTCTCCGCAGGCTCGGCGAGCGGCAGGAAGCACTCCTGCACACACCAAAAAAATTCTAGTTGGTTTAACGCGTAACTA,GGGGGAGGCACCTCCGCGAGGCTCTCCGCAGGCTCGGCGACTGGAGCGGCAGGAAGCACTCCTGCACACACCAAAAAAATTCTAGTTGGTTTAACGCGT,10,30,14,27,27,51,27,56,27,41,41,51,46,56,56.75,53.11670199
hek293t,11899,1,3,AGGTTCAGTGCAACATGTTGCATCTTAAACGGTATGCCTGTCGTCCCCAAACACGACTTCCCGTTTCCTTTACGACCTTAGTAAAAAAATTCTAGTTGG,AGGTTCAGTGCAACATGTTGCATCTTAAACCCGGGTATGCCTGTCGTCCCCAAACACGACTTCCCGTTTCCTTTACGACCTTAGTAAAAAAATTCTAGT,10,30,14,27,27,38,27,41,27,31,31,38,34,41,6.89,76.88676564
hek293t,11899,1,3,CGTGCCAGTGCAACATGTTGCATCTTAAACGGTATGCCTGTCGTCCCCAAACACGACTTCCCGTTTCCTTTACGACCTTAGTCTGCAAAAAAATTCTAG,CGTGCCAGTGCAACATGTTGCATCTTAAACCCGGGTATGCCTGTCGTCCCCAAACACGACTTCCCGTTTCCTTTACGACCTTAGTCTGCAAAAAAATTC,10,30,14,27,27,34,27,37,27,31,31,34,34,37,6.89,3.234158618
hek293t,22668,1,12,CGCACCATCCAATGAATGGAGGAAAGGTCTGGGATCAAGCACATCTGCACTACTGTAAGGACAGAAAAAAATTCTAGTTGGTTTAACGCGTAACTAGAT,CGCACCATCCAATGAATGGAGGAAAGGTCTGGGATCAAGGTAACGCTCCCGCACATCTGCACTACTGTAAGGACAGAAAAAAATTCTAGTTGGTTTAAC,10,30,14,27,27,47,27,59,27,40,40,47,52,59,35.1,0.29913205
hek293t,11902,1,10,TTCGATGGAGCACTGACATGAACTGTGCTAGGCAAATGGTATATTCCAATTTTCAAGATCTTACTATTCTTAAAAAAAATTCTAGTTGGTTTAACGCGT,TTCGATGGAGCACTGACATGAACTGTGCTATTGCGGATTGGGCAAATGGTATATTCCAATTTTCAAGATCTTACTATTCTTAAAAAAAATTCTAGTTGG,10,30,14,27,27,41,27,51,27,31,31,41,41,51,63.19,26.96838167
hek293t,11902,1,10,GATGTTGGAGCACTGACATGAACTGTGCTAGGCAAATGGTATATTCCAATTTTCAAGATCTTACTATAAAAAAATTCTAGTTGGTTTAACGCGTAACTA,GATGTTGGAGCACTGACATGAACTGTGCTATTGCGGATTGGGCAAATGGTATATTCCAATTTTCAAGATCTTACTATAAAAAAATTCTAGTTGGTTTAA,10,30,14,27,27,46,27,56,27,31,31,46,41,56,63.19,2.460660718
hek293t,5848,1,6,AGGTCGGACAGAAAGCCCTTTGCTCCTCCTGGTTCAATAAAATGAAGAGTATTTGGCACCTGCAGGATAAAAAAAATTCTAGTTGGTTTAACGCGTAAC,AGGTCGGACAGAAAGCCCTTTGCTCCTCCTGGTTTTCCTTCAATAAAATGAAGAGTATTTGGCACCTGCAGGATAAAAAAAATTCTAGTTGGTTTAACG,10,30,14,27,27,48,27,54,27,33,33,48,39,54,32.17,4.177661363
hek293t,5848,1,6,TTTTGGGACAGAAAGCCCTTTGCTCCTCCTGGTTCAATAAAATGAAGAGTATTTGGCACCTGCAGGATAGAGCCTATTATTAAAAAAATTCTAGTTGGT,TTTTGGGACAGAAAGCCCTTTGCTCCTCCTGGTTTTCCTTCAATAAAATGAAGAGTATTTGGCACCTGCAGGATAGAGCCTATTATTAAAAAAATTCTA,10,30,14,27,27,36,27,42,27,33,33,36,39,42,32.17,0.278551532
hek293t,11906,1,15,AGGTGTCTACTTGGCATATTAGCACTTACTGGAACCTCTTTTTCATTAAAGGTCAGATTAGGTTTTCAAAAAAAATTCTAGTTGGTTTAACGCGTAACT,AGGTGTCTACTTGGCATATTAGCACTTACTGGCATTATCTCCAAGGAAACCTCTTTTTCATTAAAGGTCAGATTAGGTTTTCAAAAAAAATTCTAGTTG,10,30,14,27,27,40,27,55,27,33,33,40,48,55,9.76,0.72655886
hek293t,11906,1,15,GACGTTCTACTTGGCATATTAGCACTTACTGGAACCTCTTTTTCATTAAAGGTCAGATTAGGTTTTCAGAACAAAAAAATTCTAGTTGGTTTAACGCGT,GACGTTCTACTTGGCATATTAGCACTTACTGGCATTATCTCCAAGGAAACCTCTTTTTCATTAAAGGTCAGATTAGGTTTTCAGAACAAAAAAATTCTA,10,30,14,27,27,36,27,51,27,33,33,36,48,51,9.76,0.0
hek293t,11909,1,14,CAGGTAAACTCTGACAAAGTCTTGCTGCCTGGTTTGCTGAGTGTTGGAAAAACCAGCTGCTTCTAAAAAAATTCTAGTTGGTTTAACGCGTAACTAGAT,CAGGTAAACTCTGACAAAGTCTTGCTGCCCTATATGCAAGGAATGGTTTGCTGAGTGTTGGAAAAACCAGCTGCTTCTAAAAAAATTCTAGTTGGTTTA,10,30,14,27,27,45,27,59,27,30,30,45,44,59,43.06,13.2380018
hek293t,11909,1,14,CTATCAAACTCTGACAAAGTCTTGCTGCCTGGTTTGCTGAGTGTTGGAAAAACCAGCTGCTTCTGCCGTCCCAAAAAAATTCTAGTTGGTTTAACGCGT,CTATCAAACTCTGACAAAGTCTTGCTGCCCTATATGCAAGGAATGGTTTGCTGAGTGTTGGAAAAACCAGCTGCTTCTGCCGTCCCAAAAAAATTCTAG,10,30,14,27,27,37,27,51,27,30,30,37,44,51,43.06,0.418410042
hek293t,11911,1,11,CTTTATGTTCATGCTAAATAGAGAAATGGAGGAAAAGACTCTCTGCAGGCAAAAATGCAGGAAAACATAAAAAAATTCTAGTTGGTTTAACGCGTAACT,CTTTATGTTCATGCTAAATAGAGAAATGGAGGAAAATATCAAGCCTCGACTCTCTGCAGGCAAAAATGCAGGAAAACATAAAAAAATTCTAGTTGGTTT,10,30,14,27,27,44,27,55,27,37,37,44,48,55,69.11,0.0
hek293t,11911,1,11,AGGAATGTTCATGCTAAATAGAGAAATGGAGGAAAAGACTCTCTGCAGGCAAAAATGCAGGAAAAAAAAAAATTCTAGTTGGTTTAACGCGTAACTAGA,AGGAATGTTCATGCTAAATAGAGAAATGGAGGAAAATATCAAGCCTCGACTCTCTGCAGGCAAAAATGCAGGAAAAAAAAAAATTCTAGTTGGTTTAAC,10,30,14,27,27,47,27,58,27,37,37,47,48,58,69.11,0.0
hek293t,11913,1,5,TATTGGTCATTGGCAGCCCATCTCTGGACAGGGGTTGCCAATGCGCAGGGTGAGGGGGAGCCATGGCACGAATGGAAAAAAATTCTAGTTGGTTTAACG,TATTGGTCATTGGCAGCCCATCTCTGGACAGGGGTTGCCGTGCAAATGCGCAGGGTGAGGGGGAGCCATGGCACGAATGGAAAAAAATTCTAGTTGGTT,10,30,14,27,27,43,27,48,27,40,40,43,45,48,46.03,0.0
hek293t,11914,1,7,AGCAGAGCAGAGACCTAACTCTGGTGCTCCGGAGCAGTCTGACCTGGCTTGCCTTTTCAAATAATGAGAAAAAAATTCTAGTTGGTTTAACGCGTAACT,AGCAGAGCAGAGACCTAACTCTGGTGCTCCGGTGTGGCTAGCAGTCTGACCTGGCTTGCCTTTTCAAATAATGAGAAAAAAATTCTAGTTGGTTTAACG,10,30,14,27,27,48,27,55,27,33,33,48,40,55,59.41,22.79229953
hek293t,11914,1,7,ATGCAAGCAGAGACCTAACTCTGGTGCTCCGGAGCAGTCTGACCTGGCTTGCCTTTTCAAATAATGAGAAATTAAAAAAATTCTAGTTGGTTTAACGCG,ATGCAAGCAGAGACCTAACTCTGGTGCTCCGGTGTGGCTAGCAGTCTGACCTGGCTTGCCTTTTCAAATAATGAGAAATTAAAAAAATTCTAGTTGGTT,10,30,14,27,27,43,27,50,27,33,33,43,40,50,59.41,48.70772551
hek293t,11916,1,10,CAATTAGCATGTGTAACATTTGGGAAATCTGGTGATATTCTGACAAAAACTCAAGTGGCAGTGCTAATGCCAAAAAAATTCTAGTTGGTTTAACGCGTA,CAATTAGCATGTGTAACATTTGGGAAATCTGGTGTGATTTTCCAATATTCTGACAAAAACTCAAGTGGCAGTGCTAATGCCAAAAAAATTCTAGTTGGT,10,30,14,27,27,42,27,52,27,35,35,42,45,52,20.78,0.306748466
hek293t,11917,1,12,CGGTATTCACTGAACAGGGTACCTGCCTTTGGAAAGGGGTCATGTTTCTGAACATGCTCTTGCATTCCCTGGACCACCCAAAAAAAATTCTAGTTGGTT,CGGTATTCACTGAACAGGGTACCTGCCCTATGTAGAGGATTTGGAAAGGGGTCATGTTTCTGAACATGCTCTTGCATTCCCTGGACCACCCAAAAAAAA,10,30,14,27,27,31,27,43,27,28,28,31,40,43,37.37,0.0
hek293t,11917,1,12,GTTCATTCACTGAACAGGGTACCTGCCTTTGGAAAGGGGTCATGTTTCTGAACATGCTCTTGCATTCCAAAAAAATTCTAGTTGGTTTAACGCGTAACT,GTTCATTCACTGAACAGGGTACCTGCCCTATGTAGAGGATTTGGAAAGGGGTCATGTTTCTGAACATGCTCTTGCATTCCAAAAAAATTCTAGTTGGTT,10,30,14,27,27,43,27,55,27,28,28,43,40,55,37.37,4.510736449
hek293t,20516,1,4,ATAAAGCTAAAAATTGCAGAGCAATCCCATGGTCTCTAGGTGTTTTATTGCCAAAAAGGAAATCTCTATTTCACATTAAAAAAATTCTAGTTGGTTTAA,ATAAAGCTAAAAATTGCAGAGCAATCCCATGTAGTGTCTCTAGGTGTTTTATTGCCAAAAAGGAAATCTCTATTTCACATTAAAAAAATTCTAGTTGGT,10,30,14,27,27,42,27,46,27,32,32,42,36,46,56.55,79.84092024
hek293t,20516,1,4,CTATAGCTAAAAATTGCAGAGCAATCCCATGGTCTCTAGGTGTTTTATTGCCAAAAAGGAAATCTCTATTTCACATTGTACAATAAAAAAATTCTAGTT,CTATAGCTAAAAATTGCAGAGCAATCCCATGTAGTGTCTCTAGGTGTTTTATTGCCAAAAAGGAAATCTCTATTTCACATTGTACAATAAAAAAATTCT,10,30,14,27,27,35,27,39,27,32,32,35,36,39,56.55,1.357335502
hek293t,11921,1,10,AGCCATGCATTGGTTTATCGTAGTGCAAATGGTAATGTTGCAAAGGCAGATTATAATGTGGGATAATAAAAAAAAATTCTAGTTGGTTTAACGCGTAAC,AGCCATGCATTGGTTTATCGTAGTGCAAATGGTAATGTTGGCATGGTTAGCAAAGGCAGATTATAATGTGGGATAATAAAAAAAAATTCTAGTTGGTTT,10,30,14,27,27,44,27,54,27,41,41,44,51,54,19.56,0.0
hek293t,11922,1,7,TCTAGAATCAAAGTTCACAGTAAACTTTGTGGATAAATAGGTATTTTACGAATTCATTTTCTGGATACTGTGCAGAAAAAAATTCTAGTTGGTTTAACG,TCTAGAATCAAAGTTCACAGTAAACTTTGTGGAAGTATGATAAATAGGTATTTTACGAATTCATTTTCTGGATACTGTGCAGAAAAAAATTCTAGTTGG,10,30,14,27,27,41,27,48,27,34,34,41,41,48,30.52,6.19639553
hek293t,11922,1,7,TTGTCAATCAAAGTTCACAGTAAACTTTGTGGATAAATAGGTATTTTACGAATTCATTTTCTGGATAAAAAAAATTCTAGTTGGTTTAACGCGTAACTA,TTGTCAATCAAAGTTCACAGTAAACTTTGTGGAAGTATGATAAATAGGTATTTTACGAATTCATTTTCTGGATAAAAAAAATTCTAGTTGGTTTAACGC,10,30,14,27,27,49,27,56,27,34,34,49,41,56,30.52,1.212709013
hek293t,11924,1,9,CAGCTCATACCCAGTTTGCGCTGTTTTTATGGCACCTTTCTTTCTCTGTTCTGCTTCTCTTCATATATGAAAAAATGTGTTAAAAAAATTCTAGTTGGT,CAGCTCATACCCAGTTTGCGCTGTTTTTACGCGGGGTATGGCACCTTTCTTTCTCTGTTCTGCTTCTCTTCATATATGAAAAAATGTGTTAAAAAAATT,10,30,14,27,27,33,27,42,27,30,30,33,39,42,-0.48,0.0
hek293t,11924,1,9,GCGCCCATACCCAGTTTGCGCTGTTTTTATGGCACCTTTCTTTCTCTGTTCTGCTTCTCTTCATATATGAAAAAATGAAAAAAATTCTAGTTGGTTTAA,GCGCCCATACCCAGTTTGCGCTGTTTTTACGCGGGGTATGGCACCTTTCTTTCTCTGTTCTGCTTCTCTTCATATATGAAAAAATGAAAAAAATTCTAG,10,30,14,27,27,37,27,46,27,30,30,37,39,46,-0.48,0.0
hek293t,11926,1,2,CGCGAACGAGTGTGTGTATGTGTATTTTTAGGAGGGCTTCCACTCTGTGTTGGTTTGTTTATGGTTCTGTGTTAAAAAAAATTCTAGTTGGTTTAACGC,CGCGAACGAGTGTGTGTATGTGTATTTTTAGGAGGGACCTTCCACTCTGTGTTGGTTTGTTTATGGTTCTGTGTTAAAAAAAATTCTAGTTGGTTTAAC,10,30,14,27,27,47,27,49,27,37,37,47,39,49,3.47,5.540401113
hek293t,11926,1,2,GTATCACGAGTGTGTGTATGTGTATTTTTAGGAGGGCTTCCACTCTGTGTTGGTTTGTTTATGGTTCTGAAAAAAATTCTAGTTGGTTTAACGCGTAAC,GTATCACGAGTGTGTGTATGTGTATTTTTAGGAGGGACCTTCCACTCTGTGTTGGTTTGTTTATGGTTCTGAAAAAAATTCTAGTTGGTTTAACGCGTA,10,30,14,27,27,52,27,54,27,37,37,52,39,54,3.47,5.839631032
hek293t,316,1,9,GTGGGCAAAAGTAAGACCACAAAACTTTTAGGAAATCAAGTAAATGTGAGAGCTGGGTCTAGGCCAGATTAAAAAAATTCTAGTTGGTTTAACGCGTAA,GTGGGCAAAAGTAAGACCACAAAACTTTTAGGATTTTTTCTGAATCAAGTAAATGTGAGAGCTGGGTCTAGGCCAGATTAAAAAAATTCTAGTTGGTTT,10,30,14,27,27,44,27,53,27,34,34,44,43,53,3.5,0.091762551
hek293t,316,1,9,CCTTCCAAAAGTAAGACCACAAAACTTTTAGGAAATCAAGTAAATGTGAGAGCTGGGTCTAGGCCAGATTCTCTGTAAAAAAAATTCTAGTTGGTTTAA,CCTTCCAAAAGTAAGACCACAAAACTTTTAGGATTTTTTCTGAATCAAGTAAATGTGAGAGCTGGGTCTAGGCCAGATTCTCTGTAAAAAAAATTCTAG,10,30,14,27,27,37,27,46,27,34,34,37,43,46,3.5,0.0
hek293t,11930,1,6,GAGCAACTCACTCACACACACAGCAGCTAAGGACAAACAGCACATACGGTGCGTTGCGCAGTGCCCCGTCCTGTTAAAAAAATTCTAGTTGGTTTAACG,GAGCAACTCACTCACACACACAGCAGCTAAGGACAAACGCAACTAGCACATACGGTGCGTTGCGCAGTGCCCCGTCCTGTTAAAAAAATTCTAGTTGGT,10,30,14,27,27,42,27,48,27,39,39,42,45,48,56.33,0.451356974
hek293t,11930,1,6,GGAGTACTCACTCACACACACAGCAGCTAAGGACAAACAGCACATACGGTGCGTTGCGCAGTGCCCCGTCCAAAAAAATTCTAGTTGGTTTAACGCGTA,GGAGTACTCACTCACACACACAGCAGCTAAGGACAAACGCAACTAGCACATACGGTGCGTTGCGCAGTGCCCCGTCCAAAAAAATTCTAGTTGGTTTAA,10,30,14,27,27,46,27,52,27,39,39,46,45,52,56.33,9.26117042
hek293t,15889,1,10,CGAAGTTCAGAAAAGGCTGTGATCTCTCCAGGAAACACAGTGGTGAGGAATTACAAACACATACAAAAAAAAAAATTCTAGTTGGTTTAACGCGTAACT,CGAAGTTCAGAAAAGGCTGTGATCTCTCCAGGAAGAAGGATAGGACACAGTGGTGAGGAATTACAAACACATACAAAAAAAAAAATTCTAGTTGGTTTA,10,30,14,27,27,45,27,55,27,35,35,45,45,55,38.46,6.417438104
hek293t,15889,1,10,ATTCATTCAGAAAAGGCTGTGATCTCTCCAGGAAACACAGTGGTGAGGAATTACAAACACATACAAAAGATAAAAAAAAAAATTCTAGTTGGTTTAACG,ATTCATTCAGAAAAGGCTGTGATCTCTCCAGGAAGAAGGATAGGACACAGTGGTGAGGAATTACAAACACATACAAAAGATAAAAAAAAAAATTCTAGT,10,30,14,27,27,38,27,48,27,35,35,38,45,48,38.46,0.0
hek293t,11934,1,7,ATAGACCAAGCTATTCTCCAGCAAGGCAGTGGGATGTATATTTGTTTGAATGGACCAGTATTCACTCAAACAGATGAAAAAAAATTCTAGTTGGTTTAA,ATAGACCAAGCTATTCTCCAGCAAGGCAGTGGGATGCGGACCGTATATTTGTTTGAATGGACCAGTATTCACTCAAACAGATGAAAAAAAATTCTAGTT,10,30,14,27,27,39,27,46,27,36,36,39,43,46,48.65,0.239206222
hek293t,11934,1,7,ATAAACCAAGCTATTCTCCAGCAAGGCAGTGGGATGTATATTTGTTTGAATGGACCAGTATTCACTCAAAAAAAAAATTCTAGTTGGTTTAACGCGTAA,ATAAACCAAGCTATTCTCCAGCAAGGCAGTGGGATGCGGACCGTATATTTGTTTGAATGGACCAGTATTCACTCAAAAAAAAAATTCTAGTTGGTTTAA,10,30,14,27,27,46,27,53,27,36,36,46,43,53,48.65,30.36446961
hek293t,11936,1,9,ATAATCTGTTAACTTCAAAATCCCAGGTCTGGTTCCCTATTTGTGTCAAAGGCTCACAACGTGAATTAGTTTATTTGTAAAAAAATTCTAGTTGGTTTA,ATAATCTGTTAACTTCAAAATCCCAGGTTTGCGGTGGCTGGTTCCCTATTTGTGTCAAAGGCTCACAACGTGAATTAGTTTATTTGTAAAAAAATTCTA,10,30,14,27,27,36,27,45,27,29,29,36,38,45,39.83,19.23625872
hek293t,11938,1,6,GAAGTAGCTCCTCGACTCTGGAAGGTACGCGGTCTTTCTCAGGCACCCTTGTAGAATAGGGCTGTCTCGAAAGCATGCAAAAAAATTCTAGTTGGTTTA,GAAGTAGCTCCTCGACTCTGGAAGGTACGCGGTCTTGGCGGTTCTCAGGCACCCTTGTAGAATAGGGCTGTCTCGAAAGCATGCAAAAAAATTCTAGTT,10,30,14,27,27,39,27,45,27,36,36,39,42,45,64.89,0.0
hek293t,11938,1,6,AGGCCAGCTCCTCGACTCTGGAAGGTACGCGGTCTTTCTCAGGCACCCTTGTAGAATAGGGCTGTCAAAAAAATTCTAGTTGGTTTAACGCGTAACTAG,AGGCCAGCTCCTCGACTCTGGAAGGTACGCGGTCTTGGCGGTTCTCAGGCACCCTTGTAGAATAGGGCTGTCAAAAAAATTCTAGTTGGTTTAACGCGT,10,30,14,27,27,51,27,57,27,36,36,51,42,57,64.89,23.67683181
hek293t,11940,1,1,TAAGGCTTATATTGGTGTAACAGTGTTCAAGGTTTGACCCATTTAAGTGTATGCAAAAGGAAATATATCAGGCATTAAAATATAAAAAAAATTCTAGTT,TAAGGCTTATATTGGTGTAACAGTGTTCAAGGTTGTGACCCATTTAAGTGTATGCAAAAGGAAATATATCAGGCATTAAAATATAAAAAAAATTCTAGT,10,30,14,27,27,38,27,39,27,35,35,38,36,39,30.9,0.408028732
hek293t,11940,1,1,GAGGACTTATATTGGTGTAACAGTGTTCAAGGTTTGACCCATTTAAGTGTATGCAAAAGGAAATATATCAGGCATTAAAAAAAAAAATTCTAGTTGGTT,GAGGACTTATATTGGTGTAACAGTGTTCAAGGTTGTGACCCATTTAAGTGTATGCAAAAGGAAATATATCAGGCATTAAAAAAAAAAATTCTAGTTGGT,10,30,14,27,27,42,27,43,27,35,35,42,36,43,30.9,44.78943722
hek293t,11942,1,8,ATTTTACCAATTTACACAGAGCAAATCTCAGGTTTTTTCTCACTAGCATTTCTACTAATGCTAATACCTCAGAAAAAAATTCTAGTTGGTTTAACGCGT,ATTTTACCAATTTACACAGAGCAAATCTCAGGTTTTTTCGGGCAGTGTCACTAGCATTTCTACTAATGCTAATACCTCAGAAAAAAATTCTAGTTGGTT,10,30,14,27,27,43,27,51,27,40,40,43,48,51,35.21,0.116550117
hek293t,11944,1,1,TAGCAGGGTAGGGATTAATGGCAGCAAATTGGCTATCTCTGGCTGCTATGAATTCTAAAGTCTGTAAAAAAAATTCTAGTTGGTTTAACGCGTAACTAG,TAGCAGGGTAGGGATTAATGGCAGCAAATTGGCTATCTCTCGGCTGCTATGAATTCTAAAGTCTGTAAAAAAAATTCTAGTTGGTTTAACGCGTAACTA,10,30,14,27,27,56,27,57,27,41,41,56,42,57,23.19,75.61538712
hek293t,11944,1,1,GGTTAGGGTAGGGATTAATGGCAGCAAATTGGCTATCTCTGGCTGCTATGAATTCTAAAGTCTGTAATATTAAAAAAATTCTAGTTGGTTTAACGCGTA,GGTTAGGGTAGGGATTAATGGCAGCAAATTGGCTATCTCTCGGCTGCTATGAATTCTAAAGTCTGTAATATTAAAAAAATTCTAGTTGGTTTAACGCGT,10,30,14,27,27,51,27,52,27,41,41,51,42,52,23.19,73.9661676
hek293t,11946,1,5,ACCGTTTTGTATTTGTTGTTAGAATGATGTGGTCTGTGTAGTAATGAATGTGGCTCAATGTTTCATATTGGATTAAAAAAATTCTAGTTGGTTTAACGC,ACCGTTTTGTATTTGTTGTTAGAATGATGTGGTCTGTGTATGATGGTAATGAATGTGGCTCAATGTTTCATATTGGATTAAAAAAATTCTAGTTGGTTT,10,30,14,27,27,44,27,49,27,41,41,44,46,49,33.05,0.0
hek293t,11947,1,7,GATGTTTGCCGAAATGCTGCCTCGGGTGGAGGTGCGAGAGGCAGCGGTGGCAGCCGTAACCCTGCGGGCCTCGTGCTCTAAAAAAATTCTAGTTGGTTT,GATGTTTGCCGAAATGCTGCCTCGGGTATCACGTGGAGGTGCGAGAGGCAGCGGTGGCAGCCGTAACCCTGCGGGCCTCGTGCTCTAAAAAAATTCTAG,10,30,14,27,27,37,27,44,27,27,27,37,34,44,33.51,17.61481915
hek293t,11947,1,7,TTCACTTGCCGAAATGCTGCCTCGGGTGGAGGTGCGAGAGGCAGCGGTGGCAGCCGTAACCCTGCGGGCCTCGTGCTCTCGGAAAAAAATTCTAGTTGG,TTCACTTGCCGAAATGCTGCCTCGGGTATCACGTGGAGGTGCGAGAGGCAGCGGTGGCAGCCGTAACCCTGCGGGCCTCGTGCTCTCGGAAAAAAATTC,10,30,14,27,27,34,27,41,27,27,27,34,34,41,33.51,66.69613046
hek293t,11949,1,6,ATGGTGGCTTCAATTTCTAGCTATGGAATTGGCTCTCAATGTTTTTCAGCACCCAAATAAGCACTTTTTAAAGTATTTAAGTAAAAAAAATTCTAGTTG,ATGGTGGCTTCAATTTCTAGCTATGGAATTGTCGTGGGCTCTCAATGTTTTTCAGCACCCAAATAAGCACTTTTTAAAGTATTTAAGTAAAAAAAATTC,10,30,14,27,27,34,27,40,27,31,31,34,37,40,12.38,0.0
hek293t,11949,1,6,GGCCGGGCTTCAATTTCTAGCTATGGAATTGGCTCTCAATGTTTTTCAGCACCCAAATAAGCACTTTTTAAAGTATAAAAAAATTCTAGTTGGTTTAAC,GGCCGGGCTTCAATTTCTAGCTATGGAATTGTCGTGGGCTCTCAATGTTTTTCAGCACCCAAATAAGCACTTTTTAAAGTATAAAAAAATTCTAGTTGG,10,30,14,27,27,41,27,47,27,31,31,41,37,47,12.38,62.06459306
hek293t,11951,1,15,TTGATTGTAAAAGGTCCTTTCCATTATAATGGCATGAGCTGGCATGAATCGGAGAGGTCTAGAAAGGAAAAAAAATTCTAGTTGGTTTAACGCGTAACT,TTGATTGTAAAAGGTCCTTTCCATTATAATGGCATGGTATGGCACGCACGTAGCTGGCATGAATCGGAGAGGTCTAGAAAGGAAAAAAAATTCTAGTTG,10,30,14,27,27,40,27,55,27,37,37,40,52,55,14.89,0.197823937
hek293t,11952,1,11,CGGCCAGACCTCCCTCAAAGGTCAGGACTAGGCAGCAACCAGGGCTGGAATGGCTCCTTCCCACTGCAAAAGAAAAAAATTCTAGTTGGTTTAACGCGT,CGGCCAGACCTCCCTCAAAGGTCAGGACTAGGCAGCTTACTACACATAACCAGGGCTGGAATGGCTCCTTCCCACTGCAAAAGAAAAAAATTCTAGTTG,10,30,14,27,27,40,27,51,27,37,37,40,48,51,48.86,0.0
hek293t,11953,1,11,ACGGGAAATTATTTCTTATTATCTCCACTTGGTAAGACATATGTCTGTGATTCTGATTTAAAAAAAAAAAAATTCTAGTTGGTTTAACGCGTAACTAGA,ACGGGAAATTATTTCTTATTATCTCCACTTGGTAAGACATCGGCTTCGCCTATGTCTGTGATTCTGATTTAAAAAAAAAAAAATTCTAGTTGGTTTAAC,10,30,14,27,27,47,27,58,27,40,40,47,51,58,12.88,0.065876153
hek293t,11954,1,2,AAAACCGTGGAAAAAATCCCAGAAATTTAAGGGTAAGGGACCTCCTTGCAGTCTCAGAAAGCAACCTTAATTCTCACACAAAAAAATTCTAGTTGGTTT,AAAACCGTGGAAAAAATCCCAGAAATTTAAGGGTAAGGAGGACCTCCTTGCAGTCTCAGAAAGCAACCTTAATTCTCACACAAAAAAATTCTAGTTGGT,10,30,14,27,27,42,27,44,27,39,39,42,41,44,2.48,0.0
hek293t,11954,1,2,AAGGCCGTGGAAAAAATCCCAGAAATTTAAGGGTAAGGGACCTCCTTGCAGTCTCAGAAAGCAACCTTAATTCTCAAAAAAATTCTAGTTGGTTTAACG,AAGGCCGTGGAAAAAATCCCAGAAATTTAAGGGTAAGGAGGACCTCCTTGCAGTCTCAGAAAGCAACCTTAATTCTCAAAAAAATTCTAGTTGGTTTAA,10,30,14,27,27,46,27,48,27,39,39,46,41,48,2.48,29.60108435
hek293t,11956,1,7,GACCCATCAATGAAACGTCCTCAGGAACACGGTGATGAATTGTTGATTCATAAACATTAACTGTATTTATTACTGAAAAAAAATTCTAGTTGGTTTAAC,GACCCATCAATGAAACGTCCTCAGGAACACGGTGGACTCTGATGAATTGTTGATTCATAAACATTAACTGTATTTATTACTGAAAAAAAATTCTAGTTG,10,30,14,27,27,40,27,47,27,33,33,40,40,47,72.59,0.657529388
hek293t,11956,1,7,TTTCGATCAATGAAACGTCCTCAGGAACACGGTGATGAATTGTTGATTCATAAACATTAACTGTATTTATTACTGAACATAAAAAAATTCTAGTTGGTT,TTTCGATCAATGAAACGTCCTCAGGAACACGGTGGACTCTGATGAATTGTTGATTCATAAACATTAACTGTATTTATTACTGAACATAAAAAAATTCTA,10,30,14,27,27,36,27,43,27,33,33,36,40,43,72.59,0.044682752
hek293t,20457,1,15,CCACGGGCACCCCTCTGCTCAGAGATGTATGGAATGATCTGCAGACCACTCCTGTAATTTTGCAAAAAAAATTCTAGTTGGTTTAACGCGTAACTAGAT,CCACGGGCACCCCTCTGCTCAGAGATGTATGGAGATCAGGCGGATAAAATGATCTGCAGACCACTCCTGTAATTTTGCAAAAAAAATTCTAGTTGGTTT,10,30,14,27,27,44,27,59,27,34,34,44,49,59,52.25,1.257638504
hek293t,20457,1,15,ACTGTGGCACCCCTCTGCTCAGAGATGTATGGAATGATCTGCAGACCACTCCTGTAATTTTGCAACAAAAAAAATTCTAGTTGGTTTAACGCGTAACTA,ACTGTGGCACCCCTCTGCTCAGAGATGTATGGAGATCAGGCGGATAAAATGATCTGCAGACCACTCCTGTAATTTTGCAACAAAAAAAATTCTAGTTGG,10,30,14,27,27,41,27,56,27,34,34,41,49,56,52.25,0.307412621
hek293t,11960,1,3,GTTTAGAGTGTACTTCAAGCTAAAGTTCTAGGAGGTTTTAGCAGTACTGCCATGATACACAGAGCTCAGACAAAATATCCGTAAAAAAATTCTAGTTGG,GTTTAGAGTGTACTTCAAGCTAAAGTTATTCTAGGAGGTTTTAGCAGTACTGCCATGATACACAGAGCTCAGACAAAATATCCGTAAAAAAATTCTAGT,10,30,14,27,27,38,27,41,27,28,28,38,31,41,32.19,43.28585788
hek293t,11960,1,3,GTTATGAGTGTACTTCAAGCTAAAGTTCTAGGAGGTTTTAGCAGTACTGCCATGATACACAGAGCTCAGACAAAATATCCGTTCACAAAAAAAAAATTC,GTTATGAGTGTACTTCAAGCTAAAGTTATTCTAGGAGGTTTTAGCAGTACTGCCATGATACACAGAGCTCAGACAAAATATCCGTTCACAAAAAAAAAA,10,30,14,27,27,31,27,34,27,28,28,31,31,34,32.19,0.130208333
hek293t,11962,1,13,CCCTACCTCATCTTCATCTGCTGACTTGAAGGGTGAAAGTCTTTATGTCTGAGGAGAATGGTCTGTGTAGTACAAAAAAATTCTAGTTGGTTTAACGCG,CCCTACCTCATCTTCATCTGCTGACTTATACGGCAGGTTTGAAGGGTGAAAGTCTTTATGTCTGAGGAGAATGGTCTGTGTAGTACAAAAAAATTCTAG,10,30,14,27,27,37,27,50,27,27,27,37,40,50,13.67,6.051474065
hek293t,11962,1,13,CGCGTCCTCATCTTCATCTGCTGACTTGAAGGGTGAAAGTCTTTATGTCTGAGGAGAATGGTCTGTGTAAAAAAATTCTAGTTGGTTTAACGCGTAACT,CGCGTCCTCATCTTCATCTGCTGACTTATACGGCAGGTTTGAAGGGTGAAAGTCTTTATGTCTGAGGAGAATGGTCTGTGTAAAAAAATTCTAGTTGGT,10,30,14,27,27,42,27,55,27,27,27,42,40,55,13.67,24.65912471
hek293t,11964,1,1,TCGCTTAACCTGACACTGCTGATTCTCATAGGTTAGCTGTTTGTTTATTCCCATGAGCAATGATTGGCGTAAGATCCCGAATAAAAAAATTCTAGTTGG,TCGCTTAACCTGACACTGCTGATTCTCATAGGTTTAGCTGTTTGTTTATTCCCATGAGCAATGATTGGCGTAAGATCCCGAATAAAAAAATTCTAGTTG,10,30,14,27,27,40,27,41,27,33,33,40,34,41,26.94,33.05496858
hek293t,11964,1,1,GTGTTTAACCTGACACTGCTGATTCTCATAGGTTAGCTGTTTGTTTATTCCCATGAGCAATGATTGGCGTAAGATCCCGAAAAAAATTCTAGTTGGTTT,GTGTTTAACCTGACACTGCTGATTCTCATAGGTTTAGCTGTTTGTTTATTCCCATGAGCAATGATTGGCGTAAGATCCCGAAAAAAATTCTAGTTGGTT,10,30,14,27,27,43,27,44,27,33,33,43,34,44,26.94,35.08925879
hek293t,11966,1,9,CGTGTTAATTCCACAAAGCACTGCGGCAGTGGGGCGGCTAAAACCAGGAGATTGCACGGAACATTTATCAAAAAAATTCTAGTTGGTTTAACGCGTAAC,CGTGTTAATTCCACAAAGCACTGCGGCAGTTCTTCTGTTGGGGCGGCTAAAACCAGGAGATTGCACGGAACATTTATCAAAAAAATTCTAGTTGGTTTA,10,30,14,27,27,45,27,54,27,30,30,45,39,54,31.26,10.19256914
hek293t,11966,1,9,GGATCTAATTCCACAAAGCACTGCGGCAGTGGGGCGGCTAAAACCAGGAGATTGCACGGAACATTTATCACTAAAAAAAAATTCTAGTTGGTTTAACGC,GGATCTAATTCCACAAAGCACTGCGGCAGTTCTTCTGTTGGGGCGGCTAAAACCAGGAGATTGCACGGAACATTTATCACTAAAAAAAAATTCTAGTTG,10,30,14,27,27,40,27,49,27,30,30,40,39,49,31.26,25.45678366
hek293t,11968,1,12,TCCTTAAGGTTTTAAGGCAGGGAGGGAGAAGGAAAGAGAACTTGTACTAGGAGCCAATGCTGGATCAGATAAAAAAATTCTAGTTGGTTTAACGCGTAA,TCCTTAAGGTTTTAAGGCAGGGAGGGAGAAGAAGTCCATCGTGGAAAGAGAACTTGTACTAGGAGCCAATGCTGGATCAGATAAAAAAATTCTAGTTGG,10,30,14,27,27,41,27,53,27,31,31,41,43,53,36.15,4.788017206
hek293t,11968,1,12,CCTAGAAGGTTTTAAGGCAGGGAGGGAGAAGGAAAGAGAACTTGTACTAGGAGCCAATGCTGGATCAGATCGCAAAAAAATTCTAGTTGGTTTAACGCG,CCTAGAAGGTTTTAAGGCAGGGAGGGAGAAGAAGTCCATCGTGGAAAGAGAACTTGTACTAGGAGCCAATGCTGGATCAGATCGCAAAAAAATTCTAGT,10,30,14,27,27,38,27,50,27,31,31,38,43,50,36.15,3.788223932
hek293t,11970,1,2,CGGGGGAGAGCTTTGTAATGACAGAGTTCTGGAGAACTGAAGGAGAGCTTTAAGAACTTATCTCTCAATGGAAAAAAAATTCTAGTTGGTTTAACGCGT,CGGGGGAGAGCTTTGTAATGACAGAGTTCTGGAGAACTATGAAGGAGAGCTTTAAGAACTTATCTCTCAATGGAAAAAAAATTCTAGTTGGTTTAACGC,10,30,14,27,27,49,27,51,27,39,39,49,41,51,47.28,74.18016794
hek293t,11970,1,2,GCGGAGAGAGCTTTGTAATGACAGAGTTCTGGAGAACTGAAGGAGAGCTTTAAGAACTTATCTCTCAATGGAATAATATAAAAAAATTCTAGTTGGTTT,GCGGAGAGAGCTTTGTAATGACAGAGTTCTGGAGAACTATGAAGGAGAGCTTTAAGAACTTATCTCTCAATGGAATAATATAAAAAAATTCTAGTTGGT,10,30,14,27,27,42,27,44,27,39,39,42,41,44,47.28,2.385015427
hek293t,11972,1,13,CTCCAACTAGAACGTAGAGTGCAGTAAAATGGTTCCTACAAACATGCTATCACTATGAGTAAGAAAAAAAATTCTAGTTGGTTTAACGCGTAACTAGAT,CTCCAACTAGAACGTAGAGTGCAGTAAAATGGTTCGGGCGCATGAGCGCTACAAACATGCTATCACTATGAGTAAGAAAAAAAATTCTAGTTGGTTTAA,10,30,14,27,27,46,27,59,27,36,36,46,49,59,15.28,1.413131524
hek293t,11972,1,13,ACGTCACTAGAACGTAGAGTGCAGTAAAATGGTTCCTACAAACATGCTATCACTATGAGTAAGAAACTGTAAAAAAAATTCTAGTTGGTTTAACGCGTA,ACGTCACTAGAACGTAGAGTGCAGTAAAATGGTTCGGGCGCATGAGCGCTACAAACATGCTATCACTATGAGTAAGAAACTGTAAAAAAAATTCTAGTT,10,30,14,27,27,39,27,52,27,36,36,39,49,52,15.28,0.0
hek293t,11974,1,14,CCTTAATATTGTTGCAGCTGCCACAGGCTAGGGCCTGGAAGCCTGCTGCTTCTGTTTCAGATTTGAAGAAGGGTTTGTGAAAAAAATTCTAGTTGGTTT,CCTTAATATTGTTGCAGCTGCCACAGGTTGACCTTTAAAGGCTAGGGCCTGGAAGCCTGCTGCTTCTGTTTCAGATTTGAAGAAGGGTTTGTGAAAAAA,10,30,14,27,27,30,27,44,27,27,27,30,41,44,30.56,7.2060658
hek293t,11974,1,14,AACAGATATTGTTGCAGCTGCCACAGGCTAGGGCCTGGAAGCCTGCTGCTTCTGTTTCAGATTTGAAGAAGGAAAAAAATTCTAGTTGGTTTAACGCGT,AACAGATATTGTTGCAGCTGCCACAGGTTGACCTTTAAAGGCTAGGGCCTGGAAGCCTGCTGCTTCTGTTTCAGATTTGAAGAAGGAAAAAAATTCTAG,10,30,14,27,27,37,27,51,27,27,27,37,41,51,30.56,26.58750759
hek293t,11976,1,10,CCGTGGTAGCAGTGCAAAATATCACAGTTAGGGTGCCCCCCCAATATTTCAGCAGTGTAGCTAAAAGTTATAAAAAAATTCTAGTTGGTTTAACGCGTA,CCGTGGTAGCAGTGCAAAATATCACAGTTAGGGTTTATGTGATTGCCCCCCCAATATTTCAGCAGTGTAGCTAAAAGTTATAAAAAAATTCTAGTTGGT,10,30,14,27,27,42,27,52,27,35,35,42,45,52,32.37,0.0
hek293t,11976,1,10,AGACTGTAGCAGTGCAAAATATCACAGTTAGGGTGCCCCCCCAATATTTCAGCAGTGTAGCTAAAAGTAAAAAAATTCTAGTTGGTTTAACGCGTAACT,AGACTGTAGCAGTGCAAAATATCACAGTTAGGGTTTATGTGATTGCCCCCCCAATATTTCAGCAGTGTAGCTAAAAGTAAAAAAATTCTAGTTGGTTTA,10,30,14,27,27,45,27,55,27,35,35,45,45,55,32.37,0.223964166
hek293t,11978,1,14,AGGGGTACTTGCATGGCCTAGTTCAAAGCAGGTGTTACAGACTGGTGTTATCACAAAGGGAGCCGGAACGCCAAAAAAATTCTAGTTGGTTTAACGCGT,AGGGGTACTTGCATGGCCTAGTTCAAAGCAGGTCTAATCTAGCATAGGTTACAGACTGGTGTTATCACAAAGGGAGCCGGAACGCCAAAAAAATTCTAG,10,30,14,27,27,37,27,51,27,34,34,37,48,51,49.04,0.0
hek293t,11978,1,14,ATGTATACTTGCATGGCCTAGTTCAAAGCAGGTGTTACAGACTGGTGTTATCACAAAGGGAGCCGAAAAAAATTCTAGTTGGTTTAACGCGTAACTAGA,ATGTATACTTGCATGGCCTAGTTCAAAGCAGGTCTAATCTAGCATAGGTTACAGACTGGTGTTATCACAAAGGGAGCCGAAAAAAATTCTAGTTGGTTT,10,30,14,27,27,44,27,58,27,34,34,44,48,58,49.04,18.54017795
hek293t,11982,1,9,AACCGTCACTGCACGTGGCACTGCCAGTCAGGGCTGCAGCCCTGCGAGTGCCTGCAGAAGGCGAGTGCAAAAAAATTCTAGTTGGTTTAACGCGTAACT,AACCGTCACTGCACGTGGCACTGCCAGTCAGGGCTGTTGCACAAGCAGCCCTGCGAGTGCCTGCAGAAGGCGAGTGCAAAAAAATTCTAGTTGGTTTAA,10,30,14,27,27,46,27,55,27,36,36,46,45,55,18.98,31.55430354
hek293t,11982,1,9,GAGCATCACTGCACGTGGCACTGCCAGTCAGGGCTGCAGCCCTGCGAGTGCCTGCAGAAGGCGAGTGCTGCTGCGAAAAAAATTCTAGTTGGTTTAACG,GAGCATCACTGCACGTGGCACTGCCAGTCAGGGCTGTTGCACAAGCAGCCCTGCGAGTGCCTGCAGAAGGCGAGTGCTGCTGCGAAAAAAATTCTAGTT,10,30,14,27,27,39,27,48,27,36,36,39,45,48,18.98,0.291970803
hek293t,11984,1,5,ATCGCCGTTCCTGAGCCCCGCGGCGGCTGTGGTGCCGCTCGCAGGCAGGGCGCTGCGCGTCCCCCGCCGGGGCCAGCTGCAAAGAAAAAAATTCTAGTT,ATCGCCGTTCCTGAGCCCCGCGGCGGCTGTGCGCGGGTGCCGCTCGCAGGCAGGGCGCTGCGCGTCCCCCGCCGGGGCCAGCTGCAAAGAAAAAAATTC,10,30,14,27,27,34,27,39,27,31,31,34,36,39,55.71,0.309597523
hek293t,11986,1,13,CGCTAACCTCTACTCAGCAAGAACATTCGAGGTACAGAAAACTCTACATTCTTTAATTTACAAGAAGGAAAAAAAAATTCTAGTTGGTTTAACGCGTAA,CGCTAACCTCTACTCAGCAAGAACATTCGAGGTACAATGCTCGACTCGCGAAAACTCTACATTCTTTAATTTACAAGAAGGAAAAAAAAATTCTAGTTG,10,30,14,27,27,40,27,53,27,37,37,40,50,53,61.55,0.0
hek293t,11986,1,13,GGGCCACCTCTACTCAGCAAGAACATTCGAGGTACAGAAAACTCTACATTCTTTAATTTACAAGAAAAAAAAATTCTAGTTGGTTTAACGCGTAACTAG,GGGCCACCTCTACTCAGCAAGAACATTCGAGGTACAATGCTCGACTCGCGAAAACTCTACATTCTTTAATTTACAAGAAAAAAAAATTCTAGTTGGTTT,10,30,14,27,27,44,27,57,27,37,37,44,50,57,61.55,0.087950748
hek293t,11990,1,1,TTGGTTTTCAACTGTGAAACCAGAGGAGTAGGAGGTCTGGACAAGCAAACAGCATCTTCAGAATTCAAAAGCAGAAAAAAATTCTAGTTGGTTTAACGC,TTGGTTTTCAACTGTGAAACCAGAGGAGTAGGCAGGTCTGGACAAGCAAACAGCATCTTCAGAATTCAAAAGCAGAAAAAAATTCTAGTTGGTTTAACG,10,30,14,27,27,48,27,49,27,33,33,48,34,49,51.5,80.02412181
hek293t,11990,1,1,ACACCTTTCAACTGTGAAACCAGAGGAGTAGGAGGTCTGGACAAGCAAACAGCATCTTCAGAATTCAAAAGCAGCATCATATACATAAAAAAATTCTAG,ACACCTTTCAACTGTGAAACCAGAGGAGTAGGCAGGTCTGGACAAGCAAACAGCATCTTCAGAATTCAAAAGCAGCATCATATACATAAAAAAATTCTA,10,30,14,27,27,36,27,37,27,33,33,36,34,37,51.5,3.034435201
hek293t,11992,1,15,AAGATCATTCGTCTACTGTTGTAATTGCATGGGTCCCATGGCAGGATGATACCCTTAGTCATTTAAAAAAATTCTAGTTGGTTTAACGCGTAACTAGAT,AAGATCATTCGTCTACTGTTGTAATTGCCACCTTGAGAACTTAATGGGTCCCATGGCAGGATGATACCCTTAGTCATTTAAAAAAATTCTAGTTGGTTT,10,30,14,27,27,44,27,59,27,29,29,44,44,59,30.82,19.50722083
hek293t,11992,1,15,CGCGCCATTCGTCTACTGTTGTAATTGCATGGGTCCCATGGCAGGATGATACCCTTAGTCATTTCCAAATGGAAAAAAATTCTAGTTGGTTTAACGCGT,CGCGCCATTCGTCTACTGTTGTAATTGCCACCTTGAGAACTTAATGGGTCCCATGGCAGGATGATACCCTTAGTCATTTCCAAATGGAAAAAAATTCTA,10,30,14,27,27,36,27,51,27,29,29,36,44,51,30.82,2.381891835
hek293t,11994,1,6,GATCCTATTTTCCACTGTCACGTACTACACGGGTACATTCAGAAAGGGGTGATTTGGTTCACGCTTATATTTGTAGCTGAAAAAAATTCTAGTTGGTTT,GATCCTATTTTCCACTGTCACGTACTACACGGGTCAATTAACATTCAGAAAGGGGTGATTTGGTTCACGCTTATATTTGTAGCTGAAAAAAATTCTAGT,10,30,14,27,27,38,27,44,27,35,35,38,41,44,54.48,0.120336943
hek293t,11994,1,6,TGTCCTATTTTCCACTGTCACGTACTACACGGGTACATTCAGAAAGGGGTGATTTGGTTCACGCTTATATTTAAAAAAATTCTAGTTGGTTTAACGCGT,TGTCCTATTTTCCACTGTCACGTACTACACGGGTCAATTAACATTCAGAAAGGGGTGATTTGGTTCACGCTTATATTTAAAAAAATTCTAGTTGGTTTA,10,30,14,27,27,45,27,51,27,35,35,45,41,51,54.48,29.94099262
hek293t,11996,1,3,GACCACCTCATTTACACGCTGCTGTGCATAGGTAACTTTGTTTCATACATAAGTTGACCACTAGCAGAAGTCAGAATAAAAAAATTCTAGTTGGTTTAA,GACCACCTCATTTACACGCTGCTGTGCGTTATAGGTAACTTTGTTTCATACATAAGTTGACCACTAGCAGAAGTCAGAATAAAAAAATTCTAGTTGGTT,10,30,14,27,27,43,27,46,27,28,28,43,31,46,33.68,71.18551831
hek293t,11996,1,3,CAGCACCTCATTTACACGCTGCTGTGCATAGGTAACTTTGTTTCATACATAAGTTGACCACTAGCAGAAGTCAGAATAGTTGAAAAAAATTCTAGTTGG,CAGCACCTCATTTACACGCTGCTGTGCGTTATAGGTAACTTTGTTTCATACATAAGTTGACCACTAGCAGAAGTCAGAATAGTTGAAAAAAATTCTAGT,10,30,14,27,27,38,27,41,27,28,28,38,31,41,33.68,75.04748666
hek293t,11998,1,8,CTAGTTGGAACAATGCATGAAGTAGTATTTGGATCTGCTGTGTTAGTGACTACAATGCAGTTACTAAAAAAATTCTAGTTGGTTTAACGCGTAACTAGA,CTAGTTGGAACAATGCATGAAGTAGTATTTGGATCTGCTCGAGACATGTGTTAGTGACTACAATGCAGTTACTAAAAAAATTCTAGTTGGTTTAACGCG,10,30,14,27,27,50,27,58,27,40,40,50,48,58,29.63,1.955409936
hek293t,11999,1,11,ACCCTTACTGAAGCTAAGACTGTTGTGTGAGGAGAGCCATTTCATTTCCCTATTGCCTGCTCCAGACACAAGTATTAAAAAAATTCTAGTTGGTTTAAC,ACCCTTACTGAAGCTAAGACTGTTGTGTTCACTTTCCTTGAGGAGAGCCATTTCATTTCCCTATTGCCTGCTCCAGACACAAGTATTAAAAAAATTCTA,10,30,14,27,27,36,27,47,27,29,29,36,40,47,71.29,70.5030037
hek293t,11999,1,11,CTACGTACTGAAGCTAAGACTGTTGTGTGAGGAGAGCCATTTCATTTCCCTATTGCCTGCTCCAGACACAAGTAAAAAAATTCTAGTTGGTTTAACGCG,CTACGTACTGAAGCTAAGACTGTTGTGTTCACTTTCCTTGAGGAGAGCCATTTCATTTCCCTATTGCCTGCTCCAGACACAAGTAAAAAAATTCTAGTT,10,30,14,27,27,39,27,50,27,29,29,39,40,50,71.29,59.4971814
hek293t,12001,1,11,AAACGAGAAGTATTGTTACTTATAGTGTCTGGTGTCTAGGGCCAAAAACAGAAAGCTTCAAGCTGCAAAAAAATTCTAGTTGGTTTAACGCGTAACTAG,AAACGAGAAGTATTGTTACTTATAGTGTCTACCTTTAGCTGGGTGTCTAGGGCCAAAAACAGAAAGCTTCAAGCTGCAAAAAAATTCTAGTTGGTTTAA,10,30,14,27,27,46,27,57,27,31,31,46,42,57,49.8,9.301766866
hek293t,12001,1,11,GTCCCAGAAGTATTGTTACTTATAGTGTCTGGTGTCTAGGGCCAAAAACAGAAAGCTTCAAGCTGCAAGTAAAAAAAAAAATTCTAGTTGGTTTAACGC,GTCCCAGAAGTATTGTTACTTATAGTGTCTACCTTTAGCTGGGTGTCTAGGGCCAAAAACAGAAAGCTTCAAGCTGCAAGTAAAAAAAAAAATTCTAGT,10,30,14,27,27,38,27,49,27,31,31,38,42,49,49.8,3.192738468
hek293t,12003,1,10,GGACCGGGCAAAACTCACTGTCTATCAATTGGGGTATTAAAATCCCAACTACTAACAGACAATACATAAGCTGAGAAAAAAATTCTAGTTGGTTTAACG,GGACCGGGCAAAACTCACTGTCTATCATAGCAAGATTATTGGGGTATTAAAATCCCAACTACTAACAGACAATACATAAGCTGAGAAAAAAATTCTAGT,10,30,14,27,27,38,27,48,27,28,28,38,38,48,17.04,11.10881247
hek293t,12003,1,10,GAGTTGGGCAAAACTCACTGTCTATCAATTGGGGTATTAAAATCCCAACTACTAACAGACAATACATAAGAAAAAAATTCTAGTTGGTTTAACGCGTAA,GAGTTGGGCAAAACTCACTGTCTATCATAGCAAGATTATTGGGGTATTAAAATCCCAACTACTAACAGACAATACATAAGAAAAAAATTCTAGTTGGTT,10,30,14,27,27,43,27,53,27,28,28,43,38,53,17.04,5.056605231
hek293t,12005,1,12,CAGATGGAAGCAGAAGGGGAGCCGCTGAAAGGAAGCGGCATTGCGCGCAACAGGTTACCTACCGCTGGACGGAGGTAAGCAAAAAAATTCTAGTTGGTT,CAGATGGAAGCAGAAGGGGAGCCGCTGAGGCCCCGCACAAAAGGAAGCGGCATTGCGCGCAACAGGTTACCTACCGCTGGACGGAGGTAAGCAAAAAAA,10,30,14,27,27,31,27,43,27,28,28,31,40,43,60.88,0.254452926
hek293t,12005,1,12,GCGTTGGAAGCAGAAGGGGAGCCGCTGAAAGGAAGCGGCATTGCGCGCAACAGGTTACCTACCGCTGGACGGAAAAAAAATTCTAGTTGGTTTAACGCG,GCGTTGGAAGCAGAAGGGGAGCCGCTGAGGCCCCGCACAAAAGGAAGCGGCATTGCGCGCAACAGGTTACCTACCGCTGGACGGAAAAAAAATTCTAGT,10,30,14,27,27,38,27,50,27,28,28,38,40,50,60.88,0.262467192
hek293t,12007,1,13,CGCGATTTGAGGTTGTTATCCTAATTGCAAGGATCTCTTGTTTTAATCTTGAAGGCCTCTCCTGATTAAAAAAATTCTAGTTGGTTTAACGCGTAACTA,CGCGATTTGAGGTTGTTATCCTAATTGCAAGGATCTCTTCCTAGGGTCCGGGGTTTTAATCTTGAAGGCCTCTCCTGATTAAAAAAATTCTAGTTGGTT,10,30,14,27,27,43,27,56,27,40,40,43,53,56,59.69,0.0
hek293t,12008,1,11,GCGCCTGCATGCCAGCTTCTCCTGAGCTCTGGCCTGCCCCCCCCCAATGCAGCTTAGTCTAAGAAAACTTGAATTCATGAAAAAAATTCTAGTTGGTTT,GCGCCTGCATGCCAGCTTCTCCTGAGCTCTTATGATTATTTGGCCTGCCCCCCCCCAATGCAGCTTAGTCTAAGAAAACTTGAATTCATGAAAAAAATT,10,30,14,27,27,33,27,44,27,30,30,33,41,44,53.53,0.0
hek293t,12010,1,2,ATTTACCAGCAGCAGGCCGGCAGCAGGAACGGCTGCAGCGCACAGCCCTGTATCTGCATCAGCCTCGCGCCGTCACAAAAAAATTCTAGTTGGTTTAAC,ATTTACCAGCAGCAGGCCGGCAGCAGGAACGGCTGCACGGCGCACAGCCCTGTATCTGCATCAGCCTCGCGCCGTCACAAAAAAATTCTAGTTGGTTTA,10,30,14,27,27,45,27,47,27,38,38,45,40,47,55.57,49.81216036
hek293t,12010,1,2,CCGTTCCAGCAGCAGGCCGGCAGCAGGAACGGCTGCAGCGCACAGCCCTGTATCTGCATCAGCCTCGCGCCGTAAAAAAATTCTAGTTGGTTTAACGCG,CCGTTCCAGCAGCAGGCCGGCAGCAGGAACGGCTGCACGGCGCACAGCCCTGTATCTGCATCAGCCTCGCGCCGTAAAAAAATTCTAGTTGGTTTAACG,10,30,14,27,27,48,27,50,27,38,38,48,40,50,55.57,74.89966484
hek293t,12012,1,2,CTAGCCACAGTGAATCAGCAGCAGAGTCGAGGACAGAATCCGTTTCCTAGACGAACCCCCCAACCTGCTGTAAAAAAATTCTAGTTGGTTTAACGCGTA,CTAGCCACAGTGAATCAGCAGCAGAGTCGAGGACGGAGAATCCGTTTCCTAGACGAACCCCCCAACCTGCTGTAAAAAAATTCTAGTTGGTTTAACGCG,10,30,14,27,27,50,27,52,27,35,35,50,37,52,67.6,80.5126148
hek293t,12014,1,9,CGTTAGGCATTAAATGTTCTAATGGATGGAGGTAGTAAGGACATCCCTTATTGTAAGACTCAACTGGCCTAAAAAAATTCTAGTTGGTTTAACGCGTAA,CGTTAGGCATTAAATGTTCTAATGGATGGAGGTAGCGGGGCGAGTAAGGACATCCCTTATTGTAAGACTCAACTGGCCTAAAAAAATTCTAGTTGGTTT,10,30,14,27,27,44,27,53,27,34,34,44,43,53,52.76,0.540265258
hek293t,12014,1,9,ATCATGGCATTAAATGTTCTAATGGATGGAGGTAGTAAGGACATCCCTTATTGTAAGACTCAACTGGCCTGTTTCAAAAAAAAATTCTAGTTGGTTTAA,ATCATGGCATTAAATGTTCTAATGGATGGAGGTAGCGGGGCGAGTAAGGACATCCCTTATTGTAAGACTCAACTGGCCTGTTTCAAAAAAAAATTCTAG,10,30,14,27,27,37,27,46,27,34,34,37,43,46,52.76,0.0
hek293t,12017,1,1,CCCCCGCTGGGAGCTAAACCTATGAGACTTGGTCACTGACAGGCATGTTATCCACTGCTCTGTGGATACAGGAAATTCTGATCTAAAAAAATTCTAGTT,CCCCCGCTGGGAGCTAAACCTATGAGAGCTTGGTCACTGACAGGCATGTTATCCACTGCTCTGTGGATACAGGAAATTCTGATCTAAAAAAATTCTAGT,10,30,14,27,27,38,27,39,27,28,28,38,29,39,53.05,73.53843633
hek293t,12017,1,1,AGAGTGCTGGGAGCTAAACCTATGAGACTTGGTCACTGACAGGCATGTTATCCACTGCTCTGTGGATACAGGAAATTCTAAAAAAATTCTAGTTGGTTT,AGAGTGCTGGGAGCTAAACCTATGAGAGCTTGGTCACTGACAGGCATGTTATCCACTGCTCTGTGGATACAGGAAATTCTAAAAAAATTCTAGTTGGTT,10,30,14,27,27,43,27,44,27,28,28,43,29,44,53.05,59.52833188
hek293t,12019,1,7,TTTGTACAGAATGGCCCCAGAACTTCTTCAGGACAAACAGAATAGACAGCTCATGAGTGTTTTGGATACAAAGTTAAAAAAATTCTAGTTGGTTTAACG,TTTGTACAGAATGGCCCCAGAACTTCTTCAGGATAGCGGCCAAACAGAATAGACAGCTCATGAGTGTTTTGGATACAAAGTTAAAAAAATTCTAGTTGG,10,30,14,27,27,41,27,48,27,34,34,41,41,48,24.55,6.931897161
hek293t,12019,1,7,AACTCACAGAATGGCCCCAGAACTTCTTCAGGACAAACAGAATAGACAGCTCATGAGTGTTTTGGATACAAAGTTATCAAAAAAAATTCTAGTTGGTTT,AACTCACAGAATGGCCCCAGAACTTCTTCAGGATAGCGGCCAAACAGAATAGACAGCTCATGAGTGTTTTGGATACAAAGTTATCAAAAAAAATTCTAG,10,30,14,27,27,37,27,44,27,34,34,37,41,44,24.55,1.405845357
hek293t,12021,1,14,TAGGAATTTTCATGGCTTTTTATGACTGCAGGCCAGATTATGTTTTAAATGGGCAAAATATAATACGAAAAAAATTCTAGTTGGTTTAACGCGTAACTA,TAGGAATTTTCATGGCTTTTTATGACTGCAGTGCACATTTCCCGTGCCAGATTATGTTTTAAATGGGCAAAATATAATACGAAAAAAATTCTAGTTGGT,10,30,14,27,27,42,27,56,27,32,32,42,46,56,12.58,0.645978434
hek293t,12021,1,14,CGGGGATTTTCATGGCTTTTTATGACTGCAGGCCAGATTATGTTTTAAATGGGCAAAATATAATACGTTTAAAAAAATTCTAGTTGGTTTAACGCGTAA,CGGGGATTTTCATGGCTTTTTATGACTGCAGTGCACATTTCCCGTGCCAGATTATGTTTTAAATGGGCAAAATATAATACGTTTAAAAAAATTCTAGTT,10,30,14,27,27,39,27,53,27,32,32,39,46,53,12.58,0.203873598
hek293t,12023,1,6,TATCGGCTTGTTTCTTCTAGCTGAAAATCTGGGGAGGGAAAAAGATCAGAAATATTGTCGACAAAGTTAAAAGTTAAAAAAATTCTAGTTGGTTTAACG,TATCGGCTTGTTTCTTCTAGCTGAAAATCTGCGACCCGGGAGGGAAAAAGATCAGAAATATTGTCGACAAAGTTAAAAGTTAAAAAAATTCTAGTTGGT,10,30,14,27,27,42,27,48,27,32,32,42,38,48,10.27,17.6915371
hek293t,12023,1,6,CGTCCGCTTGTTTCTTCTAGCTGAAAATCTGGGGAGGGAAAAAGATCAGAAATATTGTCGACAAAGTTAAAAGTTCATAAAAAAATTCTAGTTGGTTTA,CGTCCGCTTGTTTCTTCTAGCTGAAAATCTGCGACCCGGGAGGGAAAAAGATCAGAAATATTGTCGACAAAGTTAAAAGTTCATAAAAAAATTCTAGTT,10,30,14,27,27,39,27,45,27,32,32,39,38,45,10.27,5.04138832
hek293t,12025,1,6,ACCCGCATAACCTCATAACTCTGCCAGCTTGGCTTGCCTACACGGTGAGCTGAAGAACACTTTTTTCAGTGAAGGAAAAAAATTCTAGTTGGTTTAACG,ACCCGCATAACCTCATAACTCTGCCATGAGGAGCTTGGCTTGCCTACACGGTGAGCTGAAGAACACTTTTTTCAGTGAAGGAAAAAAATTCTAGTTGGT,10,30,14,27,27,42,27,48,27,27,27,42,33,48,24.97,78.94150796
hek293t,12025,1,6,AGGTACATAACCTCATAACTCTGCCAGCTTGGCTTGCCTACACGGTGAGCTGAAGAACACTTTTTTCAGTGAAGGTACTTCTACAAAAAAAAAATTCTA,AGGTACATAACCTCATAACTCTGCCATGAGGAGCTTGGCTTGCCTACACGGTGAGCTGAAGAACACTTTTTTCAGTGAAGGTACTTCTACAAAAAAAAA,10,30,14,27,27,30,27,36,27,27,27,30,33,36,24.97,15.61021327
hek293t,12027,1,1,CGTATATGCATAAGCCCTCTCTTGTCACATGGATTTCTCTTAGGCCACTTATGTGTATACTTTTGCAAATATATCTCTAAAAAAAATTCTAGTTGGTTT,CGTATATGCATAAGCCCTCTCTTGTCAGCATGGATTTCTCTTAGGCCACTTATGTGTATACTTTTGCAAATATATCTCTAAAAAAAATTCTAGTTGGTT,10,30,14,27,27,43,27,44,27,28,28,43,29,44,40.22,43.08553696
hek293t,12027,1,1,GACAAATGCATAAGCCCTCTCTTGTCACATGGATTTCTCTTAGGCCACTTATGTGTATACTTTTGCAAATATATCTCTAATCATAACATGAAAAAAAAT,GACAAATGCATAAGCCCTCTCTTGTCAGCATGGATTTCTCTTAGGCCACTTATGTGTATACTTTTGCAAATATATCTCTAATCATAACATGAAAAAAAA,10,30,14,27,27,31,27,32,27,28,28,31,29,32,40.22,8.741171099
hek293t,12029,1,3,TAGTATCCAGACAGTAAAAGAACTAAGAAAGGAAATTCCACTTGATTTGTCAGTCTAATGGTGAGTGCATGAAAAAAATTCTAGTTGGTTTAACGCGTA,TAGTATCCAGACAGTAAAAGAACTAAGAAAGGAAATTCACACACTTGATTTGTCAGTCTAATGGTGAGTGCATGAAAAAAATTCTAGTTGGTTTAACGC,10,30,14,27,27,49,27,52,27,39,39,49,42,52,37.71,0.232834488
hek293t,12029,1,3,GTCGGTCCAGACAGTAAAAGAACTAAGAAAGGAAATTCCACTTGATTTGTCAGTCTAATGGTGAGTGCATGAGCCTCCAAAAAAATTCTAGTTGGTTTA,GTCGGTCCAGACAGTAAAAGAACTAAGAAAGGAAATTCACACACTTGATTTGTCAGTCTAATGGTGAGTGCATGAGCCTCCAAAAAAATTCTAGTTGGT,10,30,14,27,27,42,27,45,27,39,39,42,42,45,37.71,0.0
hek293t,12031,1,2,GGAATGATCAGAAAGTCTTCCCTCAGACCAGGCTAAATGCCATGAACAGTGCAAGTAATAGTCTTCTAGGTGAAATGCTAAAAAAATTCTAGTTGGTTT,GGAATGATCAGAAAGTCTTCCCTCAGACCAGCAGCTAAATGCCATGAACAGTGCAAGTAATAGTCTTCTAGGTGAAATGCTAAAAAAATTCTAGTTGGT,10,30,14,27,27,42,27,44,27,32,32,42,34,44,64.46,89.45498786
hek293t,12031,1,2,GTATAGATCAGAAAGTCTTCCCTCAGACCAGGCTAAATGCCATGAACAGTGCAAGTAATAGTCTTCTAGGTGAAATGCTAGTAAAAAAATTCTAGTTGG,GTATAGATCAGAAAGTCTTCCCTCAGACCAGCAGCTAAATGCCATGAACAGTGCAAGTAATAGTCTTCTAGGTGAAATGCTAGTAAAAAAATTCTAGTT,10,30,14,27,27,39,27,41,27,32,32,39,34,41,64.46,89.66047349
hek293t,12033,1,9,GAAGGATCTTATTAGCAAGCATGTCCAACTGGTTTACAATTAAAAAGAAAAAGTTGTTTTACAAATCGAGAAAAAAAAATTCTAGTTGGTTTAACGCGT,GAAGGATCTTATTAGCAAGCATGTCCAACTGCTCATGCCAGTTTACAATTAAAAAGAAAAAGTTGTTTTACAAATCGAGAAAAAAAAATTCTAGTTGGT,10,30,14,27,27,42,27,51,27,32,32,42,41,51,20.08,1.338808108
hek293t,12033,1,9,CTCTAATCTTATTAGCAAGCATGTCCAACTGGTTTACAATTAAAAAGAAAAAGTTGTTTTACAAATCAAAAAAATTCTAGTTGGTTTAACGCGTAACTA,CTCTAATCTTATTAGCAAGCATGTCCAACTGCTCATGCCAGTTTACAATTAAAAAGAAAAAGTTGTTTTACAAATCAAAAAAATTCTAGTTGGTTTAAC,10,30,14,27,27,47,27,56,27,32,32,47,41,56,20.08,1.765937108
hek293t,12035,1,2,TACTTTTGCACCAGCTGAGAATCTGGTCCTGGATCACTAATGCAGACACATTATTCAGACACAGCGTAAATGTTTACCCTAGGTTAAAAAAATTCTAGT,TACTTTTGCACCAGCTGAGAATCTGGTCCTCTGGATCACTAATGCAGACACATTATTCAGACACAGCGTAAATGTTTACCCTAGGTTAAAAAAATTCTA,10,30,14,27,27,36,27,38,27,29,29,36,31,38,48.26,76.61740316
hek293t,12035,1,2,TCAACTTGCACCAGCTGAGAATCTGGTCCTGGATCACTAATGCAGACACATTATTCAGACACAGCGTAAATGTTTACCCTAGGTTTTTCAAAAAAATTC,TCAACTTGCACCAGCTGAGAATCTGGTCCTCTGGATCACTAATGCAGACACATTATTCAGACACAGCGTAAATGTTTACCCTAGGTTTTTCAAAAAAAT,10,30,14,27,27,32,27,34,27,29,29,32,31,34,48.26,1.719087265
hek293t,12038,1,5,TTGCAAACCAACTTACTCTTAGTATGATGGGGATATTATGCAGTGATTCTGGAACTGCATGTAAATTGAAGAAAAAAAATTCTAGTTGGTTTAACGCGT,TTGCAAACCAACTTACTCTTAGTATGATGGCGAAAGGATATTATGCAGTGATTCTGGAACTGCATGTAAATTGAAGAAAAAAAATTCTAGTTGGTTTAA,10,30,14,27,27,46,27,51,27,31,31,46,36,51,45.47,7.898010474
hek293t,12038,1,5,TGCGTAACCAACTTACTCTTAGTATGATGGGGATATTATGCAGTGATTCTGGAACTGCATGTAAATTGAAGATCTTTTAAACAAAAAAAAATTCTAGTT,TGCGTAACCAACTTACTCTTAGTATGATGGCGAAAGGATATTATGCAGTGATTCTGGAACTGCATGTAAATTGAAGATCTTTTAAACAAAAAAAAATTC,10,30,14,27,27,34,27,39,27,31,31,34,36,39,45.47,0.021463833
hek293t,12040,1,11,ACCATTCATTACATATTGCTAGAATGTCTAGGACTATCATTTGATCCCTTATAAATCAGTCAGAATTTACAAACTGAAAAAAATTCTAGTTGGTTTAAC,ACCATTCATTACATATTGCTAGAATGTCTTCCGGACCATTAGGACTATCATTTGATCCCTTATAAATCAGTCAGAATTTACAAACTGAAAAAAATTCTA,10,30,14,27,27,36,27,47,27,29,29,36,40,47,24.74,0.0
hek293t,12040,1,11,AGATCTCATTACATATTGCTAGAATGTCTAGGACTATCATTTGATCCCTTATAAATCAGTCAGAATTTACAAACTGTAAAAAAAAAATTCTAGTTGGTT,AGATCTCATTACATATTGCTAGAATGTCTTCCGGACCATTAGGACTATCATTTGATCCCTTATAAATCAGTCAGAATTTACAAACTGTAAAAAAAAAAT,10,30,14,27,27,32,27,43,27,29,29,32,40,43,24.74,0.0
hek293t,12042,1,6,ATGTGCCTTAGATTCCACCGAAAAGCACTTGGCAGAGAACAGGCAAACATTAGAGACTGCAAATATAAACTAAAAAAATTCTAGTTGGTTTAACGCGTA,ATGTGCCTTAGATTCCACCGAAAAGCACTTGGCAGAGATGTGTGACAGGCAAACATTAGAGACTGCAAATATAAACTAAAAAAATTCTAGTTGGTTTAA,10,30,14,27,27,46,27,52,27,39,39,46,45,52,63.15,28.80908836
hek293t,19146,1,3,AGTTGAAAACTTGACTTGTTCAGGGGATAAGGTAATGATGTTGAAAATGATTCCATGTGCCAGCTAAGTATTACCCTTATTAAAAAAAAATTCTAGTTG,AGTTGAAAACTTGACTTGTTCAGGGGTCAATAAGGTAATGATGTTGAAAATGATTCCATGTGCCAGCTAAGTATTACCCTTATTAAAAAAAAATTCTAG,10,30,14,27,27,37,27,40,27,27,27,37,30,40,19.44,5.356739902
hek293t,19146,1,3,CTTTAAAAACTTGACTTGTTCAGGGGATAAGGTAATGATGTTGAAAATGATTCCATGTGCCAGCTAAGTATTACCCTTATTAATCAAAAAAAATTCTAG,CTTTAAAAACTTGACTTGTTCAGGGGTCAATAAGGTAATGATGTTGAAAATGATTCCATGTGCCAGCTAAGTATTACCCTTATTAATCAAAAAAAATTC,10,30,14,27,27,34,27,37,27,27,27,34,30,37,19.44,9.606555411
hek293t,12045,1,9,CCTCGAGATTTTGACCTTTCAGAGTTTTGAGGGGTCCAATTATGTGGAAATATTTTGAAAATTTTCCTCTATTCTTAAAAAAATTCTAGTTGGTTTAAC,CCTCGAGATTTTGACCTTTCAGAGTTTACCTTGCCTTGAGGGGTCCAATTATGTGGAAATATTTTGAAAATTTTCCTCTATTCTTAAAAAAATTCTAGT,10,30,14,27,27,38,27,47,27,28,28,38,37,47,4.25,29.16308882
hek293t,12047,1,6,AAGCTGTTTGAGAAGGCAACTGTCCGTTGAGGCCTCCACTTCTAAGTGTGGTGTTTTTCTGTTTTTGGAAGAGAAAAAAATTCTAGTTGGTTTAACGCG,AAGCTGTTTGAGAAGGCAACTGTCCGTTGAGGCCTCTGTTATCACTTCTAAGTGTGGTGTTTTTCTGTTTTTGGAAGAGAAAAAAATTCTAGTTGGTTT,10,30,14,27,27,44,27,50,27,37,37,44,43,50,63.09,17.11214335
hek293t,12047,1,6,GAAGAGTTTGAGAAGGCAACTGTCCGTTGAGGCCTCCACTTCTAAGTGTGGTGTTTTTCTGTTTTTGGAAGAGGCAGAAAAAAATTCTAGTTGGTTTAA,GAAGAGTTTGAGAAGGCAACTGTCCGTTGAGGCCTCTGTTATCACTTCTAAGTGTGGTGTTTTTCTGTTTTTGGAAGAGGCAGAAAAAAATTCTAGTTG,10,30,14,27,27,40,27,46,27,37,37,40,43,46,63.09,0.931738793
hek293t,5268,1,3,GTCAATTCTGATTCTGTCTTACTCTACAAAGGCATTTTCTGTACAAATTTTTAACTGACATATCATGACAAAGATCTTCGCTACAAAAAAATTCTAGTT,GTCAATTCTGATTCTGTCTTACTCTACAAAGGAGACATTTTCTGTACAAATTTTTAACTGACATATCATGACAAAGATCTTCGCTACAAAAAAATTCTA,10,30,14,27,27,36,27,39,27,33,33,36,36,39,70.43,0.624457717
hek293t,5268,1,3,TCCTCTTCTGATTCTGTCTTACTCTACAAAGGCATTTTCTGTACAAATTTTTAACTGACATATCATGACAAAGATCTAAAAAAATTCTAGTTGGTTTAA,TCCTCTTCTGATTCTGTCTTACTCTACAAAGGAGACATTTTCTGTACAAATTTTTAACTGACATATCATGACAAAGATCTAAAAAAATTCTAGTTGGTT,10,30,14,27,27,43,27,46,27,33,33,43,36,46,70.43,71.67096804
hek293t,12051,1,15,ATGCACTTGATATTCCTTGCATAAAAATATGGGTAGAATATAAATGTAGAAATGTCTTCTTTCTTCTGAAAAAAAATTCTAGTTGGTTTAACGCGTAAC,ATGCACTTGATATTCCTTGCATAAAAATATGTCCCAATCCACGCACGGTAGAATATAAATGTAGAAATGTCTTCTTTCTTCTGAAAAAAAATTCTAGTT,10,30,14,27,27,39,27,54,27,32,32,39,47,54,14.18,0.0
hek293t,12052,1,8,CTGGGCTTCAGGTTCAAGGAAGAGGCAGCCGGGCAGACTGAGGCGCGCACGTGGCAGTTCTGGTTTGGCGGTCAAAAAAATTCTAGTTGGTTTAACGCG,CTGGGCTTCAGGTTCAAGGAAGAGGCGATGTCTCAGCCGGGCAGACTGAGGCGCGCACGTGGCAGTTCTGGTTTGGCGGTCAAAAAAATTCTAGTTGGT,10,30,14,27,27,42,27,50,27,27,27,42,35,50,44.2,65.6824249
hek293t,12052,1,8,CCGTCCTTCAGGTTCAAGGAAGAGGCAGCCGGGCAGACTGAGGCGCGCACGTGGCAGTTCTGGTTTGGCGGTCATAGCAGTGATTAAAAAAATTCTAGT,CCGTCCTTCAGGTTCAAGGAAGAGGCGATGTCTCAGCCGGGCAGACTGAGGCGCGCACGTGGCAGTTCTGGTTTGGCGGTCATAGCAGTGATTAAAAAA,10,30,14,27,27,30,27,38,27,27,27,30,35,38,44.2,6.510082771
hek293t,12054,1,5,TAAATATGAGGAAAAGAGGAGAGGATTTCTGGGGAGAGTCCTTCTTATGGTAAGTCACTTAAATGCACACAGCAGAAAAAAAATTCTAGTTGGTTTAAC,TAAATATGAGGAAAAGAGGAGAGGATTTCTGGTCCAGGGAGAGTCCTTCTTATGGTAAGTCACTTAAATGCACACAGCAGAAAAAAAATTCTAGTTGGT,10,30,14,27,27,42,27,47,27,32,32,42,37,47,3.68,55.35246855
hek293t,12054,1,5,AGAAAATGAGGAAAAGAGGAGAGGATTTCTGGGGAGAGTCCTTCTTATGGTAAGTCACTTAAATGCACACAGCAGAAGAAAAAAAATTCTAGTTGGTTT,AGAAAATGAGGAAAAGAGGAGAGGATTTCTGGTCCAGGGAGAGTCCTTCTTATGGTAAGTCACTTAAATGCACACAGCAGAAGAAAAAAAATTCTAGTT,10,30,14,27,27,39,27,44,27,32,32,39,37,44,3.68,22.63873673
hek293t,12058,1,9,CAGTGAAGTCCCTTTACAAGGATGACAGCTGGAACAACTGCTGCACCTTTTGTCTCCAAGGTCCATTAAAGTAAAAAAATTCTAGTTGGTTTAACGCGT,CAGTGAAGTCCCTTTACAAGGATGACAGCTGGAAATTTGCGGACAACTGCTGCACCTTTTGTCTCCAAGGTCCATTAAAGTAAAAAAATTCTAGTTGGT,10,30,14,27,27,42,27,51,27,35,35,42,44,51,24.49,16.15122635
hek293t,12058,1,9,TCTTCAAGTCCCTTTACAAGGATGACAGCTGGAACAACTGCTGCACCTTTTGTCTCCAAGGTCCAAAAAAATTCTAGTTGGTTTAACGCGTAACTAGAT,TCTTCAAGTCCCTTTACAAGGATGACAGCTGGAAATTTGCGGACAACTGCTGCACCTTTTGTCTCCAAGGTCCAAAAAAATTCTAGTTGGTTTAACGCG,10,30,14,27,27,50,27,59,27,35,35,50,44,59,24.49,12.64266952
hek293t,12060,1,7,GTAAGGATGAGGATGAGAGGATTAGACTGAGGACCATTTTTTGACCAGATTTTTTCACTCTGCATGTGTGAAAAATTGCTACAAGAAAAAAATTCTAGT,GTAAGGATGAGGATGAGAGGATTAGACAACATGGTGAGGACCATTTTTTGACCAGATTTTTTCACTCTGCATGTGTGAAAAATTGCTACAAGAAAAAAA,10,30,14,27,27,31,27,38,27,28,28,31,35,38,75.01,3.453055305
hek293t,12060,1,7,CAGAGGATGAGGATGAGAGGATTAGACTGAGGACCATTTTTTGACCAGATTTTTTCACTCTGCATGTGTGAAAAAAAAAATTCTAGTTGGTTTAACGCG,CAGAGGATGAGGATGAGAGGATTAGACAACATGGTGAGGACCATTTTTTGACCAGATTTTTTCACTCTGCATGTGTGAAAAAAAAAATTCTAGTTGGTT,10,30,14,27,27,43,27,50,27,28,28,43,35,50,75.01,72.87743815
hek293t,12062,1,8,TGGCGAACATCTTGCATTGAAATGATGTCAGGAATACAGTACCTTGAACAGATTTTACATCTTGACTAAAAAAATTCTAGTTGGTTTAACGCGTAACTA,TGGCGAACATCTTGCATTGAAATGATGTCAGGAATACCACATCTTAGTACCTTGAACAGATTTTACATCTTGACTAAAAAAATTCTAGTTGGTTTAACG,10,30,14,27,27,48,27,56,27,38,38,48,46,56,44.06,3.137731172
hek293t,12063,1,2,GGAATTGCCTGGCAGTACTTTATTTACCCTGGAAAATGACTGAAGCCAGTAACAAATAAAGCATTTTAATGCAAAAAAAATTCTAGTTGGTTTAACGCG,GGAATTGCCTGGCAGTACTTTATTTACCCTGGAAAATGGGACTGAAGCCAGTAACAAATAAAGCATTTTAATGCAAAAAAAATTCTAGTTGGTTTAACG,10,30,14,27,27,48,27,50,27,38,38,48,40,50,39.85,2.083288997
hek293t,12063,1,2,GTGCATGCCTGGCAGTACTTTATTTACCCTGGAAAATGACTGAAGCCAGTAACAAATAAAGCATTTTAATGCAGCAGGGAAAAAAAATTCTAGTTGGTT,GTGCATGCCTGGCAGTACTTTATTTACCCTGGAAAATGGGACTGAAGCCAGTAACAAATAAAGCATTTTAATGCAGCAGGGAAAAAAAATTCTAGTTGG,10,30,14,27,27,41,27,43,27,38,38,41,40,43,39.85,0.0
hek293t,12065,1,11,GCTTGAAGATTTTCTCATTTGTAAGGGAGGGGAGTGCATGTATCTTAGGCTTTAGGTAATTGCTCTGGCCCTAAAAAAATTCTAGTTGGTTTAACGCGT,GCTTGAAGATTTTCTCATTTGTAAGGGAGGGGTCCGTACGAGCAGTGCATGTATCTTAGGCTTTAGGTAATTGCTCTGGCCCTAAAAAAATTCTAGTTG,10,30,14,27,27,40,27,51,27,33,33,40,44,51,26.85,0.175983694
hek293t,12065,1,11,CCTAAAAGATTTTCTCATTTGTAAGGGAGGGGAGTGCATGTATCTTAGGCTTTAGGTAATTGCTCTGGCAAAAAAATTCTAGTTGGTTTAACGCGTAAC,CCTAAAAGATTTTCTCATTTGTAAGGGAGGGGTCCGTACGAGCAGTGCATGTATCTTAGGCTTTAGGTAATTGCTCTGGCAAAAAAATTCTAGTTGGTT,10,30,14,27,27,43,27,54,27,33,33,43,44,54,26.85,0.069013112
hek293t,12067,1,13,TCGAGAGAAGAAGAAAGCAGAAGAAATACAGGATAAAGTAAAAGAAACTTGAACATTCAGTAGATTTAAAAAAATTCTAGTTGGTTTAACGCGTAACTA,TCGAGAGAAGAAGAAAGCAGAAGAAATACAGGATAAAGTCCCCGACACCTTAAAAAGAAACTTGAACATTCAGTAGATTTAAAAAAATTCTAGTTGGTT,10,30,14,27,27,43,27,56,27,40,40,43,53,56,40.4,0.0
hek293t,12068,1,8,CGCTCCTGGCAACTAAACCTTGTTATGAGTGGATATGTATAAACATCCAAGAAGTTTCTCTTGATGGAAAAAAAATTCTAGTTGGTTTAACGCGTAACT,CGCTCCTGGCAACTAAACCTTGTTATGAGTGTTATGTCAGATATGTATAAACATCCAAGAAGTTTCTCTTGATGGAAAAAAAATTCTAGTTGGTTTAAC,10,30,14,27,27,47,27,55,27,32,32,47,40,55,45.33,8.568212378
hek293t,12068,1,8,ATATGCTGGCAACTAAACCTTGTTATGAGTGGATATGTATAAACATCCAAGAAGTTTCTCTTGATGGAGTTCCTCCAAAAAAATTCTAGTTGGTTTAAC,ATATGCTGGCAACTAAACCTTGTTATGAGTGTTATGTCAGATATGTATAAACATCCAAGAAGTTTCTCTTGATGGAGTTCCTCCAAAAAAATTCTAGTT,10,30,14,27,27,39,27,47,27,32,32,39,40,47,45.33,0.374993633
hek293t,12070,1,7,TAGACCAGTACTTTTTGTAGAACTGAAGATGGTTCATTATGGCAATAAAGGGTAAAAGGCTTTTTAATAAATTTGATACATAAAAAAATTCTAGTTGGT,TAGACCAGTACTTTTTGTAGAACTGAATTTGACGGATGGTTCATTATGGCAATAAAGGGTAAAAGGCTTTTTAATAAATTTGATACATAAAAAAATTCT,10,30,14,27,27,35,27,42,27,28,28,35,35,42,20.69,1.839290467
hek293t,12070,1,7,AATTGCAGTACTTTTTGTAGAACTGAAGATGGTTCATTATGGCAATAAAGGGTAAAAGGCTTTTTAATAAATTAAAAAAATTCTAGTTGGTTTAACGCG,AATTGCAGTACTTTTTGTAGAACTGAATTTGACGGATGGTTCATTATGGCAATAAAGGGTAAAAGGCTTTTTAATAAATTAAAAAAATTCTAGTTGGTT,10,30,14,27,27,43,27,50,27,28,28,43,35,50,20.69,4.265463349
hek293t,12072,1,6,CGATATCTAATGGGGTTTTTGCCTTCCTGAGGCTATCATAAAGCAAAGCAGGATACATTATGCCTTGAAAAAAATTCTAGTTGGTTTAACGCGTAACTA,CGATATCTAATGGGGTTTTTGCCTTCCTGAGGCTATCATGATCGCAAAGCAAAGCAGGATACATTATGCCTTGAAAAAAATTCTAGTTGGTTTAACGCG,10,30,14,27,27,50,27,56,27,40,40,50,46,56,41.32,2.863869562
hek293t,1382,1,15,GGCCAAGAGGTTGCTGAGAGATATCAGAGTGGACACAGAACAACCTTAGGAATCCACGGAGTTTTTTCTGTGAAAAAAATTCTAGTTGGTTTAACGCGT,GGCCAAGAGGTTGCTGAGAGATATCAGAGTGGAGTGGGAGAAGTCCTACACAGAACAACCTTAGGAATCCACGGAGTTTTTTCTGTGAAAAAAATTCTA,10,30,14,27,27,36,27,51,27,33,33,36,48,51,76.72,0.56609227
hek293t,1382,1,15,ATACCAGAGGTTGCTGAGAGATATCAGAGTGGACACAGAACAACCTTAGGAATCCACGGAGTTTTTTCAAAAAAATTCTAGTTGGTTTAACGCGTAACT,ATACCAGAGGTTGCTGAGAGATATCAGAGTGGAGTGGGAGAAGTCCTACACAGAACAACCTTAGGAATCCACGGAGTTTTTTCAAAAAAATTCTAGTTG,10,30,14,27,27,40,27,55,27,33,33,40,48,55,76.72,0.328404372
hek293t,12075,1,7,CCGAAAGGCATAAGTATCTATAATGAATGGGGGTGGATATGCCACCAGGCATTAGAAATAGCATATGACTCAACTCAGAAAAAAAATTCTAGTTGGTTT,CCGAAAGGCATAAGTATCTATAATGAATGGGCTATGGGGGTGGATATGCCACCAGGCATTAGAAATAGCATATGACTCAACTCAGAAAAAAAATTCTAG,10,30,14,27,27,37,27,44,27,27,27,37,34,44,34.86,0.798339671
hek293t,12075,1,7,TATAAAGGCATAAGTATCTATAATGAATGGGGGTGGATATGCCACCAGGCATTAGAAATAGCATATGACTCAACTCAGATACATTCAAAAAAATTCTAG,TATAAAGGCATAAGTATCTATAATGAATGGGCTATGGGGGTGGATATGCCACCAGGCATTAGAAATAGCATATGACTCAACTCAGATACATTCAAAAAA,10,30,14,27,27,30,27,37,27,27,27,30,34,37,34.86,0.0
hek293t,12077,1,6,GTACTCATCTTCCTGCAAAAGATTAACAGTGGAGCGGAGCTTCATGAGGAAAGCAGCTTCAGCAGGAAAAAAAAATTCTAGTTGGTTTAACGCGTAACT,GTACTCATCTTCCTGCAAAAGATTAACAGTGGAGCGGAAAATGTGCTTCATGAGGAAAGCAGCTTCAGCAGGAAAAAAAAATTCTAGTTGGTTTAACGC,10,30,14,27,27,49,27,55,27,39,39,49,45,55,64.27,0.0
hek293t,10215,1,15,TGGCAGATGGATTCAGCTATGCTTGAGGATGGATATGTCTCTGAGTTAAGTTCTAGCTACATACACCAGTAAAAAAATTCTAGTTGGTTTAACGCGTAA,TGGCAGATGGATTCAGCTATGCTTGAGGATGGATTCGAGAGTCTCCCAAATGTCTCTGAGTTAAGTTCTAGCTACATACACCAGTAAAAAAATTCTAGT,10,30,14,27,27,38,27,53,27,35,35,38,50,53,56.34,0.078802206
hek293t,2059,1,2,ATTTAACAAAGTTTTCTACTAAAATTACAAGGCTTCACTTTAACACAGTATAATTTAACGATACCAAAAAAATTCTAGTTGGTTTAACGCGTAACTAGA,ATTTAACAAAGTTTTCTACTAAAATTACAAGGCTTCACTTCCTAACACAGTATAATTTAACGATACCAAAAAAATTCTAGTTGGTTTAACGCGTAACTA,10,30,14,27,27,56,27,58,27,41,41,56,43,58,10.14,0.0
hek293t,2059,1,2,GTGCCACAAAGTTTTCTACTAAAATTACAAGGCTTCACTTTAACACAGTATAATTTAACGATACCCTTCATAAGCAGAAAAAAATTCTAGTTGGTTTAA,GTGCCACAAAGTTTTCTACTAAAATTACAAGGCTTCACTTCCTAACACAGTATAATTTAACGATACCCTTCATAAGCAGAAAAAAATTCTAGTTGGTTT,10,30,14,27,27,44,27,46,27,41,41,44,43,46,10.14,0.0
hek293t,12085,1,6,CGGCTCTGCATGCTGAGAGCTACTGCTTCTGGTGCCTGAATTTGTTCAGGTTACTGTATTGTGCTGCAGATAAAAAAATTCTAGTTGGTTTAACGCGTA,CGGCTCTGCATGCTGAGAGCTACTGCTTCTGGTGCCTGGGAGCCAATTTGTTCAGGTTACTGTATTGTGCTGCAGATAAAAAAATTCTAGTTGGTTTAA,10,30,14,27,27,46,27,52,27,39,39,46,45,52,35.78,4.416209428
hek293t,12086,1,5,ATTGCCTGGTTCTTGAGTAAGATGCTGTCAGGAAAAGCTGTATCTTGTCAATTTAATGACCCCCACTGCCTTCTGAAAAAAATTCTAGTTGGTTTAACG,ATTGCCTGGTTCTTGAGTAAGATGCTGTCAGGAAAAGCTGAGGGGTATCTTGTCAATTTAATGACCCCCACTGCCTTCTGAAAAAAATTCTAGTTGGTT,10,30,14,27,27,43,27,48,27,40,40,43,45,48,45.02,0.0
hek293t,12087,1,5,TTACTAGGTGCTACAAAATACAAAGTAGCTGGTCAGAGACAAAAGGAATTGGGAAAGAATGTGGCTTTTTACAAAAAAATTCTAGTTGGTTTAACGCGT,TTACTAGGTGCTACAAAATACAAAGTAGCTGTGGTGGTCAGAGACAAAAGGAATTGGGAAAGAATGTGGCTTTTTACAAAAAAATTCTAGTTGGTTTAA,10,30,14,27,27,46,27,51,27,31,31,46,36,51,35.34,0.0
hek293t,12087,1,5,GGTTGAGGTGCTACAAAATACAAAGTAGCTGGTCAGAGACAAAAGGAATTGGGAAAGAATGTGGCTTTTTACAGATTGAGATATAAAAAAATTCTAGTT,GGTTGAGGTGCTACAAAATACAAAGTAGCTGTGGTGGTCAGAGACAAAAGGAATTGGGAAAGAATGTGGCTTTTTACAGATTGAGATATAAAAAAATTC,10,30,14,27,27,34,27,39,27,31,31,34,36,39,35.34,0.0
hek293t,20896,1,14,TTGAGCCGATGGCCATTCCCCTCAGACTGAGGGTCTTTTGTCCAAACTTAGGATAAGGAAAAATTAAAAAAATTCTAGTTGGTTTAACGCGTAACTAGA,TTGAGCCGATGGCCATTCCCCTCAGACTGAGGGTCTTTTGGTGGAATAGAGGCGTCCAAACTTAGGATAAGGAAAAATTAAAAAAATTCTAGTTGGTTT,10,30,14,27,27,44,27,58,27,41,41,44,55,58,59.29,0.0
hek293t,12090,1,3,GGTTGATAATTCAGAAACGCTTCAGCAAGGGGTGAACCACTGAGCGCATGGAGGTGGCGTGGGACACTTCCCTGCAAAGAAAAAAATTCTAGTTGGTTT,GGTTGATAATTCAGAAACGCTTCAGCAAGGGGTGAACTCGCACTGAGCGCATGGAGGTGGCGTGGGACACTTCCCTGCAAAGAAAAAAATTCTAGTTGG,10,30,14,27,27,41,27,44,27,38,38,41,41,44,25.44,0.046323579
hek293t,12090,1,3,CAGGCATAATTCAGAAACGCTTCAGCAAGGGGTGAACCACTGAGCGCATGGAGGTGGCGTGGGACACTTCCCTGCAAAAAAATTCTAGTTGGTTTAACG,CAGGCATAATTCAGAAACGCTTCAGCAAGGGGTGAACTCGCACTGAGCGCATGGAGGTGGCGTGGGACACTTCCCTGCAAAAAAATTCTAGTTGGTTTA,10,30,14,27,27,45,27,48,27,38,38,45,41,48,25.44,35.1278768
hek293t,12092,1,4,CGAAGCCTTCTTTGTTTCTCAGAATGAAACGGGCCCCCCCGTGGCTCTTGCATTCCTTAGCACTCAAAACCAAAGCAGAAAAAAAATTCTAGTTGGTTT,CGAAGCCTTCTTTGTTTCTCAGAATGAAACGGGCCCCGCGCCCCGTGGCTCTTGCATTCCTTAGCACTCAAAACCAAAGCAGAAAAAAAATTCTAGTTG,10,30,14,27,27,40,27,44,27,37,37,40,41,44,2.03,0.0
hek293t,12092,1,4,TTGAGCCTTCTTTGTTTCTCAGAATGAAACGGGCCCCCCCGTGGCTCTTGCATTCCTTAGCACTCAAAACCAAAGAAAAAAATTCTAGTTGGTTTAACG,TTGAGCCTTCTTTGTTTCTCAGAATGAAACGGGCCCCGCGCCCCGTGGCTCTTGCATTCCTTAGCACTCAAAACCAAAGAAAAAAATTCTAGTTGGTTT,10,30,14,27,27,44,27,48,27,37,37,44,41,48,2.03,1.32954125
hek293t,12094,1,10,GGAGGATGAGAGCAAGGACCTGTTCTGCCAGGACTTAGTGGGCAGAGGAGATTGGTGCCTATGCCTTTTTTAAAAAAAAATTCTAGTTGGTTTAACGCG,GGAGGATGAGAGCAAGGACCTGTTCTGCCAGGACTTGGGCGAACACAGTGGGCAGAGGAGATTGGTGCCTATGCCTTTTTTAAAAAAAAATTCTAGTTG,10,30,14,27,27,40,27,50,27,37,37,40,47,50,54.5,0.8337306
hek293t,12095,1,3,TTTCCCCTCATTATGGAAATGCAAGGTCGAGGAGCCATATCCTAGTCGACAGAAAGCCAAAAGGAAATTCCCTCCAAAAAAATTCTAGTTGGTTTAACG,TTTCCCCTCATTATGGAAATGCAAGGTCGGCCAGGAGCCATATCCTAGTCGACAGAAAGCCAAAAGGAAATTCCCTCCAAAAAAATTCTAGTTGGTTTA,10,30,14,27,27,45,27,48,27,30,30,45,33,48,59.49,72.06180792
hek293t,12095,1,3,CCCGCCCTCATTATGGAAATGCAAGGTCGAGGAGCCATATCCTAGTCGACAGAAAGCCAAAAGGAAATTCCCTCCACCAGAAAAAAATTCTAGTTGGTT,CCCGCCCTCATTATGGAAATGCAAGGTCGGCCAGGAGCCATATCCTAGTCGACAGAAAGCCAAAAGGAAATTCCCTCCACCAGAAAAAAATTCTAGTTG,10,30,14,27,27,40,27,43,27,30,30,40,33,43,59.49,75.42017288
hek293t,12097,1,8,GCTGGGAATCTTAAAAGTATCATAGCTTCAGGGCAAGTATTAGGTTTGGCCCAATACTCCTTCAAGGAATGTGCAAAAAAATTCTAGTTGGTTTAACGC,GCTGGGAATCTTAAAAGTATCATAGCTTCAGGGCAAGGTATTCGTTATTAGGTTTGGCCCAATACTCCTTCAAGGAATGTGCAAAAAAATTCTAGTTGG,10,30,14,27,27,41,27,49,27,38,38,41,46,49,2.78,0.026476039
hek293t,12097,1,8,GATTCGAATCTTAAAAGTATCATAGCTTCAGGGCAAGTATTAGGTTTGGCCCAATACTCCTTCAAGGAAAAAAATTCTAGTTGGTTTAACGCGTAACTA,GATTCGAATCTTAAAAGTATCATAGCTTCAGGGCAAGGTATTCGTTATTAGGTTTGGCCCAATACTCCTTCAAGGAAAAAAATTCTAGTTGGTTTAACG,10,30,14,27,27,48,27,56,27,38,38,48,46,56,2.78,0.174547512
hek293t,12099,1,4,AACCGGTGCTTTACCTATGAAAGCAGGAGGGGGAGACTCGGGAAACACAAGACAGAGCACTAAATAGGTGTGCTAACAAAAAAATTCTAGTTGGTTTAA,AACCGGTGCTTTACCTATGAAAGCAGGAGGGGGAGACTAGTACGGGAAACACAAGACAGAGCACTAAATAGGTGTGCTAACAAAAAAATTCTAGTTGGT,10,30,14,27,27,42,27,46,27,39,39,42,43,46,38.1,0.0
hek293t,12099,1,4,CCCTGGTGCTTTACCTATGAAAGCAGGAGGGGGAGACTCGGGAAACACAAGACAGAGCACTAAATAGGTGAAAAAAATTCTAGTTGGTTTAACGCGTAA,CCCTGGTGCTTTACCTATGAAAGCAGGAGGGGGAGACTAGTACGGGAAACACAAGACAGAGCACTAAATAGGTGAAAAAAATTCTAGTTGGTTTAACGC,10,30,14,27,27,49,27,53,27,39,39,49,43,53,38.1,28.65096079
hek293t,12101,1,4,TCTGCGCGAGGTCTTTACCTGGAAACCTAAGGGCTCTGTTTGCTCCTTGTTTCCTCCTTTTGTGTATTTGTTTTCCCTAGACTAAAAAAATTCTAGTTG,TCTGCGCGAGGTCTTTACCTGGAAACCTAAGGATACGCTCTGTTTGCTCCTTGTTTCCTCCTTTTGTGTATTTGTTTTCCCTAGACTAAAAAAATTCTA,10,30,14,27,27,36,27,40,27,33,33,36,37,40,34.9,1.666666667
hek293t,12103,1,7,TGCACACAAATTGGAGAAATCACATGAACTGGAGAGAAAATAATACAGATACATGAAAGATCCAAGTAACCAGAAAAAAAATTCTAGTTGGTTTAACGC,TGCACACAAATTGGAGAAATCACATGAACTGGAGTGCCCGGAGAAAATAATACAGATACATGAAAGATCCAAGTAACCAGAAAAAAAATTCTAGTTGGT,10,30,14,27,27,42,27,49,27,35,35,42,42,49,38.87,1.108891681
hek293t,12103,1,7,CAGAGACAAATTGGAGAAATCACATGAACTGGAGAGAAAATAATACAGATACATGAAAGATCCAAGAAAAAAATTCTAGTTGGTTTAACGCGTAACTAG,CAGAGACAAATTGGAGAAATCACATGAACTGGAGTGCCCGGAGAAAATAATACAGATACATGAAAGATCCAAGAAAAAAATTCTAGTTGGTTTAACGCG,10,30,14,27,27,50,27,57,27,35,35,50,42,57,38.87,0.342056142
hek293t,12105,1,6,GCGATAATGTAGAAGATAAGAGTATCTTCAGGACTTACATATACTCAGTGACGGAAATGTTGCACTTCACCTTGCACAAAAAAAATTCTAGTTGGTTTA,GCGATAATGTAGAAGATAAGAGTATCTTCAGGTCCACGACTTACATATACTCAGTGACGGAAATGTTGCACTTCACCTTGCACAAAAAAAATTCTAGTT,10,30,14,27,27,39,27,45,27,32,32,39,38,45,43.62,0.980427751
hek293t,12105,1,6,TAATGAATGTAGAAGATAAGAGTATCTTCAGGACTTACATATACTCAGTGACGGAAATGTTGCACTTCACAAAAAAATTCTAGTTGGTTTAACGCGTAA,TAATGAATGTAGAAGATAAGAGTATCTTCAGGTCCACGACTTACATATACTCAGTGACGGAAATGTTGCACTTCACAAAAAAATTCTAGTTGGTTTAAC,10,30,14,27,27,47,27,53,27,32,32,47,38,53,43.62,2.400727588
hek293t,12107,1,13,CAATCAGTATTGCAGGAACCTCATGGAAACGGACATTTTCTGAAACAAAGGAAATGGAAGGAGCATAGTCTCTAAAAAAATTCTAGTTGGTTTAACGCG,CAATCAGTATTGCAGGAACCTCATGGGTTGCAGCGACAAAAACGGACATTTTCTGAAACAAAGGAAATGGAAGGAGCATAGTCTCTAAAAAAATTCTAG,10,30,14,27,27,37,27,50,27,27,27,37,40,50,38.61,0.88059985
hek293t,12107,1,13,GGTTAAGTATTGCAGGAACCTCATGGAAACGGACATTTTCTGAAACAAAGGAAATGGAAGGAGCATAGTCTCTTACTAGCAAAAAAATTCTAGTTGGTT,GGTTAAGTATTGCAGGAACCTCATGGGTTGCAGCGACAAAAACGGACATTTTCTGAAACAAAGGAAATGGAAGGAGCATAGTCTCTTACTAGCAAAAAA,10,30,14,27,27,30,27,43,27,27,27,30,40,43,38.61,0.0
hek293t,12109,1,6,TCTGCGCAGTGGGATGCTCTGCGTTCATGTGGGTATGACTGAATTTGTTGTGCTCCTAGTTTAATAATGGCCCGTTCATAAATAAAAAAATTCTAGTTG,TCTGCGCAGTGGGATGCTCTGCGTTCAATGCAATGTGGGTATGACTGAATTTGTTGTGCTCCTAGTTTAATAATGGCCCGTTCATAAATAAAAAAATTC,10,30,14,27,27,34,27,40,27,27,27,34,33,40,41.9,33.42143081
hek293t,12109,1,6,CTCTTGCAGTGGGATGCTCTGCGTTCATGTGGGTATGACTGAATTTGTTGTGCTCCTAGTTTAATAATGGCCCGTTCATAAATGGACAAAAAAATTCTA,CTCTTGCAGTGGGATGCTCTGCGTTCAATGCAATGTGGGTATGACTGAATTTGTTGTGCTCCTAGTTTAATAATGGCCCGTTCATAAATGGACAAAAAA,10,30,14,27,27,30,27,36,27,27,27,30,33,36,41.9,0.0
hek293t,21699,1,2,TCGAGCATCAGTTTATGTTGTCACATGACTGGAGGCATTATCGCACTGTGTTTTTAAACATGAAGTGCGCTATAGAAAAAAAAAATTCTAGTTGGTTTA,TCGAGCATCAGTTTATGTTGTCACATGACTGGGCAGGCATTATCGCACTGTGTTTTTAAACATGAAGTGCGCTATAGAAAAAAAAAATTCTAGTTGGTT,10,30,14,27,27,43,27,45,27,33,33,43,35,45,32.37,84.28459593
hek293t,21699,1,2,AATATCATCAGTTTATGTTGTCACATGACTGGAGGCATTATCGCACTGTGTTTTTAAACATGAAGTGCGCTATAAAAAAATTCTAGTTGGTTTAACGCG,AATATCATCAGTTTATGTTGTCACATGACTGGGCAGGCATTATCGCACTGTGTTTTTAAACATGAAGTGCGCTATAAAAAAATTCTAGTTGGTTTAACG,10,30,14,27,27,48,27,50,27,33,33,48,35,50,32.37,81.78062348
hek293t,20743,1,3,GCCGGTTGGAGAACACTTTTTCTTATTCATGGTATCTATTTATAAGCATCAAAGCAGATTGTGATTTCCCAAAAAAATTCTAGTTGGTTTAACGCGTAA,GCCGGTTGGAGAACACTTTTTCTTATTCATGGTATCGTCTATTTATAAGCATCAAAGCAGATTGTGATTTCCCAAAAAAATTCTAGTTGGTTTAACGCG,10,30,14,27,27,50,27,53,27,35,35,50,38,53,5.82,34.37448053
hek293t,20743,1,3,AGACATTGGAGAACACTTTTTCTTATTCATGGTATCTATTTATAAGCATCAAAGCAGATTGTGATTTCCCCAAAGCACAAAAAAATTCTAGTTGGTTTA,AGACATTGGAGAACACTTTTTCTTATTCATGGTATCGTCTATTTATAAGCATCAAAGCAGATTGTGATTTCCCCAAAGCACAAAAAAATTCTAGTTGGT,10,30,14,27,27,42,27,45,27,35,35,42,38,45,5.82,0.271199389
hek293t,12116,1,5,GCTATCAGACGAAACATTTGCTGATAGCGTGGCTAACAGCCTACAAAATCACCCGTCCCCAAAGTCAAAAAAATTCTAGTTGGTTTAACGCGTAACTAG,GCTATCAGACGAAACATTTGCTGATAGCGTGGCTAAACCAGCAGCCTACAAAATCACCCGTCCCCAAAGTCAAAAAAATTCTAGTTGGTTTAACGCGTA,10,30,14,27,27,52,27,57,27,37,37,52,42,57,30.58,23.65388069
hek293t,12116,1,5,ACAGTCAGACGAAACATTTGCTGATAGCGTGGCTAACAGCCTACAAAATCACCCGTCCCCAAAGTCACTGGTGAAAAAAAATTCTAGTTGGTTTAACGC,ACAGTCAGACGAAACATTTGCTGATAGCGTGGCTAAACCAGCAGCCTACAAAATCACCCGTCCCCAAAGTCACTGGTGAAAAAAAATTCTAGTTGGTTT,10,30,14,27,27,44,27,49,27,37,37,44,42,49,30.58,7.114107942
hek293t,12118,1,6,CTAGAGCGCAAGACAGGAGGTGCCTTGCTTGGGAGCTCCCTACACACACGCGTCTGCGAGGTTGCCATGGCTAAAAAAATTCTAGTTGGTTTAACGCGT,CTAGAGCGCAAGACAGGAGGTGCCTTGCTTGGGAGCTGGTGTCCCCTACACACACGCGTCTGCGAGGTTGCCATGGCTAAAAAAATTCTAGTTGGTTTA,10,30,14,27,27,45,27,51,27,38,38,45,44,51,38.8,48.92874544
hek293t,12118,1,6,TATTGGCGCAAGACAGGAGGTGCCTTGCTTGGGAGCTCCCTACACACACGCGTCTGCGAGGTTGCCATGGCTCTGCAAAAAAATTCTAGTTGGTTTAAC,TATTGGCGCAAGACAGGAGGTGCCTTGCTTGGGAGCTGGTGTCCCCTACACACACGCGTCTGCGAGGTTGCCATGGCTCTGCAAAAAAATTCTAGTTGG,10,30,14,27,27,41,27,47,27,38,38,41,44,47,38.8,5.684491203
hek293t,12120,1,15,ATCGGTTTACTGCAATAAGAGCACAGGTCAGGAAATGCAGCAGTGATTTCAAAGTTCTCTTTTTGGAAAGTCAAAAAAATTCTAGTTGGTTTAACGCGT,ATCGGTTTACTGCAATAAGAGCACAGGTTACAGAGATTTCTAGCAGGAAATGCAGCAGTGATTTCAAAGTTCTCTTTTTGGAAAGTCAAAAAAATTCTA,10,30,14,27,27,36,27,51,27,29,29,36,44,51,36.07,0.464024771
hek293t,12120,1,15,TGAATTTTACTGCAATAAGAGCACAGGTCAGGAAATGCAGCAGTGATTTCAAAGTTCTCTTTTTGGAAAGTCACTTAAAAAAATTCTAGTTGGTTTAAC,TGAATTTTACTGCAATAAGAGCACAGGTTACAGAGATTTCTAGCAGGAAATGCAGCAGTGATTTCAAAGTTCTCTTTTTGGAAAGTCACTTAAAAAAAT,10,30,14,27,27,32,27,47,27,29,29,32,44,47,36.07,3.122128854
hek293t,12122,1,13,CCTGGGTCTTAAGACTTGTCCAACACTGTTGGACACTACTCAGCTGCTTCACTGAGAATTATTAAGTAGCAAAAAAATTCTAGTTGGTTTAACGCGTAA,CCTGGGTCTTAAGACTTGTCCAACACTGTTGGACACGGGTTTAATGTCTTACTCAGCTGCTTCACTGAGAATTATTAAGTAGCAAAAAAATTCTAGTTG,10,30,14,27,27,40,27,53,27,37,37,40,50,53,50.24,0.0
hek293t,12122,1,13,ATTCGGTCTTAAGACTTGTCCAACACTGTTGGACACTACTCAGCTGCTTCACTGAGAATTATTAAGAAAAAAATTCTAGTTGGTTTAACGCGTAACTAG,ATTCGGTCTTAAGACTTGTCCAACACTGTTGGACACGGGTTTAATGTCTTACTCAGCTGCTTCACTGAGAATTATTAAGAAAAAAATTCTAGTTGGTTT,10,30,14,27,27,44,27,57,27,37,37,44,50,57,50.24,0.0
hek293t,12124,1,4,CTGCCATAATCCAACTGCATGGCTGGTTTAGGAAACGTGGCTGTAAGCTTACTCATGCTTACTGAACTGGAAAAAAAATTCTAGTTGGTTTAACGCGTA,CTGCCATAATCCAACTGCATGGCTGGTTTAGGCCGAAAACGTGGCTGTAAGCTTACTCATGCTTACTGAACTGGAAAAAAAATTCTAGTTGGTTTAACG,10,30,14,27,27,48,27,52,27,33,33,48,37,52,19.22,32.2500739
hek293t,12126,1,9,CAGACCCATTAACTAAAACCACTGCTACGGGGGGTGCAGAAGCACCTGAGACACCCAAGCAACAAAAAAAATTCTAGTTGGTTTAACGCGTAACTAGAT,CAGACCCATTAACTAAAACCACTGCTACGGGGGGGCAGCACAATGCAGAAGCACCTGAGACACCCAAGCAACAAAAAAAATTCTAGTTGGTTTAACGCG,10,30,14,27,27,50,27,59,27,35,35,50,44,59,72.54,7.156377519
hek293t,2202,1,15,ACGCTTGGAGGAGATGAGGGGTAGATGAATGGTGAACAACTGGGAAGCTGGCTCTGAAGCACGTGCAAAAAAATTCTAGTTGGTTTAACGCGTAACTAG,ACGCTTGGAGGAGATGAGGGGTAGATTTGACAGCTTAACTTGAATGGTGAACAACTGGGAAGCTGGCTCTGAAGCACGTGCAAAAAAATTCTAGTTGGT,10,30,14,27,27,42,27,57,27,27,27,42,42,57,67.92,73.13765112
hek293t,2202,1,15,ACGGTTGGAGGAGATGAGGGGTAGATGAATGGTGAACAACTGGGAAGCTGGCTCTGAAGCACGTGCTGCTGAAAAAAATTCTAGTTGGTTTAACGCGTA,ACGGTTGGAGGAGATGAGGGGTAGATTTGACAGCTTAACTTGAATGGTGAACAACTGGGAAGCTGGCTCTGAAGCACGTGCTGCTGAAAAAAATTCTAG,10,30,14,27,27,37,27,52,27,27,27,37,42,52,67.92,14.84249199
hek293t,12132,1,12,CATCACCGGCTGAACGAAGAGCTGCTGAAAGGAAGCAGAAGGGGAGCCGCTGAAAGGAAGCGGCATTGCGCGAAAAAAATTCTAGTTGGTTTAACGCGT,CATCACCGGCTGAACGAAGAGCTGCTGACATCACCCTGTCAAGGAAGCAGAAGGGGAGCCGCTGAAAGGAAGCGGCATTGCGCGAAAAAAATTCTAGTT,10,30,14,27,27,39,27,51,27,29,29,39,41,51,66.56,28.25205597
hek293t,12132,1,12,CACGACCGGCTGAACGAAGAGCTGCTGAAAGGAAGCAGAAGGGGAGCCGCTGAAAGGAAGCGGCATTGCGCGCAAAAAAAAATTCTAGTTGGTTTAACG,CACGACCGGCTGAACGAAGAGCTGCTGACATCACCCTGTCAAGGAAGCAGAAGGGGAGCCGCTGAAAGGAAGCGGCATTGCGCGCAAAAAAAAATTCTA,10,30,14,27,27,36,27,48,27,29,29,36,41,48,66.56,2.54061435
hek293t,12134,1,9,TTCTGTGAGGACTTGTCAGGTAGTAAGACAGGTAATTATGGAAACCCCTCCTCTAAAATATGCTCTAATTTGAGTCCAAAAAAATTCTAGTTGGTTTAA,TTCTGTGAGGACTTGTCAGGTAGTAATGTTAAGTTGACAGGTAATTATGGAAACCCCTCCTCTAAAATATGCTCTAATTTGAGTCCAAAAAAATTCTAG,10,30,14,27,27,37,27,46,27,27,27,37,36,46,48.47,16.76900006
hek293t,12134,1,9,ATACCTGAGGACTTGTCAGGTAGTAAGACAGGTAATTATGGAAACCCCTCCTCTAAAATATGCTCTAATTTGAGTCCAAACCTTAAAAAAATTCTAGTT,ATACCTGAGGACTTGTCAGGTAGTAATGTTAAGTTGACAGGTAATTATGGAAACCCCTCCTCTAAAATATGCTCTAATTTGAGTCCAAACCTTAAAAAA,10,30,14,27,27,30,27,39,27,27,27,30,36,39,48.47,0.735294118
hek293t,12136,1,9,TGCCACAGGGAGTTCAATTGTGGCTGGGAAGGTGGGATTAAGCATATTTTCATTTAAAGGCATACTCCATTTCTTTAAAAAAATTCTAGTTGGTTTAAC,TGCCACAGGGAGTTCAATTGTGGCTGGGAAACCGGTCGTGGTGGGATTAAGCATATTTTCATTTAAAGGCATACTCCATTTCTTTAAAAAAATTCTAGT,10,30,14,27,27,38,27,47,27,31,31,38,40,47,46.67,20.07945142
hek293t,12136,1,9,CGACGCAGGGAGTTCAATTGTGGCTGGGAAGGTGGGATTAAGCATATTTTCATTTAAAGGCATACTCCATTTCTTTGTTTAAAAAAATTCTAGTTGGTT,CGACGCAGGGAGTTCAATTGTGGCTGGGAAACCGGTCGTGGTGGGATTAAGCATATTTTCATTTAAAGGCATACTCCATTTCTTTGTTTAAAAAAATTC,10,30,14,27,27,34,27,43,27,31,31,34,40,43,46.67,1.728812147
hek293t,18666,1,4,TCATATCAACAAAGTGGCAGTTCAGGTCTTGGCTTAAACACAGGAATAAGAAAAACAGGAATCACAAGTGTTGTACATTAAAATAAAAAAATTCTAGTT,TCATATCAACAAAGTGGCAGTTCAGGTCTTGTTGTGCTTAAACACAGGAATAAGAAAAACAGGAATCACAAGTGTTGTACATTAAAATAAAAAAATTCT,10,30,14,27,27,35,27,39,27,32,32,35,36,39,33.08,0.0
hek293t,18666,1,4,CCAAATCAACAAAGTGGCAGTTCAGGTCTTGGCTTAAACACAGGAATAAGAAAAACAGGAATCACAAGTGTTGTACAAAAAAAATTCTAGTTGGTTTAA,CCAAATCAACAAAGTGGCAGTTCAGGTCTTGTTGTGCTTAAACACAGGAATAAGAAAAACAGGAATCACAAGTGTTGTACAAAAAAAATTCTAGTTGGT,10,30,14,27,27,42,27,46,27,32,32,42,36,46,33.08,77.37097761
hek293t,12142,1,8,AGCACCTGCAGACTCTGCCAGCTCTTCTTTGGCAGCAGAAGGTCTGTAATATATCTTCATTGCAAGTAAAAAAATTCTAGTTGGTTTAACGCGTAACTA,AGCACCTGCAGACTCTGCCAGCTCTTCTTTGGCAGCAGAACGATATAAGGTCTGTAATATATCTTCATTGCAAGTAAAAAAATTCTAGTTGGTTTAACG,10,30,14,27,27,48,27,56,27,41,41,48,49,56,30.02,0.068870523
hek293t,12143,1,6,GAGGTAATGTTTTATTCATCCCAAATGTTTGGGTAGCAGGTAGGTGCGATAGAGAGAGAAGCATCAGAAAAAAATTCTAGTTGGTTTAACGCGTAACTA,GAGGTAATGTTTTATTCATCCCAAATGTTTGGGTAGCAGGATATGGTAGGTGCGATAGAGAGAGAAGCATCAGAAAAAAATTCTAGTTGGTTTAACGCG,10,30,14,27,27,50,27,56,27,40,40,50,46,56,2.24,13.07062249
hek293t,12144,1,13,GGGGCGTTACTTTCAAAATTGATCCCCCTTGGAAGGTCCTTTAATAGCTAAGTGCAACTGTTGAGTAGGATTTAAAAAAATTCTAGTTGGTTTAACGCG,GGGGCGTTACTTTCAAAATTGATCCCCCTTGGACGGTACGATGAAAAGGTCCTTTAATAGCTAAGTGCAACTGTTGAGTAGGATTTAAAAAAATTCTAG,10,30,14,27,27,37,27,50,27,34,34,37,47,50,25.24,0.0
hek293t,12147,1,15,GCCGCCTGTGAGATCCTTTAGCTATATTATGGATTGCATATTATATTGAATAAGAAGAATAATAGATAAAAAAATTCTAGTTGGTTTAACGCGTAACTA,GCCGCCTGTGAGATCCTTTAGCTATATTATGGATTGCCACCCGTGTGAAATAATATTATATTGAATAAGAAGAATAATAGATAAAAAAATTCTAGTTGG,10,30,14,27,27,41,27,56,27,38,38,41,53,56,18.34,0.0
hek293t,12148,1,3,CTCTTCTTGAGTGCTCAGCAGTGTGGGCAAGGGTTGCCTGATCAGACAGACCCCTGTGCTGTTTGAGAATGACAGAAAAAAATTCTAGTTGGTTTAACG,CTCTTCTTGAGTGCTCAGCAGTGTGGGCAAGGGTGCATGCCTGATCAGACAGACCCCTGTGCTGTTTGAGAATGACAGAAAAAAATTCTAGTTGGTTTA,10,30,14,27,27,45,27,48,27,35,35,45,38,48,39.16,82.88803312
hek293t,12148,1,3,CTGTGCTTGAGTGCTCAGCAGTGTGGGCAAGGGTTGCCTGATCAGACAGACCCCTGTGCTGTTTGAGAATGACAGAGTAAAAAAATTCTAGTTGGTTTA,CTGTGCTTGAGTGCTCAGCAGTGTGGGCAAGGGTGCATGCCTGATCAGACAGACCCCTGTGCTGTTTGAGAATGACAGAGTAAAAAAATTCTAGTTGGT,10,30,14,27,27,42,27,45,27,35,35,42,38,45,39.16,58.90448796
hek293t,17513,1,15,TATCCAGAGAATATGACTTAAAAGTGGGCAGGTGTTATATCAGATGAAAAGATGACTGGTGGTAGACAAAAAAAATTCTAGTTGGTTTAACGCGTAACT,TATCCAGAGAATATGACTTAAAAGTGGGCAGGTGTTAGTGTTCCGAGTTAGATATCAGATGAAAAGATGACTGGTGGTAGACAAAAAAAATTCTAGTTG,10,30,14,27,27,40,27,55,27,37,37,40,52,55,28.0,0.32599837
hek293t,12151,1,9,TATAGACCACTCTACTGAAAAGTGGCAGATGGTAAGATTTACCTCTTTGCATTATTTTCATTGCAGATATTAAAAAAATTCTAGTTGGTTTAACGCGTA,TATAGACCACTCTACTGAAAAGTGGCAGAGGACTTTGATGGTAAGATTTACCTCTTTGCATTATTTTCATTGCAGATATTAAAAAAATTCTAGTTGGTT,10,30,14,27,27,43,27,52,27,28,28,43,37,52,49.21,22.97936178
hek293t,12151,1,9,AAAGAACCACTCTACTGAAAAGTGGCAGATGGTAAGATTTACCTCTTTGCATTATTTTCATTGCAGATATTAGACTCCCAAAAAAATTCTAGTTGGTTT,AAAGAACCACTCTACTGAAAAGTGGCAGAGGACTTTGATGGTAAGATTTACCTCTTTGCATTATTTTCATTGCAGATATTAGACTCCCAAAAAAATTCT,10,30,14,27,27,35,27,44,27,28,28,35,37,44,49.21,0.75316147
hek293t,12153,1,14,TTCGCATTCTCAGAACAAAATATGGGAAAAGGCAAGCTCACAAGCAGTTTAAAAACCTCTGACTTAAAAAAATTCTAGTTGGTTTAACGCGTAACTAGA,TTCGCATTCTCAGAACAAAATATGGGAAAAGGCAAGCTCACCGGCTTAGGCATTCAAGCAGTTTAAAAACCTCTGACTTAAAAAAATTCTAGTTGGTTT,10,30,14,27,27,44,27,58,27,41,41,44,55,58,32.71,0.0
hek293t,12154,1,3,TGCCAAAATGCTGAGTATTAAAATGAAGGTGGCTACTCAGCACTATCTCCCCCATGAAGAAAGAATATTTCCTATTTGATTCACTCTGCAAAAAAAATT,TGCCAAAATGCTGAGTATTAAAATGACGCAGGTGGCTACTCAGCACTATCTCCCCCATGAAGAAAGAATATTTCCTATTTGATTCACTCTGCAAAAAAA,10,30,14,27,27,30,27,33,27,27,27,30,30,33,39.97,0.0
hek293t,12154,1,3,GTTACAAATGCTGAGTATTAAAATGAAGGTGGCTACTCAGCACTATCTCCCCCATGAAGAAAGAATATTTCCTATTTGATTCAAAAAAAATTCTAGTTG,GTTACAAATGCTGAGTATTAAAATGACGCAGGTGGCTACTCAGCACTATCTCCCCCATGAAGAAAGAATATTTCCTATTTGATTCAAAAAAAATTCTAG,10,30,14,27,27,37,27,40,27,27,27,37,30,40,39.97,2.136352915
hek293t,23759,1,14,TAAGTAAAAGCTTTGGAAACCACTGAGTGGGGGATTGGGGTGGGACCAAACACAAGCAGTGTTAGAGAAAAAAATTCTAGTTGGTTTAACGCGTAACTA,TAAGTAAAAGCTTTGGAAACCACTGAGTGGGGGATTGGCCCCCACGTTGAATGGTGGGACCAAACACAAGCAGTGTTAGAGAAAAAAATTCTAGTTGGT,10,30,14,27,27,42,27,56,27,39,39,42,53,56,53.6,0.0
hek293t,12157,1,8,TACGGAAAGAAAAACACGTGATTGGCTGGTGGGAGCAAGTAGGGTACTGCTGGTACAGTATGTGCTGTCTTGTGTTTTAAAAAAATTCTAGTTGGTTTA,TACGGAAAGAAAAACACGTGATTGGCTGGACAGCAAATGGGAGCAAGTAGGGTACTGCTGGTACAGTATGTGCTGTCTTGTGTTTTAAAAAAATTCTAG,10,30,14,27,27,37,27,45,27,30,30,37,38,45,31.87,3.81999911
hek293t,12157,1,8,CTGAGAAAGAAAAACACGTGATTGGCTGGTGGGAGCAAGTAGGGTACTGCTGGTACAGTATGTGCTGTCTTGTGTAAAAAAATTCTAGTTGGTTTAACG,CTGAGAAAGAAAAACACGTGATTGGCTGGACAGCAAATGGGAGCAAGTAGGGTACTGCTGGTACAGTATGTGCTGTCTTGTGTAAAAAAATTCTAGTTG,10,30,14,27,27,40,27,48,27,30,30,40,38,48,31.87,2.85838727
hek293t,970,1,15,TCAGATTCATAAGGGAAAATGCTTAGACCAGGATTCCCTTTTTACAACCAGAATGCCTCAGGAAAAAAAAATTCTAGTTGGTTTAACGCGTAACTAGAT,TCAGATTCATAAGGGAAAATGCTTAGACCAGGATTCCAATGACTAAATAATCCTTTTTACAACCAGAATGCCTCAGGAAAAAAAAATTCTAGTTGGTTT,10,30,14,27,27,44,27,59,27,37,37,44,52,59,59.16,0.669642857
hek293t,12160,1,9,AACTAGTGCCTCCACCATTTCCCTCTTTGAGGGAAACTACCAAGTAATAGTAATAATATTGTTGCAGCTGCCACAGAAAAAAATTCTAGTTGGTTTAAC,AACTAGTGCCTCCACCATTTCCCTCTTTGACGATCCCAAGGGAAACTACCAAGTAATAGTAATAATATTGTTGCAGCTGCCACAGAAAAAAATTCTAGT,10,30,14,27,27,38,27,47,27,31,31,38,40,47,28.56,5.483107511
hek293t,12160,1,9,GATACGTGCCTCCACCATTTCCCTCTTTGAGGGAAACTACCAAGTAATAGTAATAATATTGTTGCAGCTGCCAAAAAAAATTCTAGTTGGTTTAACGCG,GATACGTGCCTCCACCATTTCCCTCTTTGACGATCCCAAGGGAAACTACCAAGTAATAGTAATAATATTGTTGCAGCTGCCAAAAAAAATTCTAGTTGG,10,30,14,27,27,41,27,50,27,31,31,41,40,50,28.56,6.325407563
hek293t,12162,1,15,GGCTATACTTTGTATTTGTCTCAGAGGAGAGGGAGCTCAGGGAAGAAGAGAAAAAGAATTCCTTCTCTAAAAAAATTCTAGTTGGTTTAACGCGTAACT,GGCTATACTTTGTATTTGTCTCAGAGGAGCGTCGTCGGAGTTACAGGGAGCTCAGGGAAGAAGAGAAAAAGAATTCCTTCTCTAAAAAAATTCTAGTTG,10,30,14,27,27,40,27,55,27,30,30,40,45,55,29.79,3.516141236
hek293t,12164,1,7,AGGCGTGAGAAGAGGTTTTCACTGAGCTAAGGAGTCCAGGTAGGCTTCCTACCTATGCACCGTCTAAGCCATACAAAGTAAAAAAAATTCTAGTTGGTT,AGGCGTGAGAAGAGGTTTTCACTGAGCTAAGGTGGTTATAGTCCAGGTAGGCTTCCTACCTATGCACCGTCTAAGCCATACAAAGTAAAAAAAATTCTA,10,30,14,27,27,36,27,43,27,33,33,36,40,43,54.94,1.18322847
hek293t,12164,1,7,CTAATTGAGAAGAGGTTTTCACTGAGCTAAGGAGTCCAGGTAGGCTTCCTACCTATGCACCGTCTAAGCCATAAAAAAAATTCTAGTTGGTTTAACGCG,CTAATTGAGAAGAGGTTTTCACTGAGCTAAGGTGGTTATAGTCCAGGTAGGCTTCCTACCTATGCACCGTCTAAGCCATAAAAAAAATTCTAGTTGGTT,10,30,14,27,27,43,27,50,27,33,33,43,40,50,54.94,50.98171351
hek293t,12166,1,2,TTTACTTAGAAGCTCTAAATGGCTATCTTTGGCTGGCACTCGTACAAAATGTGTTATCTGTCAATAAAGGTTAAAAAAATTCTAGTTGGTTTAACGCGT,TTTACTTAGAAGCTCTAAATGGCTATCTTTGGCTGGCAGCCTCGTACAAAATGTGTTATCTGTCAATAAAGGTTAAAAAAATTCTAGTTGGTTTAACGC,10,30,14,27,27,49,27,51,27,39,39,49,41,51,21.87,83.278343
hek293t,12166,1,2,CACAATTAGAAGCTCTAAATGGCTATCTTTGGCTGGCACTCGTACAAAATGTGTTATCTGTCAATAAAGGTTAGCAAAAAAATTCTAGTTGGTTTAACG,CACAATTAGAAGCTCTAAATGGCTATCTTTGGCTGGCAGCCTCGTACAAAATGTGTTATCTGTCAATAAAGGTTAGCAAAAAAATTCTAGTTGGTTTAA,10,30,14,27,27,46,27,48,27,39,39,46,41,48,21.87,80.76399646
hek293t,12170,1,8,AGTCTATTGCTTTGAGAAATACTTTGACATGGAAATCAGTTAAGAGCCTTCCCAGTGGTAAAAAGCCTGAAAAAAAATTCTAGTTGGTTTAACGCGTAA,AGTCTATTGCTTTGAGAAATACTTTGACATGGAAATCGATGGGAGAGTTAAGAGCCTTCCCAGTGGTAAAAAGCCTGAAAAAAAATTCTAGTTGGTTTA,10,30,14,27,27,45,27,53,27,38,38,45,46,53,33.74,0.023490721
hek293t,12170,1,8,CGACGATTGCTTTGAGAAATACTTTGACATGGAAATCAGTTAAGAGCCTTCCCAGTGGTAAAAAGCCAAAAAAATTCTAGTTGGTTTAACGCGTAACTA,CGACGATTGCTTTGAGAAATACTTTGACATGGAAATCGATGGGAGAGTTAAGAGCCTTCCCAGTGGTAAAAAGCCAAAAAAATTCTAGTTGGTTTAACG,10,30,14,27,27,48,27,56,27,38,38,48,46,56,33.74,1.114730313
hek293t,17022,1,14,CTAATTTACATGCTTTAGATTTTATTGATTGGTGGTTTAGCTTAATACAGTAAGACTGGAAATTATCAAAAAAATTCTAGTTGGTTTAACGCGTAACTA,CTAATTTACATGCTTTAGATTTTATTTGCCAGTATGCCCGGATTGGTGGTTTAGCTTAATACAGTAAGACTGGAAATTATCAAAAAAATTCTAGTTGGT,10,30,14,27,27,42,27,56,27,27,27,42,41,56,6.07,0.0
hek293t,17022,1,14,AGTTCTTACATGCTTTAGATTTTATTGATTGGTGGTTTAGCTTAATACAGTAAGACTGGAAATTATCTACTTGTCGTCGAAAAAAATTCTAGTTGGTTT,AGTTCTTACATGCTTTAGATTTTATTTGCCAGTATGCCCGGATTGGTGGTTTAGCTTAATACAGTAAGACTGGAAATTATCTACTTGTCGTCGAAAAAA,10,30,14,27,27,30,27,44,27,27,27,30,41,44,6.07,0.0
hek293t,12176,1,11,TGTCAATTCATCACTGGCATAATTCCGTCAGGCTCAATAGAAATAAACCACATATTTTCACCATTAGTACAAAAAAATTCTAGTTGGTTTAACGCGTAA,TGTCAATTCATCACTGGCATAATTCCGTCAGCAGGCAGTCGAGCTCAATAGAAATAAACCACATATTTTCACCATTAGTACAAAAAAATTCTAGTTGGT,10,30,14,27,27,42,27,53,27,32,32,42,43,53,24.09,4.261507935
hek293t,12176,1,11,GTTATATTCATCACTGGCATAATTCCGTCAGGCTCAATAGAAATAAACCACATATTTTCACCATTAGTACTTAAAAGAAAAAAATTCTAGTTGGTTTAA,GTTATATTCATCACTGGCATAATTCCGTCAGCAGGCAGTCGAGCTCAATAGAAATAAACCACATATTTTCACCATTAGTACTTAAAAGAAAAAAATTCT,10,30,14,27,27,35,27,46,27,32,32,35,43,46,24.09,0.0
hek293t,12178,1,5,TACTCTAAAGAATTTGCTTTAACAGAAAATGGTTGACTCCCTCTGCCCTGTCCACATCAAAACTAAAAAAATTCTAGTTGGTTTAACGCGTAACTAGAT,TACTCTAAAGAATTTGCTTTAACAGAAAATGGTTGACTAGCGGCCCTCTGCCCTGTCCACATCAAAACTAAAAAAATTCTAGTTGGTTTAACGCGTAAC,10,30,14,27,27,54,27,59,27,39,39,54,44,59,2.64,3.347375088
hek293t,12178,1,5,CGATGTAAAGAATTTGCTTTAACAGAAAATGGTTGACTCCCTCTGCCCTGTCCACATCAAAACTTTCTATGAAAAAAAATTCTAGTTGGTTTAACGCGT,CGATGTAAAGAATTTGCTTTAACAGAAAATGGTTGACTAGCGGCCCTCTGCCCTGTCCACATCAAAACTTTCTATGAAAAAAAATTCTAGTTGGTTTAA,10,30,14,27,27,46,27,51,27,39,39,46,44,51,2.64,0.356921776
hek293t,18528,1,4,TGGCCACCTCTGACAAACCAGGCCATCCCTGGTCATTTCAAGCACGTACATATGCAAAGGAGGCAACCTGAAAAAAAATTCTAGTTGGTTTAACGCGTA,TGGCCACCTCTGACAAACCAGGCCATCCCTGGTCATTATCATCAAGCACGTACATATGCAAAGGAGGCAACCTGAAAAAAAATTCTAGTTGGTTTAACG,10,30,14,27,27,48,27,52,27,38,38,48,42,52,67.36,11.31308843
hek293t,18528,1,4,AAGGTACCTCTGACAAACCAGGCCATCCCTGGTCATTTCAAGCACGTACATATGCAAAGGAGGCAACCTGAATAAAATAAAAAAATTCTAGTTGGTTTA,AAGGTACCTCTGACAAACCAGGCCATCCCTGGTCATTATCATCAAGCACGTACATATGCAAAGGAGGCAACCTGAATAAAATAAAAAAATTCTAGTTGG,10,30,14,27,27,41,27,45,27,38,38,41,42,45,67.36,0.072216518
hek293t,12182,1,9,GAAGGAAAAATGATGCCAGGTGAGTTCTGGGGGTGTTCTCTCTACTTCTTCTGTTTTAGTAGTATGGATGCAAAAAAAATTCTAGTTGGTTTAACGCGT,GAAGGAAAAATGATGCCAGGTGAGTTCTGGGGGTGTTCAGAAGTGAGTCTCTACTTCTTCTGTTTTAGTAGTATGGATGCAAAAAAAATTCTAGTTGGT,10,30,14,27,27,42,27,51,27,39,39,42,48,51,60.04,2.882709516
hek293t,12184,1,1,TCTGTTTTGGGAAAGGCCGTGAGTGGTAGAGGTATAGAGCTCCGTGATGCTTCAAAAAGGAAAACAATTTTAAAATTCTGAAAAAAAAATTCTAGTTGG,TCTGTTTTGGGAAAGGCCGTGAGTGGTAGAGGTATACGAGCTCCGTGATGCTTCAAAAAGGAAAACAATTTTAAAATTCTGAAAAAAAAATTCTAGTTG,10,30,14,27,27,40,27,41,27,37,37,40,38,41,38.14,2.778358266
hek293t,12184,1,1,GCTACTTTGGGAAAGGCCGTGAGTGGTAGAGGTATAGAGCTCCGTGATGCTTCAAAAAGGAAAACAATTTAAAAAAATTCTAGTTGGTTTAACGCGTAA,GCTACTTTGGGAAAGGCCGTGAGTGGTAGAGGTATACGAGCTCCGTGATGCTTCAAAAAGGAAAACAATTTAAAAAAATTCTAGTTGGTTTAACGCGTA,10,30,14,27,27,52,27,53,27,37,37,52,38,53,38.14,73.91326645
hek293t,2031,1,13,TCTTAATAAAAATACTGAATATTCTTGTTTGGCTGAAACTGTTTGTTCTGATTCATCATCTCTGAAAAAAATTCTAGTTGGTTTAACGCGTAACTAGAT,TCTTAATAAAAATACTGAATATTCTTGTTTGGCTGCTCCTGCTGCGGCAAACTGTTTGTTCTGATTCATCATCTCTGAAAAAAATTCTAGTTGGTTTAA,10,30,14,27,27,46,27,59,27,36,36,46,49,59,17.32,1.321138211
hek293t,12188,1,11,AAGCGGGAAGAATTGCCATGCTGTATGAGAGGGAGTTGCTAGTAACAGTGTGCCTGTAGGACCCAAAAAAATTCTAGTTGGTTTAACGCGTAACTAGAT,AAGCGGGAAGAATTGCCATGCTGTATGAGAGGGAGTTTTAGTACAAGAGCTAGTAACAGTGTGCCTGTAGGACCCAAAAAAATTCTAGTTGGTTTAACG,10,30,14,27,27,48,27,59,27,38,38,48,49,59,59.54,1.127869511
hek293t,12189,1,15,ATCATTAGGAATGCAGAAGTAAAGAATTAAGGTTACCAGTGAGCCCACTTTTAACATTAGAACTAAAAAAATTCTAGTTGGTTTAACGCGTAACTAGAT,ATCATTAGGAATGCAGAAGTAAAGAATTAAGGTTACGACGTGTGTCCTAGCCAGTGAGCCCACTTTTAACATTAGAACTAAAAAAATTCTAGTTGGTTT,10,30,14,27,27,44,27,59,27,37,37,44,52,59,40.4,0.035385704
hek293t,12190,1,3,ATCCTGTTTTGAATAAATGGGTAGTGTACTGGGAGAAGCACCTAGCCCTTGCAAAAGACCATAGTGTATTTACTGCCATAAAAAAATTCTAGTTGGTTT,ATCCTGTTTTGAATAAATGGGTAGTGTACTGGGTCCAGAAGCACCTAGCCCTTGCAAAAGACCATAGTGTATTTACTGCCATAAAAAAATTCTAGTTGG,10,30,14,27,27,41,27,44,27,34,34,41,37,44,24.93,85.21294696
hek293t,12192,1,4,CTTCTGAGAAAGCGCACGACAGCTACTTCTGGTACCATTACTGTGTGGCATCAGTTCCTTGGCCACGTGGGATACGTCCTCTGTAAAAAAATTCTAGTT,CTTCTGAGAAAGCGCACGACAGCTACTGTCTTCTGGTACCATTACTGTGTGGCATCAGTTCCTTGGCCACGTGGGATACGTCCTCTGTAAAAAAATTCT,10,30,14,27,27,35,27,39,27,28,28,35,32,39,27.64,84.77375419
hek293t,12196,1,11,AAATCGATATAGTAAAATCAGGTCAGGTTAGGATCATTTTTGCAGAAGGACTAATAAAAGGGCTTCAAAATGAAAAAAATTCTAGTTGGTTTAACGCGT,AAATCGATATAGTAAAATCAGGTCAGGTTAGGATCATTTCCCACTTTTTTTTGCAGAAGGACTAATAAAAGGGCTTCAAAATGAAAAAAATTCTAGTTG,10,30,14,27,27,40,27,51,27,37,37,40,48,51,39.29,0.0
hek293t,12197,1,14,GTGTCTCTGAAGCTTTCTGATGAGAAAACAGGAGAAAAAGTAGGTCACATTCAGCCACCTTGAGAAAAAAATTCTAGTTGGTTTAACGCGTAACTAGAT,GTGTCTCTGAAGCTTTCTGATGAGAAAACAGGAGAAACCCGGAAGCATCTTAAGTAGGTCACATTCAGCCACCTTGAGAAAAAAATTCTAGTTGGTTTA,10,30,14,27,27,45,27,59,27,38,38,45,52,59,29.39,0.017580872
hek293t,12201,1,3,GGACACATGTGTTGCTATCCCTAACTAGTTGGATGGGGGAAGGGAGGCAGAGAAAAGTTGGAAACAGTATGTAAGCTCAAAAAAAATTCTAGTTGGTTT,GGACACATGTGTTGCTATCCCTAACTAGTTGTTGGATGGGGGAAGGGAGGCAGAGAAAAGTTGGAAACAGTATGTAAGCTCAAAAAAAATTCTAGTTGG,10,30,14,27,27,41,27,44,27,31,31,41,34,44,28.43,45.93844162
hek293t,12201,1,3,GTATGCATGTGTTGCTATCCCTAACTAGTTGGATGGGGGAAGGGAGGCAGAGAAAAGTTGGAAACAGTATGTAAGCTCACTGAAAAAAAAAAATTCTAG,GTATGCATGTGTTGCTATCCCTAACTAGTTGTTGGATGGGGGAAGGGAGGCAGAGAAAAGTTGGAAACAGTATGTAAGCTCACTGAAAAAAAAAAATTC,10,30,14,27,27,34,27,37,27,31,31,34,34,37,28.43,0.0
hek293t,12203,1,12,GGTGTGGCACTTCTGGATCAGGGAGCTACAGGAAAACACTTGGAGTCCGAATTCCGATTGGAAGATAAAAAAATTCTAGTTGGTTTAACGCGTAACTAG,GGTGTGGCACTTCTGGATCAGGGAGCTACAGGAAAACCATCGTTCATGAACTTGGAGTCCGAATTCCGATTGGAAGATAAAAAAATTCTAGTTGGTTTA,10,30,14,27,27,45,27,57,27,38,38,45,50,57,36.27,2.004138979
hek293t,12203,1,12,CCGACGGCACTTCTGGATCAGGGAGCTACAGGAAAACACTTGGAGTCCGAATTCCGATTGGAAGATGCAGAAAAAAATTCTAGTTGGTTTAACGCGTAA,CCGACGGCACTTCTGGATCAGGGAGCTACAGGAAAACCATCGTTCATGAACTTGGAGTCCGAATTCCGATTGGAAGATGCAGAAAAAAATTCTAGTTGG,10,30,14,27,27,41,27,53,27,38,38,41,50,53,36.27,0.214082214
hek293t,12205,1,7,CGATTATCTGTTGAGCGAAGAATGATTTTTGGCTGCCTGTAGATATGAGTATAAACATGAAATGGAGGAAAAAAATTCTAGTTGGTTTAACGCGTAACT,CGATTATCTGTTGAGCGAAGAATGATTTTTGGCTGCCAGGTAGTTGTAGATATGAGTATAAACATGAAATGGAGGAAAAAAATTCTAGTTGGTTTAACG,10,30,14,27,27,48,27,55,27,38,38,48,45,55,18.48,0.017059024
hek293t,12206,1,5,ACCCCAAGGCACAAGCCCTCGCTGCAGCCCGGCAGCCCAGCCCGAGCCAGTGCTCTGCGGAGCCCAGAGCCAAAAAAATTCTAGTTGGTTTAACGCGTA,ACCCCAAGGCACAAGCCCTCGCTGCAGCCCGTATTAGCAGCCCAGCCCGAGCCAGTGCTCTGCGGAGCCCAGAGCCAAAAAAATTCTAGTTGGTTTAAC,10,30,14,27,27,47,27,52,27,32,32,47,37,52,57.43,59.05260304
hek293t,12206,1,5,ACACGAAGGCACAAGCCCTCGCTGCAGCCCGGCAGCCCAGCCCGAGCCAGTGCTCTGCGGAGCCCAGAGCCTGCACAAGAAAAAAATTCTAGTTGGTTT,ACACGAAGGCACAAGCCCTCGCTGCAGCCCGTATTAGCAGCCCAGCCCGAGCCAGTGCTCTGCGGAGCCCAGAGCCTGCACAAGAAAAAAATTCTAGTT,10,30,14,27,27,39,27,44,27,32,32,39,37,44,57.43,66.90442882
hek293t,12208,1,6,CAGCACTACAGTAGGCTAATTGAAGATTCTGGATTTTGGTCAGTGATTTCTCTAGAATTATTCAAGCAGGACAGCAAAAAAATTCTAGTTGGTTTAACG,CAGCACTACAGTAGGCTAATTGAAGATTCTGTTGGAGGATTTTGGTCAGTGATTTCTCTAGAATTATTCAAGCAGGACAGCAAAAAAATTCTAGTTGGT,10,30,14,27,27,42,27,48,27,32,32,42,38,48,25.9,46.42909187
hek293t,12208,1,6,TCGTGCTACAGTAGGCTAATTGAAGATTCTGGATTTTGGTCAGTGATTTCTCTAGAATTATTCAAGCAGGACAGCAAAAAAAAAATTCTAGTTGGTTTA,TCGTGCTACAGTAGGCTAATTGAAGATTCTGTTGGAGGATTTTGGTCAGTGATTTCTCTAGAATTATTCAAGCAGGACAGCAAAAAAAAAATTCTAGTT,10,30,14,27,27,39,27,45,27,32,32,39,38,45,25.9,26.1947057
hek293t,12210,1,1,GACCGGTAACCCTGCGGGCCTCGTGCTCTCGGCCGCTGTGGTGCGGTTACTTGCTGACCGCTAGCTGCTCAAAAAAATTCTAGTTGGTTTAACGCGTAA,GACCGGTAACCCTGCGGGCCTCGTGCTCTCGGCCGCCTGTGGTGCGGTTACTTGCTGACCGCTAGCTGCTCAAAAAAATTCTAGTTGGTTTAACGCGTA,10,30,14,27,27,52,27,53,27,37,37,52,38,53,14.8,66.38820862
hek293t,12213,1,14,GTTGCACTGGAAAAATAAGAAAGCCTGTTAGGAAATTAACCTTCGGTTTATATTGTTACATGTCTTTAAAAAAATTCTAGTTGGTTTAACGCGTAACTA,GTTGCACTGGAAAAATAAGAAAGCCTGTTAGGAAATTAACCTCTGTCTGTCAACCTTCGGTTTATATTGTTACATGTCTTTAAAAAAATTCTAGTTGGT,10,30,14,27,27,42,27,56,27,39,39,42,53,56,23.83,0.0
hek293t,12218,1,1,TTGAATTTAATTGGTTCTGTGTGCTGGTAAGGAGCTGCTGCACTCCAGTCCAGAAGTGGTTACATGTCAGTAGCAGATGATCCACGAAAAAAATTCTAG,TTGAATTTAATTGGTTCTGTGTGCTGGTAAGGCAGCTGCTGCACTCCAGTCCAGAAGTGGTTACATGTCAGTAGCAGATGATCCACGAAAAAAATTCTA,10,30,14,27,27,36,27,37,27,33,33,36,34,37,24.72,2.904932582
hek293t,12218,1,1,AAGACTTTAATTGGTTCTGTGTGCTGGTAAGGAGCTGCTGCACTCCAGTCCAGAAGTGGTTACATGTCAGTAGCAGATGAAAAAAATTCTAGTTGGTTT,AAGACTTTAATTGGTTCTGTGTGCTGGTAAGGCAGCTGCTGCACTCCAGTCCAGAAGTGGTTACATGTCAGTAGCAGATGAAAAAAATTCTAGTTGGTT,10,30,14,27,27,43,27,44,27,33,33,43,34,44,24.72,87.5219844
hek293t,12220,1,14,AGGGAAGGAGCTGACTGGCCTCTTTCATATGGGCTTTAATTTAACCTATAGTGGTAACTAGTTCCTAAAATAAAAAAATTCTAGTTGGTTTAACGCGTA,AGGGAAGGAGCTGACTGGCCTCTTTCATATGACGGTAATGTTTTGGGCTTTAATTTAACCTATAGTGGTAACTAGTTCCTAAAATAAAAAAATTCTAGT,10,30,14,27,27,38,27,52,27,31,31,38,45,52,19.56,2.761090139
hek293t,12221,1,9,CCCATATCCATGCTCTGAACTGTGTATCCTGGCCATCTTGGGCTCAAAGTTTGGTGCTACTGCTTAATGTTTTCAAAAAAAATTCTAGTTGGTTTAACG,CCCATATCCATGCTCTGAACTGTGTATCCTGGCCAAAACAAGTTTCTTGGGCTCAAAGTTTGGTGCTACTGCTTAATGTTTTCAAAAAAAATTCTAGTT,10,30,14,27,27,39,27,48,27,36,36,39,45,48,43.8,0.0
hek293t,12222,1,10,GGGGAAGGTGGTGGTGGTGGGGTTCTAGGTGGAGAGATAATATAGGCCAGTGCTCTTGTGGGGACTCCGTAAAAAAATTCTAGTTGGTTTAACGCGTAA,GGGGAAGGTGGTGGTGGTGGGGTTCTAGGTGGAGAGATACCCTCGTAGCATATAGGCCAGTGCTCTTGTGGGGACTCCGTAAAAAAATTCTAGTTGGTT,10,30,14,27,27,43,27,53,27,40,40,43,50,53,65.99,0.121212121
hek293t,12225,1,14,CGCTCACACTGTGTGTGCTTGAGACCATGTGGGAGGGAGAGGCAGATTGACTTTACCCAGACCTGTAAAATAAAAAAATTCTAGTTGGTTTAACGCGTA,CGCTCACACTGTGTGTGCTTGAGACCATGTGTAACGTGAGGTAGGGGAGGGAGAGGCAGATTGACTTTACCCAGACCTGTAAAATAAAAAAATTCTAGT,10,30,14,27,27,38,27,52,27,31,31,38,45,52,54.32,12.43552971
hek293t,12225,1,14,TACGTACACTGTGTGTGCTTGAGACCATGTGGGAGGGAGAGGCAGATTGACTTTACCCAGACCTGTAAAATGCTTAAAAAAATTCTAGTTGGTTTAACG,TACGTACACTGTGTGTGCTTGAGACCATGTGTAACGTGAGGTAGGGGAGGGAGAGGCAGATTGACTTTACCCAGACCTGTAAAATGCTTAAAAAAATTC,10,30,14,27,27,34,27,48,27,31,31,34,45,48,54.32,11.77147348
hek293t,12227,1,14,CCACCTACATGTATGTATTATCCACTACATGGGATTTATGTTATGGTAAAAGATAAATCAGAAAAACAGAAAAAAAATTCTAGTTGGTTTAACGCGTAA,CCACCTACATGTATGTATTATCCACTACATGGGATATAGGGACGGGCCTTTATGTTATGGTAAAAGATAAATCAGAAAAACAGAAAAAAAATTCTAGTT,10,30,14,27,27,39,27,53,27,36,36,39,50,53,49.62,0.0
hek293t,12228,1,1,ATGCCATTAGTGCTCCTTCCGCCACTGGAAGGAATAGTTAACGTTACAAATGCAAACCTGTGCAATCCACAAATGGAAAACTAAAAAAAATTCTAGTTG,ATGCCATTAGTGCTCCTTCCGCCACTGGAAGAGAATAGTTAACGTTACAAATGCAAACCTGTGCAATCCACAAATGGAAAACTAAAAAAAATTCTAGTT,10,30,14,27,27,39,27,40,27,32,32,39,33,40,64.8,84.60003991
hek293t,12228,1,1,AGGGTATTAGTGCTCCTTCCGCCACTGGAAGGAATAGTTAACGTTACAAATGCAAACCTGTGCAATCCACAAATGAAAAAAATTCTAGTTGGTTTAACG,AGGGTATTAGTGCTCCTTCCGCCACTGGAAGAGAATAGTTAACGTTACAAATGCAAACCTGTGCAATCCACAAATGAAAAAAATTCTAGTTGGTTTAAC,10,30,14,27,27,47,27,48,27,32,32,47,33,48,64.8,86.3461078
hek293t,12230,1,3,ATGGTGGGGACAACAGGCAACAGCTTCCCCGGCCACAGGTGCAGTGACGGAAAACAGCTTTTTGTGCTCACTCGAGTGTCCCCAAAAAAATTCTAGTTG,ATGGTGGGGACAACAGGCAACAGCTTCCCCGGCCGACACAGGTGCAGTGACGGAAAACAGCTTTTTGTGCTCACTCGAGTGTCCCCAAAAAAATTCTAG,10,30,14,27,27,37,27,40,27,34,34,37,37,40,55.51,1.30783927
hek293t,12230,1,3,AGGATGGGGACAACAGGCAACAGCTTCCCCGGCCACAGGTGCAGTGACGGAAAACAGCTTTTTGTGCTCACAAAAAAATTCTAGTTGGTTTAACGCGTA,AGGATGGGGACAACAGGCAACAGCTTCCCCGGCCGACACAGGTGCAGTGACGGAAAACAGCTTTTTGTGCTCACAAAAAAATTCTAGTTGGTTTAACGC,10,30,14,27,27,49,27,52,27,34,34,49,37,52,55.51,80.06901341
hek293t,12232,1,1,CGGCTTTGTCCTGTAGTCTAAATTCTTTCTGGCCCCCCCCACGGTATGCCCAAATCATCATTATCGAAACAAAAAAAAATTCTAGTTGGTTTAACGCGT,CGGCTTTGTCCTGTAGTCTAAATTCTTTCTGGCCCCCCCCCACGGTATGCCCAAATCATCATTATCGAAACAAAAAAAAATTCTAGTTGGTTTAACGCG,10,30,14,27,27,50,27,51,27,35,35,50,36,51,2.95,0.880157352
hek293t,12232,1,1,GACCATTGTCCTGTAGTCTAAATTCTTTCTGGCCCCCCCCACGGTATGCCCAAATCATCATTATCGAAACAAATCCCAAGACAGAAAAAAATTCTAGTT,GACCATTGTCCTGTAGTCTAAATTCTTTCTGGCCCCCCCCCACGGTATGCCCAAATCATCATTATCGAAACAAATCCCAAGACAGAAAAAAATTCTAGT,10,30,14,27,27,38,27,39,27,35,35,38,36,39,2.95,0.0
hek293t,17112,1,9,AAGTCATCTTAGGCTTTAGGTAATTGCTCTGGCCCTGATTTTGTGCAGCACTGCTGCCGGATTGCTTTGCTGAAAAAAATTCTAGTTGGTTTAACGCGT,AAGTCATCTTAGGCTTTAGGTAATTGCTCTGTGGACGACAGCCCTGATTTTGTGCAGCACTGCTGCCGGATTGCTTTGCTGAAAAAAATTCTAGTTGGT,10,30,14,27,27,42,27,51,27,32,32,42,41,51,56.51,22.9512554
hek293t,17112,1,9,ATGTTATCTTAGGCTTTAGGTAATTGCTCTGGCCCTGATTTTGTGCAGCACTGCTGCCGGATTGCTTTGCTGTGGAAAAAAATTCTAGTTGGTTTAACG,ATGTTATCTTAGGCTTTAGGTAATTGCTCTGTGGACGACAGCCCTGATTTTGTGCAGCACTGCTGCCGGATTGCTTTGCTGTGGAAAAAAATTCTAGTT,10,30,14,27,27,39,27,48,27,32,32,39,41,48,56.51,12.92546584
hek293t,12238,1,3,ACGGCTAAAACTGAGATTTGTAACAGACTTGGAATTACTATTATAGGCAATAGAAGCTAATCTGTTCATAAAAAAAATTCTAGTTGGTTTAACGCGTAA,ACGGCTAAAACTGAGATTTGTAACAGACTTGGAATTACTTACATTATAGGCAATAGAAGCTAATCTGTTCATAAAAAAAATTCTAGTTGGTTTAACGCG,10,30,14,27,27,50,27,53,27,40,40,50,43,53,34.05,67.52833604
hek293t,12238,1,3,TCAACTAAAACTGAGATTTGTAACAGACTTGGAATTACTATTATAGGCAATAGAAGCTAATCTGTAAAAAAATTCTAGTTGGTTTAACGCGTAACTAGA,TCAACTAAAACTGAGATTTGTAACAGACTTGGAATTACTTACATTATAGGCAATAGAAGCTAATCTGTAAAAAAATTCTAGTTGGTTTAACGCGTAACT,10,30,14,27,27,55,27,58,27,40,40,55,43,58,34.05,58.28392512
hek293t,12240,1,6,CTGAATACATTTGAAGTATTCCCGTTCTTTGGCTTATGCACACACATACACATATTCTTGTAAGAAAAAAATTCTAGTTGGTTTAACGCGTAACTAGAT,CTGAATACATTTGAAGTATTCCCGTTCTTTGGCTTATGCAGCAGCACACACATACACATATTCTTGTAAGAAAAAAATTCTAGTTGGTTTAACGCGTAA,10,30,14,27,27,53,27,59,27,38,38,53,44,59,13.85,35.26497301
hek293t,12240,1,6,TAACTTACATTTGAAGTATTCCCGTTCTTTGGCTTATGCACACACATACACATATTCTTGTAAGTAAGTAACAAAAAAATTCTAGTTGGTTTAACGCGT,TAACTTACATTTGAAGTATTCCCGTTCTTTGGCTTATGCAGCAGCACACACATACACATATTCTTGTAAGTAAGTAACAAAAAAATTCTAGTTGGTTTA,10,30,14,27,27,45,27,51,27,38,38,45,44,51,13.85,4.514708727
hek293t,12242,1,3,TGAGGGGTGCTACAGAGGGTTAAAGCAAATGGCTATAGACTTGAACCGATCTTTGAAGCGGACACATCTGAAAAAAATTCTAGTTGGTTTAACGCGTAA,TGAGGGGTGCTACAGAGGGTTAAAGCAAATGGCTATAATAGACTTGAACCGATCTTTGAAGCGGACACATCTGAAAAAAATTCTAGTTGGTTTAACGCG,10,30,14,27,27,50,27,53,27,35,35,50,38,53,30.44,55.3365439
hek293t,12242,1,3,GTACAGGTGCTACAGAGGGTTAAAGCAAATGGCTATAGACTTGAACCGATCTTTGAAGCGGACACATCTGTAATAGGCAAATAAAAAAATTCTAGTTGG,GTACAGGTGCTACAGAGGGTTAAAGCAAATGGCTATAATAGACTTGAACCGATCTTTGAAGCGGACACATCTGTAATAGGCAAATAAAAAAATTCTAGT,10,30,14,27,27,38,27,41,27,35,35,38,38,41,30.44,0.0
hek293t,12244,1,5,TGCGTATCTCTTGAGTGAGTTCAGTTAGCTGGTTTCCATTTAAAAGTTGAATGAGTTGGAGAAATGGAAAAAAATTCTAGTTGGTTTAACGCGTAACTA,TGCGTATCTCTTGAGTGAGTTCAGTTAGCTGGTTTCAGGTCCATTTAAAAGTTGAATGAGTTGGAGAAATGGAAAAAAATTCTAGTTGGTTTAACGCGT,10,30,14,27,27,51,27,56,27,36,36,51,41,56,16.38,13.120178
hek293t,12244,1,5,ATAGGATCTCTTGAGTGAGTTCAGTTAGCTGGTTTCCATTTAAAAGTTGAATGAGTTGGAGAAATGGAGATAAAAAAAATTCTAGTTGGTTTAACGCGT,ATAGGATCTCTTGAGTGAGTTCAGTTAGCTGGTTTCAGGTCCATTTAAAAGTTGAATGAGTTGGAGAAATGGAGATAAAAAAAATTCTAGTTGGTTTAA,10,30,14,27,27,46,27,51,27,36,36,46,41,51,16.38,33.90337774
hek293t,12246,1,12,CAGACTATAAGAGTTAATTGTCTTCAAAATGGTTACCTGGACCTTCAAAGCCAGCAAAAAATACAAAATATATATCAAAAAAAATTCTAGTTGGTTTAA,CAGACTATAAGAGTTAATTGTCTTCAAAATCTAGACACAAGGGGTTACCTGGACCTTCAAAGCCAGCAAAAAATACAAAATATATATCAAAAAAAATTC,10,30,14,27,27,34,27,46,27,31,31,34,43,46,13.65,0.0
hek293t,12246,1,12,ATCACTATAAGAGTTAATTGTCTTCAAAATGGTTACCTGGACCTTCAAAGCCAGCAAAAAATACAAAATAAAAAAAATTCTAGTTGGTTTAACGCGTAA,ATCACTATAAGAGTTAATTGTCTTCAAAATCTAGACACAAGGGGTTACCTGGACCTTCAAAGCCAGCAAAAAATACAAAATAAAAAAAATTCTAGTTGG,10,30,14,27,27,41,27,53,27,31,31,41,43,53,13.65,1.8128489
hek293t,12252,1,12,TGATAGCAATATAGGCACAGGGATAGCAATGGGAAATGTCGAAATAAGTCATCTAGTTTTCTCTTGCTAAAAAAATTCTAGTTGGTTTAACGCGTAACT,TGATAGCAATATAGGCACAGGGATAGCAATGGGGCGACCAGACTGAAATGTCGAAATAAGTCATCTAGTTTTCTCTTGCTAAAAAAATTCTAGTTGGTT,10,30,14,27,27,43,27,55,27,33,33,43,45,55,60.19,4.366717232
hek293t,12252,1,12,TAATGGCAATATAGGCACAGGGATAGCAATGGGAAATGTCGAAATAAGTCATCTAGTTTTCTCTTGCTCAGTGGGAAAAAAATTCTAGTTGGTTTAACG,TAATGGCAATATAGGCACAGGGATAGCAATGGGGCGACCAGACTGAAATGTCGAAATAAGTCATCTAGTTTTCTCTTGCTCAGTGGGAAAAAAATTCTA,10,30,14,27,27,36,27,48,27,33,33,36,45,48,60.19,0.131926121
hek293t,12254,1,6,GGTCTATATTGCGATTCCCCCATCAGTTAAGGACAGAGGCCCTGGAAGTGCTGATTGATAGGGCAGTCATTTAAAAAAATTCTAGTTGGTTTAACGCGT,GGTCTATATTGCGATTCCCCCATCAGTTAAGGACAGAATTGCTGGCCCTGGAAGTGCTGATTGATAGGGCAGTCATTTAAAAAAATTCTAGTTGGTTTA,10,30,14,27,27,45,27,51,27,38,38,45,44,51,20.36,17.0636838
hek293t,12254,1,6,AACACATATTGCGATTCCCCCATCAGTTAAGGACAGAGGCCCTGGAAGTGCTGATTGATAGGGCAGTCAAAAAAAATTCTAGTTGGTTTAACGCGTAAC,AACACATATTGCGATTCCCCCATCAGTTAAGGACAGAATTGCTGGCCCTGGAAGTGCTGATTGATAGGGCAGTCAAAAAAAATTCTAGTTGGTTTAACG,10,30,14,27,27,48,27,54,27,38,38,48,44,54,20.36,11.23652856
hek293t,12256,1,5,TATAGGACAACTAAATTCTTATAATTTGTTGGTAATTAGGTAAAATGTTTTATAATCAAGAGAACTTGAGACAGGAGGAAAAAAAAATTCTAGTTGGTT,TATAGGACAACTAAATTCTTATAATTTGTTCAATGGGTAATTAGGTAAAATGTTTTATAATCAAGAGAACTTGAGACAGGAGGAAAAAAAAATTCTAGT,10,30,14,27,27,38,27,43,27,31,31,38,36,43,6.11,0.50368978
hek293t,12256,1,5,CTTCAGACAACTAAATTCTTATAATTTGTTGGTAATTAGGTAAAATGTTTTATAATCAAGAGAACTTGAGACAGGAGGAATCCCAAAAAAATTCTAGTT,CTTCAGACAACTAAATTCTTATAATTTGTTCAATGGGTAATTAGGTAAAATGTTTTATAATCAAGAGAACTTGAGACAGGAGGAATCCCAAAAAAATTC,10,30,14,27,27,34,27,39,27,31,31,34,36,39,6.11,0.0
hek293t,12260,1,6,GTCAGTCAGGGCACAGGAGCTGTCTATCACGGCTTGTTTTCCAGAGCGCAGCGCAACGGAGCTAACCCTCGACCGAAAAAAATTCTAGTTGGTTTAACG,GTCAGTCAGGGCACAGGAGCTGTCTATCACGGCTGTCGGCTGTTTTCCAGAGCGCAGCGCAACGGAGCTAACCCTCGACCGAAAAAAATTCTAGTTGGT,10,30,14,27,27,42,27,48,27,35,35,42,41,48,56.03,18.28156866
hek293t,12260,1,6,TTCGGTCAGGGCACAGGAGCTGTCTATCACGGCTTGTTTTCCAGAGCGCAGCGCAACGGAGCTAACCCTCGACCGGCCCAAAAAAATTCTAGTTGGTTT,TTCGGTCAGGGCACAGGAGCTGTCTATCACGGCTGTCGGCTGTTTTCCAGAGCGCAGCGCAACGGAGCTAACCCTCGACCGGCCCAAAAAAATTCTAGT,10,30,14,27,27,38,27,44,27,35,35,38,41,44,56.03,2.466420006
hek293t,12262,1,5,ACTAGTCTATCATTTATTTTTAGAGCTGTTGGTGTATACAGTTAGAGTGCTCTTAGCAGAAGGTCACAGTCAAAAAAAATTCTAGTTGGTTTAACGCGT,ACTAGTCTATCATTTATTTTTAGAGCTGTTGGTGTATAACGCTCAGTTAGAGTGCTCTTAGCAGAAGGTCACAGTCAAAAAAAATTCTAGTTGGTTTAA,10,30,14,27,27,46,27,51,27,39,39,46,44,51,-0.76,0.0
hek293t,12264,1,5,ATGATGAACTCTTTGCATTATGAATTTCATGGTTCACTGGCCAGCATATCGGACAATTTCCTATAATGCAATAAAAAAATTCTAGTTGGTTTAACGCGT,ATGATGAACTCTTTGCATTATGAATTTCATGGTTCTAGGCACTGGCCAGCATATCGGACAATTTCCTATAATGCAATAAAAAAATTCTAGTTGGTTTAA,10,30,14,27,27,46,27,51,27,36,36,46,41,51,4.78,10.648264
hek293t,12266,1,6,AGGCAACCAAATATTTTTGGCTTGATCTAAGGCCCTTTTAAGTCAGTGGGAATCTTTCTCTGGATGTGGTTGGGCACTAAATCACAAAAAAATTCTAGT,AGGCAACCAAATATTTTTGGCTTGATCTAGATTGAAGGCCCTTTTAAGTCAGTGGGAATCTTTCTCTGGATGTGGTTGGGCACTAAATCACAAAAAAAT,10,30,14,27,27,32,27,38,27,29,29,32,35,38,12.71,0.660614585
hek293t,12266,1,6,CCCATACCAAATATTTTTGGCTTGATCTAAGGCCCTTTTAAGTCAGTGGGAATCTTTCTCTGGATGTGGTTGGAAAAAAATTCTAGTTGGTTTAACGCG,CCCATACCAAATATTTTTGGCTTGATCTAGATTGAAGGCCCTTTTAAGTCAGTGGGAATCTTTCTCTGGATGTGGTTGGAAAAAAATTCTAGTTGGTTT,10,30,14,27,27,44,27,50,27,29,29,44,35,50,12.71,15.26142389
hek293t,12270,1,8,AGCTTTTAACCCATGAAAACAGTACTCTCAGGCTGAAAAAGAAAGAAAACAAGACCACTGTTTGTGAACTAATAAAAAAAATTCTAGTTGGTTTAACGC,AGCTTTTAACCCATGAAAACAGTACTCTCAAATCCGCGGGCTGAAAAAGAAAGAAAACAAGACCACTGTTTGTGAACTAATAAAAAAAATTCTAGTTGG,10,30,14,27,27,41,27,49,27,31,31,41,39,49,44.15,1.075307607
hek293t,12270,1,8,TGAGCTTAACCCATGAAAACAGTACTCTCAGGCTGAAAAAGAAAGAAAACAAGACCACTGTTTGTGAACTAATACACAAAAAAATTCTAGTTGGTTTAA,TGAGCTTAACCCATGAAAACAGTACTCTCAAATCCGCGGGCTGAAAAAGAAAGAAAACAAGACCACTGTTTGTGAACTAATACACAAAAAAATTCTAGT,10,30,14,27,27,38,27,46,27,31,31,38,39,46,44.15,2.937722101
hek293t,12272,1,8,AGCTATAAATCCTGGCTTTCAAAAGAACATGGATTGCCACTTTCCTGTATTTATTTACAGGATAGACGCTTTTGCCTTACAAGAAAAAAAATTCTAGTT,AGCTATAAATCCTGGCTTTCAAAAGAATCCGGCCACATGGATTGCCACTTTCCTGTATTTATTTACAGGATAGACGCTTTTGCCTTACAAGAAAAAAAA,10,30,14,27,27,31,27,39,27,28,28,31,36,39,40.54,0.0
hek293t,12272,1,8,ATACGTAAATCCTGGCTTTCAAAAGAACATGGATTGCCACTTTCCTGTATTTATTTACAGGATAGACGCTTTAAAAAAATTCTAGTTGGTTTAACGCGT,ATACGTAAATCCTGGCTTTCAAAAGAATCCGGCCACATGGATTGCCACTTTCCTGTATTTATTTACAGGATAGACGCTTTAAAAAAATTCTAGTTGGTT,10,30,14,27,27,43,27,51,27,28,28,43,36,51,40.54,0.350877193
hek293t,12274,1,4,GTGAAAAAAGAAGCAAGATTTGATATATCAGGGAATATTAGACCAGGCACAGAGGCATGAATCATTCCTTGGAAAAAAAATTCTAGTTGGTTTAACGCG,GTGAAAAAAGAAGCAAGATTTGATATATCAGGGAATGCCTATTAGACCAGGCACAGAGGCATGAATCATTCCTTGGAAAAAAAATTCTAGTTGGTTTAA,10,30,14,27,27,46,27,50,27,36,36,46,40,50,9.48,59.30876102
hek293t,12274,1,4,ACACCAAAAGAAGCAAGATTTGATATATCAGGGAATATTAGACCAGGCACAGAGGCATGAATCATTCCTTGGAATTAAAAAAATTCTAGTTGGTTTAAC,ACACCAAAAGAAGCAAGATTTGATATATCAGGGAATGCCTATTAGACCAGGCACAGAGGCATGAATCATTCCTTGGAATTAAAAAAATTCTAGTTGGTT,10,30,14,27,27,43,27,47,27,36,36,43,40,47,9.48,7.209055364
hek293t,12276,1,2,TGGCGTGACTTGAAAAAGATGACTGCTCCAGGCAACAGGGGATCTTATTTGGTAGGAAATGTTTCATGTATCCATATTCATGCCAAAAAAAAATTCTAG,TGGCGTGACTTGAAAAAGATGACTGCTCCAGCGGCAACAGGGGATCTTATTTGGTAGGAAATGTTTCATGTATCCATATTCATGCCAAAAAAAAATTCT,10,30,14,27,27,35,27,37,27,32,32,35,34,37,17.97,0.0
hek293t,12276,1,2,TTCGATGACTTGAAAAAGATGACTGCTCCAGGCAACAGGGGATCTTATTTGGTAGGAAATGTTTCATGTATCCATATTCATGAAAAAAATTCTAGTTGG,TTCGATGACTTGAAAAAGATGACTGCTCCAGCGGCAACAGGGGATCTTATTTGGTAGGAAATGTTTCATGTATCCATATTCATGAAAAAAATTCTAGTT,10,30,14,27,27,39,27,41,27,32,32,39,34,41,17.97,0.524730679
hek293t,12278,1,12,CCCCTCCCCTTCAGGAAACGACTAGAAAAAGGAGTGCATGAAAGTGGCAGGTTCAACACAAATGGTCCCCTGTCAAAAAAATTCTAGTTGGTTTAACGC,CCCCTCCCCTTCAGGAAACGACTAGAAAAATCCTCCACTCTAGGAGTGCATGAAAGTGGCAGGTTCAACACAAATGGTCCCCTGTCAAAAAAATTCTAG,10,30,14,27,27,37,27,49,27,30,30,37,42,49,37.65,0.0
hek293t,12278,1,12,CGTCACCCCTTCAGGAAACGACTAGAAAAAGGAGTGCATGAAAGTGGCAGGTTCAACACAAATGGTCCCCTAAAAAAATTCTAGTTGGTTTAACGCGTA,CGTCACCCCTTCAGGAAACGACTAGAAAAATCCTCCACTCTAGGAGTGCATGAAAGTGGCAGGTTCAACACAAATGGTCCCCTAAAAAAATTCTAGTTG,10,30,14,27,27,40,27,52,27,30,30,40,42,52,37.65,13.6139025
hek293t,12280,1,15,TCTGAGGTGCAGAAGAAAATCAAAGTGAAAGGTGATACGTGCTTACAACCATTTTGTGGATGTGCTGTGCAAAAAAAATTCTAGTTGGTTTAACGCGTA,TCTGAGGTGCAGAAGAAAATCAAAGTGGCAGAAAATAAGATGAAAGGTGATACGTGCTTACAACCATTTTGTGGATGTGCTGTGCAAAAAAAATTCTAG,10,30,14,27,27,37,27,52,27,27,27,37,42,52,36.06,0.010598834
hek293t,12280,1,15,GACCTGGTGCAGAAGAAAATCAAAGTGAAAGGTGATACGTGCTTACAACCATTTTGTGGATGTGCTAAAAAAATTCTAGTTGGTTTAACGCGTAACTAG,GACCTGGTGCAGAAGAAAATCAAAGTGGCAGAAAATAAGATGAAAGGTGATACGTGCTTACAACCATTTTGTGGATGTGCTAAAAAAATTCTAGTTGGT,10,30,14,27,27,42,27,57,27,27,27,42,42,57,36.06,0.0
hek293t,12284,1,4,ATTAGCCAGTTTTTGCTCCTGGTTGCTGATGGGTCCACTTAATTTTTCTTTTCAAGTCTGGTGTGGTAGCATGATCACAAAAAAATTCTAGTTGGTTTA,ATTAGCCAGTTTTTGCTCCTGGTTGCTGATGGGACGATCCACTTAATTTTTCTTTTCAAGTCTGGTGTGGTAGCATGATCACAAAAAAATTCTAGTTGG,10,30,14,27,27,41,27,45,27,34,34,41,38,45,13.28,6.282657598
hek293t,12286,1,11,CTTTATGGAAGAGTGGGAAAGCCTCAGTCAGGCAACCAAAGTGCTGGGAGTACCTGACATCTCAGAGCTGCTGAGTAAAAAAATTCTAGTTGGTTTAAC,CTTTATGGAAGAGTGGGAAAGCCTCAGTTTTACATTTACCAGGCAACCAAAGTGCTGGGAGTACCTGACATCTCAGAGCTGCTGAGTAAAAAAATTCTA,10,30,14,27,27,36,27,47,27,29,29,36,40,47,63.09,9.659258371
hek293t,12286,1,11,CTTAATGGAAGAGTGGGAAAGCCTCAGTCAGGCAACCAAAGTGCTGGGAGTACCTGACATCTCAGAGCTGCTGAAAAAAATTCTAGTTGGTTTAACGCG,CTTAATGGAAGAGTGGGAAAGCCTCAGTTTTACATTTACCAGGCAACCAAAGTGCTGGGAGTACCTGACATCTCAGAGCTGCTGAAAAAAATTCTAGTT,10,30,14,27,27,39,27,50,27,29,29,39,40,50,63.09,19.14561893
hek293t,19128,1,12,GTCGGCTGTACTCCAGTCTTCAGGACTAATGGCCTCTGAGGATGTGTTGGCATGCAAGGCTGCCAAAAAAATTCTAGTTGGTTTAACGCGTAACTAGAT,GTCGGCTGTACTCCAGTCTTCAGGACTAATGGCCTCTAATTATCACGCTGAGGATGTGTTGGCATGCAAGGCTGCCAAAAAAATTCTAGTTGGTTTAAC,10,30,14,27,27,47,27,59,27,37,37,47,49,59,30.41,4.138549909
hek293t,19128,1,12,CCTCACTGTACTCCAGTCTTCAGGACTAATGGCCTCTGAGGATGTGTTGGCATGCAAGGCTGCCTCTAAAAAAATTCTAGTTGGTTTAACGCGTAACTA,CCTCACTGTACTCCAGTCTTCAGGACTAATGGCCTCTAATTATCACGCTGAGGATGTGTTGGCATGCAAGGCTGCCTCTAAAAAAATTCTAGTTGGTTT,10,30,14,27,27,44,27,56,27,37,37,44,49,56,30.41,5.211197095
hek293t,12290,1,8,CTAGCAGGGACAAGAAAGGCAAATTTGAAAGGAAACTCAATTGGTAAGTGGGTGTGGGAGAGATCAGGAAATGTTTGAGGAAAAAAATTCTAGTTGGTT,CTAGCAGGGACAAGAAAGGCAAATTTGAATACGGGAAAGGAAACTCAATTGGTAAGTGGGTGTGGGAGAGATCAGGAAATGTTTGAGGAAAAAAATTCT,10,30,14,27,27,35,27,43,27,28,28,35,36,43,13.5,0.295362597
hek293t,12290,1,8,AGAAGAGGGACAAGAAAGGCAAATTTGAAAGGAAACTCAATTGGTAAGTGGGTGTGGGAGAGATCAGGAAATGTTTGAGGAAGAAAAAAAATTCTAGTT,AGAAGAGGGACAAGAAAGGCAAATTTGAATACGGGAAAGGAAACTCAATTGGTAAGTGGGTGTGGGAGAGATCAGGAAATGTTTGAGGAAGAAAAAAAA,10,30,14,27,27,31,27,39,27,28,28,31,36,39,13.5,0.303437289
hek293t,12292,1,3,ACTTGGCATTACTGGCTGTCCTTCACTGTTGGAGAGCCGGCAGCTTCACTCCCGAGTAGAGCTGCCTAAAAAAATTCTAGTTGGTTTAACGCGTAACTA,ACTTGGCATTACTGGCTGTCCTTCACTGTTGGAGAGCCCCCGGCAGCTTCACTCCCGAGTAGAGCTGCCTAAAAAAATTCTAGTTGGTTTAACGCGTAA,10,30,14,27,27,53,27,56,27,38,38,53,41,56,59.95,82.77541561
hek293t,12292,1,3,ACTTTGCATTACTGGCTGTCCTTCACTGTTGGAGAGCCGGCAGCTTCACTCCCGAGTAGAGCTGCCTGAGCCCCTAAAAAAATTCTAGTTGGTTTAACG,ACTTTGCATTACTGGCTGTCCTTCACTGTTGGAGAGCCCCCGGCAGCTTCACTCCCGAGTAGAGCTGCCTGAGCCCCTAAAAAAATTCTAGTTGGTTTA,10,30,14,27,27,45,27,48,27,38,38,45,41,48,59.95,82.29102073
hek293t,12294,1,2,TTCACTGGCTTTGAGGGAACGATGCAGAGAGGCAATGCTTTGAAACCAAAACTCAGAACAGATTTCTGTAAACTCTTGAAAAAAATTCTAGTTGGTTTA,TTCACTGGCTTTGAGGGAACGATGCAGAGAGAGGCAATGCTTTGAAACCAAAACTCAGAACAGATTTCTGTAAACTCTTGAAAAAAATTCTAGTTGGTT,10,30,14,27,27,43,27,45,27,28,28,43,30,45,70.04,68.17883207
hek293t,12294,1,2,TGTCATGGCTTTGAGGGAACGATGCAGAGAGGCAATGCTTTGAAACCAAAACTCAGAACAGATTTCTGTAAACTCTTGAAACTGGAAAAAAAATTCTAG,TGTCATGGCTTTGAGGGAACGATGCAGAGAGAGGCAATGCTTTGAAACCAAAACTCAGAACAGATTTCTGTAAACTCTTGAAACTGGAAAAAAAATTCT,10,30,14,27,27,35,27,37,27,28,28,35,30,37,70.04,11.90951131
hek293t,18021,1,8,CGACTGGCTTTAAAGACTCTCTGTAAGGTTGGAAGAAAGGGGTCCCCCCCCAGTATCAACCTTTTTCCTCCCTAACATAAAAAAATTCTAGTTGGTTTA,CGACTGGCTTTAAAGACTCTCTGTAAGGTTGCCTCTATGGAAGAAAGGGGTCCCCCCCCAGTATCAACCTTTTTCCTCCCTAACATAAAAAAATTCTAG,10,30,14,27,27,37,27,45,27,30,30,37,38,45,43.7,0.542406312
hek293t,18021,1,8,ATCTGGGCTTTAAAGACTCTCTGTAAGGTTGGAAGAAAGGGGTCCCCCCCCAGTATCAACCTTTTTCCTCCCTAACATCCCTAAAAAAATTCTAGTTGG,ATCTGGGCTTTAAAGACTCTCTGTAAGGTTGCCTCTATGGAAGAAAGGGGTCCCCCCCCAGTATCAACCTTTTTCCTCCCTAACATCCCTAAAAAAATT,10,30,14,27,27,33,27,41,27,30,30,33,38,41,43.7,0.0
hek293t,23636,1,3,CTCATTTGGCACAGCCAACTTTCTAAGCTAGGAAATTTCATGAACTGTTGGAACATATTAATATGCACATTTTTAAAAAAATTCTAGTTGGTTTAACGC,CTCATTTGGCACAGCCAACTTTCTAAGCTAGGAAATTTTCTCATGAACTGTTGGAACATATTAATATGCACATTTTTAAAAAAATTCTAGTTGGTTTAA,10,30,14,27,27,46,27,49,27,39,39,46,42,49,19.77,49.23994923
hek293t,23636,1,3,ATCCTTTGGCACAGCCAACTTTCTAAGCTAGGAAATTTCATGAACTGTTGGAACATATTAATATGCAAAAAAATTCTAGTTGGTTTAACGCGTAACTAG,ATCCTTTGGCACAGCCAACTTTCTAAGCTAGGAAATTTTCTCATGAACTGTTGGAACATATTAATATGCAAAAAAATTCTAGTTGGTTTAACGCGTAAC,10,30,14,27,27,54,27,57,27,39,39,54,42,57,19.77,32.8211285
hek293t,12300,1,6,GTACCAGTTCACAGCTCAGCGTGAATCTCTGGAAACAGGCAGCTTTTTAACCAGAGCACAGAGGCCTAGATTCTGAAAAAAATTCTAGTTGGTTTAACG,GTACCAGTTCACAGCTCAGCGTGAATACACCGCTCTGGAAACAGGCAGCTTTTTAACCAGAGCACAGAGGCCTAGATTCTGAAAAAAATTCTAGTTGGT,10,30,14,27,27,42,27,48,27,27,27,42,33,48,17.25,52.02817361
hek293t,12300,1,6,ATTATAGTTCACAGCTCAGCGTGAATCTCTGGAAACAGGCAGCTTTTTAACCAGAGCACAGAGGCCTAGATTCTGGGTGGAAAAAAATTCTAGTTGGTT,ATTATAGTTCACAGCTCAGCGTGAATACACCGCTCTGGAAACAGGCAGCTTTTTAACCAGAGCACAGAGGCCTAGATTCTGGGTGGAAAAAAATTCTAG,10,30,14,27,27,37,27,43,27,27,27,37,33,43,17.25,24.23240003
hek293t,12302,1,11,GAGGGTGAAGTTTGTTTTGGATCATTGGATGGAGAGAACAGCGAGAATCTATATAACTGCTCATGGGAAAAAAAATTCTAGTTGGTTTAACGCGTAACT,GAGGGTGAAGTTTGTTTTGGATCATTGGATGGAGAGCTCAACCCTTAAACAGCGAGAATCTATATAACTGCTCATGGGAAAAAAAATTCTAGTTGGTTT,10,30,14,27,27,44,27,55,27,37,37,44,48,55,38.82,0.0
hek293t,12303,1,1,CAACGTTTCTGTAGAATAGCCATGCTGTAAGGTCCACTTTTTGTCCTTAATCATATTTATCCAGGAGAAAGGAAATTCTGAGTTTAAAAAAATTCTAGT,CAACGTTTCTGTAGAATAGCCATGCTGTAAGGTCCCACTTTTTGTCCTTAATCATATTTATCCAGGAGAAAGGAAATTCTGAGTTTAAAAAAATTCTAG,10,30,14,27,27,37,27,38,27,34,34,37,35,38,44.08,3.047948212
hek293t,12305,1,11,CTGGTAAAAGCCCTATACATTCCACATCCAGGTTCAACTAAAGTCTGCTAATTCTGTTGCAGAGAGAAAAAAATTCTAGTTGGTTTAACGCGTAACTAG,CTGGTAAAAGCCCTATACATTCCACATCCAGATAATGCGATGGTTCAACTAAAGTCTGCTAATTCTGTTGCAGAGAGAAAAAAATTCTAGTTGGTTTAA,10,30,14,27,27,46,27,57,27,31,31,46,42,57,41.75,19.51607035
hek293t,12305,1,11,ACACCAAAAGCCCTATACATTCCACATCCAGGTTCAACTAAAGTCTGCTAATTCTGTTGCAGAGAGTAAAATAATAAAAAAAAAATTCTAGTTGGTTTA,ACACCAAAAGCCCTATACATTCCACATCCAGATAATGCGATGGTTCAACTAAAGTCTGCTAATTCTGTTGCAGAGAGTAAAATAATAAAAAAAAAATTC,10,30,14,27,27,34,27,45,27,31,31,34,42,45,41.75,1.551769164
hek293t,12307,1,2,GCGAAATCATTTTTGTAGGCATTTCAAGGAGGGAAGGGGGGAAACAGACAGCTGATTTTGCATCTCCTCTCTCAGTGCTGCTCTCCAAAAAAATTCTAG,GCGAAATCATTTTTGTAGGCATTTCAAGGAGCGGGAAGGGGGGAAACAGACAGCTGATTTTGCATCTCCTCTCTCAGTGCTGCTCTCCAAAAAAATTCT,10,30,14,27,27,35,27,37,27,32,32,35,34,37,32.7,4.90066795
hek293t,12307,1,2,GTTTAATCATTTTTGTAGGCATTTCAAGGAGGGAAGGGGGGAAACAGACAGCTGATTTTGCATCTCCTCTCTCAAAAAAAATTCTAGTTGGTTTAACGC,GTTTAATCATTTTTGTAGGCATTTCAAGGAGCGGGAAGGGGGGAAACAGACAGCTGATTTTGCATCTCCTCTCTCAAAAAAAATTCTAGTTGGTTTAAC,10,30,14,27,27,47,27,49,27,32,32,47,34,49,32.7,50.46090732
hek293t,12309,1,3,ATAACGTTCTGCAGATTTCCTTTGCTTTACGGTTTTGCAGTTTGAGGAAAGGATCCTGAATTTACAGTCTTAATTCACAAAGCAGAGATTAAAAAAATT,ATAACGTTCTGCAGATTTCCTTTGCTAGATTACGGTTTTGCAGTTTGAGGAAAGGATCCTGAATTTACAGTCTTAATTCACAAAGCAGAGATTAAAAAA,10,30,14,27,27,30,27,33,27,27,27,30,30,33,0.86,0.0
hek293t,12309,1,3,TGATCGTTCTGCAGATTTCCTTTGCTTTACGGTTTTGCAGTTTGAGGAAAGGATCCTGAATTTACAGTCTTAATTCACAAAAAAATTCTAGTTGGTTTA,TGATCGTTCTGCAGATTTCCTTTGCTAGATTACGGTTTTGCAGTTTGAGGAAAGGATCCTGAATTTACAGTCTTAATTCACAAAAAAATTCTAGTTGGT,10,30,14,27,27,42,27,45,27,27,27,42,30,45,0.86,47.35461684
hek293t,12311,1,1,GGGGACCCCCTTGTACAAGAAGCTATTTTTGGAAGGGTTCTCCGTTACTGTGGTTTAAGAGAAGCTTTGATAGCTTGTCTGAAAAAAAAAATTCTAGTT,GGGGACCCCCTTGTACAAGAAGCTATTTTTCGGAAGGGTTCTCCGTTACTGTGGTTTAAGAGAAGCTTTGATAGCTTGTCTGAAAAAAAAAATTCTAGT,10,30,14,27,27,38,27,39,27,31,31,38,32,39,11.24,13.75795666
hek293t,12311,1,1,CCATCCCCCCTTGTACAAGAAGCTATTTTTGGAAGGGTTCTCCGTTACTGTGGTTTAAGAGAAGCTTTGATAGCTTGTCTGAAAAAAATTCTAGTTGGT,CCATCCCCCCTTGTACAAGAAGCTATTTTTCGGAAGGGTTCTCCGTTACTGTGGTTTAAGAGAAGCTTTGATAGCTTGTCTGAAAAAAATTCTAGTTGG,10,30,14,27,27,41,27,42,27,31,31,41,32,42,11.24,23.38800646
hek293t,12313,1,6,ACTGTAAAGAGTCAGATATAAGAAGAGGGAGGGGGAACCCTCACAACTGTGGTGACATCTGAGCTTCATTTTTAAAAAAATTCTAGTTGGTTTAACGCG,ACTGTAAAGAGTCAGATATAAGAAGAGGGAGGGGGAACCCAACCATTCACAACTGTGGTGACATCTGAGCTTCATTTTTAAAAAAATTCTAGTTGGTTT,10,30,14,27,27,44,27,50,27,41,41,44,47,50,47.33,0.0
hek293t,12313,1,6,ACTATAAAGAGTCAGATATAAGAAGAGGGAGGGGGAACCCTCACAACTGTGGTGACATCTGAGCTTAAAAAAATTCTAGTTGGTTTAACGCGTAACTAG,ACTATAAAGAGTCAGATATAAGAAGAGGGAGGGGGAACCCAACCATTCACAACTGTGGTGACATCTGAGCTTAAAAAAATTCTAGTTGGTTTAACGCGT,10,30,14,27,27,51,27,57,27,41,41,51,47,57,47.33,0.11778563
hek293t,12315,1,12,ACGTCTTTCAAGACATCTCTCAAACCCCATGGGAATCACACAGGTAGACAATACTGTTAGTATCAGTTAAAAAAATTCTAGTTGGTTTAACGCGTAACT,ACGTCTTTCAAGACATCTCTCAAACCCCATGGTGCTCAATTCCCGAATCACACAGGTAGACAATACTGTTAGTATCAGTTAAAAAAATTCTAGTTGGTT,10,30,14,27,27,43,27,55,27,33,33,43,45,55,45.59,11.79865412
hek293t,12315,1,12,AGTCCTTTCAAGACATCTCTCAAACCCCATGGGAATCACACAGGTAGACAATACTGTTAGTATCAGTTAAACACTAAAAAAATTCTAGTTGGTTTAACG,AGTCCTTTCAAGACATCTCTCAAACCCCATGGTGCTCAATTCCCGAATCACACAGGTAGACAATACTGTTAGTATCAGTTAAACACTAAAAAAATTCTA,10,30,14,27,27,36,27,48,27,33,33,36,45,48,45.59,0.462405954
hek293t,12317,1,13,GCGACTGCAATTTCAATGAATTGTTTTAGTGGAGTGCTCTGAAACTCTTCAAAATCAAAGGGACCCAAAAAAATTCTAGTTGGTTTAACGCGTAACTAG,GCGACTGCAATTTCAATGAATTGTTTTAGTGGAGTGCCACGTCTTCTTGCTCTGAAACTCTTCAAAATCAAAGGGACCCAAAAAAATTCTAGTTGGTTT,10,30,14,27,27,44,27,57,27,37,37,44,50,57,3.96,0.0
hek293t,12319,1,5,CCGTCAATTTTTCAAGTAAAAGCAACAGCTGGACTGTTCCTGTAGCTTATGTAGTCCATTGTTTCCAGAAAAAAATTCTAGTTGGTTTAACGCGTAACT,CCGTCAATTTTTCAAGTAAAAGCAACAGCTGGACTGTTCCACGGCTGTAGCTTATGTAGTCCATTGTTTCCAGAAAAAAATTCTAGTTGGTTTAACGCG,10,30,14,27,27,50,27,55,27,40,40,50,45,55,9.87,0.0
hek293t,12321,1,11,AAGTCAGTGGCTTGGCATCTTTCTCAAAGAGGCCACACACTCATTCCACTCCTCTACAAATAGTGTCATGACAAAAAAATTCTAGTTGGTTTAACGCGT,AAGTCAGTGGCTTGGCATCTTTCTCAAAGAGGGGGCCCAGTGACCACACACTCATTCCACTCCTCTACAAATAGTGTCATGACAAAAAAATTCTAGTTG,10,30,14,27,27,40,27,51,27,33,33,40,44,51,37.05,5.728903564
hek293t,12321,1,11,GCCGGAGTGGCTTGGCATCTTTCTCAAAGAGGCCACACACTCATTCCACTCCTCTACAAATAGTGTCATGACCATCAAAAAAATTCTAGTTGGTTTAAC,GCCGGAGTGGCTTGGCATCTTTCTCAAAGAGGGGGCCCAGTGACCACACACTCATTCCACTCCTCTACAAATAGTGTCATGACCATCAAAAAAATTCTA,10,30,14,27,27,36,27,47,27,33,33,36,44,47,37.05,0.26380949
hek293t,12323,1,12,CGTTGGAAGTTTTTCAAGGAAGAACTTTTAGGGCATCAATAACAATTGGGAATCCATATACAGGAACAATAGACAAAAAAAAATTCTAGTTGGTTTAAC,CGTTGGAAGTTTTTCAAGGAAGAACTTAAACGAGGGTCATTAGGGCATCAATAACAATTGGGAATCCATATACAGGAACAATAGACAAAAAAAAATTCT,10,30,14,27,27,35,27,47,27,28,28,35,40,47,-2.64,0.0
hek293t,12323,1,12,TGGTAGAAGTTTTTCAAGGAAGAACTTTTAGGGCATCAATAACAATTGGGAATCCATATACAGGAACAAAAAAAATTCTAGTTGGTTTAACGCGTAACT,TGGTAGAAGTTTTTCAAGGAAGAACTTAAACGAGGGTCATTAGGGCATCAATAACAATTGGGAATCCATATACAGGAACAAAAAAAATTCTAGTTGGTT,10,30,14,27,27,43,27,55,27,28,28,43,40,55,-2.64,0.163467773
hek293t,12325,1,5,CGCAAGCTAGTGCCAGCGTGATGTAACTGTGGCTCAGAAATTTTCCACGGAGAAGTGGGGCTGTGACCGTGAGAAAAAAATTCTAGTTGGTTTAACGCG,CGCAAGCTAGTGCCAGCGTGATGTAACTGTGGCTCAGCGGATAAATTTTCCACGGAGAAGTGGGGCTGTGACCGTGAGAAAAAAATTCTAGTTGGTTTA,10,30,14,27,27,45,27,50,27,38,38,45,43,50,66.83,10.66407927
hek293t,12327,1,11,TTGGGACACTCGTGTGCAGAAGGCATTCCTGGAGAAATCAGTAACAAAGGATCTGTTGAAGCTCTTAAAGGCAAAAAAAAATTCTAGTTGGTTTAACGC,TTGGGACACTCGTGTGCAGAAGGCATTAGGGTCACCCACCTGGAGAAATCAGTAACAAAGGATCTGTTGAAGCTCTTAAAGGCAAAAAAAAATTCTAGT,10,30,14,27,27,38,27,49,27,28,28,38,39,49,22.73,7.279385105
hek293t,12327,1,11,CTCCTACACTCGTGTGCAGAAGGCATTCCTGGAGAAATCAGTAACAAAGGATCTGTTGAAGCTCTTAAAAAAAAAATTCTAGTTGGTTTAACGCGTAAC,CTCCTACACTCGTGTGCAGAAGGCATTAGGGTCACCCACCTGGAGAAATCAGTAACAAAGGATCTGTTGAAGCTCTTAAAAAAAAAATTCTAGTTGGTT,10,30,14,27,27,43,27,54,27,28,28,43,39,54,22.73,27.71850629
hek293t,12330,1,10,CCCTTTGTCAAGTATTAGCTAAGATTGAACGGAAATCTATAAAAGATGTCAACATCATTAGTAGTACAAAAAAAATTCTAGTTGGTTTAACGCGTAACT,CCCTTTGTCAAGTATTAGCTAAGATTGAACGGAAATCTAGATCGAGCTATAAAAGATGTCAACATCATTAGTAGTACAAAAAAAATTCTAGTTGGTTTA,10,30,14,27,27,45,27,55,27,38,38,45,48,55,31.42,0.0
hek293t,12330,1,10,AGTATTGTCAAGTATTAGCTAAGATTGAACGGAAATCTATAAAAGATGTCAACATCATTAGTAGTACAGTTTAAAAAAATTCTAGTTGGTTTAACGCGT,AGTATTGTCAAGTATTAGCTAAGATTGAACGGAAATCTAGATCGAGCTATAAAAGATGTCAACATCATTAGTAGTACAGTTTAAAAAAATTCTAGTTGG,10,30,14,27,27,41,27,51,27,38,38,41,48,51,31.42,0.0
hek293t,12332,1,10,TTCTCGTGTCAAGTACAAATACCTGGACATGGATTTCAGTTGAGTTTCTGAGCTTTAGCTTATTGCTAAAGATCTAAAAAAATTCTAGTTGGTTTAACG,TTCTCGTGTCAAGTACAAATACCTGGACATGGATGGTGTATAACTTCAGTTGAGTTTCTGAGCTTTAGCTTATTGCTAAAGATCTAAAAAAATTCTAGT,10,30,14,27,27,38,27,48,27,35,35,38,45,48,53.62,0.09718173
hek293t,12333,1,8,AGGTCCAGCTGTATTCAATAAGATACTGTTGGATTAAATCTTGGAAAAAAGTAACTAATGCCAAACCATCTATCAAAAAAATTCTAGTTGGTTTAACGC,AGGTCCAGCTGTATTCAATAAGATACTGTTGGATTAATAACGGCTATCTTGGAAAAAAGTAACTAATGCCAAACCATCTATCAAAAAAATTCTAGTTGG,10,30,14,27,27,41,27,49,27,38,38,41,46,49,43.08,0.0
hek293t,12333,1,8,TTCACCAGCTGTATTCAATAAGATACTGTTGGATTAAATCTTGGAAAAAAGTAACTAATGCCAAACCAAAAAAATTCTAGTTGGTTTAACGCGTAACTA,TTCACCAGCTGTATTCAATAAGATACTGTTGGATTAATAACGGCTATCTTGGAAAAAAGTAACTAATGCCAAACCAAAAAAATTCTAGTTGGTTTAACG,10,30,14,27,27,48,27,56,27,38,38,48,46,56,43.08,0.089365505
hek293t,12335,1,11,ACGCGTATTGACTGTTCTGTCCATCATTCAGGGAGATTATTAAGTACGTGTACTTCTGGCTCAACTAAAAAAATTCTAGTTGGTTTAACGCGTAACTAG,ACGCGTATTGACTGTTCTGTCCATCATTCAGGGAGATTCGTGTTGATGGATTAAGTACGTGTACTTCTGGCTCAACTAAAAAAATTCTAGTTGGTTTAA,10,30,14,27,27,46,27,57,27,39,39,46,50,57,12.24,0.053981107
hek293t,12336,1,10,ACTTGTAATTTCATATACAAATCAAAAGCAGGGAGCATGATATAGCTGTACTGACGGGAGTCTATGATCCTGAAAAAAATTCTAGTTGGTTTAACGCGT,ACTTGTAATTTCATATACAAATCAAAAGCAGGGAGCAATCAGTGAGCTGATATAGCTGTACTGACGGGAGTCTATGATCCTGAAAAAAATTCTAGTTGG,10,30,14,27,27,41,27,51,27,38,38,41,48,51,14.38,0.0
hek293t,12337,1,14,TCTATAGTCAAGGCTAGAAGTGTACAAGTTGGTAATGTTGTTGCGTAATAGCATTTTAGGATCCATGCTAAAAAAATTCTAGTTGGTTTAACGCGTAAC,TCTATAGTCAAGGCTAGAAGTGTACAAGTCCCTTTTACCCGGGTGGTAATGTTGTTGCGTAATAGCATTTTAGGATCCATGCTAAAAAAATTCTAGTTG,10,30,14,27,27,40,27,54,27,30,30,40,44,54,70.14,25.6205489
hek293t,12337,1,14,GTAGAAGTCAAGGCTAGAAGTGTACAAGTTGGTAATGTTGTTGCGTAATAGCATTTTAGGATCCATGCTTGGAAAAAAATTCTAGTTGGTTTAACGCGT,GTAGAAGTCAAGGCTAGAAGTGTACAAGTCCCTTTTACCCGGGTGGTAATGTTGTTGCGTAATAGCATTTTAGGATCCATGCTTGGAAAAAAATTCTAG,10,30,14,27,27,37,27,51,27,30,30,37,44,51,70.14,5.621916445
hek293t,12339,1,9,GGTTGATCCTTATAGCTGCCACAGTGGAGAGGCACATTTCCATTCAGACATATGCAGCCTCTCCAAGGCAAAAAAATTCTAGTTGGTTTAACGCGTAAC,GGTTGATCCTTATAGCTGCCACAGTGGAGAGGCACATTCGTGTCCATTCCATTCAGACATATGCAGCCTCTCCAAGGCAAAAAAATTCTAGTTGGTTTA,10,30,14,27,27,45,27,54,27,38,38,45,47,54,59.65,0.0
hek293t,12339,1,9,GCAAGATCCTTATAGCTGCCACAGTGGAGAGGCACATTTCCATTCAGACATATGCAGCCTCTCCAAGGCCATAAAAAAAATTCTAGTTGGTTTAACGCG,GCAAGATCCTTATAGCTGCCACAGTGGAGAGGCACATTCGTGTCCATTCCATTCAGACATATGCAGCCTCTCCAAGGCCATAAAAAAAATTCTAGTTGG,10,30,14,27,27,41,27,50,27,38,38,41,47,50,59.65,35.26693627
hek293t,12341,1,5,TCGGCTGCCCAATTCATGGTGAAACCAGTTGGAAGTGAGGGAAGCCAACCTCAGCGGCCTGATCTAACTTTGAAATAAAAAAATTCTAGTTGGTTTAAC,TCGGCTGCCCAATTCATGGTGAAACCCGGGTAGTTGGAAGTGAGGGAAGCCAACCTCAGCGGCCTGATCTAACTTTGAAATAAAAAAATTCTAGTTGGT,10,30,14,27,27,42,27,47,27,27,27,42,32,47,27.81,47.60378851
hek293t,12341,1,5,ATACTTGCCCAATTCATGGTGAAACCAGTTGGAAGTGAGGGAAGCCAACCTCAGCGGCCTGATCTAACTTTGAAATTAGCAAAAAAAATTCTAGTTGGT,ATACTTGCCCAATTCATGGTGAAACCCGGGTAGTTGGAAGTGAGGGAAGCCAACCTCAGCGGCCTGATCTAACTTTGAAATTAGCAAAAAAAATTCTAG,10,30,14,27,27,37,27,42,27,27,27,37,32,42,27.81,75.71476601
hek293t,12343,1,9,CACGACTCTGCTAAAGAGAACCTCAGTCTTGGGCCACAAAGCTCTACCTAATCTCCCATACGGACGGGTACAAAAAAATTCTAGTTGGTTTAACGCGTA,CACGACTCTGCTAAAGAGAACCTCAGTCTTGGGATACAAATGCCACAAAGCTCTACCTAATCTCCCATACGGACGGGTACAAAAAAATTCTAGTTGGTT,10,30,14,27,27,43,27,52,27,33,33,43,42,52,57.61,15.42610819
hek293t,12343,1,9,GAAGCCTCTGCTAAAGAGAACCTCAGTCTTGGGCCACAAAGCTCTACCTAATCTCCCATACGGACGAAAAAAATTCTAGTTGGTTTAACGCGTAACTAG,GAAGCCTCTGCTAAAGAGAACCTCAGTCTTGGGATACAAATGCCACAAAGCTCTACCTAATCTCCCATACGGACGAAAAAAATTCTAGTTGGTTTAACG,10,30,14,27,27,48,27,57,27,33,33,48,42,57,57.61,28.80565484
hek293t,12345,1,3,TTACGCTGTCCCTGAAGCAGGGAGACCTCTGGGAGGGCTGATTGCCTTACAGCTGCAAGCTGGGCCATCTGGGCTGTGGCATGGAAAAAAATTCTAGTT,TTACGCTGTCCCTGAAGCAGGGAGACCTCTGGCCCGAGGGCTGATTGCCTTACAGCTGCAAGCTGGGCCATCTGGGCTGTGGCATGGAAAAAAATTCTA,10,30,14,27,27,36,27,39,27,33,33,36,36,39,37.56,14.9950419
hek293t,12345,1,3,CGCTGCTGTCCCTGAAGCAGGGAGACCTCTGGGAGGGCTGATTGCCTTACAGCTGCAAGCTGGGCCATCTGGGCTGTAAAAAAATTCTAGTTGGTTTAA,CGCTGCTGTCCCTGAAGCAGGGAGACCTCTGGCCCGAGGGCTGATTGCCTTACAGCTGCAAGCTGGGCCATCTGGGCTGTAAAAAAATTCTAGTTGGTT,10,30,14,27,27,43,27,46,27,33,33,43,36,46,37.56,82.44436273
hek293t,12347,1,12,TTCTGCCTTTGGAATGGAGAAATTTTCGATGGAGTTCATGTTGGATCTCTGGAGAACGACACTGAAATCATGTTTAAAAAAATTCTAGTTGGTTTAACG,TTCTGCCTTTGGAATGGAGAAATTTTCGATGGATTGAGGTGAATAGTTCATGTTGGATCTCTGGAGAACGACACTGAAATCATGTTTAAAAAAATTCTA,10,30,14,27,27,36,27,48,27,33,33,36,45,48,34.56,0.0
hek293t,12348,1,7,ATTGATTGCAGAATTTTCATCTGATTTGTTGGCTTATAATTGCAGCTGCCTGTGGCTGCTAATGAAAAAAATTCTAGTTGGTTTAACGCGTAACTAGAT,ATTGATTGCAGAATTTTCATCTGATTTGTTGGCTTACTCAAACTAATTGCAGCTGCCTGTGGCTGCTAATGAAAAAAATTCTAGTTGGTTTAACGCGTA,10,30,14,27,27,52,27,59,27,37,37,52,44,59,2.76,16.53871443
hek293t,12348,1,7,CGCATTTGCAGAATTTTCATCTGATTTGTTGGCTTATAATTGCAGCTGCCTGTGGCTGCTAATGGCTGTATTGAACAAAAAAATTCTAGTTGGTTTAAC,CGCATTTGCAGAATTTTCATCTGATTTGTTGGCTTACTCAAACTAATTGCAGCTGCCTGTGGCTGCTAATGGCTGTATTGAACAAAAAAATTCTAGTTG,10,30,14,27,27,40,27,47,27,37,37,40,44,47,2.76,0.0
hek293t,12350,1,8,TTTGTGAACTCGTAAACTAAATGTGCATTTGGGAATGGCTGTCAGACTAAATTCATCTGTGTAACATGATAAAAAAATTCTAGTTGGTTTAACGCGTAA,TTTGTGAACTCGTAAACTAAATGTGCATTTGGGAATGCAGGGCCTGCTGTCAGACTAAATTCATCTGTGTAACATGATAAAAAAATTCTAGTTGGTTTA,10,30,14,27,27,45,27,53,27,38,38,45,46,53,2.92,10.41778562
hek293t,12350,1,8,AGAGCGAACTCGTAAACTAAATGTGCATTTGGGAATGGCTGTCAGACTAAATTCATCTGTGTAACATGATTCTTAAAAAAATTCTAGTTGGTTTAACGC,AGAGCGAACTCGTAAACTAAATGTGCATTTGGGAATGCAGGGCCTGCTGTCAGACTAAATTCATCTGTGTAACATGATTCTTAAAAAAATTCTAGTTGG,10,30,14,27,27,41,27,49,27,38,38,41,46,49,2.92,0.0
hek293t,12352,1,11,ACGGCGGGAGGCTGCATAGAAAGAAGTGGTGGCACAAAAAGTAGTTAAGAAGAACAAGGCTAAGGAAAGGGAAAAAAATTCTAGTTGGTTTAACGCGTA,ACGGCGGGAGGCTGCATAGAAAGAAGTGGTGGCACAAATGGGCTCGCAAAAGTAGTTAAGAAGAACAAGGCTAAGGAAAGGGAAAAAAATTCTAGTTGG,10,30,14,27,27,41,27,52,27,38,38,41,49,52,58.62,0.0
hek293t,10443,1,12,CCGCCAAAGGCAGTGTGATTTAGCTTACGAGGAGAAAGGTCTAGTTTGGATATGGTATAATTGCATGGCAGGCTGCTAAAAAAATTCTAGTTGGTTTAA,CCGCCAAAGGCAGTGTGATTTAGCTTACGACTCTCTAAAAACGGAGAAAGGTCTAGTTTGGATATGGTATAATTGCATGGCAGGCTGCTAAAAAAATTC,10,30,14,27,27,34,27,46,27,31,31,34,43,46,52.21,0.0
hek293t,10443,1,12,TGTGCAAAGGCAGTGTGATTTAGCTTACGAGGAGAAAGGTCTAGTTTGGATATGGTATAATTGCAAAAAAAATTCTAGTTGGTTTAACGCGTAACTAGA,TGTGCAAAGGCAGTGTGATTTAGCTTACGACTCTCTAAAAACGGAGAAAGGTCTAGTTTGGATATGGTATAATTGCAAAAAAAATTCTAGTTGGTTTAA,10,30,14,27,27,46,27,58,27,31,31,46,43,58,52.21,8.829797679
hek293t,12355,1,11,CGTAACTCTGTTGGGCAAAGGCTTGCACCAGGCCTTGTTTCTGTGGCACCCTGGGGCTGCAGGCAAAAAAAATTCTAGTTGGTTTAACGCGTAACTAGA,CGTAACTCTGTTGGGCAAAGGCTTGCACCAGGCCTTGTTGGCTATATCAGTCTGTGGCACCCTGGGGCTGCAGGCAAAAAAAATTCTAGTTGGTTTAAC,10,30,14,27,27,47,27,58,27,40,40,47,51,58,57.07,2.37580854
hek293t,12356,1,15,GAAGCTTGTTCTTGCTTTTGTAGAGCACGGGGGTTTGTTCTGGGTAGAAGTCAAAGATCTGCTTCAAAAAAATTCTAGTTGGTTTAACGCGTAACTAGA,GAAGCTTGTTCTTGCTTTTGTAGAGCACGGGGGTTTGTTCCGGCAAGAGTACACCTGGGTAGAAGTCAAAGATCTGCTTCAAAAAAATTCTAGTTGGTT,10,30,14,27,27,43,27,58,27,40,40,43,55,58,36.38,0.0
hek293t,12357,1,14,GACTCTGGAATTGAAGCCAGCATCTAGTTAGGAGGGGTTAGGAAAAGACTCCCGTGGACCAGTGACAAAAAAATTCTAGTTGGTTTAACGCGTAACTAG,GACTCTGGAATTGAAGCCAGCATCTAGTTAGGAGGATGAAGTTGGATTTGGTTAGGAAAAGACTCCCGTGGACCAGTGACAAAAAAATTCTAGTTGGTT,10,30,14,27,27,43,27,57,27,36,36,43,50,57,43.1,0.502023165
hek293t,1669,1,13,TGACGTTAATGGCATTTATATATATATTTTGGGGAAGAAGAGCACTTACAATTTGCATCTCAGAGTACACCCAAAAAAAATTCTAGTTGGTTTAACGCG,TGACGTTAATGGCATTTATATATATATTTTGGGTAAGCTACGATACGAAGAAGAGCACTTACAATTTGCATCTCAGAGTACACCCAAAAAAAATTCTAG,10,30,14,27,27,37,27,50,27,34,34,37,47,50,-1.97,0.0
hek293t,12359,1,5,TCATATCTAGAACGAAAGGACTGAACGAAAGGGCTCTGGTCAATTCCAAGCACAGTCCCCGGTAACACACTGGCATAGCTTTACTAAAAAAATTCTAGT,TCATATCTAGAACGAAAGGACTGAACGAAGGTATAGGGCTCTGGTCAATTCCAAGCACAGTCCCCGGTAACACACTGGCATAGCTTTACTAAAAAAATT,10,30,14,27,27,33,27,38,27,30,30,33,35,38,29.57,1.286838847
hek293t,12359,1,5,TTAACTCTAGAACGAAAGGACTGAACGAAAGGGCTCTGGTCAATTCCAAGCACAGTCCCCGGTAACACACTGGAAAAAAATTCTAGTTGGTTTAACGCG,TTAACTCTAGAACGAAAGGACTGAACGAAGGTATAGGGCTCTGGTCAATTCCAAGCACAGTCCCCGGTAACACACTGGAAAAAAATTCTAGTTGGTTTA,10,30,14,27,27,45,27,50,27,30,30,45,35,50,29.57,13.22763958
hek293t,12361,1,6,AGTACCCCCCCCAGATTATACAGTGTAGTTGGTTATTACGAATTCTTATCAGATTTATCATGCAACCAAAAAAATTCTAGTTGGTTTAACGCGTAACTA,AGTACCCCCCCCAGATTATACAGTGTAGTTGGTTCTAAAGATTACGAATTCTTATCAGATTTATCATGCAACCAAAAAAATTCTAGTTGGTTTAACGCG,10,30,14,27,27,50,27,56,27,35,35,50,41,56,18.91,7.304104385
hek293t,12361,1,6,GAATGCCCCCCCAGATTATACAGTGTAGTTGGTTATTACGAATTCTTATCAGATTTATCATGCAACCTCTATTTTATGGAAAAAAATTCTAGTTGGTTT,GAATGCCCCCCCAGATTATACAGTGTAGTTGGTTCTAAAGATTACGAATTCTTATCAGATTTATCATGCAACCTCTATTTTATGGAAAAAAATTCTAGT,10,30,14,27,27,38,27,44,27,35,35,38,41,44,18.91,0.0
hek293t,12363,1,14,ACCAATAAATAAGCAGGCTGTTATCTTTCCGGATGACAGCTTAAATGGCCTAAGGGTCTACTACAGTATTTGCCCAAAAAAATTCTAGTTGGTTTAACG,ACCAATAAATAAGCAGGCTGTTATCTTTCCGAGTTGCCCACTGTGGATGACAGCTTAAATGGCCTAAGGGTCTACTACAGTATTTGCCCAAAAAAATTC,10,30,14,27,27,34,27,48,27,31,31,34,45,48,14.66,0.0
hek293t,12364,1,2,CCGGCACTTTACCCCTCAACTGTACTTTCTGGAAAATACCAGTGAGACACATTTGGAATGCTTTGGTTTGACCTTATCTAAAAAAATTCTAGTTGGTTT,CCGGCACTTTACCCCTCAACTGTACTTTCTGTTGAAAATACCAGTGAGACACATTTGGAATGCTTTGGTTTGACCTTATCTAAAAAAATTCTAGTTGGT,10,30,14,27,27,42,27,44,27,32,32,42,34,44,8.59,72.19753027
hek293t,12364,1,2,CCGGCACTTTACCCCTCAACTGTACTTTCTGGAAAATACCAGTGAGACACATTTGGAATGCTTTGGTTTGACCTTATCTGGCACGGAAAAAAATTCTAG,CCGGCACTTTACCCCTCAACTGTACTTTCTGTTGAAAATACCAGTGAGACACATTTGGAATGCTTTGGTTTGACCTTATCTGGCACGGAAAAAAATTCT,10,30,14,27,27,35,27,37,27,32,32,35,34,37,8.59,0.535113035
hek293t,12366,1,8,ATCCAAACTATAATGCTGTATACAGCACTCGGTGATATGTTATGGTTTAATGAAAAAGCTGTGTTACAGTTGTTAAAAAAATTCTAGTTGGTTTAACGC,ATCCAAACTATAATGCTGTATACAGCACTCGGTTTCTGGACGATATGTTATGGTTTAATGAAAAAGCTGTGTTACAGTTGTTAAAAAAATTCTAGTTGG,10,30,14,27,27,41,27,49,27,34,34,41,42,49,54.77,2.808365528
hek293t,12366,1,8,TATCCAACTATAATGCTGTATACAGCACTCGGTGATATGTTATGGTTTAATGAAAAAGCTGTGTTACAGTTAAAAAAATTCTAGTTGGTTTAACGCGTA,TATCCAACTATAATGCTGTATACAGCACTCGGTTTCTGGACGATATGTTATGGTTTAATGAAAAAGCTGTGTTACAGTTAAAAAAATTCTAGTTGGTTT,10,30,14,27,27,44,27,52,27,34,34,44,42,52,54.77,15.27241349
hek293t,12368,1,4,TTTCCAGTGCTGGAAGCTTTGTGAAGGTTAGGAAGTCTCCCTGACCTCCCTTATCCCTCACGCTAATTAATTTCAATGGGAGAAAAAAATTCTAGTTGG,TTTCCAGTGCTGGAAGCTTTGTGAAGGTTCACCAGGAAGTCTCCCTGACCTCCCTTATCCCTCACGCTAATTAATTTCAATGGGAGAAAAAAATTCTAG,10,30,14,27,27,37,27,41,27,30,30,37,34,41,45.84,25.35422204
hek293t,12368,1,4,TAACCAGTGCTGGAAGCTTTGTGAAGGTTAGGAAGTCTCCCTGACCTCCCTTATCCCTCACGCTAATTAATTTCAATGGAAAAAAATTCTAGTTGGTTT,TAACCAGTGCTGGAAGCTTTGTGAAGGTTCACCAGGAAGTCTCCCTGACCTCCCTTATCCCTCACGCTAATTAATTTCAATGGAAAAAAATTCTAGTTG,10,30,14,27,27,40,27,44,27,30,30,40,34,44,45.84,59.80201501
hek293t,12370,1,8,GGAAGTAGCTTTATAATTGCTCGTGCTTGGGGCAAGGACTGTCGTGGTAGTACAGCACTCGTGGGTACTGCTACAGAGAAAAAAATTCTAGTTGGTTTA,GGAAGTAGCTTTATAATTGCTCGTGCATGTGGTTTTGGGGCAAGGACTGTCGTGGTAGTACAGCACTCGTGGGTACTGCTACAGAGAAAAAAATTCTAG,10,30,14,27,27,37,27,45,27,27,27,37,35,45,12.97,15.41330651
hek293t,12370,1,8,AAAGCTAGCTTTATAATTGCTCGTGCTTGGGGCAAGGACTGTCGTGGTAGTACAGCACTCGTGGGTACTGCTACAGAGCAAATAAAAAAAAATTCTAGT,AAAGCTAGCTTTATAATTGCTCGTGCATGTGGTTTTGGGGCAAGGACTGTCGTGGTAGTACAGCACTCGTGGGTACTGCTACAGAGCAAATAAAAAAAA,10,30,14,27,27,30,27,38,27,27,27,30,35,38,12.97,0.0
hek293t,12372,1,10,TTGGTGTGTAATGTTCCACTGGATGGTATAGGTGAACCTATTACTCTGCACTGTAGCCATGTCACTGATTGATAAAAAAATTCTAGTTGGTTTAACGCG,TTGGTGTGTAATGTTCCACTGGATGGTATAAGAGTTCTAAGGTGAACCTATTACTCTGCACTGTAGCCATGTCACTGATTGATAAAAAAATTCTAGTTG,10,30,14,27,27,40,27,50,27,30,30,40,40,50,39.89,9.653834417
hek293t,12372,1,10,CGTCTGTGTAATGTTCCACTGGATGGTATAGGTGAACCTATTACTCTGCACTGTAGCCATGTCACTGAAAAAAAATTCTAGTTGGTTTAACGCGTAACT,CGTCTGTGTAATGTTCCACTGGATGGTATAAGAGTTCTAAGGTGAACCTATTACTCTGCACTGTAGCCATGTCACTGAAAAAAAATTCTAGTTGGTTTA,10,30,14,27,27,45,27,55,27,30,30,45,40,55,39.89,21.42819916
hek293t,12374,1,15,CTAGCCCTGAGATGATGGACAGTGAGGTAAGGCTCCCACTGATTTTCCACTGGGACCCAAGTTCTACAAAAAAATTCTAGTTGGTTTAACGCGTAACTA,CTAGCCCTGAGATGATGGACAGTGAGGTAAGGCTCCCCAAGGGACATGTGTGACTGATTTTCCACTGGGACCCAAGTTCTACAAAAAAATTCTAGTTGG,10,30,14,27,27,41,27,56,27,38,38,41,53,56,58.96,0.759323337
hek293t,12375,1,6,AGGAAGAAGCAGTTAACTGTAGAAATGAAAGGTCACCTGTGGTTTAGGGAGGCTATTCAACGTGGAGGCCTGCTTAAAAAAATTCTAGTTGGTTTAACG,AGGAAGAAGCAGTTAACTGTAGAAATGGGCGAGAAAGGTCACCTGTGGTTTAGGGAGGCTATTCAACGTGGAGGCCTGCTTAAAAAAATTCTAGTTGGT,10,30,14,27,27,42,27,48,27,27,27,42,33,48,43.32,16.02161864
hek293t,12375,1,6,TGGTAGAAGCAGTTAACTGTAGAAATGAAAGGTCACCTGTGGTTTAGGGAGGCTATTCAACGTGGAGGCCTGCTTAATTCACTAAAAAAATTCTAGTTG,TGGTAGAAGCAGTTAACTGTAGAAATGGGCGAGAAAGGTCACCTGTGGTTTAGGGAGGCTATTCAACGTGGAGGCCTGCTTAATTCACTAAAAAAATTC,10,30,14,27,27,34,27,40,27,27,27,34,33,40,43.32,2.924739899
hek293t,12377,1,14,ATAGAGAGCACAGCATGGCACTTTCCTGGAGGACCTGAAAATAGATCAATTTGAGACACATAAGGAAGCAATATAAAAAAATTCTAGTTGGTTTAACGC,ATAGAGAGCACAGCATGGCACTTTCCTGGAGCAGAGCAGAATCTAGACCTGAAAATAGATCAATTTGAGACACATAAGGAAGCAATATAAAAAAATTCT,10,30,14,27,27,35,27,49,27,32,32,35,46,49,61.22,3.791498703
hek293t,12378,1,11,TCACATTTATAATGCCAGTGAGTTTAGAAAGGAACTGCTGTCTGGAAAAATCAGAATAACTCTAATGCACCATCAAAAAAATTCTAGTTGGTTTAACGC,TCACATTTATAATGCCAGTGAGTTTAGTCGCGCTGGTTAAAGGAACTGCTGTCTGGAAAAATCAGAATAACTCTAATGCACCATCAAAAAAATTCTAGT,10,30,14,27,27,38,27,49,27,28,28,38,39,49,35.75,3.27288231
hek293t,12378,1,11,CGCTCTTTATAATGCCAGTGAGTTTAGAAAGGAACTGCTGTCTGGAAAAATCAGAATAACTCTAATGCACCATCCTAACACAAAAAAATTCTAGTTGGT,CGCTCTTTATAATGCCAGTGAGTTTAGTCGCGCTGGTTAAAGGAACTGCTGTCTGGAAAAATCAGAATAACTCTAATGCACCATCCTAACACAAAAAAA,10,30,14,27,27,31,27,42,27,28,28,31,39,42,35.75,0.0
hek293t,12380,1,10,ACACATGACTTCGCCAAATACTCGGTCTTTGGACTTGTTCATGTGGCTCAGCAGAGTACCTCTTTCGGAAGAGATAAAAAAATTCTAGTTGGTTTAACG,ACACATGACTTCGCCAAATACTCGGTCTTTGGACGGCGGTCAAATTGTTCATGTGGCTCAGCAGAGTACCTCTTTCGGAAGAGATAAAAAAATTCTAGT,10,30,14,27,27,38,27,48,27,35,35,38,45,48,22.42,0.279329609
hek293t,778,1,14,AGCCGACAGCCTCTATTACATTGACTTTCTGGAAGCAGGCATTGGCCTTGTAAGATGTGAGAAGTCATAGTAAAAAAATTCTAGTTGGTTTAACGCGTA,AGCCGACAGCCTCTATTACATTGACTTTCTACGCCCAATGAGCGGGAAGCAGGCATTGGCCTTGTAAGATGTGAGAAGTCATAGTAAAAAAATTCTAGT,10,30,14,27,27,38,27,52,27,31,31,38,45,52,2.96,4.041997116
hek293t,12382,1,4,GGGCTACGTAAGATTTTTCAGAGCATTTTTGGCATTGAGTTAGGAGCATATATGGAGTTAACTCTGAATATATGAAAAAAAAATTCTAGTTGGTTTAAC,GGGCTACGTAAGATTTTTCAGAGCATTTTTGGCATTGAGAATATTAGGAGCATATATGGAGTTAACTCTGAATATATGAAAAAAAAATTCTAGTTGGTT,10,30,14,27,27,43,27,47,27,40,40,43,44,47,0.05,0.131752306
hek293t,12382,1,4,ACCGAACGTAAGATTTTTCAGAGCATTTTTGGCATTGAGTTAGGAGCATATATGGAGTTAACTCTGAATAAAAAAATTCTAGTTGGTTTAACGCGTAAC,ACCGAACGTAAGATTTTTCAGAGCATTTTTGGCATTGAGAATATTAGGAGCATATATGGAGTTAACTCTGAATAAAAAAATTCTAGTTGGTTTAACGCG,10,30,14,27,27,50,27,54,27,40,40,50,44,54,0.05,22.14852116
hek293t,12384,1,2,GGCGCGATGTTATGCAAAAACACTAATCAAGGATGAAATTGCAAGGATTAATGCTTCTTCAGTGTTTTTGAAAAAAAATTCTAGTTGGTTTAACGCGTA,GGCGCGATGTTATGCAAAAACACTAATCAAGGATGGGAAATTGCAAGGATTAATGCTTCTTCAGTGTTTTTGAAAAAAAATTCTAGTTGGTTTAACGCG,10,30,14,27,27,50,27,52,27,35,35,50,37,52,53.93,0.215405682
hek293t,12384,1,2,ACCGAGATGTTATGCAAAAACACTAATCAAGGATGAAATTGCAAGGATTAATGCTTCTTCAGTGTTTTTGAAACTATATAAAAAAATTCTAGTTGGTTT,ACCGAGATGTTATGCAAAAACACTAATCAAGGATGGGAAATTGCAAGGATTAATGCTTCTTCAGTGTTTTTGAAACTATATAAAAAAATTCTAGTTGGT,10,30,14,27,27,42,27,44,27,35,35,42,37,44,53.93,0.0
hek293t,12386,1,9,ATCCTAAGGGCACATTAAGGAGATTGTTGTGGCCCCCCCTGTTTTCATATATGCTTACAGACAAAGTAGTGATGCATGCAAAAAAAAATTCTAGTTGGT,ATCCTAAGGGCACATTAAGGAGATTGTTGTTCAGCTTGTGGCCCCCCCTGTTTTCATATATGCTTACAGACAAAGTAGTGATGCATGCAAAAAAAAATT,10,30,14,27,27,33,27,42,27,30,30,33,39,42,53.58,0.307390742
hek293t,12386,1,9,GGTATAAGGGCACATTAAGGAGATTGTTGTGGCCCCCCCTGTTTTCATATATGCTTACAGACAAAGTAGAAAAAAATTCTAGTTGGTTTAACGCGTAAC,GGTATAAGGGCACATTAAGGAGATTGTTGTTCAGCTTGTGGCCCCCCCTGTTTTCATATATGCTTACAGACAAAGTAGAAAAAAATTCTAGTTGGTTTA,10,30,14,27,27,45,27,54,27,30,30,45,39,54,53.58,6.123841085
hek293t,18257,1,6,TATTGATAACCTGAACATAAAACAGACTATGGTTCAGAGTAATAGCACTTGCACTCTTTGTACCGACAGAAAAAAAAATTCTAGTTGGTTTAACGCGTA,TATTGATAACCTGAACATAAAACAGACTATGGTTCAGAGCACCTGTAATAGCACTTGCACTCTTTGTACCGACAGAAAAAAAAATTCTAGTTGGTTTAA,10,30,14,27,27,46,27,52,27,39,39,46,45,52,41.09,0.0
hek293t,12389,1,3,AGTGCAAAAATAAGTAACTTGTGCTTACTAGGCAAGCCAATTCAGACCTCCTATGAGTTAGTCACAAAAAAATTCTAGTTGGTTTAACGCGTAACTAGA,AGTGCAAAAATAAGTAACTTGTGCTTACTAGGCAAGCCATGCATTCAGACCTCCTATGAGTTAGTCACAAAAAAATTCTAGTTGGTTTAACGCGTAACT,10,30,14,27,27,55,27,58,27,40,40,55,43,58,15.0,80.42659745
hek293t,12389,1,3,ACCGGAAAAATAAGTAACTTGTGCTTACTAGGCAAGCCAATTCAGACCTCCTATGAGTTAGTCACGGGGCGTTAAAAAAATTCTAGTTGGTTTAACGCG,ACCGGAAAAATAAGTAACTTGTGCTTACTAGGCAAGCCATGCATTCAGACCTCCTATGAGTTAGTCACGGGGCGTTAAAAAAATTCTAGTTGGTTTAAC,10,30,14,27,27,47,27,50,27,40,40,47,43,50,15.0,67.63812139
hek293t,12391,1,8,GACATTAAGCCCCCCCCCACACAGAGATCTGGATAAAGATAGGATCATACTCTTTTCCACTTCACTTCCACCAGTCAGCAAAAAAAAATTCTAGTTGGT,GACATTAAGCCCCCCCCCACACAGAGATCTCGCAGAGTGGATAAAGATAGGATCATACTCTTTTCCACTTCACTTCCACCAGTCAGCAAAAAAAAATTC,10,30,14,27,27,34,27,42,27,31,31,34,39,42,27.84,0.0
hek293t,12393,1,9,GCTAAGTAGCTCTGAAACTATTCTAGTATTGGCCTGTATGATATGGATCATTATTTGCTTAGTTTGCAAAGTAAAAAAATTCTAGTTGGTTTAACGCGT,GCTAAGTAGCTCTGAAACTATTCTAGTATTGGCCTTGGAAAGGTGTATGATATGGATCATTATTTGCTTAGTTTGCAAAGTAAAAAAATTCTAGTTGGT,10,30,14,27,27,42,27,51,27,35,35,42,44,51,5.3,0.091701055
hek293t,12393,1,9,GTTCGGTAGCTCTGAAACTATTCTAGTATTGGCCTGTATGATATGGATCATTATTTGCTTAGTTTGCAAAGTCATTAAAAAAATTCTAGTTGGTTTAAC,GTTCGGTAGCTCTGAAACTATTCTAGTATTGGCCTTGGAAAGGTGTATGATATGGATCATTATTTGCTTAGTTTGCAAAGTCATTAAAAAAATTCTAGT,10,30,14,27,27,38,27,47,27,35,35,38,44,47,5.3,0.0
hek293t,12395,1,15,CGCGACCACGTTTCAGCAGCCTTCAGGCAAGGAGCAGTCAGCTGGGCAAGCCAACAGCTGAGTTAAAAAAAATTCTAGTTGGTTTAACGCGTAACTAGA,CGCGACCACGTTTCAGCAGCCTTCAGGAGAAGCCATTGTCGACAAGGAGCAGTCAGCTGGGCAAGCCAACAGCTGAGTTAAAAAAAATTCTAGTTGGTT,10,30,14,27,27,43,27,58,27,28,28,43,43,58,47.73,36.20450629
hek293t,12395,1,15,TGAAACCACGTTTCAGCAGCCTTCAGGCAAGGAGCAGTCAGCTGGGCAAGCCAACAGCTGAGTTAAAGCTAAAAAAATTCTAGTTGGTTTAACGCGTAA,TGAAACCACGTTTCAGCAGCCTTCAGGAGAAGCCATTGTCGACAAGGAGCAGTCAGCTGGGCAAGCCAACAGCTGAGTTAAAGCTAAAAAAATTCTAGT,10,30,14,27,27,38,27,53,27,28,28,38,43,53,47.73,14.46589659
hek293t,12397,1,2,GTAAGATATGTTATTCTGTGTAACCTTTGGGGGCAGGACAGTAAGATGCCTTACCAACACATTAGGTTTGCTTACATTAAAAAAATTCTAGTTGGTTTA,GTAAGATATGTTATTCTGTGTAACCTTTGGGGCGGCAGGACAGTAAGATGCCTTACCAACACATTAGGTTTGCTTACATTAAAAAAATTCTAGTTGGTT,10,30,14,27,27,43,27,45,27,33,33,43,35,45,30.32,83.42316695
hek293t,12397,1,2,TCCATATATGTTATTCTGTGTAACCTTTGGGGGCAGGACAGTAAGATGCCTTACCAACACATTAGGTTTGCTTAAAAAAATTCTAGTTGGTTTAACGCG,TCCATATATGTTATTCTGTGTAACCTTTGGGGCGGCAGGACAGTAAGATGCCTTACCAACACATTAGGTTTGCTTAAAAAAATTCTAGTTGGTTTAACG,10,30,14,27,27,48,27,50,27,33,33,48,35,50,30.32,82.33683074
hek293t,12399,1,15,GATTTACAGAGATATAGTTAATTATCTAGTGGTAACAACATAGCCCTGAGCAACACAGTGAACAATCTAAAAAAATTCTAGTTGGTTTAACGCGTAACT,GATTTACAGAGATATAGTTAATTATCTAGCAGGAGTACTTGCGCTGGTAACAACATAGCCCTGAGCAACACAGTGAACAATCTAAAAAAATTCTAGTTG,10,30,14,27,27,40,27,55,27,30,30,40,45,55,40.43,1.207472114
hek293t,12400,1,12,GGAGTTTCCAATCACTCGTTGCAGAAACTTGGCACGGATCCACTAAATCACTGGACAAGCTGTCCCTAAAAAAATTCTAGTTGGTTTAACGCGTAACTA,GGAGTTTCCAATCACTCGTTGCAGAAACTTGGCACGCTACACGAATGAGATCCACTAAATCACTGGACAAGCTGTCCCTAAAAAAATTCTAGTTGGTTT,10,30,14,27,27,44,27,56,27,37,37,44,49,56,42.49,1.313675286
hek293t,12400,1,12,TCTCCTTCCAATCACTCGTTGCAGAAACTTGGCACGGATCCACTAAATCACTGGACAAGCTGTCAAAAAAATTCTAGTTGGTTTAACGCGTAACTAGAT,TCTCCTTCCAATCACTCGTTGCAGAAACTTGGCACGCTACACGAATGAGATCCACTAAATCACTGGACAAGCTGTCAAAAAAATTCTAGTTGGTTTAAC,10,30,14,27,27,47,27,59,27,37,37,47,49,59,42.49,2.410496897
hek293t,2181,1,1,TTGTGTTTTCCAGTGTTGTTTCAGCTGACAGGAGTCTGGATCATACTCTCTAAGAGTGTGCCATAATGTGGACCCAGGCACAGAAAAAAATTCTAGTTG,TTGTGTTTTCCAGTGTTGTTTCAGCTGACAGTGAGTCTGGATCATACTCTCTAAGAGTGTGCCATAATGTGGACCCAGGCACAGAAAAAAATTCTAGTT,10,30,14,27,27,39,27,40,27,32,32,39,33,40,27.99,82.23769463
hek293t,2181,1,1,TATGCTTTTCCAGTGTTGTTTCAGCTGACAGGAGTCTGGATCATACTCTCTAAGAGTGTGCCATAATGTGGACCCAGGCACAGCAAGAAAAAAATTCTA,TATGCTTTTCCAGTGTTGTTTCAGCTGACAGTGAGTCTGGATCATACTCTCTAAGAGTGTGCCATAATGTGGACCCAGGCACAGCAAGAAAAAAATTCT,10,30,14,27,27,35,27,36,27,32,32,35,33,36,27.99,2.042146634
hek293t,12404,1,6,CTTGGCCCTCCTGGGCAGCCAGGGAGTCCTGGACCTCCTGGTCCCCCAGGGATCTGCCAATCATGCCCCAGTATAAATGGAGGCGAAAAAAATTCTAGT,CTTGGCCCTCCTGGGCAGCCAGGGAGTCGGCGCCCTGGACCTCCTGGTCCCCCAGGGATCTGCCAATCATGCCCCAGTATAAATGGAGGCGAAAAAAAT,10,30,14,27,27,32,27,38,27,29,29,32,35,38,42.05,6.512262444
hek293t,12407,1,6,CCTATTTGTAAGGGTGCACCAGGTAAGAACGGAGAAAGAGGCCCTGGTGGACCACCTGGAACACCTGTAAGTTTCAAAAAAATTCTAGTTGGTTTAACG,CCTATTTGTAAGGGTGCACCAGGTAAGAACGGAGAAAGCCCAAGAGGCCCTGGTGGACCACCTGGAACACCTGTAAGTTTCAAAAAAATTCTAGTTGGT,10,30,14,27,27,42,27,48,27,39,39,42,45,48,46.92,0.0
hek293t,12410,1,15,TACGTACAAGATTTATTATGTAACACAGTTGGAAAAACACAAGAGCTTACACAAGCTCTCCTTCAAAAAAATTCTAGTTGGTTTAACGCGTAACTAGAT,TACGTACAAGATTTATTATGTAACACAGTTGGAAAAACACTATCCTCATCGTGTGAAGAGCTTACACAAGCTCTCCTTCAAAAAAATTCTAGTTGGTTT,10,30,14,27,27,44,27,59,27,41,41,44,56,59,29.21,0.0
hek293t,12411,1,11,AACCCGTACTTCTGGTCATTGTAACTGGTTGGGCTGATCTTGACTTCTAGATTCTGTATTGTGGGGAATAGAAAAAAAATTCTAGTTGGTTTAACGCGT,AACCCGTACTTCTGGTCATTGTAACTGGTTGGTCGTATGAACAGCTGATCTTGACTTCTAGATTCTGTATTGTGGGGAATAGAAAAAAAATTCTAGTTG,10,30,14,27,27,40,27,51,27,33,33,40,44,51,34.98,0.946386091
hek293t,12411,1,11,TCGCGGTACTTCTGGTCATTGTAACTGGTTGGGCTGATCTTGACTTCTAGATTCTGTATTGTGGAAAAAAATTCTAGTTGGTTTAACGCGTAACTAGAT,TCGCGGTACTTCTGGTCATTGTAACTGGTTGGTCGTATGAACAGCTGATCTTGACTTCTAGATTCTGTATTGTGGAAAAAAATTCTAGTTGGTTTAACG,10,30,14,27,27,48,27,59,27,33,33,48,44,59,34.98,1.039664232
hek293t,12413,1,10,AGCATGAGTAGATTATTACTGGTATTCTTTGGGAGGAAAATGTAGCAATATCTGTACATACTCTGAAAATTCATCATTAAAAAAATTCTAGTTGGTTTA,AGCATGAGTAGATTATTACTGGTATTCTTTGATCTTATTCCGGAGGAAAATGTAGCAATATCTGTACATACTCTGAAAATTCATCATTAAAAAAATTCT,10,30,14,27,27,35,27,45,27,32,32,35,42,45,10.84,0.440684126
hek293t,12413,1,10,TCGCGGAGTAGATTATTACTGGTATTCTTTGGGAGGAAAATGTAGCAATATCTGTACATACTCTGAAAAAAAATTCTAGTTGGTTTAACGCGTAACTAG,TCGCGGAGTAGATTATTACTGGTATTCTTTGATCTTATTCCGGAGGAAAATGTAGCAATATCTGTACATACTCTGAAAAAAAATTCTAGTTGGTTTAAC,10,30,14,27,27,47,27,57,27,32,32,47,42,57,10.84,3.37061526
hek293t,12415,1,8,TGGAGCTAAATCACTTATTGTAACCAATAAGGTATCCATTAACATATCACAGTTACGATCGAGGAATCAAAAAAATTCTAGTTGGTTTAACGCGTAACT,TGGAGCTAAATCACTTATTGTAACCAATAAGGTATCCTTTCGCCCATTAACATATCACAGTTACGATCGAGGAATCAAAAAAATTCTAGTTGGTTTAAC,10,30,14,27,27,47,27,55,27,37,37,47,45,55,13.51,0.892456271
hek293t,12416,1,10,TTCCAATTATTTTTTAACATATTGCATCATGGATATATTATTCAAGATCACTTTACATTTTGTGTGTGCCTAATTATAAAAAAATTCTAGTTGGTTTAA,TTCCAATTATTTTTTAACATATTGCATCATGGCCCACCCTCCATATATTATTCAAGATCACTTTACATTTTGTGTGTGCCTAATTATAAAAAAATTCTA,10,30,14,27,27,36,27,46,27,33,33,36,43,46,5.97,0.0
hek293t,12418,1,13,CCAACATATTTACTTCCTTTGGAAAGAAATGGCAGACATTGCGGTACAATTGGGGAAATCTAGATTTTACTCCAAAAAAATTCTAGTTGGTTTAACGCG,CCAACATATTTACTTCCTTTGGAAAGAAATGGCTCCCCACCACATGAGACATTGCGGTACAATTGGGGAAATCTAGATTTTACTCCAAAAAAATTCTAG,10,30,14,27,27,37,27,50,27,34,34,37,47,50,11.52,0.0
hek293t,12419,1,2,CCGTATGAATTTGACCCTGGGGAAAGGGGAGGGAAAGGTGTTTCCTTAAGTGTTCAATTGTTTATGTCTTCTTTATTAAAAAAATTCTAGTTGGTTTAA,CCGTATGAATTTGACCCTGGGGAAAGGGGAGGGAAATGGGTGTTTCCTTAAGTGTTCAATTGTTTATGTCTTCTTTATTAAAAAAATTCTAGTTGGTTT,10,30,14,27,27,44,27,46,27,37,37,44,39,46,39.44,65.3525224
hek293t,12419,1,2,ACCTGTGAATTTGACCCTGGGGAAAGGGGAGGGAAAGGTGTTTCCTTAAGTGTTCAATTGTTTATGTCTTCTTTAAAAAAATTCTAGTTGGTTTAACGC,ACCTGTGAATTTGACCCTGGGGAAAGGGGAGGGAAATGGGTGTTTCCTTAAGTGTTCAATTGTTTATGTCTTCTTTAAAAAAATTCTAGTTGGTTTAAC,10,30,14,27,27,47,27,49,27,37,37,47,39,49,39.44,71.63754209
hek293t,12421,1,2,TTTTAAACTTTTGTGGTTCTTGAAGTCTGTGGATACGTAGAGCAAGGTTCTTACTGTACTCTTGTTTTTCAGATGGGTATGAAAAAAATTCTAGTTGGT,TTTTAAACTTTTGTGGTTCTTGAAGTCTGTGGCCATACGTAGAGCAAGGTTCTTACTGTACTCTTGTTTTTCAGATGGGTATGAAAAAAATTCTAGTTG,10,30,14,27,27,40,27,42,27,33,33,40,35,42,38.51,89.62302149
hek293t,12421,1,2,ATCTAAACTTTTGTGGTTCTTGAAGTCTGTGGATACGTAGAGCAAGGTTCTTACTGTACTCTTGTTTTTCAGATGGGTATGGGAAAAAAAAATTCTAGT,ATCTAAACTTTTGTGGTTCTTGAAGTCTGTGGCCATACGTAGAGCAAGGTTCTTACTGTACTCTTGTTTTTCAGATGGGTATGGGAAAAAAAAATTCTA,10,30,14,27,27,36,27,38,27,33,33,36,35,38,38.51,0.32488629
hek293t,12423,1,14,AAGTTAGGTGACATTCAGAGCTAGAAGCTTGGGCATTCAGTGAGCTGTGGCTTGAGCTTCCTTGCCGTGGTAAAAAAATTCTAGTTGGTTTAACGCGTA,AAGTTAGGTGACATTCAGAGCTAGAAGCTTGGGCGTACATTAAAAGAGATTCAGTGAGCTGTGGCTTGAGCTTCCTTGCCGTGGTAAAAAAATTCTAGT,10,30,14,27,27,38,27,52,27,35,35,38,49,52,55.17,0.0
hek293t,12423,1,14,ATACCAGGTGACATTCAGAGCTAGAAGCTTGGGCATTCAGTGAGCTGTGGCTTGAGCTTCCTTGAAAAAAATTCTAGTTGGTTTAACGCGTAACTAGAT,ATACCAGGTGACATTCAGAGCTAGAAGCTTGGGCGTACATTAAAAGAGATTCAGTGAGCTGTGGCTTGAGCTTCCTTGAAAAAAATTCTAGTTGGTTTA,10,30,14,27,27,45,27,59,27,35,35,45,49,59,55.17,0.057273769
hek293t,12425,1,8,CTGTTTAAAATGAGACTGCAAGCGGTCAGAGGGAACTGATACATGGCAACAGGCCACAGCACCACCAAAAAAATTCTAGTTGGTTTAACGCGTAACTAG,CTGTTTAAAATGAGACTGCAAGCGGTCAGAGGGAACTGTACTAGATATACATGGCAACAGGCCACAGCACCACCAAAAAAATTCTAGTTGGTTTAACGC,10,30,14,27,27,49,27,57,27,39,39,49,47,57,44.51,8.486344932
hek293t,12426,1,10,AAATAAAATTCTTTTCATAGATCAGAAACTGGCTTGTACACAGAAAATTATGCAAACTTCTACTATATACCAAAAAAATTCTAGTTGGTTTAACGCGTA,AAATAAAATTCTTTTCATAGATCAGAAACTGGCTTGTACTATGGCCACCACAGAAAATTATGCAAACTTCTACTATATACCAAAAAAATTCTAGTTGGT,10,30,14,27,27,42,27,52,27,39,39,42,49,52,7.26,0.0
hek293t,12426,1,10,GCACAAAATTCTTTTCATAGATCAGAAACTGGCTTGTACACAGAAAATTATGCAAACTTCTACTAAAAAAATTCTAGTTGGTTTAACGCGTAACTAGAT,GCACAAAATTCTTTTCATAGATCAGAAACTGGCTTGTACTATGGCCACCACAGAAAATTATGCAAACTTCTACTAAAAAAATTCTAGTTGGTTTAACGC,10,30,14,27,27,49,27,59,27,39,39,49,49,59,7.26,0.0
hek293t,12428,1,1,CGCTGTTGAGCTTATTCGTTGCTGTGTTCTGGGGGGAGAGGGTCTTTACATGCTTCTCCTTGGGCTGGAGGTGCTGGGGTGAGAAAAAAATTCTAGTTG,CGCTGTTGAGCTTATTCGTTGCTGTGTTCTGGGGGCGAGAGGGTCTTTACATGCTTCTCCTTGGGCTGGAGGTGCTGGGGTGAGAAAAAAATTCTAGTT,10,30,14,27,27,39,27,40,27,36,36,39,37,40,8.49,49.44933225
hek293t,12428,1,1,CACTGTTGAGCTTATTCGTTGCTGTGTTCTGGGGGGAGAGGGTCTTTACATGCTTCTCCTTGGGCTGGAGGTGCTGGGGAAAAAAATTCTAGTTGGTTT,CACTGTTGAGCTTATTCGTTGCTGTGTTCTGGGGGCGAGAGGGTCTTTACATGCTTCTCCTTGGGCTGGAGGTGCTGGGGAAAAAAATTCTAGTTGGTT,10,30,14,27,27,43,27,44,27,36,36,43,37,44,8.49,81.58183552
hek293t,12430,1,15,TTGTCCACCAGACCCACTAAAAATATAAAAGGATAAAACATACACTGCTAGAACTTAAGCTGCTGTCCAAAAAAAAATTCTAGTTGGTTTAACGCGTAA,TTGTCCACCAGACCCACTAAAAATATAAAAGGATAAAGACTAGTTTTACAAAACATACACTGCTAGAACTTAAGCTGCTGTCCAAAAAAAAATTCTAGT,10,30,14,27,27,38,27,53,27,35,35,38,50,53,13.04,0.0
hek293t,12431,1,4,TCTACCAGCCTTTTGTTATCTTCCTTTTTAGGCAACCGTAGCCTCTGTATATATATTACACACATACACTCTCAAAAGTAACCAAAAAAATTCTAGTTG,TCTACCAGCCTTTTGTTATCTTCCTTTTTAGGACAACAACCGTAGCCTCTGTATATATATTACACACATACACTCTCAAAAGTAACCAAAAAAATTCTA,10,30,14,27,27,36,27,40,27,33,33,36,37,40,-3.73,0.0
hek293t,12431,1,4,GATGTCAGCCTTTTGTTATCTTCCTTTTTAGGCAACCGTAGCCTCTGTATATATATTACACACATACACTCAAAAAAATTCTAGTTGGTTTAACGCGTA,GATGTCAGCCTTTTGTTATCTTCCTTTTTAGGACAACAACCGTAGCCTCTGTATATATATTACACACATACACTCAAAAAAATTCTAGTTGGTTTAACG,10,30,14,27,27,48,27,52,27,33,33,48,37,52,-3.73,0.0
hek293t,12433,1,14,GGTGTATTCTATAACCACCCACTAAAAAGAGGAACAAAACTTGTTTCATTTTAATGTCTTGAAAAGCTGAAAAAAATTCTAGTTGGTTTAACGCGTAAC,GGTGTATTCTATAACCACCCACTAAAAAGAGGAACAAACGACACGGGACTAAACTTGTTTCATTTTAATGTCTTGAAAAGCTGAAAAAAATTCTAGTTG,10,30,14,27,27,40,27,54,27,37,37,40,51,54,76.12,0.0
hek293t,12435,1,9,CTTACTGTAAGCCTTGGTCCAGCGTATGTAGGACTTTTTCACTACTTGCACTAGAGTTCATCAGTGACGTGAAAAAAATTCTAGTTGGTTTAACGCGTA,CTTACTGTAAGCCTTGGTCCAGCGTATGTAGGACTCTTACGATGTTTTCACTACTTGCACTAGAGTTCATCAGTGACGTGAAAAAAATTCTAGTTGGTT,10,30,14,27,27,43,27,52,27,36,36,43,45,52,34.41,0.853348927
hek293t,12436,1,2,GGTTACCAGATTGCATGTGATACTGGTTCAGGTGATATTGCTCACTCTCTTCTTTCTCCCCCCCCCTTCAGGGTAATCCAGGTCCAAAAAAATTCTAGT,GGTTACCAGATTGCATGTGATACTGGTTCACAGGTGATATTGCTCACTCTCTTCTTTCTCCCCCCCCCTTCAGGGTAATCCAGGTCCAAAAAAATTCTA,10,30,14,27,27,36,27,38,27,29,29,36,31,38,49.86,76.70525535
hek293t,12436,1,2,GGATGCCAGATTGCATGTGATACTGGTTCAGGTGATATTGCTCACTCTCTTCTTTCTCCCCCCCCCTTCAGGGTAATCCAGGAAAAAAATTCTAGTTGG,GGATGCCAGATTGCATGTGATACTGGTTCACAGGTGATATTGCTCACTCTCTTCTTTCTCCCCCCCCCTTCAGGGTAATCCAGGAAAAAAATTCTAGTT,10,30,14,27,27,39,27,41,27,29,29,39,31,41,49.86,80.16602245
hek293t,12438,1,15,ATTCGTGCCTACTGCTCTGCACCTGAGCATGGGTACAACCACTTCAGTCCTGAAACACCACTGAGAAGCTCAAAAAAATTCTAGTTGGTTTAACGCGTA,ATTCGTGCCTACTGCTCTGCACCTGAAAAAAATTATCCGGTGCATGGGTACAACCACTTCAGTCCTGAAACACCACTGAGAAGCTCAAAAAAATTCTAG,10,30,14,27,27,37,27,52,27,27,27,37,42,52,50.41,0.0
hek293t,12438,1,15,GTATATGCCTACTGCTCTGCACCTGAGCATGGGTACAACCACTTCAGTCCTGAAACACCACTGAGAAGCTCTGCAAAAAAATTCTAGTTGGTTTAACGC,GTATATGCCTACTGCTCTGCACCTGAAAAAAATTATCCGGTGCATGGGTACAACCACTTCAGTCCTGAAACACCACTGAGAAGCTCTGCAAAAAAATTC,10,30,14,27,27,34,27,49,27,27,27,34,42,49,50.41,0.0
hek293t,12440,1,12,GGAAGCCCACTATTCCACAGAGAGAAATTTGGTTCATCTGACCAAGCGTGACATCTCCAATGCTTATAAAAAAAATTCTAGTTGGTTTAACGCGTAACT,GGAAGCCCACTATTCCACAGAGAGAAATTTGGTTCATCTAGGCAACTTCCTGACCAAGCGTGACATCTCCAATGCTTATAAAAAAAATTCTAGTTGGTT,10,30,14,27,27,43,27,55,27,40,40,43,52,55,31.34,0.0
hek293t,12441,1,8,AATATTCCCCCTGGAACAGGGCACCTCTGAGGAGGGTTGTGGTGCAGCCCGTCACCGAGGCGCAGAGCCTGGTTAAAAAAAATTCTAGTTGGTTTAACG,AATATTCCCCCTGGAACAGGGCACCTCTGAGGACAGGTCTAGGGTTGTGGTGCAGCCCGTCACCGAGGCGCAGAGCCTGGTTAAAAAAAATTCTAGTTG,10,30,14,27,27,40,27,48,27,33,33,40,41,48,53.22,2.746074138
hek293t,12441,1,8,GCGATTCCCCCTGGAACAGGGCACCTCTGAGGAGGGTTGTGGTGCAGCCCGTCACCGAGGCGCAGAGCCTGGAAAAAAATTCTAGTTGGTTTAACGCGT,GCGATTCCCCCTGGAACAGGGCACCTCTGAGGACAGGTCTAGGGTTGTGGTGCAGCCCGTCACCGAGGCGCAGAGCCTGGAAAAAAATTCTAGTTGGTT,10,30,14,27,27,43,27,51,27,33,33,43,41,51,53.22,5.187615554
hek293t,12443,1,9,ATCACAACAACCTTTCTGGCTAATACAAGAGGCCCATTTTCTACTGCTGTTTTATTCCTACAACTAAAAAAATTCTAGTTGGTTTAACGCGTAACTAGA,ATCACAACAACCTTTCTGGCTAATACAAGAGGCCCATTGTAAGTCATTTCTACTGCTGTTTTATTCCTACAACTAAAAAAATTCTAGTTGGTTTAACGC,10,30,14,27,27,49,27,58,27,39,39,49,48,58,45.98,2.527094663
hek293t,12443,1,9,ATTTCAACAACCTTTCTGGCTAATACAAGAGGCCCATTTTCTACTGCTGTTTTATTCCTACAACTGATGATTAAAAAAATTCTAGTTGGTTTAACGCGT,ATTTCAACAACCTTTCTGGCTAATACAAGAGGCCCATTGTAAGTCATTTCTACTGCTGTTTTATTCCTACAACTGATGATTAAAAAAATTCTAGTTGGT,10,30,14,27,27,42,27,51,27,39,39,42,48,51,45.98,0.0
hek293t,12445,1,5,CAGCCCTCCCTCTTTTATCTATCCTAAGAAGGTTTTCGCTAAAAGCAGTGGAGAATGCTCACCTTCTGTCCTGCATAAGTGTCCAAAAAAATTCTAGTT,CAGCCCTCCCTCTTTTATCTATCCTACAGATAGAAGGTTTTCGCTAAAAGCAGTGGAGAATGCTCACCTTCTGTCCTGCATAAGTGTCCAAAAAAATTC,10,30,14,27,27,34,27,39,27,27,27,34,32,39,11.11,0.0
hek293t,12445,1,5,TTATGCTCCCTCTTTTATCTATCCTAAGAAGGTTTTCGCTAAAAGCAGTGGAGAATGCTCACCTTCTGTCCTGCATAAAAAAATTCTAGTTGGTTTAAC,TTATGCTCCCTCTTTTATCTATCCTACAGATAGAAGGTTTTCGCTAAAAGCAGTGGAGAATGCTCACCTTCTGTCCTGCATAAAAAAATTCTAGTTGGT,10,30,14,27,27,42,27,47,27,27,27,42,32,47,11.11,3.679210931
hek293t,12447,1,8,CCCACTCCAATTAAGAGCAGGATTTAGGTAGGGTTTTCGGCTTAAGCGGTGTGCAATTGGAGAGGAAAGGAAAAAAATTCTAGTTGGTTTAACGCGTAA,CCCACTCCAATTAAGAGCAGGATTTAGGTAGGGTGTTAAACATTTCGGCTTAAGCGGTGTGCAATTGGAGAGGAAAGGAAAAAAATTCTAGTTGGTTTA,10,30,14,27,27,45,27,53,27,35,35,45,43,53,56.82,1.621566905
hek293t,12447,1,8,CGTTTTCCAATTAAGAGCAGGATTTAGGTAGGGTTTTCGGCTTAAGCGGTGTGCAATTGGAGAGGAAAGGAAAAAAAAAATTCTAGTTGGTTTAACGCG,CGTTTTCCAATTAAGAGCAGGATTTAGGTAGGGTGTTAAACATTTCGGCTTAAGCGGTGTGCAATTGGAGAGGAAAGGAAAAAAAAAATTCTAGTTGGT,10,30,14,27,27,42,27,50,27,35,35,42,43,50,56.82,0.263504611
hek293t,12451,1,15,ACAGATGTTTGACTTGTTTCTTACTTTGGTGGCAGAAGCTCTTGGTTGCTCATTTCCACCTCCTTGTTGAAAAAAATTCTAGTTGGTTTAACGCGTAAC,ACAGATGTTTGACTTGTTTCTTACTTTGGTGGCAGACAAATATTAGTTCCAAGCTCTTGGTTGCTCATTTCCACCTCCTTGTTGAAAAAAATTCTAGTT,10,30,14,27,27,39,27,54,27,36,36,39,51,54,40.98,0.0
hek293t,12452,1,8,GCGCGTCTTAGAGGAGGGAGGCTTTATTCAGGAAGCAGAACTAACCAGCTGTGATTGTAGGAGGACTTCAACTAAAAAAATTCTAGTTGGTTTAACGCG,GCGCGTCTTAGAGGAGGGAGGCTTTATTCAGGAAGCAGTTTAGCTAAACTAACCAGCTGTGATTGTAGGAGGACTTCAACTAAAAAAATTCTAGTTGGT,10,30,14,27,27,42,27,50,27,39,39,42,47,50,25.33,4.244128879
hek293t,12453,1,13,TTGTAAGGCTTCACAAGAACCTCGCCCCGGGGCCCTCACACGGGCGCTGGGAGGCCGGCACCCTCCCGGCTGCGGGGGAAAAAAATTCTAGTTGGTTTA,TTGTAAGGCTTCACAAGAACCTCGCCCCACCGTACTTAAAGGGGGCCCTCACACGGGCGCTGGGAGGCCGGCACCCTCCCGGCTGCGGGGGAAAAAAAT,10,30,14,27,27,32,27,45,27,29,29,32,42,45,62.12,5.254825455
hek293t,12455,1,4,AAAGCCTCACAGTTTGGGGTGTCAGGTTTTGGGTTCTGGCTCTAGTGCTGCAAAGAAGTGAGGCCTGATTCAAGTTGCTAAAAAAATTCTAGTTGGTTT,AAAGCCTCACAGTTTGGGGTGTCAGGTTTTGGGGTCGTTCTGGCTCTAGTGCTGCAAAGAAGTGAGGCCTGATTCAAGTTGCTAAAAAAATTCTAGTTG,10,30,14,27,27,40,27,44,27,33,33,40,37,44,12.96,0.0
hek293t,12455,1,4,ACATACTCACAGTTTGGGGTGTCAGGTTTTGGGTTCTGGCTCTAGTGCTGCAAAGAAGTGAGGCCTGATTCAAGTTAAAAAAATTCTAGTTGGTTTAAC,ACATACTCACAGTTTGGGGTGTCAGGTTTTGGGGTCGTTCTGGCTCTAGTGCTGCAAAGAAGTGAGGCCTGATTCAAGTTAAAAAAATTCTAGTTGGTT,10,30,14,27,27,43,27,47,27,33,33,43,37,47,12.96,30.64364103
hek293t,12457,1,13,TAAAAGCATGCATAAGCCCCCCCTGGACTTGGATTTTTGCAAGCTGATCTAACTTATGTGGTTAAGTCAAAAAAATTCTAGTTGGTTTAACGCGTAACT,TAAAAGCATGCATAAGCCCCCCCTGGACTTGGATTTTTCAGACTAAACGGGGCAAGCTGATCTAACTTATGTGGTTAAGTCAAAAAAATTCTAGTTGGT,10,30,14,27,27,42,27,55,27,39,39,42,52,55,44.45,0.0
hek293t,12459,1,15,TTCCATACTGATGTTAATTATGCACAAAATGGGATCTTGGAACTGCTGACCAAGCAACTCATTTAGAAAAAAAAATTCTAGTTGGTTTAACGCGTAACT,TTCCATACTGATGTTAATTATGCACAAAATGGGATCATTGAAGCAGCTGAATTGGAACTGCTGACCAAGCAACTCATTTAGAAAAAAAAATTCTAGTTG,10,30,14,27,27,40,27,55,27,37,37,40,52,55,8.82,0.0
hek293t,12459,1,15,CGTCTTACTGATGTTAATTATGCACAAAATGGGATCTTGGAACTGCTGACCAAGCAACTCATTTAAAAAAATTCTAGTTGGTTTAACGCGTAACTAGAT,CGTCTTACTGATGTTAATTATGCACAAAATGGGATCATTGAAGCAGCTGAATTGGAACTGCTGACCAAGCAACTCATTTAAAAAAATTCTAGTTGGTTT,10,30,14,27,27,44,27,59,27,37,37,44,52,59,8.82,0.070997515
hek293t,12461,1,2,ACGGCTTCTTTCTAATTTAAAAATGGGCCAGGAGACACTGGAGTTAATAAGAAGTGGATGAAAATAAAAAAATTCTAGTTGGTTTAACGCGTAACTAGA,ACGGCTTCTTTCTAATTTAAAAATGGGCCAGGAGACACTGACGAGTTAATAAGAAGTGGATGAAAATAAAAAAATTCTAGTTGGTTTAACGCGTAACTA,10,30,14,27,27,56,27,58,27,41,41,56,43,58,-1.51,0.0
hek293t,12461,1,2,GCCAATTCTTTCTAATTTAAAAATGGGCCAGGAGACACTGGAGTTAATAAGAAGTGGATGAAAATGAAAATGTCCTTAAAAAAATTCTAGTTGGTTTAA,GCCAATTCTTTCTAATTTAAAAATGGGCCAGGAGACACTGACGAGTTAATAAGAAGTGGATGAAAATGAAAATGTCCTTAAAAAAATTCTAGTTGGTTT,10,30,14,27,27,44,27,46,27,41,41,44,43,46,-1.51,0.0
hek293t,12463,1,7,ACCTCGCAAACTGGGCTACTCCAGAAATAAGGCCTGTGCGAACCAGGCCACATTTGCGACGAAGCCAGGTGAAAAAAAAAATTCTAGTTGGTTTAACGC,ACCTCGCAAACTGGGCTACTCCAGAAATAAGGCCTGTGTGGTTATCGAACCAGGCCACATTTGCGACGAAGCCAGGTGAAAAAAAAAATTCTAGTTGGT,10,30,14,27,27,42,27,49,27,39,39,42,46,49,38.0,3.686259094
hek293t,12464,1,7,CGAAGATAGTTGAGTGAAAATACTATTTGGGGAAAGATGGCAGAACTCACTGAATAATATATAATAACCTTGAAGACTAAAAAAAAAATTCTAGTTGGT,CGAAGATAGTTGAGTGAAAATACTATTTGGGAGGTTTTGAAAGATGGCAGAACTCACTGAATAATATATAATAACCTTGAAGACTAAAAAAAAAATTCT,10,30,14,27,27,35,27,42,27,32,32,35,39,42,35.4,0.0
hek293t,12464,1,7,CCGCCATAGTTGAGTGAAAATACTATTTGGGGAAAGATGGCAGAACTCACTGAATAATATATAATAACCTTGAAGACAAAAAAATTCTAGTTGGTTTAA,CCGCCATAGTTGAGTGAAAATACTATTTGGGAGGTTTTGAAAGATGGCAGAACTCACTGAATAATATATAATAACCTTGAAGACAAAAAAATTCTAGTT,10,30,14,27,27,39,27,46,27,32,32,39,39,46,35.4,0.048875855
hek293t,12466,1,2,GCGCTACCCCACATCAATGTTTATTGCAATGGATGTGTGATCTTTGGCTCATCACACATTAGAACTGCTCTGTCAAAAAAAATTCTAGTTGGTTTAACG,GCGCTACCCCACATCAATGTTTATTGCAATGGATGTGTTTGATCTTTGGCTCATCACACATTAGAACTGCTCTGTCAAAAAAAATTCTAGTTGGTTTAA,10,30,14,27,27,46,27,48,27,39,39,46,41,48,9.92,21.50381917
hek293t,12466,1,2,CGTATACCCCACATCAATGTTTATTGCAATGGATGTGTGATCTTTGGCTCATCACACATTAGAACTGAAAAAAATTCTAGTTGGTTTAACGCGTAACTA,CGTATACCCCACATCAATGTTTATTGCAATGGATGTGTTTGATCTTTGGCTCATCACACATTAGAACTGAAAAAAATTCTAGTTGGTTTAACGCGTAAC,10,30,14,27,27,54,27,56,27,39,39,54,41,56,9.92,17.49045281
hek293t,12468,1,4,GGCCGGTCAAACAATAGAAACTAATCAGGAGGCTTAAGGTGAGAAAACCAATCAGAAAATCATAAAAATCCTCTAAAAAAATTCTAGTTGGTTTAACGC,GGCCGGTCAAACAATAGAAACTAATCAGGAGGCTTAACCCAGGTGAGAAAACCAATCAGAAAATCATAAAAATCCTCTAAAAAAATTCTAGTTGGTTTA,10,30,14,27,27,45,27,49,27,38,38,45,42,49,59.9,6.450101557
hek293t,12468,1,4,TATGTGTCAAACAATAGAAACTAATCAGGAGGCTTAAGGTGAGAAAACCAATCAGAAAATCATAAAAATCCTCTTACAAAAAAAATTCTAGTTGGTTTA,TATGTGTCAAACAATAGAAACTAATCAGGAGGCTTAACCCAGGTGAGAAAACCAATCAGAAAATCATAAAAATCCTCTTACAAAAAAAATTCTAGTTGG,10,30,14,27,27,41,27,45,27,38,38,41,42,45,59.9,0.210151781
hek293t,12470,1,2,GTGTTTGCCAACAAAGTGAGAGAACTGTCAGGTTTGTCCCTCCTGAAGTTTGGCAGTGTTCGTGCAGGCTCTTTCAAAAAAATTCTAGTTGGTTTAACG,GTGTTTGCCAACAAAGTGAGAGAACTGTCACAGGTTTGTCCCTCCTGAAGTTTGGCAGTGTTCGTGCAGGCTCTTTCAAAAAAATTCTAGTTGGTTTAA,10,30,14,27,27,46,27,48,27,31,31,46,33,48,47.67,73.10694562
hek293t,12470,1,2,GTGTCTGCCAACAAAGTGAGAGAACTGTCAGGTTTGTCCCTCCTGAAGTTTGGCAGTGTTCGTGCAGGCTCTTTCCAGTTAAAAAAATTCTAGTTGGTT,GTGTCTGCCAACAAAGTGAGAGAACTGTCACAGGTTTGTCCCTCCTGAAGTTTGGCAGTGTTCGTGCAGGCTCTTTCCAGTTAAAAAAATTCTAGTTGG,10,30,14,27,27,41,27,43,27,31,31,41,33,43,47.67,90.43931305
hek293t,12472,1,8,TTCCTCTTTCTTTGGTTTCTAGGGCATCGGGGCAGGACCAAAACAACACAAACCTCCCAAACCCTGCCTTTCCAAAAAAATTCTAGTTGGTTTAACGCG,TTCCTCTTTCTTTGGTTTCTAGGGCATCGGGGCAGGACATATTTGACAAAACAACACAAACCTCCCAAACCCTGCCTTTCCAAAAAAATTCTAGTTGGT,10,30,14,27,27,42,27,50,27,39,39,42,47,50,57.81,0.0
hek293t,12472,1,8,CTAAACTTTCTTTGGTTTCTAGGGCATCGGGGCAGGACCAAAACAACACAAACCTCCCAAACCCTGCCTAAAAAAATTCTAGTTGGTTTAACGCGTAAC,CTAAACTTTCTTTGGTTTCTAGGGCATCGGGGCAGGACATATTTGACAAAACAACACAAACCTCCCAAACCCTGCCTAAAAAAATTCTAGTTGGTTTAA,10,30,14,27,27,46,27,54,27,39,39,46,47,54,57.81,0.516795866
hek293t,12474,1,5,TCCATGAGGGCAGCAATAAAGTCAGTGCTTGGATATGCCTAATAAATTTGGGCATCTGAAGAGATGCATTGTGTAAAAAAATTCTAGTTGGTTTAACGC,TCCATGAGGGCAGCAATAAAGTCAGTGCTTGGATATGTCTAGCCTAATAAATTTGGGCATCTGAAGAGATGCATTGTGTAAAAAAATTCTAGTTGGTTT,10,30,14,27,27,44,27,49,27,37,37,44,42,49,60.04,1.125499325
hek293t,12474,1,5,CCGAAGAGGGCAGCAATAAAGTCAGTGCTTGGATATGCCTAATAAATTTGGGCATCTGAAGAGATGCATTGTGTCTCTAAAAAAATTCTAGTTGGTTTA,CCGAAGAGGGCAGCAATAAAGTCAGTGCTTGGATATGTCTAGCCTAATAAATTTGGGCATCTGAAGAGATGCATTGTGTCTCTAAAAAAATTCTAGTTG,10,30,14,27,27,40,27,45,27,37,37,40,42,45,60.04,0.334448161
hek293t,12478,1,1,CGTGCGCATCTAATTAATTGGATTGGTTTTGGTGAAAATCAGTTGAGAGCTAATGCCCCCCCTGTGTCAATAAAAAAATTCTAGTTGGTTTAACGCGTA,CGTGCGCATCTAATTAATTGGATTGGTTTTGGTGAGAAATCAGTTGAGAGCTAATGCCCCCCCTGTGTCAATAAAAAAATTCTAGTTGGTTTAACGCGT,10,30,14,27,27,51,27,52,27,36,36,51,37,52,3.05,14.5598745
hek293t,12478,1,1,GGCTAGCATCTAATTAATTGGATTGGTTTTGGTGAAAATCAGTTGAGAGCTAATGCCCCCCCTGTGTCAATTAACATGGGAAAAAAAAAATTCTAGTTG,GGCTAGCATCTAATTAATTGGATTGGTTTTGGTGAGAAATCAGTTGAGAGCTAATGCCCCCCCTGTGTCAATTAACATGGGAAAAAAAAAATTCTAGTT,10,30,14,27,27,39,27,40,27,36,36,39,37,40,3.05,0.164744646
hek293t,12480,1,14,CGCGTCCACACCTTGCCTTCCCTCTTAGCAGGAGATCTTAGCGAAACCTAAGCCCAAGGAATTGCAAAAAAAAAATTCTAGTTGGTTTAACGCGTAACT,CGCGTCCACACCTTGCCTTCCCTCTTAGCAGGAGATCGCGGCATTTCTATGTTAGCGAAACCTAAGCCCAAGGAATTGCAAAAAAAAAATTCTAGTTGG,10,30,14,27,27,41,27,55,27,38,38,41,52,55,36.55,0.343642612
hek293t,12483,1,9,GCGAAGCTAAAGGACCCCTTTGCTATATAAGGGCAGCACAAGACAAGAATTGCCTTTGCAGTGAGGAAGGCAGCTGGGAGAAAAAAAATTCTAGTTGGT,GCGAAGCTAAAGGACCCCTTTGCTATATAGAGTAAGGCAGGGCAGCACAAGACAAGAATTGCCTTTGCAGTGAGGAAGGCAGCTGGGAGAAAAAAAATT,10,30,14,27,27,33,27,42,27,30,30,33,39,42,16.01,0.971331845
hek293t,12483,1,9,CTGCTGCTAAAGGACCCCTTTGCTATATAAGGGCAGCACAAGACAAGAATTGCCTTTGCAGTGAGGAAGGCAGCAAAAAAATTCTAGTTGGTTTAACGC,CTGCTGCTAAAGGACCCCTTTGCTATATAGAGTAAGGCAGGGCAGCACAAGACAAGAATTGCCTTTGCAGTGAGGAAGGCAGCAAAAAAATTCTAGTTG,10,30,14,27,27,40,27,49,27,30,30,40,39,49,16.01,56.00479368
hek293t,12485,1,15,ATGACGAAATTTTCTTCCTATCTTCTCTGTGGTATCCACTCAGGGTAATGCAAAAGATATTTTAAAAAAAATTCTAGTTGGTTTAACGCGTAACTAGAT,ATGACGAAATTTTCTTCCTATCTTCTCTGTGGTATCCACTACATTGTGTATGCACCAGGGTAATGCAAAAGATATTTTAAAAAAAATTCTAGTTGGTTT,10,30,14,27,27,44,27,59,27,41,41,44,56,59,38.89,0.0
hek293t,12486,1,1,GACCCTCATGATATTTTCAAAATACAATTTGGAGCTCTTCCTATTGTTGAACGGATTTGGCTTGTGTACAAGTATTCTAAAAAAATTCTAGTTGGTTTA,GACCCTCATGATATTTTCAAAATACAATTTGGAGCTCTTCCCTATTGTTGAACGGATTTGGCTTGTGTACAAGTATTCTAAAAAAATTCTAGTTGGTTT,10,30,14,27,27,44,27,45,27,41,41,44,42,45,3.92,0.0
hek293t,12488,1,8,GTATCTGTATATTCTTTTCACTAATGATTAGGTCTTCTCTTGCAGGAAAATCCTGGCTGTGCTGCAGCTGAAAAAAAATTCTAGTTGGTTTAACGCGTA,GTATCTGTATATTCTTTTCACTAATGATTAGGTCTTAGAGTCCACTCTTGCAGGAAAATCCTGGCTGTGCTGCAGCTGAAAAAAAATTCTAGTTGGTTT,10,30,14,27,27,44,27,52,27,37,37,44,45,52,5.58,2.144560159
hek293t,12489,1,12,TATAAGAGACCATCACCACTCACCCAATTTGGTATGTGCCAATAGGTTCCAAAGTTCTCTGGGTAAAAAAATTCTAGTTGGTTTAACGCGTAACTAGAT,TATAAGAGACCATCACCACTCACCCAATTTGGTATGATCCTCCTCGACTGCCAATAGGTTCCAAAGTTCTCTGGGTAAAAAAATTCTAGTTGGTTTAAC,10,30,14,27,27,47,27,59,27,37,37,47,49,59,9.17,1.302155177
hek293t,12489,1,12,CTTAGGAGACCATCACCACTCACCCAATTTGGTATGTGCCAATAGGTTCCAAAGTTCTCTGGGTGAGAAAAAAATTCTAGTTGGTTTAACGCGTAACTA,CTTAGGAGACCATCACCACTCACCCAATTTGGTATGATCCTCCTCGACTGCCAATAGGTTCCAAAGTTCTCTGGGTGAGAAAAAAATTCTAGTTGGTTT,10,30,14,27,27,44,27,56,27,37,37,44,49,56,9.17,0.480872676
hek293t,12491,1,1,CTTCTCTTCTCTTGACAGTTTGGGTACAGTGGCAAGCTTTTTCCAGGCCAGTTGCTTACTTAGAAGCCTTGTCTAAATAAAAAAATTCTAGTTGGTTTA,CTTCTCTTCTCTTGACAGTTTGGGTACAAGTGGCAAGCTTTTTCCAGGCCAGTTGCTTACTTAGAAGCCTTGTCTAAATAAAAAAATTCTAGTTGGTTT,10,30,14,27,27,44,27,45,27,29,29,44,30,45,56.36,62.62345826
hek293t,12493,1,3,GGACTTTATTCTTGCAATTTGCAGGCCTTTGGAAGTCAGTTTGAGAGTACGAATGCATTGTGCTGAACTCCTAGATGAAAAAAATTCTAGTTGGTTTAA,GGACTTTATTCTTGCAATTTGCAGGCCTTTGGTACAAGTCAGTTTGAGAGTACGAATGCATTGTGCTGAACTCCTAGATGAAAAAAATTCTAGTTGGTT,10,30,14,27,27,43,27,46,27,33,33,43,36,46,15.19,80.37203317
hek293t,12493,1,3,CTACGTTATTCTTGCAATTTGCAGGCCTTTGGAAGTCAGTTTGAGAGTACGAATGCATTGTGCTGAACTCCTAGATGCAGCCGTAAAAAAATTCTAGTT,CTACGTTATTCTTGCAATTTGCAGGCCTTTGGTACAAGTCAGTTTGAGAGTACGAATGCATTGTGCTGAACTCCTAGATGCAGCCGTAAAAAAATTCTA,10,30,14,27,27,36,27,39,27,33,33,36,36,39,15.19,0.127226463
hek293t,12495,1,6,TGCCGTCCATTGGTTTGCAAATATGTTGACGGCATTGAAATAAATTCTGACTTATAATTAAATAATTTAAATGAGCTGGTAAAAAAATTCTAGTTGGTT,TGCCGTCCATTGGTTTGCAAATATGTTGACGGCTGCTGTATTGAAATAAATTCTGACTTATAATTAAATAATTTAAATGAGCTGGTAAAAAAATTCTAG,10,30,14,27,27,37,27,43,27,34,34,37,40,43,36.38,0.0
hek293t,12499,1,12,CACTATAACAAAGCCTGGGAAGGTGTGTGGGGGGAAGAAGACGTTATACTGTTTTATCCCTGGGCTTTACCAAAAAAATTCTAGTTGGTTTAACGCGTA,CACTATAACAAAGCCTGGGAAGGTGTGTGGTCCGGGGGACGGGGGGAAGAAGACGTTATACTGTTTTATCCCTGGGCTTTACCAAAAAAATTCTAGTTG,10,30,14,27,27,40,27,52,27,30,30,40,42,52,49.97,14.11878964
hek293t,12499,1,12,CACATTAACAAAGCCTGGGAAGGTGTGTGGGGGGAAGAAGACGTTATACTGTTTTATCCCTGGGCTTTACCATGAAAAAAATTCTAGTTGGTTTAACGC,CACATTAACAAAGCCTGGGAAGGTGTGTGGTCCGGGGGACGGGGGGAAGAAGACGTTATACTGTTTTATCCCTGGGCTTTACCATGAAAAAAATTCTAG,10,30,14,27,27,37,27,49,27,30,30,37,42,49,49.97,8.964343412
hek293t,12501,1,2,AATGCAATCAGTAAGCGGTGCTCTGGTAGGGGAAAGCCACCAAATCCTGGCTGGTGTCATCCTGCATCGTAAAAAAATTCTAGTTGGTTTAACGCGTAA,AATGCAATCAGTAAGCGGTGCTCTGGTAGGGGAAAGCCACAACAAATCCTGGCTGGTGTCATCCTGCATCGTAAAAAAATTCTAGTTGGTTTAACGCGT,10,30,14,27,27,51,27,53,27,41,41,51,43,53,44.12,72.57988817
hek293t,12501,1,2,GGAAGAATCAGTAAGCGGTGCTCTGGTAGGGGAAAGCCACCAAATCCTGGCTGGTGTCATCCTGCATCGTGACCAATAAAAAAATTCTAGTTGGTTTAA,GGAAGAATCAGTAAGCGGTGCTCTGGTAGGGGAAAGCCACAACAAATCCTGGCTGGTGTCATCCTGCATCGTGACCAATAAAAAAATTCTAGTTGGTTT,10,30,14,27,27,44,27,46,27,41,41,44,43,46,44.12,0.973148208
hek293t,12504,1,1,CTCATTCATTTGTTACTGTTATAGTTTCTTGGCATTGAGGACCTCTCTTACAAGACTACTAAGGGAAAAGATGTCACAGTTTAAAAAAAATTCTAGTTG,CTCATTCATTTGTTACTGTTATAGTTTCTTGAGCATTGAGGACCTCTCTTACAAGACTACTAAGGGAAAAGATGTCACAGTTTAAAAAAAATTCTAGTT,10,30,14,27,27,39,27,40,27,32,32,39,33,40,5.26,69.99665909
hek293t,12504,1,1,ACCAATCATTTGTTACTGTTATAGTTTCTTGGCATTGAGGACCTCTCTTACAAGACTACTAAGGGAAAAGATGTCACAGTTTATATTAAAAAAATTCTA,ACCAATCATTTGTTACTGTTATAGTTTCTTGAGCATTGAGGACCTCTCTTACAAGACTACTAAGGGAAAAGATGTCACAGTTTATATTAAAAAAATTCT,10,30,14,27,27,35,27,36,27,32,32,35,33,36,5.26,0.849145533
hek293t,12506,1,10,CACCGTGTTACCTACTCAGAGCAATGACATGGAATTTGCCTTGGAAAACAGAACCCGTTTGATTTCAAAAAAATTCTAGTTGGTTTAACGCGTAACTAG,CACCGTGTTACCTACTCAGAGCAATGACATGGAATTTGCGCCTCTTAGTCTTGGAAAACAGAACCCGTTTGATTTCAAAAAAATTCTAGTTGGTTTAAC,10,30,14,27,27,47,27,57,27,40,40,47,50,57,69.14,0.549773505
hek293t,12506,1,10,TTCTCTGTTACCTACTCAGAGCAATGACATGGAATTTGCCTTGGAAAACAGAACCCGTTTGATTTCAAAAAAAAAAATTCTAGTTGGTTTAACGCGTAA,TTCTCTGTTACCTACTCAGAGCAATGACATGGAATTTGCGCCTCTTAGTCTTGGAAAACAGAACCCGTTTGATTTCAAAAAAAAAAATTCTAGTTGGTT,10,30,14,27,27,43,27,53,27,40,40,43,50,53,69.14,0.50714548
hek293t,12508,1,10,TAAACCTGGATGTGTTGGACCTCTGTGTTTGGCATTAATAATATTTCTGTCCTGAAAACTGCAGAAAGAAATAAAAAAAATTCTAGTTGGTTTAACGCG,TAAACCTGGATGTGTTGGACCTCTGTGTTTGGGAGACTAGGGCATTAATAATATTTCTGTCCTGAAAACTGCAGAAAGAAATAAAAAAAATTCTAGTTG,10,30,14,27,27,40,27,50,27,33,33,40,43,50,39.66,0.791025342
hek293t,12508,1,10,TATGCCTGGATGTGTTGGACCTCTGTGTTTGGCATTAATAATATTTCTGTCCTGAAAACTGCAGAAAAAAAATTCTAGTTGGTTTAACGCGTAACTAGA,TATGCCTGGATGTGTTGGACCTCTGTGTTTGGGAGACTAGGGCATTAATAATATTTCTGTCCTGAAAACTGCAGAAAAAAAATTCTAGTTGGTTTAACG,10,30,14,27,27,48,27,58,27,33,33,48,43,58,39.66,1.317670266
hek293t,12510,1,10,GCTTTATTATTTTATAGCAAGAGAGTTGTAGGCGATACTTTAAACATAAATAAATGTGGTGGTTCCTTGAAAAAAATTCTAGTTGGTTTAACGCGTAAC,GCTTTATTATTTTATAGCAAGAGAGTTGTAGCGGCGGCTAGGCGATACTTTAAACATAAATAAATGTGGTGGTTCCTTGAAAAAAATTCTAGTTGGTTT,10,30,14,27,27,44,27,54,27,29,29,44,39,54,15.91,5.405608542
hek293t,12510,1,10,TCAAAATTATTTTATAGCAAGAGAGTTGTAGGCGATACTTTAAACATAAATAAATGTGGTGGTTCCTTGTTCCAGAGAAAAAAATTCTAGTTGGTTTAA,TCAAAATTATTTTATAGCAAGAGAGTTGTAGCGGCGGCTAGGCGATACTTTAAACATAAATAAATGTGGTGGTTCCTTGTTCCAGAGAAAAAAATTCTA,10,30,14,27,27,36,27,46,27,29,29,36,39,46,15.91,0.0
hek293t,12512,1,10,AAAAAATGACAACTTACAGCTGCTTTGGCAGGTAGCCTGGCATTCTTCCAAATTCTTAAAGTTGTTCTGGTTTCCAAAAAAATTCTAGTTGGTTTAACG,AAAAAATGACAACTTACAGCTGCTTTGGCAGGTACGCTGGATGAGCCTGGCATTCTTCCAAATTCTTAAAGTTGTTCTGGTTTCCAAAAAAATTCTAGT,10,30,14,27,27,38,27,48,27,35,35,38,45,48,51.61,0.0
hek293t,12513,1,6,ACCCCAACTGTCCTCTAGTGCACACTTTGGGGTGGGAGAAGGCAAAAGAGATAAATGTCACTAGACCCGTCCTCACGTTACCTGAAAAAAATTCTAGTT,ACCCCAACTGTCCTCTAGTGCACACTTTGGCCTTGGGGTGGGAGAAGGCAAAAGAGATAAATGTCACTAGACCCGTCCTCACGTTACCTGAAAAAAATT,10,30,14,27,27,33,27,39,27,30,30,33,36,39,45.53,4.197486868
hek293t,12513,1,6,ACCAGAACTGTCCTCTAGTGCACACTTTGGGGTGGGAGAAGGCAAAAGAGATAAATGTCACTAGACCCGTCCAAAAAAATTCTAGTTGGTTTAACGCGT,ACCAGAACTGTCCTCTAGTGCACACTTTGGCCTTGGGGTGGGAGAAGGCAAAAGAGATAAATGTCACTAGACCCGTCCAAAAAAATTCTAGTTGGTTTA,10,30,14,27,27,45,27,51,27,30,30,45,36,51,45.53,33.57569542
hek293t,12515,1,5,GGATTTTCAAGGATCATTATTACTGTTACTGGTGTGCTTAGATATAGCACATAGTATTGTTTTTCACAAAAAAATTCTAGTTGGTTTAACGCGTAACTA,GGATTTTCAAGGATCATTATTACTGTTACTGGTGTGCTTACCGGCGATATAGCACATAGTATTGTTTTTCACAAAAAAATTCTAGTTGGTTTAACGCGT,10,30,14,27,27,51,27,56,27,41,41,51,46,56,8.34,30.15312637
hek293t,12519,1,12,CTCACTGTTCAGAAGCAAACCTCACTTTCAGGCATTCCATGGATGTCAACACTTGAAGAATATAAACAACCAAAAAAATTCTAGTTGGTTTAACGCGTA,CTCACTGTTCAGAAGCAAACCTCACTTTCAGGCATTATAGTCCTGTAGCCATGGATGTCAACACTTGAAGAATATAAACAACCAAAAAAATTCTAGTTG,10,30,14,27,27,40,27,52,27,37,37,40,49,52,8.79,0.0
hek293t,12520,1,2,TGGCAAATACTCAAATAGCAAGGGAATCCAGGCTGAGGTTGAAGGTCTGCATAATGGTCTGCTTAGGCCATTAAAAAAATTCTAGTTGGTTTAACGCGT,TGGCAAATACTCAAATAGCAAGGGAATCCAGGCCTTGAGGTTGAAGGTCTGCATAATGGTCTGCTTAGGCCATTAAAAAAATTCTAGTTGGTTTAACGC,10,30,14,27,27,49,27,51,27,34,34,49,36,51,40.54,82.95524773
hek293t,12520,1,2,GCGTTAATACTCAAATAGCAAGGGAATCCAGGCTGAGGTTGAAGGTCTGCATAATGGTCTGCTTAGGCCATTGCAGGAAAAAAATTCTAGTTGGTTTAA,GCGTTAATACTCAAATAGCAAGGGAATCCAGGCCTTGAGGTTGAAGGTCTGCATAATGGTCTGCTTAGGCCATTGCAGGAAAAAAATTCTAGTTGGTTT,10,30,14,27,27,44,27,46,27,34,34,44,36,46,40.54,85.4935074
hek293t,12522,1,10,TCGCTTTTTATGTAGAAATACTGCATAGAAGGATTTTTAACCCTGATAAGAGTCAAAGGAATGTCACAATAATGTAAAAAAATTCTAGTTGGTTTAACG,TCGCTTTTTATGTAGAAATACTGCATAGAAGTCCTATTACGGATTTTTAACCCTGATAAGAGTCAAAGGAATGTCACAATAATGTAAAAAAATTCTAGT,10,30,14,27,27,38,27,48,27,31,31,38,41,48,30.35,0.645569354
hek293t,12522,1,10,GATTATTTTATGTAGAAATACTGCATAGAAGGATTTTTAACCCTGATAAGAGTCAAAGGAATGTCACAAAAAAATTCTAGTTGGTTTAACGCGTAACTA,GATTATTTTATGTAGAAATACTGCATAGAAGTCCTATTACGGATTTTTAACCCTGATAAGAGTCAAAGGAATGTCACAAAAAAATTCTAGTTGGTTTAA,10,30,14,27,27,46,27,56,27,31,31,46,41,56,30.35,6.998277962
hek293t,12524,1,15,GGTTAACTGTAAAATAGAGGGTGTGGCTGGGGTCTTGGCCCTACAATAGCGAATGGCAAGAATATAAAAAAATTCTAGTTGGTTTAACGCGTAACTAGA,GGTTAACTGTAAAATAGAGGGTGTGGCTGGGGTCTTTGCTATGAGGGATCTGGCCCTACAATAGCGAATGGCAAGAATATAAAAAAATTCTAGTTGGTT,10,30,14,27,27,43,27,58,27,36,36,43,51,58,40.64,0.18876545
hek293t,12524,1,15,AACCTACTGTAAAATAGAGGGTGTGGCTGGGGTCTTGGCCCTACAATAGCGAATGGCAAGAATATCCATAAAAAAATTCTAGTTGGTTTAACGCGTAAC,AACCTACTGTAAAATAGAGGGTGTGGCTGGGGTCTTTGCTATGAGGGATCTGGCCCTACAATAGCGAATGGCAAGAATATCCATAAAAAAATTCTAGTT,10,30,14,27,27,39,27,54,27,36,36,39,51,54,40.64,0.0
hek293t,12526,1,5,GGTGCGACTTTAGGCAGAGCAGCTTAGGGTGGAAGAAGGTTGCTAATTAGCAAAGTATGCATGAGCAAAAAAATTCTAGTTGGTTTAACGCGTAACTAG,GGTGCGACTTTAGGCAGAGCAGCTTAGGGTGGAAGACCAAAAGGTTGCTAATTAGCAAAGTATGCATGAGCAAAAAAATTCTAGTTGGTTTAACGCGTA,10,30,14,27,27,52,27,57,27,37,37,52,42,57,67.03,1.55791372
hek293t,12526,1,5,AGTGCGACTTTAGGCAGAGCAGCTTAGGGTGGAAGAAGGTTGCTAATTAGCAAAGTATGCATGAGCATTTGAAAAAAATTCTAGTTGGTTTAACGCGTA,AGTGCGACTTTAGGCAGAGCAGCTTAGGGTGGAAGACCAAAAGGTTGCTAATTAGCAAAGTATGCATGAGCATTTGAAAAAAATTCTAGTTGGTTTAAC,10,30,14,27,27,47,27,52,27,37,37,47,42,52,67.03,1.716838891
hek293t,12528,1,10,ACCTCTGGATCTGCTTAAAAAATGGTGCGGGGAGTAAGGAAAGGATGGGGATGCTACAGAGGGAGCTTTCTGGCACTCAAAAAAAATTCTAGTTGGTTT,ACCTCTGGATCTGCTTAAAAAATGGTCATTCGAGCTGCGGGGAGTAAGGAAAGGATGGGGATGCTACAGAGGGAGCTTTCTGGCACTCAAAAAAAATTC,10,30,14,27,27,34,27,44,27,27,27,34,37,44,63.71,0.281398527
hek293t,12528,1,10,ACTTCTGGATCTGCTTAAAAAATGGTGCGGGGAGTAAGGAAAGGATGGGGATGCTACAGAGGGAGCTTTCTGGCACTCATCAGAAAAAAATTCTAGTTG,ACTTCTGGATCTGCTTAAAAAATGGTCATTCGAGCTGCGGGGAGTAAGGAAAGGATGGGGATGCTACAGAGGGAGCTTTCTGGCACTCATCAGAAAAAA,10,30,14,27,27,30,27,40,27,27,27,30,37,40,63.71,0.0
hek293t,12530,1,1,TGATCCTGTACAAACCTTATGGAGGCTGTCGGAGATATGTTGAATCTTTAGGACATCATGTGTTTATTAACATAAAAAAATTCTAGTTGGTTTAACGCG,TGATCCTGTACAAACCTTATGGAGGCTGTCGGAGATATCGTTGAATCTTTAGGACATCATGTGTTTATTAACATAAAAAAATTCTAGTTGGTTTAACGC,10,30,14,27,27,49,27,50,27,39,39,49,40,50,40.83,79.02969794
hek293t,12530,1,1,CAAATCTGTACAAACCTTATGGAGGCTGTCGGAGATATGTTGAATCTTTAGGACATCATGTGTTTATTAAAAAAATTCTAGTTGGTTTAACGCGTAACT,CAAATCTGTACAAACCTTATGGAGGCTGTCGGAGATATCGTTGAATCTTTAGGACATCATGTGTTTATTAAAAAAATTCTAGTTGGTTTAACGCGTAAC,10,30,14,27,27,54,27,55,27,39,39,54,40,55,40.83,79.21479053
hek293t,12532,1,11,ACGATAAGTAGACATTTGAGAACAGCACAAGGGGTCTAGGTGGTGGGAGCTTTCCCATTGCTGAAAAAAAAATTCTAGTTGGTTTAACGCGTAACTAGA,ACGATAAGTAGACATTTGAGAACAGCACAAGCATCTCAACATGGGTCTAGGTGGTGGGAGCTTTCCCATTGCTGAAAAAAAAATTCTAGTTGGTTTAAC,10,30,14,27,27,47,27,58,27,32,32,47,43,58,43.68,6.549737331
hek293t,12532,1,11,TGTGGAAGTAGACATTTGAGAACAGCACAAGGGGTCTAGGTGGTGGGAGCTTTCCCATTGCTGAAAACAGAAAAAAATTCTAGTTGGTTTAACGCGTAA,TGTGGAAGTAGACATTTGAGAACAGCACAAGCATCTCAACATGGGTCTAGGTGGTGGGAGCTTTCCCATTGCTGAAAACAGAAAAAAATTCTAGTTGGT,10,30,14,27,27,42,27,53,27,32,32,42,43,53,43.68,8.711305484
hek293t,12534,1,3,GGCGATAAAAGCTCTGACAAGAAAAGAAAAGGTCTGTAACCATTGCACATTCCTAGTGTGTCCACAAGCATAAAAAAATTCTAGTTGGTTTAACGCGTA,GGCGATAAAAGCTCTGACAAGAAAAGAAAAGGTCTGTAGGAACCATTGCACATTCCTAGTGTGTCCACAAGCATAAAAAAATTCTAGTTGGTTTAACGC,10,30,14,27,27,49,27,52,27,39,39,49,42,52,28.62,0.389085471
hek293t,12534,1,3,TACTATAAAAGCTCTGACAAGAAAAGAAAAGGTCTGTAACCATTGCACATTCCTAGTGTGTCCACAAGCATTATAAAAAAATTCTAGTTGGTTTAACGC,TACTATAAAAGCTCTGACAAGAAAAGAAAAGGTCTGTAGGAACCATTGCACATTCCTAGTGTGTCCACAAGCATTATAAAAAAATTCTAGTTGGTTTAA,10,30,14,27,27,46,27,49,27,39,39,46,42,49,28.62,0.698020856
hek293t,12536,1,2,CGGTGTGGCCTTGTTTTCAGAGGTGTGAAAGGTTTGTGACAGGCACAGCAGCTAATAATACCTCTAAAATTTAAAAAAAATTCTAGTTGGTTTAACGCG,CGGTGTGGCCTTGTTTTCAGAGGTGTGAAAGGGGTTTGTGACAGGCACAGCAGCTAATAATACCTCTAAAATTTAAAAAAAATTCTAGTTGGTTTAACG,10,30,14,27,27,48,27,50,27,33,33,48,35,50,26.89,48.347812
hek293t,12536,1,2,CTCTCTGGCCTTGTTTTCAGAGGTGTGAAAGGTTTGTGACAGGCACAGCAGCTAATAATACCTCTAAAATTTAGGCTGAAAAAAATTCTAGTTGGTTTA,CTCTCTGGCCTTGTTTTCAGAGGTGTGAAAGGGGTTTGTGACAGGCACAGCAGCTAATAATACCTCTAAAATTTAGGCTGAAAAAAATTCTAGTTGGTT,10,30,14,27,27,43,27,45,27,33,33,43,35,45,26.89,51.1920758
hek293t,12538,1,1,TACGCTGTATAGGAATGTCACAGCCCAAGGGGTTCATCTTTCGTTTCTTTCTCATATCTCTGCAGTCAGAAGGATTGCATAAAAAAATTCTAGTTGGTT,TACGCTGTATAGGAATGTCACAGCCCAAGGGGTTCCATCTTTCGTTTCTTTCTCATATCTCTGCAGTCAGAAGGATTGCATAAAAAAATTCTAGTTGGT,10,30,14,27,27,42,27,43,27,35,35,42,36,43,62.42,82.03150793
hek293t,12538,1,1,TATGCTGTATAGGAATGTCACAGCCCAAGGGGTTCATCTTTCGTTTCTTTCTCATATCTCTGCAGTCAGAAGGATTGCATTTTCAAAAAAATTCTAGTT,TATGCTGTATAGGAATGTCACAGCCCAAGGGGTTCCATCTTTCGTTTCTTTCTCATATCTCTGCAGTCAGAAGGATTGCATTTTCAAAAAAATTCTAGT,10,30,14,27,27,38,27,39,27,35,35,38,36,39,62.42,7.236914288
hek293t,12540,1,4,GTCATGGGAGCTGTTGTGCCTTTGGGGTATGGTCTCTGGTAAAAGCCAAGGAGCTGGAGGGAGCAGCACAAAAAAATTCTAGTTGGTTTAACGCGTAAC,GTCATGGGAGCTGTTGTGCCTTTGGGGTATGGTCACTCTCTGGTAAAAGCCAAGGAGCTGGAGGGAGCAGCACAAAAAAATTCTAGTTGGTTTAACGCG,10,30,14,27,27,50,27,54,27,35,35,50,39,54,44.82,70.33287666
hek293t,12542,1,12,TTGCCCTTCAGCTTAGGGTAACTAGAGATTGGAACTGATTAACGTCTGTGATAAACATGTTAATGGAAAATTTAAATGAAAAAAATTCTAGTTGGTTTA,TTGCCCTTCAGCTTAGGGTAACTAGAGATGTAACCAAGTGGTGGAACTGATTAACGTCTGTGATAAACATGTTAATGGAAAATTTAAATGAAAAAAATT,10,30,14,27,27,33,27,45,27,30,30,33,42,45,41.54,0.0
hek293t,12542,1,12,GACAGCTTCAGCTTAGGGTAACTAGAGATTGGAACTGATTAACGTCTGTGATAAACATGTTAATGGAAAAAAATTCTAGTTGGTTTAACGCGTAACTAG,GACAGCTTCAGCTTAGGGTAACTAGAGATGTAACCAAGTGGTGGAACTGATTAACGTCTGTGATAAACATGTTAATGGAAAAAAATTCTAGTTGGTTTA,10,30,14,27,27,45,27,57,27,30,30,45,42,57,41.54,25.19438115
hek293t,12544,1,9,TATATTTAAAGTTAAATCCAGAGATAAATTGGGCACTTAGACATTAGAAGCTTTCAGTAGATGTTCAAAAAAATTCTAGTTGGTTTAACGCGTAACTAG,TATATTTAAAGTTAAATCCAGAGATAAATTGGGCACTATACATTGCTAGACATTAGAAGCTTTCAGTAGATGTTCAAAAAAATTCTAGTTGGTTTAACG,10,30,14,27,27,48,27,57,27,38,38,48,47,57,8.51,2.035161882
hek293t,12544,1,9,CGTTTTTAAAGTTAAATCCAGAGATAAATTGGGCACTTAGACATTAGAAGCTTTCAGTAGATGTTCTGGACACAAAAAAATTCTAGTTGGTTTAACGCG,CGTTTTTAAAGTTAAATCCAGAGATAAATTGGGCACTATACATTGCTAGACATTAGAAGCTTTCAGTAGATGTTCTGGACACAAAAAAATTCTAGTTGG,10,30,14,27,27,41,27,50,27,38,38,41,47,50,8.51,0.0
hek293t,12546,1,12,TCTCGTGGCAAAGAAAATCATTTTTACTTCGGGATGAAAAGTGCAGATAATACATTGAAGTAGCAATTAAAAAAAAAAATTCTAGTTGGTTTAACGCGT,TCTCGTGGCAAAGAAAATCATTTTTACTTCGGTTTGTCCGAGCGGATGAAAAGTGCAGATAATACATTGAAGTAGCAATTAAAAAAAAAAATTCTAGTT,10,30,14,27,27,39,27,51,27,32,32,39,44,51,3.31,0.0
hek293t,12546,1,12,ATCCTTGGCAAAGAAAATCATTTTTACTTCGGGATGAAAAGTGCAGATAATACATTGAAGTAGCAAAAAAATTCTAGTTGGTTTAACGCGTAACTAGAT,ATCCTTGGCAAAGAAAATCATTTTTACTTCGGTTTGTCCGAGCGGATGAAAAGTGCAGATAATACATTGAAGTAGCAAAAAAATTCTAGTTGGTTTAAC,10,30,14,27,27,47,27,59,27,32,32,47,44,59,3.31,0.0
hek293t,12548,1,6,CACAGAATTACTGACAGAGTTTCCTTTGGCGGTAGAGGAGAACGATCTTCGCGATGGGGGCACTGAGCCAGGCAAAAAAATTCTAGTTGGTTTAACGCG,CACAGAATTACTGACAGAGTTTCCTTTGCACGGCGCGGTAGAGGAGAACGATCTTCGCGATGGGGGCACTGAGCCAGGCAAAAAAATTCTAGTTGGTTT,10,30,14,27,27,44,27,50,27,29,29,44,35,50,56.51,76.05657715
hek293t,12550,1,15,GTTGCCGTAGGATACTGTCAGCCTATACTAGGTTAGTTGTTTAAAGGAATGGATAGCAGCAATTTCAAAAAAATTCTAGTTGGTTTAACGCGTAACTAG,GTTGCCGTAGGATACTGTCAGCCTATACTAGGTTAGTTGAAAAGCATGACACTGTTTAAAGGAATGGATAGCAGCAATTTCAAAAAAATTCTAGTTGGT,10,30,14,27,27,42,27,57,27,39,39,42,54,57,46.29,0.28551035
hek293t,12551,1,2,CCTGAACAGCATTTCCCTAGTTCAGTCCAAGGAGGGTTAGGTGATACATGGAAGTAGAAAGTTTTCAGGAGTGATCTGAATTTGGAAAAAAAATTCTAG,CCTGAACAGCATTTCCCTAGTTCAGTCCACAAGGAGGGTTAGGTGATACATGGAAGTAGAAAGTTTTCAGGAGTGATCTGAATTTGGAAAAAAAATTCT,10,30,14,27,27,35,27,37,27,28,28,35,30,37,60.26,67.18295868
hek293t,12551,1,2,TAAGCACAGCATTTCCCTAGTTCAGTCCAAGGAGGGTTAGGTGATACATGGAAGTAGAAAGTTTTCAGGAGTGATCTGAATTTGGAGAGTAAAAAAATT,TAAGCACAGCATTTCCCTAGTTCAGTCCACAAGGAGGGTTAGGTGATACATGGAAGTAGAAAGTTTTCAGGAGTGATCTGAATTTGGAGAGTAAAAAAA,10,30,14,27,27,31,27,33,27,28,28,31,30,33,60.26,0.679650605
hek293t,12553,1,4,CGGCAATCTGAATGCTTTACAAACACAAGGGGCCACATTATTCCATTTTTCTTGAGTACAGCAGAGCAAACCTCATTAAAAAAATTCTAGTTGGTTTAA,CGGCAATCTGAATGCTTTACAAACACGTGCAAGGGGCCACATTATTCCATTTTTCTTGAGTACAGCAGAGCAAACCTCATTAAAAAAATTCTAGTTGGT,10,30,14,27,27,42,27,46,27,27,27,42,31,46,41.93,66.75953622
hek293t,12553,1,4,GTTACATCTGAATGCTTTACAAACACAAGGGGCCACATTATTCCATTTTTCTTGAGTACAGCAGAGCAAACCTCATTTATACTAGAAAAAAATTCTAGT,GTTACATCTGAATGCTTTACAAACACGTGCAAGGGGCCACATTATTCCATTTTTCTTGAGTACAGCAGAGCAAACCTCATTTATACTAGAAAAAAATTC,10,30,14,27,27,34,27,38,27,27,27,34,31,38,41.93,76.45075799
hek293t,12555,1,6,AAGACCAACACCCATCATTTATCCACAGGTGGCTCATACCAATGTAAAAAACATATAAAATGTACTATAATTCTAAAAAAATTCTAGTTGGTTTAACGC,AAGACCAACACCCATCATTTATCCACAGTATTTGGTGGCTCATACCAATGTAAAAAACATATAAAATGTACTATAATTCTAAAAAAATTCTAGTTGGTT,10,30,14,27,27,43,27,49,27,28,28,43,34,49,31.44,82.26269742
hek293t,12555,1,6,GGGGCCAACACCCATCATTTATCCACAGGTGGCTCATACCAATGTAAAAAACATATAAAATGTACTATAATTCTCAACAAAAAAAATTCTAGTTGGTTT,GGGGCCAACACCCATCATTTATCCACAGTATTTGGTGGCTCATACCAATGTAAAAAACATATAAAATGTACTATAATTCTCAACAAAAAAAATTCTAGT,10,30,14,27,27,38,27,44,27,28,28,38,34,44,31.44,80.33107029
hek293t,12557,1,3,GACCCGTGGAATTCAAGTTTATTATCTCTAGGCCAAGCTCTCTTCAAACTCTAAATTTCATCTGCTTCTGCCCCCCCACTAAAAAGTAAAAAAATTCTA,GACCCGTGGAATTCAAGTTTATTATCTCTTGAAGGCCAAGCTCTCTTCAAACTCTAAATTTCATCTGCTTCTGCCCCCCCACTAAAAAGTAAAAAAATT,10,30,14,27,27,33,27,36,27,30,30,33,33,36,13.09,1.126529875
hek293t,12559,1,7,GACCCATGGCAATGCTATTTAAATCAAAGTGGAGAAAGAAGGGTGATGAGGAATGAAGAAAAGGATTAGAAAAAAATTCTAGTTGGTTTAACGCGTAAC,GACCCATGGCAATGCTATTTAAATCAAAGTGGAGAAAGACGTACTTAGGGTGATGAGGAATGAAGAAAAGGATTAGAAAAAAATTCTAGTTGGTTTAAC,10,30,14,27,27,47,27,54,27,40,40,47,47,54,17.39,0.032268474
hek293t,12559,1,7,ATCCGATGGCAATGCTATTTAAATCAAAGTGGAGAAAGAAGGGTGATGAGGAATGAAGAAAAGGATTAGTATAAAAAAAATTCTAGTTGGTTTAACGCG,ATCCGATGGCAATGCTATTTAAATCAAAGTGGAGAAAGACGTACTTAGGGTGATGAGGAATGAAGAAAAGGATTAGTATAAAAAAAATTCTAGTTGGTT,10,30,14,27,27,43,27,50,27,40,40,43,47,50,17.39,0.0
hek293t,12561,1,12,GGCGATGTGGAAAAACAAGCTTTATAACCTGGCTGCAGTTAGGAGTAAAGATTTTTACAGCAAAAAAAAAATTCTAGTTGGTTTAACGCGTAACTAGAT,GGCGATGTGGAAAAACAAGCTTTATAACCTGGCTGCAGTTGTGACCCCGAATAGGAGTAAAGATTTTTACAGCAAAAAAAAAATTCTAGTTGGTTTAAC,10,30,14,27,27,47,27,59,27,40,40,47,52,59,29.48,0.0
hek293t,12562,1,13,TAGGGGTGAGTTTAACTGTTGGAAATGGAAGGTAGCAGCCACCCTAAGGGTTTGTTTGTTTGTTTTAAAAAAATTCTAGTTGGTTTAACGCGTAACTAG,TAGGGGTGAGTTTAACTGTTGGAAATGGAAGGTAGCAGCCCATTGTTACACCGACCCTAAGGGTTTGTTTGTTTGTTTTAAAAAAATTCTAGTTGGTTT,10,30,14,27,27,44,27,57,27,41,41,44,54,57,57.27,0.0
hek293t,12563,1,13,AGATCAAATAAGGAAAAGTGTCTGAGTAAAGGTCATAAAGAGTAACATCATTGGCTACATTTATATTAAGGAAAAAAATTCTAGTTGGTTTAACGCGTA,AGATCAAATAAGGAAAAGTGTCTGAGTACGACGCCAGGATCAAGGTCATAAAGAGTAACATCATTGGCTACATTTATATTAAGGAAAAAAATTCTAGTT,10,30,14,27,27,39,27,52,27,29,29,39,42,52,35.49,2.10232325
hek293t,12563,1,13,GTACAAAATAAGGAAAAGTGTCTGAGTAAAGGTCATAAAGAGTAACATCATTGGCTACATTTATATTAAGGTAAAAAAAAATTCTAGTTGGTTTAACGC,GTACAAAATAAGGAAAAGTGTCTGAGTACGACGCCAGGATCAAGGTCATAAAGAGTAACATCATTGGCTACATTTATATTAAGGTAAAAAAAAATTCTA,10,30,14,27,27,36,27,49,27,29,29,36,42,49,35.49,0.519658311
hek293t,12565,1,6,AGTTTTAGGGCCTCTGTATTCCTACAGACAGGAATTCTGTAATCACAGCCAAGTTGTGCAAGGGGGGTCAAAAAAATTCTAGTTGGTTTAACGCGTAAC,AGTTTTAGGGCCTCTGTATTCCTACAGACAGGAATTCTGTCCTACAAATCACAGCCAAGTTGTGCAAGGGGGGTCAAAAAAATTCTAGTTGGTTTAACG,10,30,14,27,27,48,27,54,27,41,41,48,47,54,59.11,5.610892539
hek293t,12565,1,6,ACAACTAGGGCCTCTGTATTCCTACAGACAGGAATTCTGTAATCACAGCCAAGTTGTGCAAGGGGGGTCCATGAAAAAAATTCTAGTTGGTTTAACGCG,ACAACTAGGGCCTCTGTATTCCTACAGACAGGAATTCTGTCCTACAAATCACAGCCAAGTTGTGCAAGGGGGGTCCATGAAAAAAATTCTAGTTGGTTT,10,30,14,27,27,44,27,50,27,41,41,44,47,50,59.11,0.157232704
hek293t,12567,1,15,GTCGATCTGAAAAGCAAGGACTCTGCAGAAGGGTCACAGCCTGTAAGTTGCCCCCCCCAGTCGTATTTTAAAAAAATTCTAGTTGGTTTAACGCGTAAC,GTCGATCTGAAAAGCAAGGACTCTGCAGAAGGGTCTAAGGTGCTCCATTGACAGCCTGTAAGTTGCCCCCCCCAGTCGTATTTTAAAAAAATTCTAGTT,10,30,14,27,27,39,27,54,27,36,36,39,51,54,19.84,1.182294573
hek293t,12567,1,15,CTGGATCTGAAAAGCAAGGACTCTGCAGAAGGGTCACAGCCTGTAAGTTGCCCCCCCCAGTCGTAAAAAAAATTCTAGTTGGTTTAACGCGTAACTAGA,CTGGATCTGAAAAGCAAGGACTCTGCAGAAGGGTCTAAGGTGCTCCATTGACAGCCTGTAAGTTGCCCCCCCCAGTCGTAAAAAAAATTCTAGTTGGTT,10,30,14,27,27,43,27,58,27,36,36,43,51,58,19.84,2.283115145
hek293t,12569,1,12,ATACTACCCTATCAATATTACATGTGCAGTGGGAAGCTCAGGAGATACACTATTACAGTACAACATGGCAATAAAAAAATTCTAGTTGGTTTAACGCGT,ATACTACCCTATCAATATTACATGTGCAATATTTATGTTGGTGGGAAGCTCAGGAGATACACTATTACAGTACAACATGGCAATAAAAAAATTCTAGTT,10,30,14,27,27,39,27,51,27,29,29,39,41,51,26.33,1.422510697
hek293t,12569,1,12,GGTGCACCCTATCAATATTACATGTGCAGTGGGAAGCTCAGGAGATACACTATTACAGTACAACATGAAAAAAATTCTAGTTGGTTTAACGCGTAACTA,GGTGCACCCTATCAATATTACATGTGCAATATTTATGTTGGTGGGAAGCTCAGGAGATACACTATTACAGTACAACATGAAAAAAATTCTAGTTGGTTT,10,30,14,27,27,44,27,56,27,29,29,44,41,56,26.33,2.330197046
hek293t,12571,1,12,TATCAGCCATGCACAAAATGAGAGAGCACTGGTGTGTGGAAGGTTCCTTCTGTGTGTCGATCTGGAAGAAAAAAATTCTAGTTGGTTTAACGCGTAACT,TATCAGCCATGCACAAAATGAGAGAGCACTGGTGTGTGGAGATTCGGGGGAAAGGTTCCTTCTGTGTGTCGATCTGGAAGAAAAAAATTCTAGTTGGTT,10,30,14,27,27,43,27,55,27,40,40,43,52,55,52.92,0.0
hek293t,12572,1,2,AACCGTTTCTATTAAAAATTGTTCCAGGGTGGATCATTTACTGAAATCTAGAAATAAAATCCGTAATAAACTTAATATGCAAAAGAAAAAAATTCTAGT,AACCGTTTCTATTAAAAATTGTTCCAGGGAGTGGATCATTTACTGAAATCTAGAAATAAAATCCGTAATAAACTTAATATGCAAAAGAAAAAAATTCTA,10,30,14,27,27,36,27,38,27,29,29,36,31,38,25.43,1.595728959
hek293t,12574,1,5,CGTAATCTGCATGTGCTGACATTCAGCTCTGGATCTCCTGGTGTGCATATACCATCCAGGGCATGATTGCTGTAAGCCCTTAAAAAAATTCTAGTTGGT,CGTAATCTGCATGTGCTGACATTCAGCTCTGGATATACTCTCCTGGTGTGCATATACCATCCAGGGCATGATTGCTGTAAGCCCTTAAAAAAATTCTAG,10,30,14,27,27,37,27,42,27,34,34,37,39,42,53.67,3.908234099
hek293t,12574,1,5,CGCCTTCTGCATGTGCTGACATTCAGCTCTGGATCTCCTGGTGTGCATATACCATCCAGGGCATGATTGCTGTAAAAAAAATTCTAGTTGGTTTAACGC,CGCCTTCTGCATGTGCTGACATTCAGCTCTGGATATACTCTCCTGGTGTGCATATACCATCCAGGGCATGATTGCTGTAAAAAAAATTCTAGTTGGTTT,10,30,14,27,27,44,27,49,27,34,34,44,39,49,53.67,78.60746249
hek293t,12576,1,9,GTCGAATATTCATTCTGAATTGTTAATACAGGAATGTTATCCTAAATTGATGACCAGCCCCCCCCCTATGTCAAAAAAAATTCTAGTTGGTTTAACGCG,GTCGAATATTCATTCTGAATTGTTAATACAGGCGCGTTAGGAATGTTATCCTAAATTGATGACCAGCCCCCCCCCTATGTCAAAAAAAATTCTAGTTGG,10,30,14,27,27,41,27,50,27,31,31,41,40,50,18.91,4.462957163
hek293t,12581,1,15,GATCGCTGGTTTTACAAGGCTGCCTGTCGTGGTTAATAACTGCCTCAAGCACATATGGTAACTTACCAAAAAAATTCTAGTTGGTTTAACGCGTAACTA,GATCGCTGGTTTTACAAGGCTGCCTGTCGTGGTAAATCAAGGGATTCCTAATAACTGCCTCAAGCACATATGGTAACTTACCAAAAAAATTCTAGTTGG,10,30,14,27,27,41,27,56,27,34,34,41,49,56,35.66,0.0
hek293t,12582,1,3,GCTGATTCTTAAGAGTAGGGCAGATAGTTTGGATCTTTTCTACCAGTCTGATTTCAGTCTGTGTGTGGACCCCCCCCAAAAAAATTCTAGTTGGTTTAA,GCTGATTCTTAAGAGTAGGGCAGATAGAGCTTTGGATCTTTTCTACCAGTCTGATTTCAGTCTGTGTGTGGACCCCCCCCAAAAAAATTCTAGTTGGTT,10,30,14,27,27,43,27,46,27,28,28,43,31,46,33.17,82.66227697
hek293t,12583,1,15,AGAAACTGGAGCGGTACAACAGGCAGACCAGGAAAGCCCTGGAACAGAGCAGCCACAGGGCAGCAAAGGAGGTGAAAAAAATTCTAGTTGGTTTAACGC,AGAAACTGGAGCGGTACAACAGGCAGACCACCACGTTTCGGAGCTGGAAAGCCCTGGAACAGAGCAGCCACAGGGCAGCAAAGGAGGTGAAAAAAATTC,10,30,14,27,27,34,27,49,27,31,31,34,46,49,49.53,5.376505014
hek293t,12583,1,15,GAAATCTGGAGCGGTACAACAGGCAGACCAGGAAAGCCCTGGAACAGAGCAGCCACAGGGCAGCAAAAAAAAAATTCTAGTTGGTTTAACGCGTAACTA,GAAATCTGGAGCGGTACAACAGGCAGACCACCACGTTTCGGAGCTGGAAAGCCCTGGAACAGAGCAGCCACAGGGCAGCAAAAAAAAAATTCTAGTTGG,10,30,14,27,27,41,27,56,27,31,31,41,46,56,49.53,53.10040854
hek293t,12585,1,1,GAAAAGCCAGCAAATAAAGAAATATGTTCTGGTAGGACAGAAGGGAGAGGGAAAGGGACTGATCTAAAACCCACTGAAAAAAAAAATTCTAGTTGGTTT,GAAAAGCCAGCAAATAAAGAAATATGTTCTGGGTAGGACAGAAGGGAGAGGGAAAGGGACTGATCTAAAACCCACTGAAAAAAAAAATTCTAGTTGGTT,10,30,14,27,27,43,27,44,27,33,33,43,34,44,25.63,1.042106179
hek293t,12585,1,1,GCTGCGCCAGCAAATAAAGAAATATGTTCTGGTAGGACAGAAGGGAGAGGGAAAGGGACTGATCTAAAACCCACTGAAACTAGAACAAAAAAATTCTAG,GCTGCGCCAGCAAATAAAGAAATATGTTCTGGGTAGGACAGAAGGGAGAGGGAAAGGGACTGATCTAAAACCCACTGAAACTAGAACAAAAAAATTCTA,10,30,14,27,27,36,27,37,27,33,33,36,34,37,25.63,0.648248542
hek293t,12587,1,5,GCATGTTAGGTGCTTAATGTTTGGTGATGTGGAAACCCCTGTGTGTCCATCAGTAAAAAGGGATGGGAAGAAAAAAAATTCTAGTTGGTTTAACGCGTA,GCATGTTAGGTGCTTAATGTTTGGTGATGTGGAAACAACGGCCCTGTGTGTCCATCAGTAAAAAGGGATGGGAAGAAAAAAAATTCTAGTTGGTTTAAC,10,30,14,27,27,47,27,52,27,37,37,47,42,52,13.8,74.30757858
hek293t,12589,1,5,CCTCGAAAATATCTTGGTTAAAGATGGTCTGGTACTATCATATGGATCAAAGGAAAAGATGAATCTAAAAAAATTCTAGTTGGTTTAACGCGTAACTAG,CCTCGAAAATATCTTGGTTAAAGATGGTCTGGTACTTACCAATCATATGGATCAAAGGAAAAGATGAATCTAAAAAAATTCTAGTTGGTTTAACGCGTA,10,30,14,27,27,52,27,57,27,37,37,52,42,57,35.71,2.20605753
hek293t,12589,1,5,TATTTAAAATATCTTGGTTAAAGATGGTCTGGTACTATCATATGGATCAAAGGAAAAGATGAATCTTGTTGAAAAAAATTCTAGTTGGTTTAACGCGTA,TATTTAAAATATCTTGGTTAAAGATGGTCTGGTACTTACCAATCATATGGATCAAAGGAAAAGATGAATCTTGTTGAAAAAAATTCTAGTTGGTTTAAC,10,30,14,27,27,47,27,52,27,37,37,47,42,52,35.71,3.744103894
hek293t,12591,1,11,TGGTAACTCCCAGTGGTAAAAGAAGATTTAGGTATCTCTGAAGATTTCTTATCGCTGTGCAACATAACTCTAAAAAAATTCTAGTTGGTTTAACGCGTA,TGGTAACTCCCAGTGGTAAAAGAAGATTTAGGTTCAATAGGCCCATCTCTGAAGATTTCTTATCGCTGTGCAACATAACTCTAAAAAAATTCTAGTTGG,10,30,14,27,27,41,27,52,27,34,34,41,45,52,45.48,0.0
hek293t,12592,1,10,CAACGGTCCAGCAGACTTTATTCTACATCAGGCTCTGGAAAGTAAGGATTACTGCTGCTAACCAGAAAAAAATTCTAGTTGGTTTAACGCGTAACTAGA,CAACGGTCCAGCAGACTTTATTCTACATCAGGCTCTGCACACTGATGGAAAGTAAGGATTACTGCTGCTAACCAGAAAAAAATTCTAGTTGGTTTAACG,10,30,14,27,27,48,27,58,27,38,38,48,48,58,6.69,6.15702351
hek293t,12592,1,10,GGTGCGTCCAGCAGACTTTATTCTACATCAGGCTCTGGAAAGTAAGGATTACTGCTGCTAACCAGATTAAAAAAATTCTAGTTGGTTTAACGCGTAACT,GGTGCGTCCAGCAGACTTTATTCTACATCAGGCTCTGCACACTGATGGAAAGTAAGGATTACTGCTGCTAACCAGATTAAAAAAATTCTAGTTGGTTTA,10,30,14,27,27,45,27,55,27,38,38,45,48,55,6.69,1.448182697
hek293t,12596,1,2,GAGGGTCTCTGTATGTATCTATACTCATTAGGCTAGTGAGAAAATGTAACTTACTTTCATAATCTCCTTCCCAAAAAAATTCTAGTTGGTTTAACGCGT,GAGGGTCTCTGTATGTATCTATACTCATTAGGCGTTAGTGAGAAAATGTAACTTACTTTCATAATCTCCTTCCCAAAAAAATTCTAGTTGGTTTAACGC,10,30,14,27,27,49,27,51,27,34,34,49,36,51,20.29,25.20442994
hek293t,12596,1,2,TGATCTCTCTGTATGTATCTATACTCATTAGGCTAGTGAGAAAATGTAACTTACTTTCATAATCTCCTTCCCTATAGAAAAAAATTCTAGTTGGTTTAA,TGATCTCTCTGTATGTATCTATACTCATTAGGCGTTAGTGAGAAAATGTAACTTACTTTCATAATCTCCTTCCCTATAGAAAAAAATTCTAGTTGGTTT,10,30,14,27,27,44,27,46,27,34,34,44,36,46,20.29,85.94808484
hek293t,12598,1,8,CTGACTGAAAACGGACAAAATAACTTCCATGGAAAAGGGTCATATGACTGCTAAAAGGTACCTTTCCCCAAGAGCAAAAAAATTCTAGTTGGTTTAACG,CTGACTGAAAACGGACAAAATAACTTCCAGAGGCATGTGGAAAAGGGTCATATGACTGCTAAAAGGTACCTTTCCCCAAGAGCAAAAAAATTCTAGTTG,10,30,14,27,27,40,27,48,27,30,30,40,38,48,47.21,0.063371356
hek293t,12598,1,8,AAATTTGAAAACGGACAAAATAACTTCCATGGAAAAGGGTCATATGACTGCTAAAAGGTACCTTTCCCCAAAAAAAATTCTAGTTGGTTTAACGCGTAA,AAATTTGAAAACGGACAAAATAACTTCCAGAGGCATGTGGAAAAGGGTCATATGACTGCTAAAAGGTACCTTTCCCCAAAAAAAATTCTAGTTGGTTTA,10,30,14,27,27,45,27,53,27,30,30,45,38,53,47.21,0.0
hek293t,12600,1,13,ATTAACAGCAAAGGATGAAAAGATAACAGTGGCGAAGAGGCACATAAGAAGACAGGAGAAAGGGAAGGGAAAAAAAAAATTCTAGTTGGTTTAACGCGT,ATTAACAGCAAAGGATGAAAAGATAACAGTAACAATGTTTTAGGGCGAAGAGGCACATAAGAAGACAGGAGAAAGGGAAGGGAAAAAAAAAATTCTAGT,10,30,14,27,27,38,27,51,27,31,31,38,44,51,76.74,0.031610558
hek293t,12600,1,13,TGTTCCAGCAAAGGATGAAAAGATAACAGTGGCGAAGAGGCACATAAGAAGACAGGAGAAAGGGAAAAAAATTCTAGTTGGTTTAACGCGTAACTAGAT,TGTTCCAGCAAAGGATGAAAAGATAACAGTAACAATGTTTTAGGGCGAAGAGGCACATAAGAAGACAGGAGAAAGGGAAAAAAATTCTAGTTGGTTTAA,10,30,14,27,27,46,27,59,27,31,31,46,44,59,76.74,0.076097203
hek293t,12602,1,1,CTCAAAAAGACTGTACTCAGCTAAAGTAGAGGAAATGCACAGTTACACCACTTTGATCTCTGTGTGTCAACAGGATTGACAAAAAAATTCTAGTTGGTT,CTCAAAAAGACTGTACTCAGCTAAAGATAGAGGAAATGCACAGTTACACCACTTTGATCTCTGTGTGTCAACAGGATTGACAAAAAAATTCTAGTTGGT,10,30,14,27,27,42,27,43,27,27,27,42,28,43,59.67,35.12965116
hek293t,12602,1,1,CAAGGAAAGACTGTACTCAGCTAAAGTAGAGGAAATGCACAGTTACACCACTTTGATCTCTGTGTGTCAACAGGATTGACTTGAAAAAAAAATTCTAGT,CAAGGAAAGACTGTACTCAGCTAAAGATAGAGGAAATGCACAGTTACACCACTTTGATCTCTGTGTGTCAACAGGATTGACTTGAAAAAAAAATTCTAG,10,30,14,27,27,37,27,38,27,27,27,37,28,38,59.67,28.58409698
hek293t,12604,1,6,ATAGGTATTATTAAGATTCCTGAAATAACTGGGGAGACAATACAAACAGAAGAAAAACAGGCATACTCTTCATGAAAAAAATTCTAGTTGGTTTAACGC,ATAGGTATTATTAAGATTCCTGAAATAACTGGGGAGACAGTTGGCATACAAACAGAAGAAAAACAGGCATACTCTTCATGAAAAAAATTCTAGTTGGTT,10,30,14,27,27,43,27,49,27,40,40,43,46,49,5.18,0.208215029
hek293t,12604,1,6,CGCCATATTATTAAGATTCCTGAAATAACTGGGGAGACAATACAAACAGAAGAAAAACAGGCATACTAAAAAAATTCTAGTTGGTTTAACGCGTAACTA,CGCCATATTATTAAGATTCCTGAAATAACTGGGGAGACAGTTGGCATACAAACAGAAGAAAAACAGGCATACTAAAAAAATTCTAGTTGGTTTAACGCG,10,30,14,27,27,50,27,56,27,40,40,50,46,56,5.18,2.483338489
hek293t,12606,1,3,CTCTGATTGCCATGTGTATTGGGTCTTCTTGGAAGTGATCCTGACATTAGAGACAGTCTGTTAAACAAGCAAAAAAATTCTAGTTGGTTTAACGCGTAA,CTCTGATTGCCATGTGTATTGGGTCTTCTTGGAAGTGATTTTCCTGACATTAGAGACAGTCTGTTAAACAAGCAAAAAAATTCTAGTTGGTTTAACGCG,10,30,14,27,27,50,27,53,27,40,40,50,43,53,10.2,57.30089688
hek293t,12607,1,13,GCGCTCAAGAGCAGTGAAGTTGGCAGGTATGGGAAATCCACAGTCCTCCAGAATTTGCCACTGCTTTGCTCCATGATCTAAAAAAATTCTAGTTGGTTT,GCGCTCAAGAGCAGTGAAGTTGGCAGGCAGAGGGTGTGTCTATGGGAAATCCACAGTCCTCCAGAATTTGCCACTGCTTTGCTCCATGATCTAAAAAAA,10,30,14,27,27,31,27,44,27,28,28,31,41,44,27.92,0.476166571
hek293t,12607,1,13,AATCCCAAGAGCAGTGAAGTTGGCAGGTATGGGAAATCCACAGTCCTCCAGAATTTGCCACTGCTTTGCTCCATGAAAAAAATTCTAGTTGGTTTAACG,AATCCCAAGAGCAGTGAAGTTGGCAGGCAGAGGGTGTGTCTATGGGAAATCCACAGTCCTCCAGAATTTGCCACTGCTTTGCTCCATGAAAAAAATTCT,10,30,14,27,27,35,27,48,27,28,28,35,41,48,27.92,0.060882801
hek293t,12609,1,12,CGGTTATATTATATTTTTATAGTCCAGATAGGATTTTATATTACACCAACTGCCAGAGTTCAGCTGTGGTTACTCAAAAAAATTCTAGTTGGTTTAACG,CGGTTATATTATATTTTTATAGTCCAGACTGTTGGAACGATAGGATTTTATATTACACCAACTGCCAGAGTTCAGCTGTGGTTACTCAAAAAAATTCTA,10,30,14,27,27,36,27,48,27,29,29,36,41,48,1.07,0.33626525
hek293t,12611,1,12,TTCACTTCTTTGCTTGGTTCTTGCAAGCTTGGGACCGATTGTTACATCTTTTTCTGTATTTATCTCTTTTTATAACAAAAAAAATTCTAGTTGGTTTAA,TTCACTTCTTTGCTTGGTTCTTGCAACAAGGACGATTAGCTTGGGACCGATTGTTACATCTTTTTCTGTATTTATCTCTTTTTATAACAAAAAAAATTC,10,30,14,27,27,34,27,46,27,27,27,34,39,46,9.09,5.884368394
hek293t,12613,1,13,TTCCGCTAATAGTCATGCAGTCGGAAAGCTGGAATATTATAAATTCCATCCTGTGCTCCAGACTGCAGAAAAAAATTCTAGTTGGTTTAACGCGTAACT,TTCCGCTAATAGTCATGCAGTCGGAACTTTTGCGCAGTAAGCTGGAATATTATAAATTCCATCCTGTGCTCCAGACTGCAGAAAAAAATTCTAGTTGGT,10,30,14,27,27,42,27,55,27,27,27,42,40,55,40.62,10.25987772
hek293t,12613,1,13,TTGAACTAATAGTCATGCAGTCGGAAAGCTGGAATATTATAAATTCCATCCTGTGCTCCAGACTGCAGAGGCAAAAAAAATTCTAGTTGGTTTAACGCG,TTGAACTAATAGTCATGCAGTCGGAACTTTTGCGCAGTAAGCTGGAATATTATAAATTCCATCCTGTGCTCCAGACTGCAGAGGCAAAAAAAATTCTAG,10,30,14,27,27,37,27,50,27,27,27,37,40,50,40.62,5.699315345
hek293t,12615,1,3,GGGTCTACAACAAATGTATTATGCTACTAAGGTATTGAAATACATAACCTCTGTGGCTATGACAGCCTTTTGGAAAAAAAAAAAAATTCTAGTTGGTTT,GGGTCTACAACAAATGTATTATGCTACTAAGGTATTGGACAAATACATAACCTCTGTGGCTATGACAGCCTTTTGGAAAAAAAAAAAAATTCTAGTTGG,10,30,14,27,27,41,27,44,27,38,38,41,41,44,29.69,0.0
hek293t,12615,1,3,CCGAGTACAACAAATGTATTATGCTACTAAGGTATTGAAATACATAACCTCTGTGGCTATGACAGCCTTTTGGAAAAAAAAATTCTAGTTGGTTTAACG,CCGAGTACAACAAATGTATTATGCTACTAAGGTATTGGACAAATACATAACCTCTGTGGCTATGACAGCCTTTTGGAAAAAAAAATTCTAGTTGGTTTA,10,30,14,27,27,45,27,48,27,38,38,45,41,48,29.69,31.34110625
hek293t,12617,1,14,CTCAGCCTATATGAAAATTCTTTATATGAAGGGATTAAAAAAGATCATTTCTTTGCTGAATGTATTTGAGCTGAAAAAAAATTCTAGTTGGTTTAACGC,CTCAGCCTATATGAAAATTCTTTATATGGTTCGCGTTCACGGAAGGGATTAAAAAAGATCATTTCTTTGCTGAATGTATTTGAGCTGAAAAAAAATTCT,10,30,14,27,27,35,27,49,27,28,28,35,42,49,15.93,0.0
hek293t,12617,1,14,AAGGCCCTATATGAAAATTCTTTATATGAAGGGATTAAAAAAGATCATTTCTTTGCTGAATGTATTTGAGCTGACCTCAAAAAAATTCTAGTTGGTTTA,AAGGCCCTATATGAAAATTCTTTATATGGTTCGCGTTCACGGAAGGGATTAAAAAAGATCATTTCTTTGCTGAATGTATTTGAGCTGACCTCAAAAAAA,10,30,14,27,27,31,27,45,27,28,28,31,42,45,15.93,0.0
hek293t,12619,1,15,CAGGGAAAATAACCTGTTACTTTTAAAGAAGGGAATAATGCACTTAACCTGTTTGAAGGACTACTTAAAAAAATTCTAGTTGGTTTAACGCGTAACTAG,CAGGGAAAATAACCTGTTACTTTTAAAGAAGGGAATAATTCTCTGATCTGCAATGCACTTAACCTGTTTGAAGGACTACTTAAAAAAATTCTAGTTGGT,10,30,14,27,27,42,27,57,27,39,39,42,54,57,14.33,0.0
hek293t,12622,1,4,TAGCCAATGATTTTTGAACAAGAAAGTTTTGGACTTGTAAACTTGCTCTCCAACAAAAATAAAATACTGCTGAAAAAAATTCTAGTTGGTTTAACGCGT,TAGCCAATGATTTTTGAACAAGAAAGTTTTGTATAGACTTGTAAACTTGCTCTCCAACAAAAATAAAATACTGCTGAAAAAAATTCTAGTTGGTTTAAC,10,30,14,27,27,47,27,51,27,32,32,47,36,51,4.81,3.308431114
hek293t,12622,1,4,TGTTCAATGATTTTTGAACAAGAAAGTTTTGGACTTGTAAACTTGCTCTCCAACAAAAATAAAATACTGCTGCACCTGGGAGCTAAAAAAATTCTAGTT,TGTTCAATGATTTTTGAACAAGAAAGTTTTGTATAGACTTGTAAACTTGCTCTCCAACAAAAATAAAATACTGCTGCACCTGGGAGCTAAAAAAATTCT,10,30,14,27,27,35,27,39,27,32,32,35,36,39,4.81,0.0
hek293t,12624,1,9,CTTGTGGGAAATGGGAGTGGCTGGAGGTCAGGGACAAAGGATAAATTTAAGTGTGCTACGACTGAAAAAGAAAAAAAATTCTAGTTGGTTTAACGCGTA,CTTGTGGGAAATGGGAGTGGCTGGAGGTCAGGGACGAGCAGCGCAAAGGATAAATTTAAGTGTGCTACGACTGAAAAAGAAAAAAAATTCTAGTTGGTT,10,30,14,27,27,43,27,52,27,36,36,43,45,52,38.55,2.713365543
hek293t,12624,1,9,TTCACGGGAAATGGGAGTGGCTGGAGGTCAGGGACAAAGGATAAATTTAAGTGTGCTACGACTGAAAAAAAAAAATTCTAGTTGGTTTAACGCGTAACT,TTCACGGGAAATGGGAGTGGCTGGAGGTCAGGGACGAGCAGCGCAAAGGATAAATTTAAGTGTGCTACGACTGAAAAAAAAAAATTCTAGTTGGTTTAA,10,30,14,27,27,46,27,55,27,36,36,46,45,55,38.55,1.834887115
hek293t,12626,1,12,GTGCGACCAATGGCACACATTGGACTTTGGGGTTTGTTTTGTTCTGATGACTTTTGCCTTTCTGCAAAAAAATTCTAGTTGGTTTAACGCGTAACTAGA,GTGCGACCAATGGCACACATTGGACTTTGGCCCAGCGAGTGAGGTTTGTTTTGTTCTGATGACTTTTGCCTTTCTGCAAAAAAATTCTAGTTGGTTTAA,10,30,14,27,27,46,27,58,27,31,31,46,43,58,42.55,47.74139363
hek293t,12626,1,12,TGCGAACCAATGGCACACATTGGACTTTGGGGTTTGTTTTGTTCTGATGACTTTTGCCTTTCTGCTGGTCAAAAAAATTCTAGTTGGTTTAACGCGTAA,TGCGAACCAATGGCACACATTGGACTTTGGCCCAGCGAGTGAGGTTTGTTTTGTTCTGATGACTTTTGCCTTTCTGCTGGTCAAAAAAATTCTAGTTGG,10,30,14,27,27,41,27,53,27,31,31,41,43,53,42.55,42.196898
hek293t,12628,1,2,GTTGTAAACTATTTGATGCCTCCTTCACATGGAAACCGATGGAGTTTCTCCATGTCCTCACCGCTACTTCTTTCTTTAAAAAAATTCTAGTTGGTTTAA,GTTGTAAACTATTTGATGCCTCCTTCACATGGAAACTCCGATGGAGTTTCTCCATGTCCTCACCGCTACTTCTTTCTTTAAAAAAATTCTAGTTGGTTT,10,30,14,27,27,44,27,46,27,37,37,44,39,46,42.4,84.51477238
hek293t,12630,1,8,CGCTGTTGTCTTTGGTCAACTCAGGATCAAGGCACAGACGCCAAGAAAAGCCGTCCTAAGACTGGCATTGCTTGTACTAAAAAAATTCTAGTTGGTTTA,CGCTGTTGTCTTTGGTCAACTCAGGATCAACGCATTAAGGCACAGACGCCAAGAAAAGCCGTCCTAAGACTGGCATTGCTTGTACTAAAAAAATTCTAG,10,30,14,27,27,37,27,45,27,30,30,37,38,45,58.56,59.52006657
hek293t,12630,1,8,CAGGCTTGTCTTTGGTCAACTCAGGATCAAGGCACAGACGCCAAGAAAAGCCGTCCTAAGACTGGCATTGCTTGTACTGATGAAAAAAATTCTAGTTGG,CAGGCTTGTCTTTGGTCAACTCAGGATCAACGCATTAAGGCACAGACGCCAAGAAAAGCCGTCCTAAGACTGGCATTGCTTGTACTGATGAAAAAAATT,10,30,14,27,27,33,27,41,27,30,30,33,38,41,58.56,0.940688541
hek293t,12632,1,7,AGAGATTATTGCAGCTGTATGTTCTCTATTGGGATTTGGCCCTTTGTGGATAGGTGAATGGTTCTTCGGAAAAAAATTCTAGTTGGTTTAACGCGTAAC,AGAGATTATTGCAGCTGTATGTTCTCTATTGGGATTTGGCCCGTGCCCCTTTGTGGATAGGTGAATGGTTCTTCGGAAAAAAATTCTAGTTGGTTTAAC,10,30,14,27,27,47,27,54,27,40,40,47,47,54,6.64,0.0
hek293t,12633,1,8,GTGTGATAAACTTTTTCATGTTATGAATCAGGAAATACACAGTCTTAATATTTACTGTCTAGCAAAAAAAATTCTAGTTGGTTTAACGCGTAACTAGAT,GTGTGATAAACTTTTTCATGTTATGAATCAGGAAATACACATACAGGCAGTCTTAATATTTACTGTCTAGCAAAAAAAATTCTAGTTGGTTTAACGCGT,10,30,14,27,27,51,27,59,27,41,41,51,49,59,6.79,0.722793117
hek293t,12634,1,15,TCTATCCACCAGCACGCTCGCCCTCCCTGCGGCGGCCCTGCCGGCACCCCGAGGTTAGGCTGTACCAAAAAAATTCTAGTTGGTTTAACGCGTAACTAG,TCTATCCACCAGCACGCTCGCCCTCCCTGCGACAGGTGGATGAAATGCGGCCCTGCCGGCACCCCGAGGTTAGGCTGTACCAAAAAAATTCTAGTTGGT,10,30,14,27,27,42,27,57,27,32,32,42,47,57,58.07,17.30050208
hek293t,12636,1,13,AGTAGGGTGCAGAAAAAAGCTTTTTCTAGTGGGGCTCATGTTTATCATGTGAAAGAAGAAATACAAAAAAATTCTAGTTGGTTTAACGCGTAACTAGAT,AGTAGGGTGCAGAAAAAAGCTTTTTCTAGTGGGGCCCTTAGGTGGTAATCATGTTTATCATGTGAAAGAAGAAATACAAAAAAATTCTAGTTGGTTTAA,10,30,14,27,27,46,27,59,27,36,36,46,49,59,2.19,0.032970656
hek293t,12636,1,13,AGCAGGGTGCAGAAAAAAGCTTTTTCTAGTGGGGCTCATGTTTATCATGTGAAAGAAGAAATACCTGAGATAAAAAAATTCTAGTTGGTTTAACGCGTA,AGCAGGGTGCAGAAAAAAGCTTTTTCTAGTGGGGCCCTTAGGTGGTAATCATGTTTATCATGTGAAAGAAGAAATACCTGAGATAAAAAAATTCTAGTT,10,30,14,27,27,39,27,52,27,36,36,39,49,52,2.19,0.0
hek293t,12638,1,15,AGGTGGTAAGTTACAGGAGGTGTTACAAGAGGAAGAAGGTTTTGTTTATTCTGATGTTCTTAAACTTAAAAAAATTCTAGTTGGTTTAACGCGTAACTA,AGGTGGTAAGTTACAGGAGGTGTTACAAGAAGCCGCCTCACCTGCGGAAGAAGGTTTTGTTTATTCTGATGTTCTTAAACTTAAAAAAATTCTAGTTGG,10,30,14,27,27,41,27,56,27,31,31,41,46,56,68.4,15.72786026
hek293t,12638,1,15,AATGCGTAAGTTACAGGAGGTGTTACAAGAGGAAGAAGGTTTTGTTTATTCTGATGTTCTTAAACTTCTTCACGAAAAAAATTCTAGTTGGTTTAACGC,AATGCGTAAGTTACAGGAGGTGTTACAAGAAGCCGCCTCACCTGCGGAAGAAGGTTTTGTTTATTCTGATGTTCTTAAACTTCTTCACGAAAAAAATTC,10,30,14,27,27,34,27,49,27,31,31,34,46,49,68.4,0.088183422
hek293t,12640,1,14,CATAAAAAATCTGCTAATCCCTTTAGACATGGTCTCTAACAACTTTGCGAGAGAAACTGCAGCTCCAAAAAAATTCTAGTTGGTTTAACGCGTAACTAG,CATAAAAAATCTGCTAATCCCTTTAGATGGGACCCGGCAACCATGGTCTCTAACAACTTTGCGAGAGAAACTGCAGCTCCAAAAAAATTCTAGTTGGTT,10,30,14,27,27,43,27,57,27,28,28,43,42,57,46.3,4.438246641
hek293t,12640,1,14,GACTCAAAATCTGCTAATCCCTTTAGACATGGTCTCTAACAACTTTGCGAGAGAAACTGCAGCTCCTTTTGACAGAAAAAAAAAATTCTAGTTGGTTTA,GACTCAAAATCTGCTAATCCCTTTAGATGGGACCCGGCAACCATGGTCTCTAACAACTTTGCGAGAGAAACTGCAGCTCCTTTTGACAGAAAAAAAAAA,10,30,14,27,27,31,27,45,27,28,28,31,42,45,46.3,0.0
hek293t,12642,1,15,CGGTAGCAATTATGGCTGGACTGAAAGCATGGCTGGAATGAAAAGAGAGGAAAAAGCTGTGCCCCCCCCCAAGAAAAAAATTCTAGTTGGTTTAACGCG,CGGTAGCAATTATGGCTGGACTGAAAGCATGTCTGTGGACGGGTTTGCTGGAATGAAAAGAGAGGAAAAAGCTGTGCCCCCCCCCAAGAAAAAAATTCT,10,30,14,27,27,35,27,50,27,32,32,35,47,50,64.3,0.030892802
hek293t,12643,1,3,GCTCCTAATGCTTCATGAGAAAGATATGCAGGTAACAGATACCTTACCTGATGTTCCACCATCTCAGAAGGCTGCTACTGACAGAAAAAAATTCTAGTT,GCTCCTAATGCTTCATGAGAAAGATATGCAGGTTCTAACAGATACCTTACCTGATGTTCCACCATCTCAGAAGGCTGCTACTGACAGAAAAAAATTCTA,10,30,14,27,27,36,27,39,27,33,33,36,36,39,56.95,0.068540096
hek293t,12643,1,3,GCCGCTAATGCTTCATGAGAAAGATATGCAGGTAACAGATACCTTACCTGATGTTCCACCATCTCAGAAGGCAAAAAAATTCTAGTTGGTTTAACGCGT,GCCGCTAATGCTTCATGAGAAAGATATGCAGGTTCTAACAGATACCTTACCTGATGTTCCACCATCTCAGAAGGCAAAAAAATTCTAGTTGGTTTAACG,10,30,14,27,27,48,27,51,27,33,33,48,36,51,56.95,42.93602364
hek293t,12645,1,11,GCAACAGCATGCCATAAATCTTGCTTTACAGGACAGGATACTCTGTGTTGCTAGAATTTGTTATAAAGCCAAAAAAATTCTAGTTGGTTTAACGCGTAA,GCAACAGCATGCCATAAATCTTGCTTTACAGGACAGGATTACACGCTCCTACTCTGTGTTGCTAGAATTTGTTATAAAGCCAAAAAAATTCTAGTTGGT,10,30,14,27,27,42,27,53,27,39,39,42,50,53,5.04,0.0
hek293t,12646,1,2,GTCTAATTGCTGTGCTCAAGCCACACATCTGGGTACTGAGGCTGATGTCTTTGCTGATGGAGCATGCAGGTGTTACTGCTCCACAAAAAAAATTCTAGT,GTCTAATTGCTGTGCTCAAGCCACACATCTGGTTGTACTGAGGCTGATGTCTTTGCTGATGGAGCATGCAGGTGTTACTGCTCCACAAAAAAAATTCTA,10,30,14,27,27,36,27,38,27,33,33,36,35,38,25.87,0.997343958
hek293t,12646,1,2,CCACTATTGCTGTGCTCAAGCCACACATCTGGGTACTGAGGCTGATGTCTTTGCTGATGGAGCATGCAGGTGTTACTGCTCAAAAAAATTCTAGTTGGT,CCACTATTGCTGTGCTCAAGCCACACATCTGGTTGTACTGAGGCTGATGTCTTTGCTGATGGAGCATGCAGGTGTTACTGCTCAAAAAAATTCTAGTTG,10,30,14,27,27,40,27,42,27,33,33,40,35,42,25.87,83.97660819
hek293t,12648,1,4,CTTATCACCATGGCTGACAGGAGGATCACAGGGTTCAGAGGAAATAAAAAGATAACCTTTTAAAGAGCAATGCAAAAAAAAATTCTAGTTGGTTTAACG,CTTATCACCATGGCTGACAGGAGGATCAAAATCAGGGTTCAGAGGAAATAAAAAGATAACCTTTTAAAGAGCAATGCAAAAAAAAATTCTAGTTGGTTT,10,30,14,27,27,44,27,48,27,29,29,44,33,48,60.99,33.04561457
hek293t,12648,1,4,GGCCCCACCATGGCTGACAGGAGGATCACAGGGTTCAGAGGAAATAAAAAGATAACCTTTTAAAGAGCAATGCAAATGTTATGAAAAAAAAAAATTCTA,GGCCCCACCATGGCTGACAGGAGGATCAAAATCAGGGTTCAGAGGAAATAAAAAGATAACCTTTTAAAGAGCAATGCAAATGTTATGAAAAAAAAAAAT,10,30,14,27,27,32,27,36,27,29,29,32,33,36,60.99,0.370856438
hek293t,12650,1,14,TTCTGAAGCAGGGGGAATAAAGGGGATGCAGGACTGAAAATGCTCCCAGCTAAGGCTCTGGATCTAAAAAAATTCTAGTTGGTTTAACGCGTAACTAGA,TTCTGAAGCAGGGGGAATAAAGGGGATGCAGGACTGAGACTCCGACCTTCAAAATGCTCCCAGCTAAGGCTCTGGATCTAAAAAAATTCTAGTTGGTTT,10,30,14,27,27,44,27,58,27,37,37,44,51,58,49.03,0.0
hek293t,5124,1,14,GCGTCAAGTACGTTTTGCACTTTGTTTTTAGGTGTAGATGAGCACAATGGAGCCTTTGTTACATCTGGAAGTAATGTTAAAAAAATTCTAGTTGGTTTA,GCGTCAAGTACGTTTTGCACTTTGTTTCGGTTCGAAATGTGTTAGGTGTAGATGAGCACAATGGAGCCTTTGTTACATCTGGAAGTAATGTTAAAAAAA,10,30,14,27,27,31,27,45,27,28,28,31,42,45,-9.88,0.0
hek293t,5124,1,14,ACCTTAAGTACGTTTTGCACTTTGTTTTTAGGTGTAGATGAGCACAATGGAGCCTTTGTTACATCTGGAAGTAAAAAAAAATTCTAGTTGGTTTAACGC,ACCTTAAGTACGTTTTGCACTTTGTTTCGGTTCGAAATGTGTTAGGTGTAGATGAGCACAATGGAGCCTTTGTTACATCTGGAAGTAAAAAAAAATTCT,10,30,14,27,27,35,27,49,27,28,28,35,42,49,-9.88,0.0
hek293t,12653,1,4,CGACCTTCCTTTATTGAAACACAAAAATAAGGTGCTTTCATAACTTTGTTGACAAAATGTTGTGATGATCATAAAAAAATTCTAGTTGGTTTAACGCGT,CGACCTTCCTTTATTGAAACACAAAAATAAGGTGCTTTCCTGAATAACTTTGTTGACAAAATGTTGTGATGATCATAAAAAAATTCTAGTTGGTTTAAC,10,30,14,27,27,47,27,51,27,40,40,47,44,51,14.49,0.0
hek293t,12653,1,4,AGTGATTCCTTTATTGAAACACAAAAATAAGGTGCTTTCATAACTTTGTTGACAAAATGTTGTGATGATCATCTGCAAAAAAATTCTAGTTGGTTTAAC,AGTGATTCCTTTATTGAAACACAAAAATAAGGTGCTTTCCTGAATAACTTTGTTGACAAAATGTTGTGATGATCATCTGCAAAAAAATTCTAGTTGGTT,10,30,14,27,27,43,27,47,27,40,40,43,44,47,14.49,0.0
hek293t,12656,1,12,GGGCTGCCCCCCCGGGAAGAGTAAGTATTAGGTTCAGGTAAATAAGGATATTAGATTTCTTGGTAAAAAAATTCTAGTTGGTTTAACGCGTAACTAGAT,GGGCTGCCCCCCCGGGAAGAGTAAGTATTAGGTTCAGCCAAGCGCTCCGGTAAATAAGGATATTAGATTTCTTGGTAAAAAAATTCTAGTTGGTTTAAC,10,30,14,27,27,47,27,59,27,37,37,47,49,59,22.41,0.044682752
hek293t,12656,1,12,GCCCAGCCCCCCCGGGAAGAGTAAGTATTAGGTTCAGGTAAATAAGGATATTAGATTTCTTGGTGCTAAAAAAATTCTAGTTGGTTTAACGCGTAACTA,GCCCAGCCCCCCCGGGAAGAGTAAGTATTAGGTTCAGCCAAGCGCTCCGGTAAATAAGGATATTAGATTTCTTGGTGCTAAAAAAATTCTAGTTGGTTT,10,30,14,27,27,44,27,56,27,37,37,44,49,56,22.41,0.0
hek293t,12660,1,13,GCGACAAATATATTAAAAGTAAAACATTTTGGTCAGATTATTAAAACTGTTCACAATTAACTTTTCAGCAGCTAAAAAAAAATTCTAGTTGGTTTAACG,GCGACAAATATATTAAAAGTAAAACATTTTGCTCGATGGTTATAGTCAGATTATTAAAACTGTTCACAATTAACTTTTCAGCAGCTAAAAAAAAATTCT,10,30,14,27,27,35,27,48,27,32,32,35,45,48,8.14,0.0
hek293t,12661,1,11,TTCGCTTTTTGCTTCCCACAGGGTTTTGATGGAAAAGATGGTGCAAAAGGTGACAGTGGTGCTCCTGGTCCAAAGGAAAAAAATTCTAGTTGGTTTAAC,TTCGCTTTTTGCTTCCCACAGGGTTTTGCTGATTGGCGGATGGAAAAGATGGTGCAAAAGGTGACAGTGGTGCTCCTGGTCCAAAGGAAAAAAATTCTA,10,30,14,27,27,36,27,47,27,29,29,36,40,47,17.89,0.12776347
hek293t,12661,1,11,GAGGCTTTTTGCTTCCCACAGGGTTTTGATGGAAAAGATGGTGCAAAAGGTGACAGTGGTGCTCCTGGTCCAAAGGTAAAAAAAAAATTCTAGTTGGTT,GAGGCTTTTTGCTTCCCACAGGGTTTTGCTGATTGGCGGATGGAAAAGATGGTGCAAAAGGTGACAGTGGTGCTCCTGGTCCAAAGGTAAAAAAAAAAT,10,30,14,27,27,32,27,43,27,29,29,32,40,43,17.89,0.15056233
hek293t,12663,1,6,GGTTATCTAATTAGGGACTTATCCAGTCAAGGAACAGAAATATCACTTAGGTATGTACACACAGTGAATGCCAAATCGCAAAAAAAAAATTCTAGTTGG,GGTTATCTAATTAGGGACTTATCCAGTCAAGAGAACAGAACAGAAATATCACTTAGGTATGTACACACAGTGAATGCCAAATCGCAAAAAAAAAATTCT,10,30,14,27,27,35,27,41,27,32,32,35,38,41,45.21,82.43959955
hek293t,12663,1,6,ATCCCTCTAATTAGGGACTTATCCAGTCAAGGAACAGAAATATCACTTAGGTATGTACACACAGTGAATGCCAAATCGAAAAAAATTCTAGTTGGTTTA,ATCCCTCTAATTAGGGACTTATCCAGTCAAGAGAACAGAACAGAAATATCACTTAGGTATGTACACACAGTGAATGCCAAATCGAAAAAAATTCTAGTT,10,30,14,27,27,39,27,45,27,32,32,39,38,45,45.21,0.334518152
hek293t,12665,1,11,GATGCGAGGCAGAGGAACTGGGGGTTGCAAGGAGGATTCAGCTGACAAAAGCTGAAGTAGATGTCATAAAAAAAAATTCTAGTTGGTTTAACGCGTAAC,GATGCGAGGCAGAGGAACTGGGGGTTGCAAGGAGGCAGATGTATGGATTCAGCTGACAAAAGCTGAAGTAGATGTCATAAAAAAAAATTCTAGTTGGTT,10,30,14,27,27,43,27,54,27,36,36,43,47,54,51.12,1.848342172
hek293t,12665,1,11,GGAGGGAGGCAGAGGAACTGGGGGTTGCAAGGAGGATTCAGCTGACAAAAGCTGAAGTAGATGTCATAAGAAGAAAAAAATTCTAGTTGGTTTAACGCG,GGAGGGAGGCAGAGGAACTGGGGGTTGCAAGGAGGCAGATGTATGGATTCAGCTGACAAAAGCTGAAGTAGATGTCATAAGAAGAAAAAAATTCTAGTT,10,30,14,27,27,39,27,50,27,36,36,39,47,50,51.12,0.0
hek293t,12667,1,7,CATCTTGAATAGGTCATTTCTCATTGGTAAGGACAGATCAAAAGCCAGACTTTTGCCAGACCATTTCTGGAACTGAAAAAAATTCTAGTTGGTTTAACG,CATCTTGAATAGGTCATTTCTCATTGGTAAGGACGCCAGCCAGATCAAAAGCCAGACTTTTGCCAGACCATTTCTGGAACTGAAAAAAATTCTAGTTGG,10,30,14,27,27,41,27,48,27,34,34,41,41,48,50.65,2.170452719
hek293t,12667,1,7,TTTTGTGAATAGGTCATTTCTCATTGGTAAGGACAGATCAAAAGCCAGACTTTTGCCAGACCATTTCTGGAACTGAGTTAAAAAAATTCTAGTTGGTTT,TTTTGTGAATAGGTCATTTCTCATTGGTAAGGACGCCAGCCAGATCAAAAGCCAGACTTTTGCCAGACCATTTCTGGAACTGAGTTAAAAAAATTCTAG,10,30,14,27,27,37,27,44,27,34,34,37,41,44,50.65,1.519979174
hek293t,12669,1,5,AGGGTGAGCTGCTCTCCATAACTGCTTTGGGGGAGAGCAGCCAGAAGGGAGAACAACTGTCTGAGCTTGAGGAGCAATAAAAAAATTCTAGTTGGTTTA,AGGGTGAGCTGCTCTCCATAACTGCTTTGGCAGTGGGGAGAGCAGCCAGAAGGGAGAACAACTGTCTGAGCTTGAGGAGCAATAAAAAAATTCTAGTTG,10,30,14,27,27,40,27,45,27,30,30,40,35,45,47.29,20.03157673
hek293t,12669,1,5,TTTACGAGCTGCTCTCCATAACTGCTTTGGGGGAGAGCAGCCAGAAGGGAGAACAACTGTCTGAGCTTGAGGAGCAATGTCGGCAAAAAAAATTCTAGT,TTTACGAGCTGCTCTCCATAACTGCTTTGGCAGTGGGGAGAGCAGCCAGAAGGGAGAACAACTGTCTGAGCTTGAGGAGCAATGTCGGCAAAAAAAATT,10,30,14,27,27,33,27,38,27,30,30,33,35,38,47.29,0.41334781
hek293t,12671,1,9,ATTAAAGTGAGTTTGGGGAAAAAGTCCTTTGGGAAGAAGGATCCTCTAATAGGAGAATCAAAGCTGGCAAAAAAAAAATTCTAGTTGGTTTAACGCGTA,ATTAAAGTGAGTTTGGGGAAAAAGTCCATCCCGGAATTTGGGAAGAAGGATCCTCTAATAGGAGAATCAAAGCTGGCAAAAAAAAAATTCTAGTTGGTT,10,30,14,27,27,43,27,52,27,28,28,43,37,52,23.87,0.43378955
hek293t,12671,1,9,CTGTCAGTGAGTTTGGGGAAAAAGTCCTTTGGGAAGAAGGATCCTCTAATAGGAGAATCAAAGCTGGCAAAATTGAGATAAAAAAATTCTAGTTGGTTT,CTGTCAGTGAGTTTGGGGAAAAAGTCCATCCCGGAATTTGGGAAGAAGGATCCTCTAATAGGAGAATCAAAGCTGGCAAAATTGAGATAAAAAAATTCT,10,30,14,27,27,35,27,44,27,28,28,35,37,44,23.87,0.0
hek293t,12674,1,9,TGGCAAAGGCATTCAAGGAAGATATTTTCTGGAAAAGCTTATGAATGACTCTGAATAACCAGGGATGTTATATAAAAAAATTCTAGTTGGTTTAACGCG,TGGCAAAGGCATTCAAGGAAGATATTTTCTGGAAAGACGTTCAAAGCTTATGAATGACTCTGAATAACCAGGGATGTTATATAAAAAAATTCTAGTTGG,10,30,14,27,27,41,27,50,27,34,34,41,43,50,2.28,0.0
hek293t,12674,1,9,CCTGCAAGGCATTCAAGGAAGATATTTTCTGGAAAAGCTTATGAATGACTCTGAATAACCAGGGAAAAAAAATTCTAGTTGGTTTAACGCGTAACTAGA,CCTGCAAGGCATTCAAGGAAGATATTTTCTGGAAAGACGTTCAAAGCTTATGAATGACTCTGAATAACCAGGGAAAAAAAATTCTAGTTGGTTTAACGC,10,30,14,27,27,49,27,58,27,34,34,49,43,58,2.28,0.36979899
hek293t,12676,1,8,GATCGACTGGTTGCATAATCTTAAATGACTGGTTGTGAAATAATTAAATACCTGAGAAAAGAACTAAAAAAAATTCTAGTTGGTTTAACGCGTAACTAG,GATCGACTGGTTGCATAATCTTAAATGACTGGTAATTGCAGTGTGAAATAATTAAATACCTGAGAAAAGAACTAAAAAAAATTCTAGTTGGTTTAACGC,10,30,14,27,27,49,27,57,27,34,34,49,42,57,44.0,0.0
hek293t,12676,1,8,CGAGCACTGGTTGCATAATCTTAAATGACTGGTTGTGAAATAATTAAATACCTGAGAAAAGAACTATTTGAAAAAAAAAAATTCTAGTTGGTTTAACGC,CGAGCACTGGTTGCATAATCTTAAATGACTGGTAATTGCAGTGTGAAATAATTAAATACCTGAGAAAAGAACTATTTGAAAAAAAAAAATTCTAGTTGG,10,30,14,27,27,41,27,49,27,34,34,41,42,49,44.0,0.08984726
hek293t,12679,1,10,GGAATCTGATGTCAAACTTAGAGTTAAAAAGGTCCATGTCACTTTAATTTAATGACTGTCTGCTTCCTCTTTAGCAACAAAAAAAATTCTAGTTGGTTT,GGAATCTGATGTCAAACTTAGAGTTAAAAATGGAAATGGAGGTCCATGTCACTTTAATTTAATGACTGTCTGCTTCCTCTTTAGCAACAAAAAAAATTC,10,30,14,27,27,34,27,44,27,31,31,34,41,44,3.4,0.0
hek293t,12679,1,10,GCGGTCTGATGTCAAACTTAGAGTTAAAAAGGTCCATGTCACTTTAATTTAATGACTGTCTGCTTCCTCTTTAAAAAAATTCTAGTTGGTTTAACGCGT,GCGGTCTGATGTCAAACTTAGAGTTAAAAATGGAAATGGAGGTCCATGTCACTTTAATTTAATGACTGTCTGCTTCCTCTTTAAAAAAATTCTAGTTGG,10,30,14,27,27,41,27,51,27,31,31,41,41,51,3.4,0.164609053
hek293t,12681,1,9,TGTTGAGCCAACCTCTGTCCTTTGCTTTGTGGAAATAGTCCCCCACATATACGAGGACATTCATGGAGAACCTATTTTAAAAAAAATTCTAGTTGGTTT,TGTTGAGCCAACCTCTGTCCTTTGCTTAGCAATATTTGTGGAAATAGTCCCCCACATATACGAGGACATTCATGGAGAACCTATTTTAAAAAAAATTCT,10,30,14,27,27,35,27,44,27,28,28,35,37,44,20.68,0.319897633
hek293t,12681,1,9,TAGGCAGCCAACCTCTGTCCTTTGCTTTGTGGAAATAGTCCCCCACATATACGAGGACATTCATGGAGAACAAAAAAATTCTAGTTGGTTTAACGCGTA,TAGGCAGCCAACCTCTGTCCTTTGCTTAGCAATATTTGTGGAAATAGTCCCCCACATATACGAGGACATTCATGGAGAACAAAAAAATTCTAGTTGGTT,10,30,14,27,27,43,27,52,27,28,28,43,37,52,20.68,41.22638666
hek293t,12683,1,10,CTAACGTGGATAAAACTGTAACTGTATTTTGGACAAAATACAACAAGGATCACCTAACTGGTGGTAGTTTGAAGAAAAAAATTCTAGTTGGTTTAACGC,CTAACGTGGATAAAACTGTAACTGTATTTTGGACAGTGAGTAGTCAAATACAACAAGGATCACCTAACTGGTGGTAGTTTGAAGAAAAAAATTCTAGTT,10,30,14,27,27,39,27,49,27,36,36,39,46,49,7.64,0.345423143
hek293t,12684,1,8,CGCTTCAGTGCTTGAGGAGACAGTAATCCCGGTAGGCTCGTTTAAAAATCCAAGCTCTGGCTACTTAAAAAAATTCTAGTTGGTTTAACGCGTAACTAG,CGCTTCAGTGCTTGAGGAGACAGTAATCCCGGTAGGCTACGCTTAACGTTTAAAAATCCAAGCTCTGGCTACTTAAAAAAATTCTAGTTGGTTTAACGC,10,30,14,27,27,49,27,57,27,39,39,49,47,57,68.06,0.135501355
hek293t,12684,1,8,CATTGCAGTGCTTGAGGAGACAGTAATCCCGGTAGGCTCGTTTAAAAATCCAAGCTCTGGCTACTTGCTAAAAAAATTCTAGTTGGTTTAACGCGTAAC,CATTGCAGTGCTTGAGGAGACAGTAATCCCGGTAGGCTACGCTTAACGTTTAAAAATCCAAGCTCTGGCTACTTGCTAAAAAAATTCTAGTTGGTTTAA,10,30,14,27,27,46,27,54,27,39,39,46,47,54,68.06,0.187265918
hek293t,12686,1,10,TGGAGAGATAATTCAATAGCTCCCATCTCTGGTAGGAATGATGTCAACCTGAGTTACTGTTTCTAAAAAAATTCTAGTTGGTTTAACGCGTAACTAGAT,TGGAGAGATAATTCAATAGCTCCCATCTCTGGTAGAGTAAAACAGGAATGATGTCAACCTGAGTTACTGTTTCTAAAAAAATTCTAGTTGGTTTAACGC,10,30,14,27,27,49,27,59,27,34,34,49,44,59,38.18,3.993376356
hek293t,12686,1,10,TGAGTAGATAATTCAATAGCTCCCATCTCTGGTAGGAATGATGTCAACCTGAGTTACTGTTTCTGATGAATAGTGAAAAAAAATTCTAGTTGGTTTAAC,TGAGTAGATAATTCAATAGCTCCCATCTCTGGTAGAGTAAAACAGGAATGATGTCAACCTGAGTTACTGTTTCTGATGAATAGTGAAAAAAAATTCTAG,10,30,14,27,27,37,27,47,27,34,34,37,44,47,38.18,0.0
hek293t,12688,1,13,TACTAGTTACATCTATGGCATTGCTTAGAAGGCCTCTATTCCAGAGTATCTTCATGCACATACTGAGGGGAAAAAAATTCTAGTTGGTTTAACGCGTAA,TACTAGTTACATCTATGGCATTGCTTAGAAGGGCTCGTGTTACCTCCTCTATTCCAGAGTATCTTCATGCACATACTGAGGGGAAAAAAATTCTAGTTG,10,30,14,27,27,40,27,53,27,33,33,40,46,53,13.05,0.542760665
hek293t,12688,1,13,TATTCGTTACATCTATGGCATTGCTTAGAAGGCCTCTATTCCAGAGTATCTTCATGCACATACTGAGGGGTGGTAAAAAAATTCTAGTTGGTTTAACGC,TATTCGTTACATCTATGGCATTGCTTAGAAGGGCTCGTGTTACCTCCTCTATTCCAGAGTATCTTCATGCACATACTGAGGGGTGGTAAAAAAATTCTA,10,30,14,27,27,36,27,49,27,33,33,36,46,49,13.05,0.412796698
hek293t,12690,1,10,TCTGAATTCTGCCAAAGCCTCTCCCGGGCAGGGCCCTGGCTAACTCCTGCGGTGCGTACACAGCCCTTGCAAAAAAATTCTAGTTGGTTTAACGCGTAA,TCTGAATTCTGCCAAAGCCTCTCCCGGGCAGGGGAGGATGCAGCCCTGGCTAACTCCTGCGGTGCGTACACAGCCCTTGCAAAAAAATTCTAGTTGGTT,10,30,14,27,27,43,27,53,27,33,33,43,43,53,15.99,17.16988626
hek293t,12690,1,10,TGCATATTCTGCCAAAGCCTCTCCCGGGCAGGGCCCTGGCTAACTCCTGCGGTGCGTACACAGCCCTTGCTTCAAAAAAATTCTAGTTGGTTTAACGCG,TGCATATTCTGCCAAAGCCTCTCCCGGGCAGGGGAGGATGCAGCCCTGGCTAACTCCTGCGGTGCGTACACAGCCCTTGCTTCAAAAAAATTCTAGTTG,10,30,14,27,27,40,27,50,27,33,33,40,43,50,15.99,2.553500476
hek293t,12692,1,1,GGAATGTGTTTCTTTGTATAAGTATTAAATGGAAGAATTACATATAAATAACGAGTATTTTAAAAGGAAAGTCCTCAAAAAAAATTCTAGTTGGTTTAA,GGAATGTGTTTCTTTGTATAAGTATTAAATGGAATGAATTACATATAAATAACGAGTATTTTAAAAGGAAAGTCCTCAAAAAAAATTCTAGTTGGTTTA,10,30,14,27,27,45,27,46,27,35,35,45,36,46,2.47,1.272813545
hek293t,12692,1,1,CTTGTGTGTTTCTTTGTATAAGTATTAAATGGAAGAATTACATATAAATAACGAGTATTTTAAAAGGAAAGTCCTCAGTAAAAAAAATTCTAGTTGGTT,CTTGTGTGTTTCTTTGTATAAGTATTAAATGGAATGAATTACATATAAATAACGAGTATTTTAAAAGGAAAGTCCTCAGTAAAAAAAATTCTAGTTGGT,10,30,14,27,27,42,27,43,27,35,35,42,36,43,2.47,1.930828406
hek293t,12694,1,5,GACTGTGTGCTTTCTTGTTATATCGCAGGTGGGGGGTCAGGCGTTCTGAGAGAGAGGCAGTCTAAATGTTTTTAAAAAAAAATTCTAGTTGGTTTAACG,GACTGTGTGCTTTCTTGTTATATCGCAGGTGGGTACGGGGGTCAGGCGTTCTGAGAGAGAGGCAGTCTAAATGTTTTTAAAAAAAAATTCTAGTTGGTT,10,30,14,27,27,43,27,48,27,33,33,43,38,48,8.57,41.62007389
hek293t,12694,1,5,GCTTATGTGCTTTCTTGTTATATCGCAGGTGGGGGGTCAGGCGTTCTGAGAGAGAGGCAGTCTAAATGTTTTTAAATAAACCAAAAAAATTCTAGTTGG,GCTTATGTGCTTTCTTGTTATATCGCAGGTGGGTACGGGGGTCAGGCGTTCTGAGAGAGAGGCAGTCTAAATGTTTTTAAATAAACCAAAAAAATTCTA,10,30,14,27,27,36,27,41,27,33,33,36,38,41,8.57,0.175613102
hek293t,12696,1,14,TGTTGTGGTTCTCCAGAAAAACAGAAATCAGGGACATAATTTTTATATCTAGCTGCACTTTATGAAAAAAAAATTCTAGTTGGTTTAACGCGTAACTAG,TGTTGTGGTTCTCCAGAAAAACAGAAAGGTCGATAGCGCCGTCAGGGACATAATTTTTATATCTAGCTGCACTTTATGAAAAAAAAATTCTAGTTGGTT,10,30,14,27,27,43,27,57,27,28,28,43,42,57,31.06,0.0
hek293t,12696,1,14,CACAGTGGTTCTCCAGAAAAACAGAAATCAGGGACATAATTTTTATATCTAGCTGCACTTTATGAAAGCTTAAAAAAATTCTAGTTGGTTTAACGCGTA,CACAGTGGTTCTCCAGAAAAACAGAAAGGTCGATAGCGCCGTCAGGGACATAATTTTTATATCTAGCTGCACTTTATGAAAGCTTAAAAAAATTCTAGT,10,30,14,27,27,38,27,52,27,28,28,38,42,52,31.06,0.210279693
hek293t,12700,1,5,TCGTTACCAACACACCTCATCAGCCTACGAGGATGACTAAAGACATCATGCGTCTTCCATAGGCCTTAAAAAAATTCTAGTTGGTTTAACGCGTAACTA,TCGTTACCAACACACCTCATCAGCCTACGAGGATGACTAAAAGCCAGACATCATGCGTCTTCCATAGGCCTTAAAAAAATTCTAGTTGGTTTAACGCGT,10,30,14,27,27,51,27,56,27,41,41,51,46,56,63.95,6.905143543
hek293t,12701,1,6,TCAAGGCAAGGATAAAAAGTCTTCCTACCAGGTGAAGGGCTGTAAATTCACCTAGAAGCCAAGCAAAAAAAATTCTAGTTGGTTTAACGCGTAACTAGA,TCAAGGCAAGGATAAAAAGTCTTCCTACCAGGTGAATGACACGGGCTGTAAATTCACCTAGAAGCCAAGCAAAAAAAATTCTAGTTGGTTTAACGCGTA,10,30,14,27,27,52,27,58,27,37,37,52,43,58,38.39,19.57416812
hek293t,12701,1,6,TACTGGCAAGGATAAAAAGTCTTCCTACCAGGTGAAGGGCTGTAAATTCACCTAGAAGCCAAGCACTGCAACAAAAAAAATTCTAGTTGGTTTAACGCG,TACTGGCAAGGATAAAAAGTCTTCCTACCAGGTGAATGACACGGGCTGTAAATTCACCTAGAAGCCAAGCACTGCAACAAAAAAAATTCTAGTTGGTTT,10,30,14,27,27,44,27,50,27,37,37,44,43,50,38.39,13.75286691
hek293t,12703,1,10,GGAGCCCTCTGGTATCAGTAATAAGAAGCTGGATGCCTGCATAACTCCACTGCAAAAATGTAAGAACCGGTTGTGAAGAAAAAAATTCTAGTTGGTTTA,GGAGCCCTCTGGTATCAGTAATAAGAAGCTGTTGTTTATTGGATGCCTGCATAACTCCACTGCAAAAATGTAAGAACCGGTTGTGAAGAAAAAAATTCT,10,30,14,27,27,35,27,45,27,32,32,35,42,45,37.12,0.0
hek293t,12703,1,10,GCGTGCCTCTGGTATCAGTAATAAGAAGCTGGATGCCTGCATAACTCCACTGCAAAAATGTAAGAACCGGTAAAAAAATTCTAGTTGGTTTAACGCGTA,GCGTGCCTCTGGTATCAGTAATAAGAAGCTGTTGTTTATTGGATGCCTGCATAACTCCACTGCAAAAATGTAAGAACCGGTAAAAAAATTCTAGTTGGT,10,30,14,27,27,42,27,52,27,32,32,42,42,52,37.12,0.161109301
hek293t,12705,1,1,AAAACAGATAGGAATGGGCCCCATTTCACTGGACAAATTAAAAACCTCCCTCAAGTGGATTCTCTGAAATACTTTCCCCATCTACAAAAAAATTCTAGT,AAAACAGATAGGAATGGGCCCCATTTCACGTGGACAAATTAAAAACCTCCCTCAAGTGGATTCTCTGAAATACTTTCCCCATCTACAAAAAAATTCTAG,10,30,14,27,27,37,27,38,27,30,30,37,31,38,34.61,29.54720064
hek293t,12705,1,1,CCATTAGATAGGAATGGGCCCCATTTCACTGGACAAATTAAAAACCTCCCTCAAGTGGATTCTCTGAAATACTTTCCCCATCTACCAAAAAAAAAATTC,CCATTAGATAGGAATGGGCCCCATTTCACGTGGACAAATTAAAAACCTCCCTCAAGTGGATTCTCTGAAATACTTTCCCCATCTACCAAAAAAAAAATT,10,30,14,27,27,33,27,34,27,30,30,33,31,34,34.61,0.802503952
hek293t,12707,1,2,ATTGCGCAGCATAGCTCAAAATCAGCTGCAGGTTTTCTCCCACCTTCCACGGCCCTCCACCCTTTCCCACTCCAGCCTTCCCTGCCAGGAAAAAAATTC,ATTGCGCAGCATAGCTCAAAATCAGCTGTGCAGGTTTTCTCCCACCTTCCACGGCCCTCCACCCTTTCCCACTCCAGCCTTCCCTGCCAGGAAAAAAAT,10,30,14,27,27,32,27,34,27,29,29,32,31,34,39.1,3.150628538
hek293t,12707,1,2,AAGGCGCAGCATAGCTCAAAATCAGCTGCAGGTTTTCTCCCACCTTCCACGGCCCTCCACCCTTTCCCACTCCAGCCAAAAAAATTCTAGTTGGTTTAA,AAGGCGCAGCATAGCTCAAAATCAGCTGTGCAGGTTTTCTCCCACCTTCCACGGCCCTCCACCCTTTCCCACTCCAGCCAAAAAAATTCTAGTTGGTTT,10,30,14,27,27,44,27,46,27,29,29,44,31,46,39.1,59.64495455
hek293t,12709,1,4,TGAATTTCCAGGAATGAGACTAGTCAGGGAGGAATCCAGCCAAGCTGTTCTTCTGAAAAGCTCATGACATGGAGATATTTGCATTTAAAAAAATTCTAG,TGAATTTCCAGGAATGAGACTAGTCAGGGAACAAGGAATCCAGCCAAGCTGTTCTTCTGAAAAGCTCATGACATGGAGATATTTGCATTTAAAAAAATT,10,30,14,27,27,33,27,37,27,30,30,33,34,37,64.9,0.972734019
hek293t,12709,1,4,GGCCCTTCCAGGAATGAGACTAGTCAGGGAGGAATCCAGCCAAGCTGTTCTTCTGAAAAGCTCATGACATGGAGATATTTGCAAAAAAATTCTAGTTGG,GGCCCTTCCAGGAATGAGACTAGTCAGGGAACAAGGAATCCAGCCAAGCTGTTCTTCTGAAAAGCTCATGACATGGAGATATTTGCAAAAAAATTCTAG,10,30,14,27,27,37,27,41,27,30,30,37,34,41,64.9,24.0394061
hek293t,12712,1,2,GTAAGGTACTGTGAATGTAGGTGGCTAGTTGGGAATAGTATCTGTTCATGACAAGAGGATGTCCAGTGTTCGAGATCAAAAAAATTCTAGTTGGTTTAA,GTAAGGTACTGTGAATGTAGGTGGCTAGGTTTGGGAATAGTATCTGTTCATGACAAGAGGATGTCCAGTGTTCGAGATCAAAAAAATTCTAGTTGGTTT,10,30,14,27,27,44,27,46,27,29,29,44,31,46,34.98,63.04138806
hek293t,12712,1,2,AATGAGTACTGTGAATGTAGGTGGCTAGTTGGGAATAGTATCTGTTCATGACAAGAGGATGTCCAGTGTTCGAGATCATGTCCAAAAAAAAATTCTAGT,AATGAGTACTGTGAATGTAGGTGGCTAGGTTTGGGAATAGTATCTGTTCATGACAAGAGGATGTCCAGTGTTCGAGATCATGTCCAAAAAAAAATTCTA,10,30,14,27,27,36,27,38,27,29,29,36,31,38,34.98,70.63148668
hek293t,12714,1,12,GCGTTCAACATCAGATGTAGTATCTTATGTGGGACATCCATTTTTAGCTGAAACAATTAAAAAAGAAAAAAAATTCTAGTTGGTTTAACGCGTAACTAG,GCGTTCAACATCAGATGTAGTATCTTATGTGGGAGTATGCGGTACACATCCATTTTTAGCTGAAACAATTAAAAAAGAAAAAAAATTCTAGTTGGTTTA,10,30,14,27,27,45,27,57,27,35,35,45,47,57,31.31,3.091064866
hek293t,12714,1,12,GATGCCAACATCAGATGTAGTATCTTATGTGGGACATCCATTTTTAGCTGAAACAATTAAAAAAGAGTCCTCTAAAAAAATTCTAGTTGGTTTAACGCG,GATGCCAACATCAGATGTAGTATCTTATGTGGGAGTATGCGGTACACATCCATTTTTAGCTGAAACAATTAAAAAAGAGTCCTCTAAAAAAATTCTAGT,10,30,14,27,27,38,27,50,27,35,35,38,47,50,31.31,0.042735043
hek293t,12718,1,9,GGATTTCTGTCTGCCTGCTCAATGACTACAGGGGTTTTGTGTGTCCAGGATAAGGCTCACGTCCGCCAGCAAAAAAATTCTAGTTGGTTTAACGCGTAA,GGATTTCTGTCTGCCTGCTCAATGACTACAGGGGTTTTGTGCAAGAGGAGTGTCCAGGATAAGGCTCACGTCCGCCAGCAAAAAAATTCTAGTTGGTTT,10,30,14,27,27,44,27,53,27,41,41,44,50,53,35.0,0.0
hek293t,12719,1,6,CAAGACTCTGTGGCTGTCCTATCTGGCAACGGCCTGGTGCCTGGCCCTGCTTTCGAGGCCCCAGAAGCACAGCTCCTTAAAAAAATTCTAGTTGGTTTA,CAAGACTCTGTGGCTGTCCTATCTGGCATTACGGACGGCCTGGTGCCTGGCCCTGCTTTCGAGGCCCCAGAAGCACAGCTCCTTAAAAAAATTCTAGTT,10,30,14,27,27,39,27,45,27,29,29,39,35,45,48.27,74.98223442
hek293t,12719,1,6,AAAGACTCTGTGGCTGTCCTATCTGGCAACGGCCTGGTGCCTGGCCCTGCTTTCGAGGCCCCAGAAGCACAGCAAAAAAATTCTAGTTGGTTTAACGCG,AAAGACTCTGTGGCTGTCCTATCTGGCATTACGGACGGCCTGGTGCCTGGCCCTGCTTTCGAGGCCCCAGAAGCACAGCAAAAAAATTCTAGTTGGTTT,10,30,14,27,27,44,27,50,27,29,29,44,35,50,48.27,83.78147325
hek293t,12721,1,13,TGTGTGTTTCCTGGGACTCCTGTTTCGGAAGGTAATCTTCAAGATCTGGCCTACATTTGTCTTCTGAAAAAAATTCTAGTTGGTTTAACGCGTAACTAG,TGTGTGTTTCCTGGGACTCCTGTTTCGGAAGGTTTACCTGCGATAAAATCTTCAAGATCTGGCCTACATTTGTCTTCTGAAAAAAATTCTAGTTGGTTT,10,30,14,27,27,44,27,57,27,34,34,44,47,57,45.35,0.543303675
hek293t,12721,1,13,GTATTGTTTCCTGGGACTCCTGTTTCGGAAGGTAATCTTCAAGATCTGGCCTACATTTGTCTTCTGCTGAGACAAAAAAATTCTAGTTGGTTTAACGCG,GTATTGTTTCCTGGGACTCCTGTTTCGGAAGGTTTACCTGCGATAAAATCTTCAAGATCTGGCCTACATTTGTCTTCTGCTGAGACAAAAAAATTCTAG,10,30,14,27,27,37,27,50,27,34,34,37,47,50,45.35,0.0
hek293t,12723,1,4,GCCGTTATATGCGTATGTGCATACAGAACAGGAAAAGGTAGAAACAATGCATAAAAATCTACAAATTTCTTCTTCATGTGCAAAAAAATTCTAGTTGGT,GCCGTTATATGCGTATGTGCATACAGAACACCATGGAAAAGGTAGAAACAATGCATAAAAATCTACAAATTTCTTCTTCATGTGCAAAAAAATTCTAGT,10,30,14,27,27,38,27,42,27,31,31,38,35,42,40.13,62.15493302
hek293t,12723,1,4,GAATTTATATGCGTATGTGCATACAGAACAGGAAAAGGTAGAAACAATGCATAAAAATCTACAAATTTCTTCTTCATGAAAAAAATTCTAGTTGGTTTA,GAATTTATATGCGTATGTGCATACAGAACACCATGGAAAAGGTAGAAACAATGCATAAAAATCTACAAATTTCTTCTTCATGAAAAAAATTCTAGTTGG,10,30,14,27,27,41,27,45,27,31,31,41,35,45,40.13,40.93228647
hek293t,12725,1,14,AATAGGAAACTGGTATCAGCCCTACCCTTTGGTGAAATGCTTGAAGGCTAATATGTGTGAAACCATAAAAAAAAATTCTAGTTGGTTTAACGCGTAACT,AATAGGAAACTGGTATCAGCCCTACCCTTTGGTGAAAGCCACCTGGATTGTTGCTTGAAGGCTAATATGTGTGAAACCATAAAAAAAAATTCTAGTTGG,10,30,14,27,27,41,27,55,27,38,38,41,52,55,45.91,0.0
hek293t,12726,1,4,AGCTAAGAACATGGGAGGATCTTATCAGTTGGGTGGAAAAGCCTTGTCATGAAGAAATGTGCACTGCATTTTTAAAAAAATTCTAGTTGGTTTAACGCG,AGCTAAGAACATGGGAGGATCTTATCAGTTTGATGGGTGGAAAAGCCTTGTCATGAAGAAATGTGCACTGCATTTTTAAAAAAATTCTAGTTGGTTTAA,10,30,14,27,27,46,27,50,27,31,31,46,35,50,42.88,17.77115846
hek293t,12726,1,4,TATTGAGAACATGGGAGGATCTTATCAGTTGGGTGGAAAAGCCTTGTCATGAAGAAATGTGCACTGCATTTTTAAGAGAAAAAAATTCTAGTTGGTTTA,TATTGAGAACATGGGAGGATCTTATCAGTTTGATGGGTGGAAAAGCCTTGTCATGAAGAAATGTGCACTGCATTTTTAAGAGAAAAAAATTCTAGTTGG,10,30,14,27,27,41,27,45,27,31,31,41,35,45,42.88,49.71181037
hek293t,12728,1,5,TCCGTTTGTAGATACTTCTCATTCTTATGGGGAAAAACTACTATATTCTTTGCACAGGATTTATGAAATCTGGGGGATGGAACATCTAAAAAAATTCTA,TCCGTTTGTAGATACTTCTCATTCTTATCCCCTGGGGAAAAACTACTATATTCTTTGCACAGGATTTATGAAATCTGGGGGATGGAACATCTAAAAAAA,10,30,14,27,27,31,27,36,27,28,28,31,33,36,28.77,0.805343623
hek293t,12728,1,5,AACGTTTGTAGATACTTCTCATTCTTATGGGGAAAAACTACTATATTCTTTGCACAGGATTTATGAAATCTGGGGAAAAAAATTCTAGTTGGTTTAACG,AACGTTTGTAGATACTTCTCATTCTTATCCCCTGGGGAAAAACTACTATATTCTTTGCACAGGATTTATGAAATCTGGGGAAAAAAATTCTAGTTGGTT,10,30,14,27,27,43,27,48,27,28,28,43,33,48,28.77,7.901586194
hek293t,12730,1,13,ACTAACTTGGCGAAACCAGCTGGTTTCTGAGGTGTTTGGTCTGTTCCAGGCTGCTGTTCGGGAGGGGAAGTAAAAAAAATTCTAGTTGGTTTAACGCGT,ACTAACTTGGCGAAACCAGCTGGTTTCATCGACCCATCAGTGAGGTGTTTGGTCTGTTCCAGGCTGCTGTTCGGGAGGGGAAGTAAAAAAAATTCTAGT,10,30,14,27,27,38,27,51,27,28,28,38,41,51,44.12,52.21361959
hek293t,12732,1,8,TCACGTTAGTATTTGCTTTGCTTTTGTACTGGTTGACAGAGCAAAGATGATTTTAATGCATAAGGGAAAAAAATTCTAGTTGGTTTAACGCGTAACTAG,TCACGTTAGTATTTGCTTTGCTTTTGTACTGGTTGACACTCATGCAGAGCAAAGATGATTTTAATGCATAAGGGAAAAAAATTCTAGTTGGTTTAACGC,10,30,14,27,27,49,27,57,27,39,39,49,47,57,6.8,4.363306722
hek293t,12733,1,11,GTTGTTTTTCACAGTTGCAGATCCTTTTGGGGGGATGTAATCTTCCGATCATTCTACACCCCATATTCCTACTGAAAAAAAAATTCTAGTTGGTTTAAC,GTTGTTTTTCACAGTTGCAGATCCTTTTGAGCCCCCCATGGGGGGATGTAATCTTCCGATCATTCTACACCCCATATTCCTACTGAAAAAAAAATTCTA,10,30,14,27,27,36,27,47,27,29,29,36,40,47,6.73,0.235652388
hek293t,12733,1,11,TGATATTTTCACAGTTGCAGATCCTTTTGGGGGGATGTAATCTTCCGATCATTCTACACCCCATATTCAAAAAAATTCTAGTTGGTTTAACGCGTAACT,TGATATTTTCACAGTTGCAGATCCTTTTGAGCCCCCCATGGGGGGATGTAATCTTCCGATCATTCTACACCCCATATTCAAAAAAATTCTAGTTGGTTT,10,30,14,27,27,44,27,55,27,29,29,44,40,55,6.73,2.896448657
hek293t,12735,1,5,GATCTAGTATCCCCAGGTTCCTACTACTTTGGGTTGATTTTAGAGAACTTTAGCCTCAGCACTAATCGTGCTAAAAAAATTCTAGTTGGTTTAACGCGT,GATCTAGTATCCCCAGGTTCCTACTACTTTGGGTTGATCTTCGTTTAGAGAACTTTAGCCTCAGCACTAATCGTGCTAAAAAAATTCTAGTTGGTTTAA,10,30,14,27,27,46,27,51,27,39,39,46,44,51,31.89,7.069957813
hek293t,12735,1,5,GTAACAGTATCCCCAGGTTCCTACTACTTTGGGTTGATTTTAGAGAACTTTAGCCTCAGCACTAATCGTGCTGCATAAAAAAATTCTAGTTGGTTTAAC,GTAACAGTATCCCCAGGTTCCTACTACTTTGGGTTGATCTTCGTTTAGAGAACTTTAGCCTCAGCACTAATCGTGCTGCATAAAAAAATTCTAGTTGGT,10,30,14,27,27,42,27,47,27,39,39,42,44,47,31.89,0.0
hek293t,12737,1,3,AGCGCCTCAAAAAATTGCAAAGTCATTTGGGGGTCGTTGTGTTGGTCAAATCTTGGGACATTGGAGAGAATTCCAGATTTTTAAGAAGTAAAAAAATTC,AGCGCCTCAAAAAATTGCAAAGTCATTACATGGGGGTCGTTGTGTTGGTCAAATCTTGGGACATTGGAGAGAATTCCAGATTTTTAAGAAGTAAAAAAA,10,30,14,27,27,31,27,34,27,28,28,31,31,34,14.74,0.060938452
hek293t,12737,1,3,TCTGCCTCAAAAAATTGCAAAGTCATTTGGGGGTCGTTGTGTTGGTCAAATCTTGGGACATTGGAGAGAATTCCAGATTTTTAAAAAAATTCTAGTTGG,TCTGCCTCAAAAAATTGCAAAGTCATTACATGGGGGTCGTTGTGTTGGTCAAATCTTGGGACATTGGAGAGAATTCCAGATTTTTAAAAAAATTCTAGT,10,30,14,27,27,38,27,41,27,28,28,38,31,41,14.74,35.0045526
hek293t,12739,1,11,TCGCTCAAGGCTTGGACGGCGGCGGGTGGCGGCGCAGCACAGCAGCGGCTGCCGTCGGGATGGGAGCCCACACAAAAAAATTCTAGTTGGTTTAACGCG,TCGCTCAAGGCTTGGACGGCGGCGGGTGGCGCGATTGGTTATGCGCAGCACAGCAGCGGCTGCCGTCGGGATGGGAGCCCACACAAAAAAATTCTAGTT,10,30,14,27,27,39,27,50,27,32,32,39,43,50,22.81,47.37639553
hek293t,12741,1,9,CCTTTTACCTACAACCAGCTGCCTTCCTTCGGCCACGGCGCTGCGTGCAGCTCTGCCTTTCCAGCGCAAGAAAAAAAAATTCTAGTTGGTTTAACGCGT,CCTTTTACCTACAACCAGCTGCCTTCCTTCGTCAGATGGAGCCACGGCGCTGCGTGCAGCTCTGCCTTTCCAGCGCAAGAAAAAAAAATTCTAGTTGGT,10,30,14,27,27,42,27,51,27,32,32,42,41,51,44.01,56.57953343
hek293t,12741,1,9,CTCAATACCTACAACCAGCTGCCTTCCTTCGGCCACGGCGCTGCGTGCAGCTCTGCCTTTCCAGCGCAAGAATGAGCCGAAAAAAATTCTAGTTGGTTT,CTCAATACCTACAACCAGCTGCCTTCCTTCGTCAGATGGAGCCACGGCGCTGCGTGCAGCTCTGCCTTTCCAGCGCAAGAATGAGCCGAAAAAAATTCT,10,30,14,27,27,35,27,44,27,32,32,35,41,44,44.01,5.614846702
hek293t,12743,1,12,CGACCGACCATCTTGCTTGAGACAGAAACTGGTTTAGAAAGAACTAACGCTGCCTTAAATTGTGAAAAAAAATTCTAGTTGGTTTAACGCGTAACTAGA,CGACCGACCATCTTGCTTGAGACAGAAACTGGTTTAGAGGGTGTAATTGCAAGAACTAACGCTGCCTTAAATTGTGAAAAAAAATTCTAGTTGGTTTAA,10,30,14,27,27,46,27,58,27,39,39,46,51,58,18.05,0.0
hek293t,12746,1,2,TGCTGCAGAAAGAATAGCAAAAAGCCTTCAGGCAGGATGACTTGTTTCCTGAAGAATTCCACCCCAAATCCTGCTAACTGAAGAAAAAAATTCTAGTTG,TGCTGCAGAAAGAATAGCAAAAAGCCTTCATTGGCAGGATGACTTGTTTCCTGAAGAATTCCACCCCAAATCCTGCTAACTGAAGAAAAAAATTCTAGT,10,30,14,27,27,38,27,40,27,31,31,38,33,40,27.05,1.721346135
hek293t,12746,1,2,GCTGCCAGAAAGAATAGCAAAAAGCCTTCAGGCAGGATGACTTGTTTCCTGAAGAATTCCACCCCAAATCCTGCTAACTGAAGACTTAAAAAAATTCTA,GCTGCCAGAAAGAATAGCAAAAAGCCTTCATTGGCAGGATGACTTGTTTCCTGAAGAATTCCACCCCAAATCCTGCTAACTGAAGACTTAAAAAAATTC,10,30,14,27,27,34,27,36,27,31,31,34,33,36,27.05,0.0
hek293t,12748,1,15,ATTACTGACTCACATAAATCGGAGTAAGCAGGGTTTATTTGGCTTTGATTTTTGTCCTTTAAACTGATCAAAAAAATTCTAGTTGGTTTAACGCGTAAC,ATTACTGACTCACATAAATCGGAGTAAGCAGGGTTGTCCATTGAAGTGTGTATTTGGCTTTGATTTTTGTCCTTTAAACTGATCAAAAAAATTCTAGTT,10,30,14,27,27,39,27,54,27,36,36,39,51,54,24.08,0.0
hek293t,12749,1,11,TAGACCAATCAGAGTTAAGCTCTGGGACGTGGCAACAAGAAACGGTAAGACGGCGGCAGGACTTTTAGCCAAAAAAATTCTAGTTGGTTTAACGCGTAA,TAGACCAATCAGAGTTAAGCTCTGGGCTTCATTAACTACGTGGCAACAAGAAACGGTAAGACGGCGGCAGGACTTTTAGCCAAAAAAATTCTAGTTGGT,10,30,14,27,27,42,27,53,27,27,27,42,38,53,51.26,21.95760326
hek293t,12751,1,3,CGAAAGGCCCTGGCCAGATAAGCAATAGTAGGAACTACACACTTTATTGAATCAGTGTGAGAAAAGACCAAAAAAAATTCTAGTTGGTTTAACGCGTAA,CGAAAGGCCCTGGCCAGATAAGCAATAGTAGGAACTACAATTCACTTTATTGAATCAGTGTGAGAAAAGACCAAAAAAAATTCTAGTTGGTTTAACGCG,10,30,14,27,27,50,27,53,27,40,40,50,43,53,54.85,28.38399831
hek293t,12751,1,3,TTACCGGCCCTGGCCAGATAAGCAATAGTAGGAACTACACACTTTATTGAATCAGTGTGAGAAAAGACCATTTAAAAAAATTCTAGTTGGTTTAACGCG,TTACCGGCCCTGGCCAGATAAGCAATAGTAGGAACTACAATTCACTTTATTGAATCAGTGTGAGAAAAGACCATTTAAAAAAATTCTAGTTGGTTTAAC,10,30,14,27,27,47,27,50,27,40,40,47,43,50,54.85,37.77764891
hek293t,12753,1,13,TATTAAACGGTCAAATCCAGGGGACTTCCAGGCATGAATACAGAGATGGCACATAAGATCAGACAAGCAAACTGGGCAAAAAAATTCTAGTTGGTTTAA,TATTAAACGGTCAAATCCAGGGGACTTCCGAAATCTAACTTAAGGCATGAATACAGAGATGGCACATAAGATCAGACAAGCAAACTGGGCAAAAAAATT,10,30,14,27,27,33,27,46,27,30,30,33,43,46,26.95,0.0
hek293t,12753,1,13,CATAAAACGGTCAAATCCAGGGGACTTCCAGGCATGAATACAGAGATGGCACATAAGATCAGACAAGCAAAAAAAAATTCTAGTTGGTTTAACGCGTAA,CATAAAACGGTCAAATCCAGGGGACTTCCGAAATCTAACTTAAGGCATGAATACAGAGATGGCACATAAGATCAGACAAGCAAAAAAAAATTCTAGTTG,10,30,14,27,27,40,27,53,27,30,30,40,43,53,26.95,12.14873171
hek293t,12755,1,13,TACCCGTGCATGGAATTCTGCTTCTCGGCTGGGAAACGCTGGAATAGGAGCTCAAAAGTAGGACTAAAAAAATTCTAGTTGGTTTAACGCGTAACTAGA,TACCCGTGCATGGAATTCTGCTTCTCGGCTGGGACATACAAGTGTCCAACGCTGGAATAGGAGCTCAAAAGTAGGACTAAAAAAATTCTAGTTGGTTTA,10,30,14,27,27,45,27,58,27,35,35,45,48,58,27.9,4.304195537
hek293t,12756,1,9,GACGATGAATATACCTGAAAGCCTCAAACAGGTATTTTATTATCAATCATAATTAGTCTTCCACCAAATTTAAAAAAAATTCTAGTTGGTTTAACGCGT,GACGATGAATATACCTGAAAGCCTCAAACAGGTATTTTAACTCCTAGATTATCAATCATAATTAGTCTTCCACCAAATTTAAAAAAAATTCTAGTTGGT,10,30,14,27,27,42,27,51,27,39,39,42,48,51,48.58,0.0
hek293t,12757,1,8,TGTTGTGTCCCCAACAGCCGGAGGAGGGCAGGCTGCACTAGAGGATGGCTCCGGTGGCATTGACTGGGACGTTGATAAAAAAATTCTAGTTGGTTTAAC,TGTTGTGTCCCCAACAGCCGGAGGAGGGGACACATTCAGGCTGCACTAGAGGATGGCTCCGGTGGCATTGACTGGGACGTTGATAAAAAAATTCTAGTT,10,30,14,27,27,39,27,47,27,29,29,39,37,47,41.64,28.2576668
hek293t,12757,1,8,GCGCGTGTCCCCAACAGCCGGAGGAGGGCAGGCTGCACTAGAGGATGGCTCCGGTGGCATTGACTGGGACGTTGATGTTGGTGAAAAAAATTCTAGTTG,GCGCGTGTCCCCAACAGCCGGAGGAGGGGACACATTCAGGCTGCACTAGAGGATGGCTCCGGTGGCATTGACTGGGACGTTGATGTTGGTGAAAAAAAT,10,30,14,27,27,32,27,40,27,29,29,32,37,40,41.64,0.62727377
hek293t,12759,1,10,CCGCGCTGTAGCTCTTCACTACTGCAAATTGGCCCCATCTGAGAAAACTGGCTTCACCTTGATGTCTTCCAAAAAAATTCTAGTTGGTTTAACGCGTAA,CCGCGCTGTAGCTCTTCACTACTGCAAATTGGCCCGACCGGGCGCCATCTGAGAAAACTGGCTTCACCTTGATGTCTTCCAAAAAAATTCTAGTTGGTT,10,30,14,27,27,43,27,53,27,36,36,43,46,53,10.42,24.84065391
hek293t,12760,1,2,GGCTAACATGACTTAGAAGGACAAAGGTGTGGTCTATGAAAAGTTTGAACCCTGTTTTCATGTCCTGTTGTCAAAGAAGTTAAAAAAATTCTAGTTGGT,GGCTAACATGACTTAGAAGGACAAAGGTGTGGCATCTATGAAAAGTTTGAACCCTGTTTTCATGTCCTGTTGTCAAAGAAGTTAAAAAAATTCTAGTTG,10,30,14,27,27,40,27,42,27,33,33,40,35,42,61.4,82.08032015
hek293t,12760,1,2,AATTGACATGACTTAGAAGGACAAAGGTGTGGTCTATGAAAAGTTTGAACCCTGTTTTCATGTCCTGTTGTCAAAGAAAAAAAAATTCTAGTTGGTTTA,AATTGACATGACTTAGAAGGACAAAGGTGTGGCATCTATGAAAAGTTTGAACCCTGTTTTCATGTCCTGTTGTCAAAGAAAAAAAAATTCTAGTTGGTT,10,30,14,27,27,43,27,45,27,33,33,43,35,45,61.4,77.21200197
hek293t,12762,1,5,TTCTCCCTACAAGATGTGTATCATGTACCTGGAACAGTCATCAAACCAAAAAACCAAATAACCAACTGCAATGGCTCAGAAAAAAATTCTAGTTGGTTT,TTCTCCCTACAAGATGTGTATCATGTACCTGCGCTTGAACAGTCATCAAACCAAAAAACCAAATAACCAACTGCAATGGCTCAGAAAAAAATTCTAGTT,10,30,14,27,27,39,27,44,27,32,32,39,37,44,55.77,79.57579981
hek293t,12762,1,5,ATCCACCTACAAGATGTGTATCATGTACCTGGAACAGTCATCAAACCAAAAAACCAAATAACCAACTGCAAAAAAAAATTCTAGTTGGTTTAACGCGTA,ATCCACCTACAAGATGTGTATCATGTACCTGCGCTTGAACAGTCATCAAACCAAAAAACCAAATAACCAACTGCAAAAAAAAATTCTAGTTGGTTTAAC,10,30,14,27,27,47,27,52,27,32,32,47,37,52,55.77,75.57483399
hek293t,12764,1,4,ATCTGCTCTCTACAATGCAACTTTATGTCTGGTCTAGCAACTGTGTTCTATCAGAGACAATTTAAACTGAGGAAAAAAATTCTAGTTGGTTTAACGCGT,ATCTGCTCTCTACAATGCAACTTTATGTCTGGTCTATAATGCAACTGTGTTCTATCAGAGACAATTTAAACTGAGGAAAAAAATTCTAGTTGGTTTAAC,10,30,14,27,27,47,27,51,27,37,37,47,41,51,26.08,17.13887679
hek293t,12764,1,4,CCGACCTCTCTACAATGCAACTTTATGTCTGGTCTAGCAACTGTGTTCTATCAGAGACAATTTAAACTGAGGACCACATAAAAAAATTCTAGTTGGTTT,CCGACCTCTCTACAATGCAACTTTATGTCTGGTCTATAATGCAACTGTGTTCTATCAGAGACAATTTAAACTGAGGACCACATAAAAAAATTCTAGTTG,10,30,14,27,27,40,27,44,27,37,37,40,41,44,26.08,0.0
hek293t,12766,1,3,TCGGTTAGTACACTGCATCATGACAACCATGGCAAGCATGGAGCTGGACCGATACTGCAGGCTGAAAGCAGCCAAAAAAATTCTAGTTGGTTTAACGCG,TCGGTTAGTACACTGCATCATGACAACCATGGCAAGCATATTGGAGCTGGACCGATACTGCAGGCTGAAAGCAGCCAAAAAAATTCTAGTTGGTTTAAC,10,30,14,27,27,47,27,50,27,40,40,47,43,50,78.15,67.03142167
hek293t,12766,1,3,GGCACTAGTACACTGCATCATGACAACCATGGCAAGCATGGAGCTGGACCGATACTGCAGGCTGAAAAAAAATTCTAGTTGGTTTAACGCGTAACTAGA,GGCACTAGTACACTGCATCATGACAACCATGGCAAGCATATTGGAGCTGGACCGATACTGCAGGCTGAAAAAAAATTCTAGTTGGTTTAACGCGTAACT,10,30,14,27,27,55,27,58,27,40,40,55,43,58,78.15,78.41966812
hek293t,12768,1,8,CTGCGAGAAACACTACTCCTCTGACAATAAGGGTCTATTTTGTTCCAAGACATTTTAAAATGTTATAAAAAAATTCTAGTTGGTTTAACGCGTAACTAG,CTGCGAGAAACACTACTCCTCTGACAATAAGGGTCTATCGCCGGACTTTGTTCCAAGACATTTTAAAATGTTATAAAAAAATTCTAGTTGGTTTAACGC,10,30,14,27,27,49,27,57,27,39,39,49,47,57,18.88,22.46865443
hek293t,12769,1,12,AAGCGAACAAAGTGGGAGGGGAAAAAGAGGGGAGAAATCTCCTTTCACATCATCCTAAAATGCACTGAAAAAAAAATTCTAGTTGGTTTAACGCGTAAC,AAGCGAACAAAGTGGGAGGGGAAAAAGAGGGGAGAAATTATGTAGTTCCACTCCTTTCACATCATCCTAAAATGCACTGAAAAAAAAATTCTAGTTGGT,10,30,14,27,27,42,27,54,27,39,39,42,51,54,64.93,0.0
hek293t,12770,1,8,GAGTGGTAGAGTCCTTACTTCCAGATCTGGGGAGGGGGCGATCACAGTATTTCTGAATAGTGCTAAAAAAATTCTAGTTGGTTTAACGCGTAACTAGAT,GAGTGGTAGAGTCCTTACTTCCAGATCTGGGGAGGGGGCGTTATGTTTATCACAGTATTTCTGAATAGTGCTAAAAAAATTCTAGTTGGTTTAACGCGT,10,30,14,27,27,51,27,59,27,41,41,51,49,59,62.98,6.034967754
hek293t,12771,1,3,GGGCGACAGCGAAAAACAGTATCCTTTTCAGGGAGGCTTTTCCACTCTTACATTCTGAAAGTTATATAAAGCACAGCAAAAAAATTCTAGTTGGTTTAA,GGGCGACAGCGAAAAACAGTATCCTTTTCAGGGAGTACGCTTTTCCACTCTTACATTCTGAAAGTTATATAAAGCACAGCAAAAAAATTCTAGTTGGTT,10,30,14,27,27,43,27,46,27,36,36,43,39,46,3.26,0.685688078
hek293t,12771,1,3,CAACAACAGCGAAAAACAGTATCCTTTTCAGGGAGGCTTTTCCACTCTTACATTCTGAAAGTTATATAAAGCACAGCTGACAAAAAAATTCTAGTTGGT,CAACAACAGCGAAAAACAGTATCCTTTTCAGGGAGTACGCTTTTCCACTCTTACATTCTGAAAGTTATATAAAGCACAGCTGACAAAAAAATTCTAGTT,10,30,14,27,27,39,27,42,27,36,36,39,39,42,3.26,0.0
hek293t,12773,1,1,GCGCCGGGATTAGTGACAATGCTGAGTGCAGGACCAGAAGAGCATGCTCCTTCTGTAGTATCATTCTCCTGGAAAAAAATTCTAGTTGGTTTAACGCGT,GCGCCGGGATTAGTGACAATGCTGAGTGCAGGACCCAGAAGAGCATGCTCCTTCTGTAGTATCATTCTCCTGGAAAAAAATTCTAGTTGGTTTAACGCG,10,30,14,27,27,50,27,51,27,35,35,50,36,51,63.87,80.10267458
hek293t,12773,1,1,TTCAAGGGATTAGTGACAATGCTGAGTGCAGGACCAGAAGAGCATGCTCCTTCTGTAGTATCATTCTCCTGGCCCCCCCCAAAAAAATTCTAGTTGGTT,TTCAAGGGATTAGTGACAATGCTGAGTGCAGGACCCAGAAGAGCATGCTCCTTCTGTAGTATCATTCTCCTGGCCCCCCCCAAAAAAATTCTAGTTGGT,10,30,14,27,27,42,27,43,27,35,35,42,36,43,63.87,74.55677103
hek293t,12775,1,8,GGCATTATTTTTATGATACATCTATGGACTGGATGAGTGAAGACATATTGTAAGCCTCAGTAATTGTAAAAAAATTCTAGTTGGTTTAACGCGTAACTA,GGCATTATTTTTATGATACATCTATGGACTGGATGAGTGACCTTCCGTAGACATATTGTAAGCCTCAGTAATTGTAAAAAAATTCTAGTTGGTTTAACG,10,30,14,27,27,48,27,56,27,41,41,48,49,56,37.81,0.394933526
hek293t,12776,1,8,CTCGGATATTTGTACAGTATCTAGAACAGTGGGAAGCTCCGACATATTTACAGATGGTGAATGATTAAAAAAAAATTCTAGTTGGTTTAACGCGTAACT,CTCGGATATTTGTACAGTATCTAGAACAGTGGGAAGCTCTAACTCGACGACATATTTACAGATGGTGAATGATTAAAAAAAAATTCTAGTTGGTTTAAC,10,30,14,27,27,47,27,55,27,40,40,47,48,55,62.41,0.089270057
hek293t,12776,1,8,ATGCCATATTTGTACAGTATCTAGAACAGTGGGAAGCTCCGACATATTTACAGATGGTGAATGATTAATACCAAAAAAATTCTAGTTGGTTTAACGCGT,ATGCCATATTTGTACAGTATCTAGAACAGTGGGAAGCTCTAACTCGACGACATATTTACAGATGGTGAATGATTAATACCAAAAAAATTCTAGTTGGTT,10,30,14,27,27,43,27,51,27,40,40,43,48,51,62.41,0.0
hek293t,12778,1,2,GCCCAAAAATTGACTTTTGCTACCAGAACTGGGGTATAGAAGCAGAAGTCAAGTTAGGTGTGTGCACCATGGTCAGGTGCTAAAAAAATTCTAGTTGGT,GCCCAAAAATTGACTTTTGCTACCAGAACTGGGGTAGGTAGAAGCAGAAGTCAAGTTAGGTGTGTGCACCATGGTCAGGTGCTAAAAAAATTCTAGTTG,10,30,14,27,27,40,27,42,27,37,37,40,39,42,6.07,0.0
hek293t,12778,1,2,ATAATAAAATTGACTTTTGCTACCAGAACTGGGGTATAGAAGCAGAAGTCAAGTTAGGTGTGTGCACCATGGTCAAAAAAATTCTAGTTGGTTTAACGC,ATAATAAAATTGACTTTTGCTACCAGAACTGGGGTAGGTAGAAGCAGAAGTCAAGTTAGGTGTGTGCACCATGGTCAAAAAAATTCTAGTTGGTTTAAC,10,30,14,27,27,47,27,49,27,37,37,47,39,49,6.07,0.408472572
hek293t,12780,1,3,CGTGACTGTGATATCCATCATCCAAGACTTGGGAACTGGGAATATTCTGGCAGGCAAAAGGGGCTAAAAAAATTCTAGTTGGTTTAACGCGTAACTAGA,CGTGACTGTGATATCCATCATCCAAGACTTGGGAACTGGGAAGAATATTCTGGCAGGCAAAAGGGGCTAAAAAAATTCTAGTTGGTTTAACGCGTAACT,10,30,14,27,27,55,27,58,27,40,40,55,43,58,49.57,70.25090942
hek293t,12780,1,3,TGATGCTGTGATATCCATCATCCAAGACTTGGGAACTGGGAATATTCTGGCAGGCAAAAGGGGCTGAGAATGCACCTAAAAAAATTCTAGTTGGTTTAA,TGATGCTGTGATATCCATCATCCAAGACTTGGGAACTGGGAAGAATATTCTGGCAGGCAAAAGGGGCTGAGAATGCACCTAAAAAAATTCTAGTTGGTT,10,30,14,27,27,43,27,46,27,40,40,43,43,46,49.57,0.0
hek293t,12782,1,7,ATTTAGCAGGAAACCAAATGAAAATGATTAGGAAGATAAATAAAATAGAAGCGGGGGGAAAGAGATTGAGTCGGTCTAAATGAAAAAAATTCTAGTTGG,ATTTAGCAGGAAACCAAATGAAAATGATTAGACCCCAGGAAGATAAATAAAATAGAAGCGGGGGGAAAGAGATTGAGTCGGTCTAAATGAAAAAAATTC,10,30,14,27,27,34,27,41,27,31,31,34,38,41,22.9,0.0
hek293t,12782,1,7,ACTACGCAGGAAACCAAATGAAAATGATTAGGAAGATAAATAAAATAGAAGCGGGGGGAAAGAGATTGAGTCGGTCTAAAAAAAATTCTAGTTGGTTTA,ACTACGCAGGAAACCAAATGAAAATGATTAGACCCCAGGAAGATAAATAAAATAGAAGCGGGGGGAAAGAGATTGAGTCGGTCTAAAAAAAATTCTAGT,10,30,14,27,27,38,27,45,27,31,31,38,38,45,22.9,0.0
hek293t,12784,1,11,TGTGCGCGGCCCTCATTTCCATGCATGAATGGCCATTTCCATATCATTACCCATAATGCTGCGCACTCCAAAAAAATTCTAGTTGGTTTAACGCGTAAC,TGTGCGCGGCCCTCATTTCCATGCATGAATGGCCATTTCTAGATATACCTCATATCATTACCCATAATGCTGCGCACTCCAAAAAAATTCTAGTTGGTT,10,30,14,27,27,43,27,54,27,40,40,43,51,54,22.81,0.0
hek293t,12785,1,7,GAGCGTGGTCTTGTTGATCATGTGTATAAAGGTGTTCATCTGTTCAGTCTGTACTAATCACAGTAACAAGGCTGTTAAAAAAATTCTAGTTGGTTTAAC,GAGCGTGGTCTTGTTGATCATGTGTATAATGCATTGAGGTGTTCATCTGTTCAGTCTGTACTAATCACAGTAACAAGGCTGTTAAAAAAATTCTAGTTG,10,30,14,27,27,40,27,47,27,30,30,40,37,47,18.56,18.22758175
hek293t,12785,1,7,AAGGGTGGTCTTGTTGATCATGTGTATAAAGGTGTTCATCTGTTCAGTCTGTACTAATCACAGTAACAAGGCTGTTGCTCAGAAAAAAAATTCTAGTTG,AAGGGTGGTCTTGTTGATCATGTGTATAATGCATTGAGGTGTTCATCTGTTCAGTCTGTACTAATCACAGTAACAAGGCTGTTGCTCAGAAAAAAAATT,10,30,14,27,27,33,27,40,27,30,30,33,37,40,18.56,0.406796379
hek293t,12787,1,15,TAAAGCCCCCCCAGGGTTCGTTATAAAAGAGGAGGAGCATGGAATGTGTAATAATGCTAACGTGAGCTTTAAAAAAATTCTAGTTGGTTTAACGCGTAA,TAAAGCCCCCCCAGGGTTCGTTATAAAAGACGGGGACACTCTATTGGAGGAGCATGGAATGTGTAATAATGCTAACGTGAGCTTTAAAAAAATTCTAGT,10,30,14,27,27,38,27,53,27,31,31,38,46,53,50.37,0.0
hek293t,12787,1,15,TTTAACCCCCCCAGGGTTCGTTATAAAAGAGGAGGAGCATGGAATGTGTAATAATGCTAACGTGAGCAAAAAAATTCTAGTTGGTTTAACGCGTAACTA,TTTAACCCCCCCAGGGTTCGTTATAAAAGACGGGGACACTCTATTGGAGGAGCATGGAATGTGTAATAATGCTAACGTGAGCAAAAAAATTCTAGTTGG,10,30,14,27,27,41,27,56,27,31,31,41,46,56,50.37,1.211806253
hek293t,12789,1,8,AGCGCCTTGGACAAACTGCAACAACCTGCTGGTTATTGACTGTAAAGTCTAAGCCTCGGATTAAAGTTACATTTAACTGTAAAAAAAATTCTAGTTGGT,AGCGCCTTGGACAAACTGCAACAACCCTTGATCATGCTGGTTATTGACTGTAAAGTCTAAGCCTCGGATTAAAGTTACATTTAACTGTAAAAAAAATTC,10,30,14,27,27,34,27,42,27,27,27,34,35,42,33.75,39.9773852
hek293t,12789,1,8,GGATACTTGGACAAACTGCAACAACCTGCTGGTTATTGACTGTAAAGTCTAAGCCTCGGATTAAAGTTACATTTAACTAAAAAAATTCTAGTTGGTTTA,GGATACTTGGACAAACTGCAACAACCCTTGATCATGCTGGTTATTGACTGTAAAGTCTAAGCCTCGGATTAAAGTTACATTTAACTAAAAAAATTCTAG,10,30,14,27,27,37,27,45,27,27,27,37,35,45,33.75,32.83195171
hek293t,12791,1,8,CACTACGGCGCTAAACCGCTCCGGGAGGACGGCGTGGCTCCTGGGAAGATCAGCGCCTGCTCCCAGCCTCGGCCAAAAAAATTCTAGTTGGTTTAACGC,CACTACGGCGCTAAACCGCTCCGGGAGGACTCGTCAAGGGCGTGGCTCCTGGGAAGATCAGCGCCTGCTCCCAGCCTCGGCCAAAAAAATTCTAGTTGG,10,30,14,27,27,41,27,49,27,31,31,41,39,49,58.85,77.99838191
hek293t,12793,1,7,GAAGCTGCTTTAAGCACACAGTGATAAGCTGGATAAATAGGAAATTCTTTCCACTAGGCCAGCAACACAAAAAAATTCTAGTTGGTTTAACGCGTAACT,GAAGCTGCTTTAAGCACACAGTGATAAGCTGGATAAATAAAGCCTAGGAAATTCTTTCCACTAGGCCAGCAACACAAAAAAATTCTAGTTGGTTTAACG,10,30,14,27,27,48,27,55,27,38,38,48,45,55,26.33,0.5148376
hek293t,12794,1,6,TTAAGTTTATTAGGCCTTGATCTAACCAGTGGGTCTTTGAGGTGGTTGCTCAGATCTAAATGGCTAATTTGGTCCGTTCTGTTTTAAAAAAAATTCTAG,TTAAGTTTATTAGGCCTTGATCTAACCTTACTAAGTGGGTCTTTGAGGTGGTTGCTCAGATCTAAATGGCTAATTTGGTCCGTTCTGTTTTAAAAAAAA,10,30,14,27,27,31,27,37,27,28,28,31,34,37,58.47,3.239805182
hek293t,12794,1,6,AAATCTTTATTAGGCCTTGATCTAACCAGTGGGTCTTTGAGGTGGTTGCTCAGATCTAAATGGCTAATTTGGTCCGTTCAAAAAAATTCTAGTTGGTTT,AAATCTTTATTAGGCCTTGATCTAACCTTACTAAGTGGGTCTTTGAGGTGGTTGCTCAGATCTAAATGGCTAATTTGGTCCGTTCAAAAAAATTCTAGT,10,30,14,27,27,38,27,44,27,28,28,38,34,44,58.47,67.722557
hek293t,12800,1,13,GGTTGAATTTGATTGCTCAGAGGTTCAGCAGGCTCCTGTAAAGGTCAGATGGATTATTACAGGTAATCACTAAAAAAATTCTAGTTGGTTTAACGCGTA,GGTTGAATTTGATTGCTCAGAGGTTCAGCAGGCTCATCCGACATACTTCTGTAAAGGTCAGATGGATTATTACAGGTAATCACTAAAAAAATTCTAGTT,10,30,14,27,27,39,27,52,27,36,36,39,49,52,44.19,0.197005516
hek293t,12800,1,13,ACTACAATTTGATTGCTCAGAGGTTCAGCAGGCTCCTGTAAAGGTCAGATGGATTATTACAGGTAATAAAAAAATTCTAGTTGGTTTAACGCGTAACTA,ACTACAATTTGATTGCTCAGAGGTTCAGCAGGCTCATCCGACATACTTCTGTAAAGGTCAGATGGATTATTACAGGTAATAAAAAAATTCTAGTTGGTT,10,30,14,27,27,43,27,56,27,36,36,43,49,56,44.19,2.907238141
hek293t,12802,1,2,CTCAGCCTCAGAGGTAATAAAACTATTTTAGGCAAACTTAATAAAAAACAGTTGTGCTGTCATTGTGTTGAATGTCAGCAAAAAAATTCTAGTTGGTTT,CTCAGCCTCAGAGGTAATAAAACTATTTTAGGCAAACTCATAATAAAAAACAGTTGTGCTGTCATTGTGTTGAATGTCAGCAAAAAAATTCTAGTTGGT,10,30,14,27,27,42,27,44,27,39,39,42,41,44,6.1,0.0
hek293t,12804,1,4,GCTTTGCGAGATGCTGTGCAGCGAGGGAGCGGCGGGTGGCAGGAGGGCCGCTCGCCCTGCGACCAGCGAGGAGAGCACGAAAAAAATTCTAGTTGGTTT,GCTTTGCGAGATGCTGTGCAGCGAGGGAGCGGGCGCCGGGTGGCAGGAGGGCCGCTCGCCCTGCGACCAGCGAGGAGAGCACGAAAAAAATTCTAGTTG,10,30,14,27,27,40,27,44,27,33,33,40,37,44,55.2,76.35605939
hek293t,12806,1,8,AGTTCGTGGAGGCAGGAATGCACAGCTGAAGGTGGAGGGAAGAGCAAGACTGACCGTTTATAAATCTATAAAAAAATTCTAGTTGGTTTAACGCGTAAC,AGTTCGTGGAGGCAGGAATGCACAGCTGAAGGTGGAGGAGAGCGATGAAGAGCAAGACTGACCGTTTATAAATCTATAAAAAAATTCTAGTTGGTTTAA,10,30,14,27,27,46,27,54,27,39,39,46,47,54,59.24,0.77326295
hek293t,12808,1,1,TTTAGACTCTGACACCATAATTCAGTTCATGGGAACCCAATGCTTAAGTCAGGGAATCTCTTTACAAATGTCTAAAAAAATTCTAGTTGGTTTAACGCG,TTTAGACTCTGACACCATAATTCAGTTCATGGGAACCCTAATGCTTAAGTCAGGGAATCTCTTTACAAATGTCTAAAAAAATTCTAGTTGGTTTAACGC,10,30,14,27,27,49,27,50,27,39,39,49,40,50,16.9,19.59576571
hek293t,12808,1,1,AGTGGACTCTGACACCATAATTCAGTTCATGGGAACCCAATGCTTAAGTCAGGGAATCTCTTTACAAAAAAAAAATTCTAGTTGGTTTAACGCGTAACT,AGTGGACTCTGACACCATAATTCAGTTCATGGGAACCCTAATGCTTAAGTCAGGGAATCTCTTTACAAAAAAAAAATTCTAGTTGGTTTAACGCGTAAC,10,30,14,27,27,54,27,55,27,39,39,54,40,55,16.9,5.9620767
hek293t,12810,1,14,ATCGGAGTTTATAGTAAATTCATGTTTTCAGGATGAAATAATTAAGTTACTATGTAAAATGTGCTAAAAAAATTCTAGTTGGTTTAACGCGTAACTAGA,ATCGGAGTTTATAGTAAATTCATGTTTTCAGGAATAACCGGGCACCTTGAAATAATTAAGTTACTATGTAAAATGTGCTAAAAAAATTCTAGTTGGTTT,10,30,14,27,27,44,27,58,27,34,34,44,48,58,0.71,0.0
hek293t,12811,1,12,AACACCTGCACTTGGGATTCTTGGATAGCTGGTCTTCGCAGGAGAGTGAGTGCAACATGTCTTGAACAAAAAAATTCTAGTTGGTTTAACGCGTAACTA,AACACCTGCACTTGGGATTCTTGGATAGCTGGTCTTCGCAACAGTTCCCTAGGGAGAGTGAGTGCAACATGTCTTGAACAAAAAAATTCTAGTTGGTTT,10,30,14,27,27,44,27,56,27,41,41,44,53,56,21.36,0.614312767
hek293t,12812,1,10,GTCTGACAAGATACTTTGTAAAATAATGTTGGAAATTGGTATTCTTTTTGTAATGCTGCTTGTGAAAAAAATTCTAGTTGGTTTAACGCGTAACTAGAT,GTCTGACAAGATACTTTGTAAAATAATGTTGGAAATTGCACGGTTGCTGTATTCTTTTTGTAATGCTGCTTGTGAAAAAAATTCTAGTTGGTTTAACGC,10,30,14,27,27,49,27,59,27,39,39,49,49,59,30.46,0.0
hek293t,12812,1,10,GACCTACAAGATACTTTGTAAAATAATGTTGGAAATTGGTATTCTTTTTGTAATGCTGCTTGTGGATAAAAAAATTCTAGTTGGTTTAACGCGTAACTA,GACCTACAAGATACTTTGTAAAATAATGTTGGAAATTGCACGGTTGCTGTATTCTTTTTGTAATGCTGCTTGTGGATAAAAAAATTCTAGTTGGTTTAA,10,30,14,27,27,46,27,56,27,39,39,46,49,56,30.46,0.0
hek293t,12814,1,4,CCTAAGTAGAATCTCTACTTTTTTGGAAGAGGAGATTATCACCATTGCATTTATAAGATTAGTTAGATTTCAAAAAAAATTCTAGTTGGTTTAACGCGT,CCTAAGTAGAATCTCTACTTTTTTGGAAGAGGAGATGGCTTATCACCATTGCATTTATAAGATTAGTTAGATTTCAAAAAAAATTCTAGTTGGTTTAAC,10,30,14,27,27,47,27,51,27,37,37,47,41,51,-0.82,0.595038918
hek293t,12814,1,4,AGGCGGTAGAATCTCTACTTTTTTGGAAGAGGAGATTATCACCATTGCATTTATAAGATTAGTTAGAAAAAAAATTCTAGTTGGTTTAACGCGTAACTA,AGGCGGTAGAATCTCTACTTTTTTGGAAGAGGAGATGGCTTATCACCATTGCATTTATAAGATTAGTTAGAAAAAAAATTCTAGTTGGTTTAACGCGTA,10,30,14,27,27,52,27,56,27,37,37,52,41,56,-0.82,0.752393981
hek293t,12816,1,9,ACTGGCTCTTTTTGCTTGCATGTGTCACATGGGACAGTCAGTTGGCTTTTGTGTGGAAGAGTCTGTATGACCCTCTATTAAAAAAATTCTAGTTGGTTT,ACTGGCTCTTTTTGCTTGCATGTGTCACATGCACGTGTACGGACAGTCAGTTGGCTTTTGTGTGGAAGAGTCTGTATGACCCTCTATTAAAAAAATTCT,10,30,14,27,27,35,27,44,27,32,32,35,41,44,20.03,0.0
hek293t,12816,1,9,CGATCCTCTTTTTGCTTGCATGTGTCACATGGGACAGTCAGTTGGCTTTTGTGTGGAAGAGTCTGTATGACCCTCAAAAAAATTCTAGTTGGTTTAACG,CGATCCTCTTTTTGCTTGCATGTGTCACATGCACGTGTACGGACAGTCAGTTGGCTTTTGTGTGGAAGAGTCTGTATGACCCTCAAAAAAATTCTAGTT,10,30,14,27,27,39,27,48,27,32,32,39,41,48,20.03,1.758499485
hek293t,12818,1,8,ATGAGAAATATATAGGTCAAATATCTATGGGGAAATCAGTGTTGTGTACGTGGTGGTATGTTGGAAAAAAATTCTAGTTGGTTTAACGCGTAACTAGAT,ATGAGAAATATATAGGTCAAATATCTATGGGGAAAACTAGAGTTCAGTGTTGTGTACGTGGTGGTATGTTGGAAAAAAATTCTAGTTGGTTTAACGCGT,10,30,14,27,27,51,27,59,27,36,36,51,44,59,65.86,0.234535508
hek293t,12818,1,8,GCAACAAATATATAGGTCAAATATCTATGGGGAAATCAGTGTTGTGTACGTGGTGGTATGTTGGAGAATCCCCCCCAAAAAAATTCTAGTTGGTTTAAC,GCAACAAATATATAGGTCAAATATCTATGGGGAAAACTAGAGTTCAGTGTTGTGTACGTGGTGGTATGTTGGAGAATCCCCCCCAAAAAAATTCTAGTT,10,30,14,27,27,39,27,47,27,36,36,39,44,47,65.86,0.0
hek293t,12820,1,10,GGATGGTCTGAAACATCCCTGTGGAAACATGGCAAGCCCCCCCCCGGGGGCAGAAGGAGGAAAGGGGATAGAAAAAAATTCTAGTTGGTTTAACGCGTA,GGATGGTCTGAAACATCCCTGTGGAAACATGTCGAACCAGCGCAAGCCCCCCCCCGGGGGCAGAAGGAGGAAAGGGGATAGAAAAAAATTCTAGTTGGT,10,30,14,27,27,42,27,52,27,32,32,42,42,52,60.42,61.72610783
hek293t,12820,1,10,GCATAGTCTGAAACATCCCTGTGGAAACATGGCAAGCCCCCCCCCGGGGGCAGAAGGAGGAAAGGGGATAGAAACTTGAAAAAAATTCTAGTTGGTTTA,GCATAGTCTGAAACATCCCTGTGGAAACATGTCGAACCAGCGCAAGCCCCCCCCCGGGGGCAGAAGGAGGAAAGGGGATAGAAACTTGAAAAAAATTCT,10,30,14,27,27,35,27,45,27,32,32,35,42,45,60.42,1.350848254
hek293t,12822,1,12,ACGAAATCCCAATAGATCAACCATCAGTAAGGTGTATGAATCTCAAACACCTACCTTACATTAAAATCCCGGATGGAAAAAAATTCTAGTTGGTTTAAC,ACGAAATCCCAATAGATCAACCATCAGTAAGTTCGGCCGTATAGTGTATGAATCTCAAACACCTACCTTACATTAAAATCCCGGATGGAAAAAAATTCT,10,30,14,27,27,35,27,47,27,32,32,35,44,47,53.99,0.0
hek293t,12822,1,12,CAATGATCCCAATAGATCAACCATCAGTAAGGTGTATGAATCTCAAACACCTACCTTACATTAAAAAAAAATTCTAGTTGGTTTAACGCGTAACTAGAT,CAATGATCCCAATAGATCAACCATCAGTAAGTTCGGCCGTATAGTGTATGAATCTCAAACACCTACCTTACATTAAAAAAAAATTCTAGTTGGTTTAAC,10,30,14,27,27,47,27,59,27,32,32,47,44,59,53.99,13.40962623
hek293t,12824,1,2,CCCCTCGCTTGCAGTATTGCACACGAAACTGGATCAAGTAGGACCAAGTACTTGGAATGGGAGAGGAATAGCAAAAAAATTCTAGTTGGTTTAACGCGT,CCCCTCGCTTGCAGTATTGCACACGAAACTGGATCAAGTCTAGGACCAAGTACTTGGAATGGGAGAGGAATAGCAAAAAAATTCTAGTTGGTTTAACGC,10,30,14,27,27,49,27,51,27,39,39,49,41,51,9.33,36.35925472
hek293t,12824,1,2,GCTAACGCTTGCAGTATTGCACACGAAACTGGATCAAGTAGGACCAAGTACTTGGAATGGGAGAGGAAAAAAAATTCTAGTTGGTTTAACGCGTAACTA,GCTAACGCTTGCAGTATTGCACACGAAACTGGATCAAGTCTAGGACCAAGTACTTGGAATGGGAGAGGAAAAAAAATTCTAGTTGGTTTAACGCGTAAC,10,30,14,27,27,54,27,56,27,39,39,54,41,56,9.33,16.67607451
hek293t,12826,1,1,AGTCGTGGACATTTAGATATGCACTAGTGAGGATACATGTAAAATTTTTGGTTGATAGAAGAACTTTAGGATGTTAAAAAAATTCTAGTTGGTTTAACG,AGTCGTGGACATTTAGATATGCACTAGTGAGGATACATGTTAAAATTTTTGGTTGATAGAAGAACTTTAGGATGTTAAAAAAATTCTAGTTGGTTTAAC,10,30,14,27,27,47,27,48,27,40,40,47,41,48,48.35,36.52363844
hek293t,12826,1,1,CCTCCTGGACATTTAGATATGCACTAGTGAGGATACATGTAAAATTTTTGGTTGATAGAAGAACTTTAGGATAAAAAAATTCTAGTTGGTTTAACGCGT,CCTCCTGGACATTTAGATATGCACTAGTGAGGATACATGTTAAAATTTTTGGTTGATAGAAGAACTTTAGGATAAAAAAATTCTAGTTGGTTTAACGCG,10,30,14,27,27,50,27,51,27,40,40,50,41,51,48.35,17.85481287
hek293t,12828,1,14,TACGGTAAATATTGTCACCCCTGTCTCCATGGGGCTGTGGACATACAACATATAGGATATGAGGAAAAAAATTCTAGTTGGTTTAACGCGTAACTAGAT,TACGGTAAATATTGTCACCCCTGTCTCCATGGGGGCCAACGATATGTTCTGTGGACATACAACATATAGGATATGAGGAAAAAAATTCTAGTTGGTTTA,10,30,14,27,27,45,27,59,27,35,35,45,49,59,37.03,3.204325945
hek293t,12829,1,5,GTTGTTAGCAGCCATTGAAAATGATTGTCTGGTGAAATGCTGACCACAGTGTAGTCAATTTAATAGCAATAAAAAAATTCTAGTTGGTTTAACGCGTAA,GTTGTTAGCAGCCATTGAAAATGATTGTCTGGAAGAATGAAATGCTGACCACAGTGTAGTCAATTTAATAGCAATAAAAAAATTCTAGTTGGTTTAACG,10,30,14,27,27,48,27,53,27,33,33,48,38,53,23.37,0.215053763
hek293t,12829,1,5,CACTCTAGCAGCCATTGAAAATGATTGTCTGGTGAAATGCTGACCACAGTGTAGTCAATTTAATAGCAATTAGATAAAAAAATTCTAGTTGGTTTAACG,CACTCTAGCAGCCATTGAAAATGATTGTCTGGAAGAATGAAATGCTGACCACAGTGTAGTCAATTTAATAGCAATTAGATAAAAAAATTCTAGTTGGTT,10,30,14,27,27,43,27,48,27,33,33,43,38,48,23.37,0.131492439
hek293t,12831,1,3,ATACCTATAGCAGTGGCTATATAAACATGGGGACAAAATTTACATTCTTATTTTGGTCTTTTGAGGGCCTTTCTAAAAAAAATTCTAGTTGGTTTAACG,ATACCTATAGCAGTGGCTATATAAACATGGGGACAAACGAATTTACATTCTTATTTTGGTCTTTTGAGGGCCTTTCTAAAAAAAATTCTAGTTGGTTTA,10,30,14,27,27,45,27,48,27,38,38,45,41,48,65.18,17.0310624
hek293t,2494,1,8,ATACTCAGTGAGATCAGTGACAAGGAAGCAGGATAGAACACAGTTAAAGGAAAATTATCCTGCTATAAAAAAATTCTAGTTGGTTTAACGCGTAACTAG,ATACTCAGTGAGATCAGTGACAAGGAAGCAGGATAGAATCGAACAGCACAGTTAAAGGAAAATTATCCTGCTATAAAAAAATTCTAGTTGGTTTAACGC,10,30,14,27,27,49,27,57,27,39,39,49,47,57,59.46,1.691439451
hek293t,2494,1,8,CGTCACAGTGAGATCAGTGACAAGGAAGCAGGATAGAACACAGTTAAAGGAAAATTATCCTGCTATGTTAAAAAAATTCTAGTTGGTTTAACGCGTAAC,CGTCACAGTGAGATCAGTGACAAGGAAGCAGGATAGAATCGAACAGCACAGTTAAAGGAAAATTATCCTGCTATGTTAAAAAAATTCTAGTTGGTTTAA,10,30,14,27,27,46,27,54,27,39,39,46,47,54,59.46,1.149425287
hek293t,12835,1,1,TTGGCTTGGGGGAAGCCATTGGGAAAGCGAGGCTTCCTCGTGCATCCAACAACATGCAATGATCTGCACGTTACTAAAAAAAATTCTAGTTGGTTTAAC,TTGGCTTGGGGGAAGCCATTGGGAAAGCGAGGCTTTCCTCGTGCATCCAACAACATGCAATGATCTGCACGTTACTAAAAAAAATTCTAGTTGGTTTAA,10,30,14,27,27,46,27,47,27,36,36,46,37,47,66.27,79.0305166
hek293t,12835,1,1,GCGTATTGGGGGAAGCCATTGGGAAAGCGAGGCTTCCTCGTGCATCCAACAACATGCAATGATCTGCACGTAAAAAAATTCTAGTTGGTTTAACGCGTA,GCGTATTGGGGGAAGCCATTGGGAAAGCGAGGCTTTCCTCGTGCATCCAACAACATGCAATGATCTGCACGTAAAAAAATTCTAGTTGGTTTAACGCGT,10,30,14,27,27,51,27,52,27,36,36,51,37,52,66.27,78.66469304
hek293t,12837,1,9,GTCAGTGACTGCCTCATCCCTCTATGAGGAGGCCCCCCCCCCAGTATAGACCACGGGCCAGAAAAGCAGGAACAAAAAAAATTCTAGTTGGTTTAACGC,GTCAGTGACTGCCTCATCCCTCTATGAGGAGGCCCCATACTGTAACCCCCCAGTATAGACCACGGGCCAGAAAAGCAGGAACAAAAAAAATTCTAGTTG,10,30,14,27,27,40,27,49,27,37,37,40,46,49,63.23,0.0
hek293t,12839,1,10,GCGCAAAGAGATGCCAAGGAGAAGGGCCGGGGCCCTACTCGGGTTCCTCATACAAATCAAGCAGGGAAAAAAAATTCTAGTTGGTTTAACGCGTAACTA,GCGCAAAGAGATGCCAAGGAGAAGGGCCGGGGCCCTACCCCACCAGGCTCGGGTTCCTCATACAAATCAAGCAGGGAAAAAAAATTCTAGTTGGTTTAA,10,30,14,27,27,46,27,56,27,39,39,46,49,56,33.44,1.204439831
hek293t,12841,1,8,GGCTTTGGAAATGAGACAGTTTTGTAGACAGGTGGCAGGCAAGAATTTTTCGCAGTGGTATCGATTAAAAAAATTCTAGTTGGTTTAACGCGTAACTAG,GGCTTTGGAAATGAGACAGTTTTGTAGACAGGTGGCAGAGTATTGTGCAAGAATTTTTCGCAGTGGTATCGATTAAAAAAATTCTAGTTGGTTTAACGC,10,30,14,27,27,49,27,57,27,39,39,49,47,57,33.35,2.056829563
hek293t,12841,1,8,CGAGTTGGAAATGAGACAGTTTTGTAGACAGGTGGCAGGCAAGAATTTTTCGCAGTGGTATCGATTCCATACTAAAAAAATTCTAGTTGGTTTAACGCG,CGAGTTGGAAATGAGACAGTTTTGTAGACAGGTGGCAGAGTATTGTGCAAGAATTTTTCGCAGTGGTATCGATTCCATACTAAAAAAATTCTAGTTGGT,10,30,14,27,27,42,27,50,27,39,39,42,47,50,33.35,0.155219247
hek293t,12843,1,12,TAGCTACCTTCCTAAATTCCTAAATGAAAAGGTAATACCAAACAATAAAGGAAAGAGTGAGGATGGAATAAAATCAAAAAAATTCTAGTTGGTTTAACG,TAGCTACCTTCCTAAATTCCTAAATGAAAAGGAAATCAGATTTATAATACCAAACAATAAAGGAAAGAGTGAGGATGGAATAAAATCAAAAAAATTCTA,10,30,14,27,27,36,27,48,27,33,33,36,45,48,11.14,0.0
hek293t,12843,1,12,AAACTACCTTCCTAAATTCCTAAATGAAAAGGTAATACCAAACAATAAAGGAAAGAGTGAGGATGGAATAAAAAAAAATTCTAGTTGGTTTAACGCGTA,AAACTACCTTCCTAAATTCCTAAATGAAAAGGAAATCAGATTTATAATACCAAACAATAAAGGAAAGAGTGAGGATGGAATAAAAAAAAATTCTAGTTG,10,30,14,27,27,40,27,52,27,33,33,40,45,52,11.14,0.0
hek293t,12845,1,10,TATTTCAGTGTACATTAATAATATGAGTCAGGGACAGATTATGCACTGAAGTGTTATACAGTGTCATGGAAAAATTCTGCAGAAAAAAATTCTAGTTGG,TATTTCAGTGTACATTAATAATATGAGGGCGATCCGGTCAGGGACAGATTATGCACTGAAGTGTTATACAGTGTCATGGAAAAATTCTGCAGAAAAAAA,10,30,14,27,27,31,27,41,27,28,28,31,38,41,17.64,0.0
hek293t,12845,1,10,CGAAACAGTGTACATTAATAATATGAGTCAGGGACAGATTATGCACTGAAGTGTTATACAGTGTCATGGAAAAAAAATTCTAGTTGGTTTAACGCGTAA,CGAAACAGTGTACATTAATAATATGAGGGCGATCCGGTCAGGGACAGATTATGCACTGAAGTGTTATACAGTGTCATGGAAAAAAAATTCTAGTTGGTT,10,30,14,27,27,43,27,53,27,28,28,43,38,53,17.64,1.362883677
hek293t,12847,1,13,GAATATCAAGTGCCTACACAGAAACATTACGGTAGTATAAACCAGTACACATCATACACTGAAAAATTAAATCCCAAAGAAAAAAAATTCTAGTTGGTT,GAATATCAAGTGCCTACACAGAAACATTTCCCGCTGTGGTTACGGTAGTATAAACCAGTACACATCATACACTGAAAAATTAAATCCCAAAGAAAAAAA,10,30,14,27,27,30,27,43,27,27,27,30,40,43,41.86,0.177655768
hek293t,12847,1,13,GGCAATCAAGTGCCTACACAGAAACATTACGGTAGTATAAACCAGTACACATCATACACTGAAAAATTAAAAAAATTCTAGTTGGTTTAACGCGTAACT,GGCAATCAAGTGCCTACACAGAAACATTTCCCGCTGTGGTTACGGTAGTATAAACCAGTACACATCATACACTGAAAAATTAAAAAAATTCTAGTTGGT,10,30,14,27,27,42,27,55,27,27,27,42,40,55,41.86,10.36683117
hek293t,12849,1,3,GAACGTCTGGAGTTTTTTCCTCGATACTGAGGCTGACAGAGTATGGAACATTGGACTTCGGAAAGCTGGTTGTTAATTAAAAAAATTCTAGTTGGTTTA,GAACGTCTGGAGTTTTTTCCTCGATATATCTGAGGCTGACAGAGTATGGAACATTGGACTTCGGAAAGCTGGTTGTTAATTAAAAAAATTCTAGTTGGT,10,30,14,27,27,42,27,45,27,27,27,42,30,45,38.6,78.00908321
hek293t,12849,1,3,ACGAATCTGGAGTTTTTTCCTCGATACTGAGGCTGACAGAGTATGGAACATTGGACTTCGGAAAGCTGGTTGTTAATTAGTTAAACAAAAAAATTCTAG,ACGAATCTGGAGTTTTTTCCTCGATATATCTGAGGCTGACAGAGTATGGAACATTGGACTTCGGAAAGCTGGTTGTTAATTAGTTAAACAAAAAAATTC,10,30,14,27,27,34,27,37,27,27,27,34,30,37,38.6,70.36849856
hek293t,12851,1,3,GTTATGTTTCCAAGTGAAGATATACTTAAAGGTCAGATTGGCAAATTAATCCATGACACTATTGCTGTACATGCCCCCCCGCTAAAAAAATTCTAGTTG,GTTATGTTTCCAAGTGAAGATATACTTAAAGGTTTGCAGATTGGCAAATTAATCCATGACACTATTGCTGTACATGCCCCCCCGCTAAAAAAATTCTAG,10,30,14,27,27,37,27,40,27,34,34,37,37,40,12.16,0.390468532
hek293t,12851,1,3,GGGTTGTTTCCAAGTGAAGATATACTTAAAGGTCAGATTGGCAAATTAATCCATGACACTATTGCTGTACATGCCCCCCAAAAAAATTCTAGTTGGTTT,GGGTTGTTTCCAAGTGAAGATATACTTAAAGGTTTGCAGATTGGCAAATTAATCCATGACACTATTGCTGTACATGCCCCCCAAAAAAATTCTAGTTGG,10,30,14,27,27,41,27,44,27,34,34,41,37,44,12.16,38.92502591
hek293t,12853,1,1,TGTGTCGAAATGCTAGAAGCAATTATGGCTGGACTGAAAGCATGGCTGGAATGAAAAGAGAGGAAAAAGCTGTGCCCCCCCCCAAAAAAATTCTAGTTG,TGTGTCGAAATGCTAGAAGCAATTATGGCTGAGACTGAAAGCATGGCTGGAATGAAAAGAGAGGAAAAAGCTGTGCCCCCCCCCAAAAAAATTCTAGTT,10,30,14,27,27,39,27,40,27,32,32,39,33,40,45.82,80.27285398
hek293t,12853,1,1,TCCCTCGAAATGCTAGAAGCAATTATGGCTGGACTGAAAGCATGGCTGGAATGAAAAGAGAGGAAAAAGCTGTGCCCCCCAAAAAAATTCTAGTTGGTT,TCCCTCGAAATGCTAGAAGCAATTATGGCTGAGACTGAAAGCATGGCTGGAATGAAAAGAGAGGAAAAAGCTGTGCCCCCCAAAAAAATTCTAGTTGGT,10,30,14,27,27,42,27,43,27,32,32,42,33,43,45.82,68.78493417
hek293t,12855,1,2,CCCGTTAAAGCATGGATTATTTTTATGTATGGCCCCCCCCTATATATGATCATCGTAAACGTACTTGGGTGTACATGAAAAGAGAACAAAAAAATTCTA,CCCGTTAAAGCATGGATTATTTTTATGTATATGGCCCCCCCCTATATATGATCATCGTAAACGTACTTGGGTGTACATGAAAAGAGAACAAAAAAATTC,10,30,14,27,27,34,27,36,27,31,31,34,33,36,5.27,0.0
hek293t,12855,1,2,ACAAGTAAAGCATGGATTATTTTTATGTATGGCCCCCCCCTATATATGATCATCGTAAACGTACTTGGGTGTACATGAAAAGAAAAAAAATTCTAGTTG,ACAAGTAAAGCATGGATTATTTTTATGTATATGGCCCCCCCCTATATATGATCATCGTAAACGTACTTGGGTGTACATGAAAAGAAAAAAAATTCTAGT,10,30,14,27,27,38,27,40,27,31,31,38,33,40,5.27,0.32843815
hek293t,12857,1,3,GGGATATCAAAAGGTTCTTGTGATTTTGATGGGAATATCAGAGACTGAGTTGTTAAAAGTTAAGTAAAAAAAATTCTAGTTGGTTTAACGCGTAACTAG,GGGATATCAAAAGGTTCTTGTGATTTTGATGGGAATATAGACAGAGACTGAGTTGTTAAAAGTTAAGTAAAAAAAATTCTAGTTGGTTTAACGCGTAAC,10,30,14,27,27,54,27,57,27,39,39,54,42,57,10.72,20.93336693
hek293t,12858,1,13,TGAGTGTGATAGAGTAAGGAGCAGGGTCGTGGAAGGCGGATGTTGTCCTGAGACTATGCAGTTCGATTTTCAAAAAAAAATTCTAGTTGGTTTAACGCG,TGAGTGTGATAGAGTAAGGAGCAGGGTCGTGGACACGGGCCCGCGTAGGCGGATGTTGTCCTGAGACTATGCAGTTCGATTTTCAAAAAAAAATTCTAG,10,30,14,27,27,37,27,50,27,34,34,37,47,50,46.9,0.0
hek293t,12858,1,13,ACAGTGTGATAGAGTAAGGAGCAGGGTCGTGGAAGGCGGATGTTGTCCTGAGACTATGCAGTTCGATTTAAAAAAATTCTAGTTGGTTTAACGCGTAAC,ACAGTGTGATAGAGTAAGGAGCAGGGTCGTGGACACGGGCCCGCGTAGGCGGATGTTGTCCTGAGACTATGCAGTTCGATTTAAAAAAATTCTAGTTGG,10,30,14,27,27,41,27,54,27,34,34,41,47,54,46.9,0.873966912
hek293t,2546,1,3,CACCTAGGTTTTATCCAGGGTTTCAATAGAGGTCCTGGAGACCCAGCTTGAATTGCCAGAAGAGAATTCAGATTTAAAAAAATTCTAGTTGGTTTAACG,CACCTAGGTTTTATCCAGGGTTTCAATAGAGGTCCTGAATGAGACCCAGCTTGAATTGCCAGAAGAGAATTCAGATTTAAAAAAATTCTAGTTGGTTTA,10,30,14,27,27,45,27,48,27,38,38,45,41,48,30.09,80.82426595
hek293t,2546,1,3,GCGCTAGGTTTTATCCAGGGTTTCAATAGAGGTCCTGGAGACCCAGCTTGAATTGCCAGAAGAGAATTCAGAAAAAAAATTCTAGTTGGTTTAACGCGT,GCGCTAGGTTTTATCCAGGGTTTCAATAGAGGTCCTGAATGAGACCCAGCTTGAATTGCCAGAAGAGAATTCAGAAAAAAAATTCTAGTTGGTTTAACG,10,30,14,27,27,48,27,51,27,38,38,48,41,51,30.09,72.59734429
hek293t,12864,1,8,CCTGCGTGTTTTGCATCCAGTTACAGAACTGGATCACTCAATAGATGATGCTGGGGTACATGTTTTGTTTAAAAAAATTCTAGTTGGTTTAACGCGTAA,CCTGCGTGTTTTGCATCCAGTTACAGAACTGGATAGGTGCGTCACTCAATAGATGATGCTGGGGTACATGTTTTGTTTAAAAAAATTCTAGTTGGTTTA,10,30,14,27,27,45,27,53,27,35,35,45,43,53,33.79,3.023903024
hek293t,12865,1,2,ATCAGCTGTGTCAGACATGGCCGCACCTGGGGAGCTCTGCTTGCAGGAGAACTGCCCTCTGGATGTCCGAACTGAAAAAAATTCTAGTTGGTTTAACGC,ATCAGCTGTGTCAGACATGGCCGCACCTGGGGAGCTCTGCGCTTGCAGGAGAACTGCCCTCTGGATGTCCGAACTGAAAAAAATTCTAGTTGGTTTAAC,10,30,14,27,27,47,27,49,27,40,40,47,42,49,55.0,76.06030236
hek293t,12865,1,2,GTAAACTGTGTCAGACATGGCCGCACCTGGGGAGCTCTGCTTGCAGGAGAACTGCCCTCTGGATGTAAAAAAATTCTAGTTGGTTTAACGCGTAACTAG,GTAAACTGTGTCAGACATGGCCGCACCTGGGGAGCTCTGCGCTTGCAGGAGAACTGCCCTCTGGATGTAAAAAAATTCTAGTTGGTTTAACGCGTAACT,10,30,14,27,27,55,27,57,27,40,40,55,42,57,55.0,78.99724317
hek293t,12867,1,2,TTATTTGTAGGCTATTTAGCCTCTTTGCTTGGTTTGAATGTAAAGCTTTCTTCATTTACTGTGGGGACAAAAAAATTCTAGTTGGTTTAACGCGTAACT,TTATTTGTAGGCTATTTAGCCTCTTTGCTTGGTTTGATTATGTAAAGCTTTCTTCATTTACTGTGGGGACAAAAAAATTCTAGTTGGTTTAACGCGTAA,10,30,14,27,27,53,27,55,27,38,38,53,40,55,20.96,58.05726163
hek293t,12867,1,2,GATGATGTAGGCTATTTAGCCTCTTTGCTTGGTTTGAATGTAAAGCTTTCTTCATTTACTGTGGGGACATACCAAAAAAATTCTAGTTGGTTTAACGCG,GATGATGTAGGCTATTTAGCCTCTTTGCTTGGTTTGATTATGTAAAGCTTTCTTCATTTACTGTGGGGACATACCAAAAAAATTCTAGTTGGTTTAACG,10,30,14,27,27,48,27,50,27,38,38,48,40,50,20.96,77.54643018
hek293t,12869,1,5,TAACAACTCACGTAAAAGGTGATGGACTGTGGCCTTTGGAATGCTGTTTCCTACCTCAAATGCAATAGTCGTGATAGCTATGAAAAAAATTCTAGTTGG,TAACAACTCACGTAAAAGGTGATGGACTGTGGATGCCCCTTTGGAATGCTGTTTCCTACCTCAAATGCAATAGTCGTGATAGCTATGAAAAAAATTCTA,10,30,14,27,27,36,27,41,27,33,33,36,38,41,49.35,0.143369176
hek293t,12869,1,5,GCTGCACTCACGTAAAAGGTGATGGACTGTGGCCTTTGGAATGCTGTTTCCTACCTCAAATGCAATAGTCAAAAAAATTCTAGTTGGTTTAACGCGTAA,GCTGCACTCACGTAAAAGGTGATGGACTGTGGATGCCCCTTTGGAATGCTGTTTCCTACCTCAAATGCAATAGTCAAAAAAATTCTAGTTGGTTTAACG,10,30,14,27,27,48,27,53,27,33,33,48,38,53,49.35,51.87179042
hek293t,12871,1,3,GATCTGGAGCATCCCACCAGGCAGGCACATGGGCCATGTAAAAACGCAAATTACTGACCTGTTGCTTTAAAAAAATTCTAGTTGGTTTAACGCGTAACT,GATCTGGAGCATCCCACCAGGCAGGCACATGGGCCAGGGTGTAAAAACGCAAATTACTGACCTGTTGCTTTAAAAAAATTCTAGTTGGTTTAACGCGTA,10,30,14,27,27,52,27,55,27,37,37,52,40,55,54.74,13.78697104
hek293t,12873,1,5,CGCTTGCCTCCGACCTGCCAAGGCAGACTTGGACGCTGCCGCGATGGGGAGCGGCGGCCCCAGCTTGGCTTTTGCCCGGCGGAGCGCTAAAAAAATTCT,CGCTTGCCTCCGACCTGCCAAGGCAGTCTCCACTTGGACGCTGCCGCGATGGGGAGCGGCGGCCCCAGCTTGGCTTTTGCCCGGCGGAGCGCTAAAAAA,10,30,14,27,27,30,27,35,27,27,27,30,32,35,43.88,0.630577003
hek293t,12875,1,15,ACGAAAAATAATACAGGCTGCCAGACCTATGGGTTCAGGTGGGCTTGGACACAGACCCTGCTAATCAAAAAAATTCTAGTTGGTTTAACGCGTAACTAG,ACGAAAAATAATACAGGCTGCCAGACCTATGGCTGAAATAACCGCCGGTTCAGGTGGGCTTGGACACAGACCCTGCTAATCAAAAAAATTCTAGTTGGT,10,30,14,27,27,42,27,57,27,32,32,42,47,57,55.91,7.564056744
hek293t,12876,1,8,GAGTAAGAAGGGATCTTCCTTGAAGTAAAAGGTGGCAATATTAAGTGAAATGCATCGATGCTTATTCTAGGTGAAAAAAATTCTAGTTGGTTTAACGCG,GAGTAAGAAGGGATCTTCCTTGAAGTAAAAGGTGACCTTAGTGCAATATTAAGTGAAATGCATCGATGCTTATTCTAGGTGAAAAAAATTCTAGTTGGT,10,30,14,27,27,42,27,50,27,35,35,42,43,50,25.35,2.25260109
hek293t,12876,1,8,TCGCCAGAAGGGATCTTCCTTGAAGTAAAAGGTGGCAATATTAAGTGAAATGCATCGATGCTTATTCTAGGTGGAGAAAAAAAATTCTAGTTGGTTTAA,TCGCCAGAAGGGATCTTCCTTGAAGTAAAAGGTGACCTTAGTGCAATATTAAGTGAAATGCATCGATGCTTATTCTAGGTGGAGAAAAAAAATTCTAGT,10,30,14,27,27,38,27,46,27,35,35,38,43,46,25.35,0.0
hek293t,12878,1,14,CACGATAAGGGGCATGTATTTTAAAGTTCAGGTAACTATATTCCTTAGAATGAGTGTGAAAACGCTATTCATATCAAAAAAATTCTAGTTGGTTTAACG,CACGATAAGGGGCATGTATTTTAAAGTTCACATCCTCTGCGTCCGGTAACTATATTCCTTAGAATGAGTGTGAAAACGCTATTCATATCAAAAAAATTC,10,30,14,27,27,34,27,48,27,31,31,34,45,48,14.42,0.0
hek293t,12878,1,14,CCTAATAAGGGGCATGTATTTTAAAGTTCAGGTAACTATATTCCTTAGAATGAGTGTGAAAACGCTATAAAAAAATTCTAGTTGGTTTAACGCGTAACT,CCTAATAAGGGGCATGTATTTTAAAGTTCACATCCTCTGCGTCCGGTAACTATATTCCTTAGAATGAGTGTGAAAACGCTATAAAAAAATTCTAGTTGG,10,30,14,27,27,41,27,55,27,31,31,41,45,55,14.42,0.102849304
hek293t,12880,1,12,CTCTATCACTTTTTCACAGATAGAGAAGGTGGAGAACAGAGATTCAGGGTGATCAGGCTGACAGGTAGGTAAGTAAAAAAAATTCTAGTTGGTTTAACG,CTCTATCACTTTTTCACAGATAGAGAAGGTGGCTCCCAGGACGCAGAACAGAGATTCAGGGTGATCAGGCTGACAGGTAGGTAAGTAAAAAAAATTCTA,10,30,14,27,27,36,27,48,27,33,33,36,45,48,39.37,0.022148394
hek293t,12881,1,11,CTAAGTAATACAGGCTGTCAATAAATAATTGGTCTTCTAATTGTTTGCTTCACAAATGGTAATTGGTAAAAAAAATTCTAGTTGGTTTAACGCGTAACT,CTAAGTAATACAGGCTGTCAATAAATAATTGGTCTTTTTTGGCGGGCCTAATTGTTTGCTTCACAAATGGTAATTGGTAAAAAAAATTCTAGTTGGTTT,10,30,14,27,27,44,27,55,27,37,37,44,48,55,14.36,0.0
hek293t,12881,1,11,GATACTAATACAGGCTGTCAATAAATAATTGGTCTTCTAATTGTTTGCTTCACAAATGGTAATTGGTAAATAAAAAAAATTCTAGTTGGTTTAACGCGT,GATACTAATACAGGCTGTCAATAAATAATTGGTCTTTTTTGGCGGGCCTAATTGTTTGCTTCACAAATGGTAATTGGTAAATAAAAAAAATTCTAGTTG,10,30,14,27,27,40,27,51,27,37,37,40,48,51,14.36,0.0
hek293t,12883,1,8,ACTACTTCTAATCACTTTGGTAGCCTCTTTGGTTTCAAAATAAATTGAAGTCTAATTTAGGCATTTCCCTGATGACTAAAAAAATTCTAGTTGGTTTAA,ACTACTTCTAATCACTTTGGTAGCCTCTTTGGTTTAGACCCCTCAAAATAAATTGAAGTCTAATTTAGGCATTTCCCTGATGACTAAAAAAATTCTAGT,10,30,14,27,27,38,27,46,27,35,35,38,43,46,9.81,0.0
hek293t,12883,1,8,AATTCTTCTAATCACTTTGGTAGCCTCTTTGGTTTCAAAATAAATTGAAGTCTAATTTAGGCATTTCCCTAAAAAAATTCTAGTTGGTTTAACGCGTAA,AATTCTTCTAATCACTTTGGTAGCCTCTTTGGTTTAGACCCCTCAAAATAAATTGAAGTCTAATTTAGGCATTTCCCTAAAAAAATTCTAGTTGGTTTA,10,30,14,27,27,45,27,53,27,35,35,45,43,53,9.81,2.52527008
hek293t,12885,1,8,TAGTGGTTGCTATTTTAGAGGACGCATTCAGGGACAAATGCATTTGACATCAAGTTCTGAACTATAGTTTGAAAAAAATTCTAGTTGGTTTAACGCGTA,TAGTGGTTGCTATTTTAGAGGACGCATTCAGGGACAAATGGAGTTGGACATTTGACATCAAGTTCTGAACTATAGTTTGAAAAAAATTCTAGTTGGTTT,10,30,14,27,27,44,27,52,27,41,41,44,49,52,5.29,33.18850538
hek293t,12885,1,8,AAGAGGTTGCTATTTTAGAGGACGCATTCAGGGACAAATGCATTTGACATCAAGTTCTGAACTAAAAAAAATTCTAGTTGGTTTAACGCGTAACTAGAT,AAGAGGTTGCTATTTTAGAGGACGCATTCAGGGACAAATGGAGTTGGACATTTGACATCAAGTTCTGAACTAAAAAAAATTCTAGTTGGTTTAACGCGT,10,30,14,27,27,51,27,59,27,41,41,51,49,59,5.29,4.67149301
hek293t,12887,1,7,GGCACCACTTTGCTTGCATCTATTACCCCCGGATCTGTGCCTTGGCAGCAATTTATCAACATGTAATTAAAAAAAATTCTAGTTGGTTTAACGCGTAAC,GGCACCACTTTGCTTGCATCTATTACCCCCGGATCTGTGAAGCCTGCCTTGGCAGCAATTTATCAACATGTAATTAAAAAAAATTCTAGTTGGTTTAAC,10,30,14,27,27,47,27,54,27,40,40,47,47,54,53.16,9.867586516
hek293t,12888,1,5,AGCCTTTTTAGGTGTTTTGAGGGGGAGGGAGGATTTGCTTGACCATAGCCAACTACTTCACAGTTAGATAATTGCAAAAAAAAATTCTAGTTGGTTTAA,AGCCTTTTTAGGTGTTTTGAGGGGGAGGGAGGATTTGACCGCCTTGACCATAGCCAACTACTTCACAGTTAGATAATTGCAAAAAAAAATTCTAGTTGG,10,30,14,27,27,41,27,46,27,38,38,41,43,46,15.35,0.0
hek293t,12890,1,8,CCACGAAGGGCCAACTCCACATTAATACCAGGAACAAGCTTGTGCTTTTTGTTCTTCATACAAGCTAAAAAAATTCTAGTTGGTTTAACGCGTAACTAG,CCACGAAGGGCCAACTCCACATTAATACCAGGAACAAGTAGAACTACTTGTGCTTTTTGTTCTTCATACAAGCTAAAAAAATTCTAGTTGGTTTAACGC,10,30,14,27,27,49,27,57,27,39,39,49,47,57,55.33,3.819648284
hek293t,12890,1,8,AGACGAAGGGCCAACTCCACATTAATACCAGGAACAAGCTTGTGCTTTTTGTTCTTCATACAAGCTGAATGAGAAAAAAATTCTAGTTGGTTTAACGCG,AGACGAAGGGCCAACTCCACATTAATACCAGGAACAAGTAGAACTACTTGTGCTTTTTGTTCTTCATACAAGCTGAATGAGAAAAAAATTCTAGTTGGT,10,30,14,27,27,42,27,50,27,39,39,42,47,50,55.33,0.149210614
hek293t,12892,1,13,CCTGATTTGTTGCACTTTTGAGCCAAATTTGGCTAACCTTTAGCTGATGTCTTTATACATATTTAGGCAAAAAAATTCTAGTTGGTTTAACGCGTAACT,CCTGATTTGTTGCACTTTTGAGCCAAATTTGGCTTAGTTCCGAGCACAACCTTTAGCTGATGTCTTTATACATATTTAGGCAAAAAAATTCTAGTTGGT,10,30,14,27,27,42,27,55,27,35,35,42,48,55,4.42,0.0
hek293t,12892,1,13,CCCCTTTTGTTGCACTTTTGAGCCAAATTTGGCTAACCTTTAGCTGATGTCTTTATACATATTTAGGCAATTAAAAAAATTCTAGTTGGTTTAACGCGT,CCCCTTTTGTTGCACTTTTGAGCCAAATTTGGCTTAGTTCCGAGCACAACCTTTAGCTGATGTCTTTATACATATTTAGGCAATTAAAAAAATTCTAGT,10,30,14,27,27,38,27,51,27,35,35,38,48,51,4.42,0.0
hek293t,12894,1,11,GCTGAACATGCCTTTGAGTTACCATCAAGAGGATGCCTTAATTTTACTATTTCCCATTAGGGAACTCAATAAAATAAAAAAATTCTAGTTGGTTTAACG,GCTGAACATGCCTTTGAGTTACCATCCAGGCAGGCGCAAGAGGATGCCTTAATTTTACTATTTCCCATTAGGGAACTCAATAAAATAAAAAAATTCTAG,10,30,14,27,27,37,27,48,27,27,27,37,38,48,62.89,5.206054452
hek293t,12894,1,11,TTAACACATGCCTTTGAGTTACCATCAAGAGGATGCCTTAATTTTACTATTTCCCATTAGGGAACTCAATAAAAAAATTCTAGTTGGTTTAACGCGTAA,TTAACACATGCCTTTGAGTTACCATCCAGGCAGGCGCAAGAGGATGCCTTAATTTTACTATTTCCCATTAGGGAACTCAATAAAAAAATTCTAGTTGGT,10,30,14,27,27,42,27,53,27,27,27,42,38,53,62.89,9.180445703
hek293t,12896,1,6,AAACAGATAGGCTCAGAAACCGTGTTGACAGGACTCAGGTAAGTACCTTGTACTCAGCCACCTGAATGCAGTGAGAAAAAAAATTCTAGTTGGTTTAAC,AAACAGATAGGCTCAGAAACCGTGTTGACACATTTAGGACTCAGGTAAGTACCTTGTACTCAGCCACCTGAATGCAGTGAGAAAAAAAATTCTAGTTGG,10,30,14,27,27,41,27,47,27,31,31,41,37,47,29.97,33.83215908
hek293t,12896,1,6,TAGCCGATAGGCTCAGAAACCGTGTTGACAGGACTCAGGTAAGTACCTTGTACTCAGCCACCTGAATGCAGAAAAAAATTCTAGTTGGTTTAACGCGTA,TAGCCGATAGGCTCAGAAACCGTGTTGACACATTTAGGACTCAGGTAAGTACCTTGTACTCAGCCACCTGAATGCAGAAAAAAATTCTAGTTGGTTTAA,10,30,14,27,27,46,27,52,27,31,31,46,37,52,29.97,27.22124785
hek293t,12898,1,8,GGAGATTTCCACTTTTCTATGAGACATAATGGTTAGGAAAGAAGACAGACAATTTCTATTATGTTTAGGAAACAAAAAAAATTCTAGTTGGTTTAACGC,GGAGATTTCCACTTTTCTATGAGACATAATGTCAACAGGGTTAGGAAAGAAGACAGACAATTTCTATTATGTTTAGGAAACAAAAAAAATTCTAGTTGG,10,30,14,27,27,41,27,49,27,31,31,41,39,49,2.87,0.046625645
hek293t,12898,1,8,ACTCGTTTCCACTTTTCTATGAGACATAATGGTTAGGAAAGAAGACAGACAATTTCTATTATGTTTAGGAAACAATTAAAAAAATTCTAGTTGGTTTAA,ACTCGTTTCCACTTTTCTATGAGACATAATGTCAACAGGGTTAGGAAAGAAGACAGACAATTTCTATTATGTTTAGGAAACAATTAAAAAAATTCTAGT,10,30,14,27,27,38,27,46,27,31,31,38,39,46,2.87,0.0
hek293t,284,1,1,AAAAGGTCAACAGCTTTTTGATTACAGCAAGGAACTGGTTTTTAGTATTCTTATCCCAGTCTCTGTTCTTCTAAAAAAATTCTAGTTGGTTTAACGCGT,AAAAGGTCAACAGCTTTTTGATTACAGCAAGGAACTGGTGTTTTAGTATTCTTATCCCAGTCTCTGTTCTTCTAAAAAAATTCTAGTTGGTTTAACGCG,10,30,14,27,27,50,27,51,27,40,40,50,41,51,38.76,63.68702934
hek293t,284,1,1,TGCGAGTCAACAGCTTTTTGATTACAGCAAGGAACTGGTTTTTAGTATTCTTATCCCAGTCTCTGTTCTTCTTACAAAAAAATTCTAGTTGGTTTAACG,TGCGAGTCAACAGCTTTTTGATTACAGCAAGGAACTGGTGTTTTAGTATTCTTATCCCAGTCTCTGTTCTTCTTACAAAAAAATTCTAGTTGGTTTAAC,10,30,14,27,27,47,27,48,27,40,40,47,41,48,38.76,74.92477041
hek293t,12902,1,3,GGGAGTGTGAGCAGAAAAATATGCTTTACTGGATTCCAAACTACCACTATATTTCTTGCAGAGAGACTTGAAGTGCAAAAAAAATTCTAGTTGGTTTAA,GGGAGTGTGAGCAGAAAAATATGCTTTACTGGCGTATTCCAAACTACCACTATATTTCTTGCAGAGAGACTTGAAGTGCAAAAAAAATTCTAGTTGGTT,10,30,14,27,27,43,27,46,27,33,33,43,36,46,2.49,25.9130539
hek293t,12903,1,13,CAAAATCATTACTGATTATTGCTCGATGAAGGTTCTGACTCAGATGTAAGCCAAAAATCAAAGGGTAGAAAAAAATTCTAGTTGGTTTAACGCGTAACT,CAAAATCATTACTGATTATTGCTCGATGAAGGTTCTGAGTCAACGGCAATACTCAGATGTAAGCCAAAAATCAAAGGGTAGAAAAAAATTCTAGTTGGT,10,30,14,27,27,42,27,55,27,39,39,42,52,55,38.28,0.0
hek293t,12904,1,5,GAATCACTTCTGTATTGAACCCTCTCTTGTGGCTTAGGTTTTCCATGAACTGTTTTACTTGTCGAGGCAGGCTTGAAAAAAATTCTAGTTGGTTTAACG,GAATCACTTCTGTATTGAACCCTCTCTTGTGGTCGGTCTTAGGTTTTCCATGAACTGTTTTACTTGTCGAGGCAGGCTTGAAAAAAATTCTAGTTGGTT,10,30,14,27,27,43,27,48,27,33,33,43,38,48,52.84,85.47496791
hek293t,12904,1,5,ATCTTACTTCTGTATTGAACCCTCTCTTGTGGCTTAGGTTTTCCATGAACTGTTTTACTTGTCGAGGCAGGCTTGCTGAAAAAAATTCTAGTTGGTTTA,ATCTTACTTCTGTATTGAACCCTCTCTTGTGGTCGGTCTTAGGTTTTCCATGAACTGTTTTACTTGTCGAGGCAGGCTTGCTGAAAAAAATTCTAGTTG,10,30,14,27,27,40,27,45,27,33,33,40,38,45,52.84,58.36324169
hek293t,12906,1,3,CGCCGGGATATTTTGAAAAATTAGTCTCTCGGATAAGGAACATCTGCTTATTTGTGCTGTTAAAAAAAAAAAATTCTAGTTGGTTTAACGCGTAACTAG,CGCCGGGATATTTTGAAAAATTAGTCTCTCGGATAAGGTATAACATCTGCTTATTTGTGCTGTTAAAAAAAAAAAATTCTAGTTGGTTTAACGCGTAAC,10,30,14,27,27,54,27,57,27,39,39,54,42,57,16.4,0.254670647
hek293t,12906,1,3,CGTCAGGATATTTTGAAAAATTAGTCTCTCGGATAAGGAACATCTGCTTATTTGTGCTGTTAAAAACATCAGGCATTAAAAAAAATTCTAGTTGGTTTA,CGTCAGGATATTTTGAAAAATTAGTCTCTCGGATAAGGTATAACATCTGCTTATTTGTGCTGTTAAAAACATCAGGCATTAAAAAAAATTCTAGTTGGT,10,30,14,27,27,42,27,45,27,39,39,42,42,45,16.4,0.0
hek293t,12908,1,5,CGATGAAGCCTGCGGGGAAGCACTGCTGGCGGAGGCTCCCAGCAGGGATGACCACCCCTGTTCGTGCTGCTTGGTCTCTGGAGCAAAAAAATTCTAGTT,CGATGAAGCCTGCGGGGAAGCACTGCTTAGCTGGCGGAGGCTCCCAGCAGGGATGACCACCCCTGTTCGTGCTGCTTGGTCTCTGGAGCAAAAAAATTC,10,30,14,27,27,34,27,39,27,27,27,34,32,39,54.25,83.49223305
hek293t,12908,1,5,TATCCAAGCCTGCGGGGAAGCACTGCTGGCGGAGGCTCCCAGCAGGGATGACCACCCCTGTTCGTGCTGCTTGGTCTCTGGAGCACGCAAAAAAATTCT,TATCCAAGCCTGCGGGGAAGCACTGCTTAGCTGGCGGAGGCTCCCAGCAGGGATGACCACCCCTGTTCGTGCTGCTTGGTCTCTGGAGCACGCAAAAAA,10,30,14,27,27,30,27,35,27,27,27,30,32,35,54.25,4.947263151
hek293t,12910,1,7,AAGTCTCAATGGCAAGTAAGTTTTTATATTGGCCATTAGCAGCAAACCTAGTCTAGAAGCCTGACTTACTGCATAAAAAAATTCTAGTTGGTTTAACGC,AAGTCTCAATGGCAAGTAAGTTTTTATATTGGCCATTATGCTGCCGCAGCAAACCTAGTCTAGAAGCCTGACTTACTGCATAAAAAAATTCTAGTTGGT,10,30,14,27,27,42,27,49,27,39,39,42,46,49,7.56,0.0
hek293t,12912,1,4,GCGGGGTTCGCTGATTCTTAGGAGAGATAAGGAAAGTATGTGGGACTCTAGAAGACAAGGAGACAGTTTAAAGCAAAAAAAATTCTAGTTGGTTTAACG,GCGGGGTTCGCTGATTCTTAGGAGAGATAAGGAAAGTATGGTACTGGGACTCTAGAAGACAAGGAGACAGTTTAAAGCAAAAAAAATTCTAGTTGGTTT,10,30,14,27,27,44,27,48,27,41,41,44,45,48,29.64,0.888108447
hek293t,12913,1,15,GCCGGACAAGCTAGGAAAAGTATTCCCTTAGGAGTGAAGCGATGGCAAAGTCAGTGAGGCCAGAACGCATCCTAAAAAAATTCTAGTTGGTTTAACGCG,GCCGGACAAGCTAGGAAAAGTATTCCCTTAGCAGTGAACGCACGCCGAGTGAAGCGATGGCAAAGTCAGTGAGGCCAGAACGCATCCTAAAAAAATTCT,10,30,14,27,27,35,27,50,27,32,32,35,47,50,60.26,0.0
hek293t,12914,1,11,CGGCAGGCAGCTTGGCCAAGCTCCTGTAGTGGTCTCTTCAGCGCATGGAGCACAGCCAAGAAGATGGCACCAAAAAAAAAAATTCTAGTTGGTTTAACG,CGGCAGGCAGCTTGGCCAAGCTCCTGTAGTGGTGGGGAAAGAAGCTCTTCAGCGCATGGAGCACAGCCAAGAAGATGGCACCAAAAAAAAAAATTCTAG,10,30,14,27,27,37,27,48,27,34,34,37,45,48,54.36,0.334349671
hek293t,12918,1,4,CCCAGGGGTTTTTGCAGCTATAGCAGTACAGGTGTTTAAAGCTGCTTCAGGTATGTATACGTGAAAATACAGAAAAAAATTCTAGTTGGTTTAACGCGT,CCCAGGGGTTTTTGCAGCTATAGCAGTACAGGTGTTATACTAAAGCTGCTTCAGGTATGTATACGTGAAAATACAGAAAAAAATTCTAGTTGGTTTAAC,10,30,14,27,27,47,27,51,27,37,37,47,41,51,23.48,3.114851735
hek293t,12918,1,4,TTCAAGGGTTTTTGCAGCTATAGCAGTACAGGTGTTTAAAGCTGCTTCAGGTATGTATACGTGAAAAAAAAAAATTCTAGTTGGTTTAACGCGTAACTA,TTCAAGGGTTTTTGCAGCTATAGCAGTACAGGTGTTATACTAAAGCTGCTTCAGGTATGTATACGTGAAAAAAAAAAATTCTAGTTGGTTTAACGCGTA,10,30,14,27,27,52,27,56,27,37,37,52,41,56,23.48,0.875381207
hek293t,12921,1,11,TGGAGTTTGCAAATGTTCCTATTTAGGCACGGTCAGAATGTAAGAGACAGGGCATTGATAATGAAAAAAAATTCTAGTTGGTTTAACGCGTAACTAGAT,TGGAGTTTGCAAATGTTCCTATTTAGGCACGGTCAGAATGGCTCAATAATGTAAGAGACAGGGCATTGATAATGAAAAAAAATTCTAGTTGGTTTAACG,10,30,14,27,27,48,27,59,27,41,41,48,52,59,22.41,0.0
hek293t,12922,1,11,ATGCAACAACACATACATTGAGAAAATCCTGGCAGCTCCCAAAGACAAGTGACTACCCCTGCATAAAAAAAAAATTCTAGTTGGTTTAACGCGTAACTA,ATGCAACAACACATACATTGAGAAAATCCTAGCGAGTTCATGGCAGCTCCCAAAGACAAGTGACTACCCCTGCATAAAAAAAAAATTCTAGTTGGTTTA,10,30,14,27,27,45,27,56,27,30,30,45,41,56,49.04,1.085551312
hek293t,12922,1,11,CGATCACAACACATACATTGAGAAAATCCTGGCAGCTCCCAAAGACAAGTGACTACCCCTGCATAAAAAGGCAAAAAAATTCTAGTTGGTTTAACGCGT,CGATCACAACACATACATTGAGAAAATCCTAGCGAGTTCATGGCAGCTCCCAAAGACAAGTGACTACCCCTGCATAAAAAGGCAAAAAAATTCTAGTTG,10,30,14,27,27,40,27,51,27,30,30,40,41,51,49.04,0.77002584
hek293t,12924,1,7,GTACGATATGGGGAGTACAGGGAATATGCTGGAATCTCTTTCATAGGCTTGCCAGGTTCATGTACTGGCATAAAAAAATTCTAGTTGGTTTAACGCGTA,GTACGATATGGGGAGTACAGGGAATATGCTGGAATCTCCACACACTTTCATAGGCTTGCCAGGTTCATGTACTGGCATAAAAAAATTCTAGTTGGTTTA,10,30,14,27,27,45,27,52,27,38,38,45,45,52,64.0,0.78778716
hek293t,12925,1,13,CGCATTGAAAGGTCAAGAGGGTAAGCAGATGGCTAGCTGCAGAATTTATTGCACTTTTAGCAACTAAAAAAATTCTAGTTGGTTTAACGCGTAACTAGA,CGCATTGAAAGGTCAAGAGGGTAAGCAGATGGCTAGCTAAATGCGGAACGTGCAGAATTTATTGCACTTTTAGCAACTAAAAAAATTCTAGTTGGTTTA,10,30,14,27,27,45,27,58,27,38,38,45,51,58,60.5,0.0
hek293t,12928,1,10,TCAGAAAAATAGTAAATACTAATCTGGCACGGGTTCTTGAGACACTCTACAAATAGATTCCTTCAACTGCTGAAAAAAATTCTAGTTGGTTTAACGCGT,TCAGAAAAATAGTAAATACTAATCTGGCACGGGACCACTAAAATTCTTGAGACACTCTACAAATAGATTCCTTCAACTGCTGAAAAAAATTCTAGTTGG,10,30,14,27,27,41,27,51,27,34,34,41,44,51,33.46,0.0
hek293t,12930,1,2,ACCGGGAATGTCCTTGCAATGTGATCGTCTGGTGTGTTGTCCACCAAAGTTGAGAAATGTCTGCAGTCTCAGGGGAAAAAAAAAATTCTAGTTGGTTTA,ACCGGGAATGTCCTTGCAATGTGATCGTCTGGTGTGTTGGCTCCACCAAAGTTGAGAAATGTCTGCAGTCTCAGGGGAAAAAAAAAATTCTAGTTGGTT,10,30,14,27,27,43,27,45,27,40,40,43,42,45,26.41,0.730538141
hek293t,12930,1,2,TCCACGAATGTCCTTGCAATGTGATCGTCTGGTGTGTTGTCCACCAAAGTTGAGAAATGTCTGCAGAAAAAAATTCTAGTTGGTTTAACGCGTAACTAG,TCCACGAATGTCCTTGCAATGTGATCGTCTGGTGTGTTGGCTCCACCAAAGTTGAGAAATGTCTGCAGAAAAAAATTCTAGTTGGTTTAACGCGTAACT,10,30,14,27,27,55,27,57,27,40,40,55,42,57,26.41,77.4619369
hek293t,12934,1,7,CCTGGTTTGTGCACAGTATAGTCTAACACAGGGCGGCCAACCTATTACTCCCATTTTGCATGCCCCCCCCAACTTGTTAAAGACAAAAAAATTCTAGTT,CCTGGTTTGTGCACAGTATAGTCTAACAAGTATTTCAGGGCGGCCAACCTATTACTCCCATTTTGCATGCCCCCCCCAACTTGTTAAAGACAAAAAAAT,10,30,14,27,27,32,27,39,27,29,29,32,36,39,56.11,0.0
hek293t,12934,1,7,AATAGTTTGTGCACAGTATAGTCTAACACAGGGCGGCCAACCTATTACTCCCATTTTGCATGCCCCCCCCAAAAAAAAATTCTAGTTGGTTTAACGCGT,AATAGTTTGTGCACAGTATAGTCTAACAAGTATTTCAGGGCGGCCAACCTATTACTCCCATTTTGCATGCCCCCCCCAAAAAAAAATTCTAGTTGGTTT,10,30,14,27,27,44,27,51,27,29,29,44,36,51,56.11,38.22265494
hek293t,12936,1,15,GCTTATAGGTATAATTACAGCATTCCATGAGGGTGCAGAATTTTCTCACTGAATACAAGAAAAATGAGTAGAAAAAAATTCTAGTTGGTTTAACGCGTA,GCTTATAGGTATAATTACAGCATTCCATGGAACGGGTCACCTCGAGGGTGCAGAATTTTCTCACTGAATACAAGAAAAATGAGTAGAAAAAAATTCTAG,10,30,14,27,27,37,27,52,27,30,30,37,45,52,45.74,8.379290914
hek293t,12936,1,15,GATTATAGGTATAATTACAGCATTCCATGAGGGTGCAGAATTTTCTCACTGAATACAAGAAAAATGAGTAGATCTAAAAAAATTCTAGTTGGTTTAACG,GATTATAGGTATAATTACAGCATTCCATGGAACGGGTCACCTCGAGGGTGCAGAATTTTCTCACTGAATACAAGAAAAATGAGTAGATCTAAAAAAATT,10,30,14,27,27,33,27,48,27,30,30,33,45,48,45.74,0.0
hek293t,12938,1,11,CCATACTAATTTTACAGTCAGCAGCTTGCAGGCTAAACATAAACAGTGCAACCCCATATAAAAATTGCTCAGCTGAAGAAAAAAATTCTAGTTGGTTTA,CCATACTAATTTTACAGTCAGCAGCTTGCAACAGAACCGCAGGCTAAACATAAACAGTGCAACCCCATATAAAAATTGCTCAGCTGAAGAAAAAAATTC,10,30,14,27,27,34,27,45,27,31,31,34,42,45,15.58,0.0
hek293t,12938,1,11,CCTTGCTAATTTTACAGTCAGCAGCTTGCAGGCTAAACATAAACAGTGCAACCCCATATAAAAATTGCTCAGCTAAAAAAATTCTAGTTGGTTTAACGC,CCTTGCTAATTTTACAGTCAGCAGCTTGCAACAGAACCGCAGGCTAAACATAAACAGTGCAACCCCATATAAAAATTGCTCAGCTAAAAAAATTCTAGT,10,30,14,27,27,38,27,49,27,31,31,38,42,49,15.58,3.659453194
hek293t,12940,1,2,TTGAGAGAAATAAAGGTTCTAAGAGTTTACGGTATATAGAGTTTATGGTACATGGGTATAAAGAAGGGAAACAGTACCTTCAGAAAAAAATTCTAGTTG,TTGAGAGAAATAAAGGTTCTAAGAGTTGTTACGGTATATAGAGTTTATGGTACATGGGTATAAAGAAGGGAAACAGTACCTTCAGAAAAAAATTCTAGT,10,30,14,27,27,38,27,40,27,28,28,38,30,40,12.9,60.88848156
hek293t,12940,1,2,GCGCAAGAAATAAAGGTTCTAAGAGTTTACGGTATATAGAGTTTATGGTACATGGGTATAAAGAAGGGAAACAGTACCAAAAAAATTCTAGTTGGTTTA,GCGCAAGAAATAAAGGTTCTAAGAGTTGTTACGGTATATAGAGTTTATGGTACATGGGTATAAAGAAGGGAAACAGTACCAAAAAAATTCTAGTTGGTT,10,30,14,27,27,43,27,45,27,28,28,43,30,45,12.9,59.55471042
hek293t,12942,1,2,GCTCAGGAAAAGCAGAAGAATGGACAGGGTGGAAAACCAGAGGTGCAAAAATGAAATGGCTTTACGTACCACAAAAAAATTCTAGTTGGTTTAACGCGT,GCTCAGGAAAAGCAGAAGAATGGACAGGGTGGAAAACCTGAGAGGTGCAAAAATGAAATGGCTTTACGTACCACAAAAAAATTCTAGTTGGTTTAACGC,10,30,14,27,27,49,27,51,27,39,39,49,41,51,59.59,42.14562893
hek293t,12944,1,3,TTGTCTTGAGCGTACACTCATCAAAAAATTGGTCTTGATTCAGTTGCCTAAATATAGGTGGTCTTTAGATGCCATAGGGTAAAAAAAATTCTAGTTGGT,TTGTCTTGAGCGTACACTCATCAAAAAAGGATTGGTCTTGATTCAGTTGCCTAAATATAGGTGGTCTTTAGATGCCATAGGGTAAAAAAAATTCTAGTT,10,30,14,27,27,39,27,42,27,29,29,39,32,42,12.45,0.189933523
hek293t,12944,1,3,CATATTTGAGCGTACACTCATCAAAAAATTGGTCTTGATTCAGTTGCCTAAATATAGGTGGTCTTTAGATGCCATAGGGTATCCAAGAAAAAAAATTCT,CATATTTGAGCGTACACTCATCAAAAAAGGATTGGTCTTGATTCAGTTGCCTAAATATAGGTGGTCTTTAGATGCCATAGGGTATCCAAGAAAAAAAAT,10,30,14,27,27,32,27,35,27,29,29,32,32,35,12.45,0.0
hek293t,12946,1,3,CCACAAGATTAAAGCCCGTAAGCCGTATCTGGCTTTGTTCTTTTCCCTTCCTTCTTGTTCTGGAGCAAGCGTTTTAAAAAAATTCTAGTTGGTTTAACG,CCACAAGATTAAAGCCCGTAAGCCGTATCTGGCTTTGAAGTTCTTTTCCCTTCCTTCTTGTTCTGGAGCAAGCGTTTTAAAAAAATTCTAGTTGGTTTA,10,30,14,27,27,45,27,48,27,38,38,45,41,48,19.38,8.679150981
hek293t,12948,1,7,AAACGATATAGACTACCCTTGCTTTGATACGGACATATCTGCACAGCAAGAATAAGCTTATTGAAGATGAAAAAAATTCTAGTTGGTTTAACGCGTAAC,AAACGATATAGACTACCCTTGCTTTGATACGGACATGATGCGAATCTGCACAGCAAGAATAAGCTTATTGAAGATGAAAAAAATTCTAGTTGGTTTAAC,10,30,14,27,27,47,27,54,27,37,37,47,44,54,31.06,19.0789463
hek293t,12948,1,7,CGAGAATATAGACTACCCTTGCTTTGATACGGACATATCTGCACAGCAAGAATAAGCTTATTGAAGATGACCAAAAAAATTCTAGTTGGTTTAACGCGT,CGAGAATATAGACTACCCTTGCTTTGATACGGACATGATGCGAATCTGCACAGCAAGAATAAGCTTATTGAAGATGACCAAAAAAATTCTAGTTGGTTT,10,30,14,27,27,44,27,51,27,37,37,44,44,51,31.06,2.807324354
hek293t,12952,1,10,CACCTCCATACTCCTGCCCACACGGAATATGGAGGACTACAAAAGCTGATCGTTAAAAGTATGAGAAAAAAAAAAATTCTAGTTGGTTTAACGCGTAAC,CACCTCCATACTCCTGCCCACACGGAATATGGAGGAGTGGGCTATTCTACAAAAGCTGATCGTTAAAAGTATGAGAAAAAAAAAAATTCTAGTTGGTTT,10,30,14,27,27,44,27,54,27,37,37,44,47,54,31.26,0.0
hek293t,12952,1,10,CAATACCATACTCCTGCCCACACGGAATATGGAGGACTACAAAAGCTGATCGTTAAAAGTATGAGAAAACTACAAAAAAATTCTAGTTGGTTTAACGCG,CAATACCATACTCCTGCCCACACGGAATATGGAGGAGTGGGCTATTCTACAAAAGCTGATCGTTAAAAGTATGAGAAAACTACAAAAAAATTCTAGTTG,10,30,14,27,27,40,27,50,27,37,37,40,47,50,31.26,0.0
hek293t,12954,1,8,TTATCTACCAGTTCTCCCAAACATGGGAAAGGTCAAGATTTTCAGATGCCATTATCTGGAGTCTGTAACCTATTAGCCTGTGTTAAAAAAATTCTAGTT,TTATCTACCAGTTCTCCCAAACATGGGCGGTACAGAAAGGTCAAGATTTTCAGATGCCATTATCTGGAGTCTGTAACCTATTAGCCTGTGTTAAAAAAA,10,30,14,27,27,31,27,39,27,28,28,31,36,39,51.59,0.0
hek293t,12954,1,8,GGAAGTACCAGTTCTCCCAAACATGGGAAAGGTCAAGATTTTCAGATGCCATTATCTGGAGTCTGTAACCTATTAGCAAAAAAATTCTAGTTGGTTTAA,GGAAGTACCAGTTCTCCCAAACATGGGCGGTACAGAAAGGTCAAGATTTTCAGATGCCATTATCTGGAGTCTGTAACCTATTAGCAAAAAAATTCTAGT,10,30,14,27,27,38,27,46,27,28,28,38,36,46,51.59,9.488948648
hek293t,12956,1,10,CTATTCATGAGAGAAGACTGAGATGTGCTTGGGAAGCCATACCTTACCATCTGTTTTATCACCAGCAGAAAAAAATTCTAGTTGGTTTAACGCGTAACT,CTATTCATGAGAGAAGACTGAGATGTGCTTGGGAAGCGTTTGCTGTGCATACCTTACCATCTGTTTTATCACCAGCAGAAAAAAATTCTAGTTGGTTTA,10,30,14,27,27,45,27,55,27,38,38,45,48,55,66.14,0.825878277
hek293t,12956,1,10,TTAGACATGAGAGAAGACTGAGATGTGCTTGGGAAGCCATACCTTACCATCTGTTTTATCACCAGCAGATGCAAAAAAATTCTAGTTGGTTTAACGCGT,TTAGACATGAGAGAAGACTGAGATGTGCTTGGGAAGCGTTTGCTGTGCATACCTTACCATCTGTTTTATCACCAGCAGATGCAAAAAAATTCTAGTTGG,10,30,14,27,27,41,27,51,27,38,38,41,48,51,66.14,0.097040272
hek293t,12960,1,14,GCAGAAGCACATGTATGAAGCTGTGCAGTAGGGTCTAAAAGTAAGCACAAACTGAACTTTTTGGATTTAAAAAAATTCTAGTTGGTTTAACGCGTAACT,GCAGAAGCACATGTATGAAGCTGTGCAGTAGGGTATACTAGATCTACTCTAAAAGTAAGCACAAACTGAACTTTTTGGATTTAAAAAAATTCTAGTTGG,10,30,14,27,27,41,27,55,27,34,34,41,48,55,39.11,1.359479318
hek293t,12961,1,14,GCCCCGGGCTGGCGCAGCAAAGAACAGGGAGGTTTGGGATAGCACTCGTTAATAAACCTGTGTACGAGCTGCTGCCAAAAAAATTCTAGTTGGTTTAAC,GCCCCGGGCTGGCGCAGCAAAGAACAGGGAACCGGAGTCGGACAGGTTTGGGATAGCACTCGTTAATAAACCTGTGTACGAGCTGCTGCCAAAAAAATT,10,30,14,27,27,33,27,47,27,30,30,33,44,47,69.87,0.0
hek293t,12963,1,5,GACAACTAAGAGGAAGGAGTCCTTGACTGGGGTGGTGGTGCTCCGCTAGGACAGTCTGGGCAGCCTAAAGACCAAGCTTGTAAAAAAATTCTAGTTGGT,GACAACTAAGAGGAAGGAGTCCTTGACTGAACTAGGGTGGTGGTGCTCCGCTAGGACAGTCTGGGCAGCCTAAAGACCAAGCTTGTAAAAAAATTCTAG,10,30,14,27,27,37,27,42,27,30,30,37,35,42,70.91,82.73697271
hek293t,12963,1,5,CTTGGCTAAGAGGAAGGAGTCCTTGACTGGGGTGGTGGTGCTCCGCTAGGACAGTCTGGGCAGCCTAAAGACCAAAAAAATTCTAGTTGGTTTAACGCG,CTTGGCTAAGAGGAAGGAGTCCTTGACTGAACTAGGGTGGTGGTGCTCCGCTAGGACAGTCTGGGCAGCCTAAAGACCAAAAAAATTCTAGTTGGTTTA,10,30,14,27,27,45,27,50,27,30,30,45,35,50,70.91,78.07647932
hek293t,12965,1,5,AGAGAAGCAAGGACTCAGCAAACACAAAGAGGACTTCAAATTTATTGAGGGATGATCCAGGAATTGTGAGGCTGGCTTAAAAAAAATTCTAGTTGGTTT,AGAGAAGCAAGGACTCAGCAAACACAAAATCCTGAGGACTTCAAATTTATTGAGGGATGATCCAGGAATTGTGAGGCTGGCTTAAAAAAAATTCTAGTT,10,30,14,27,27,39,27,44,27,29,29,39,34,44,65.44,22.88650086
hek293t,12965,1,5,GACATAGCAAGGACTCAGCAAACACAAAGAGGACTTCAAATTTATTGAGGGATGATCCAGGAATTGTGAGGCTGAAAAAAATTCTAGTTGGTTTAACGC,GACATAGCAAGGACTCAGCAAACACAAAATCCTGAGGACTTCAAATTTATTGAGGGATGATCCAGGAATTGTGAGGCTGAAAAAAATTCTAGTTGGTTT,10,30,14,27,27,44,27,49,27,29,29,44,34,49,65.44,25.10293616
hek293t,12967,1,11,AATGGACATCGGTTTTTACCAAAACCAGGAGGAGTTTGGAATTAACCTTGCCTTGGTCCTGGATGCAAAAAAAATTCTAGTTGGTTTAACGCGTAACTA,AATGGACATCGGTTTTTACCAAAACCAGGAGGAGGCACGATTTATTTTGGAATTAACCTTGCCTTGGTCCTGGATGCAAAAAAAATTCTAGTTGGTTTA,10,30,14,27,27,45,27,56,27,35,35,45,46,56,38.09,0.06385696
hek293t,12967,1,11,GCTACACATCGGTTTTTACCAAAACCAGGAGGAGTTTGGAATTAACCTTGCCTTGGTCCTGGATGCACTGAAAAAAATTCTAGTTGGTTTAACGCGTAA,GCTACACATCGGTTTTTACCAAAACCAGGAGGAGGCACGATTTATTTTGGAATTAACCTTGCCTTGGTCCTGGATGCACTGAAAAAAATTCTAGTTGGT,10,30,14,27,27,42,27,53,27,35,35,42,46,53,38.09,0.031123561
hek293t,12969,1,10,GGTAGCTCTCCCCTTCAGTGCATTGACGATGGCAGAGCAACATCTCGGCAATCACGGCGGGCACAGGAAACTGAAAAAAATTCTAGTTGGTTTAACGCG,GGTAGCTCTCCCCTTCAGTGCATTGACGATGGCAGATCCATGTTAGGCAACATCTCGGCAATCACGGCGGGCACAGGAAACTGAAAAAAATTCTAGTTG,10,30,14,27,27,40,27,50,27,37,37,40,47,50,60.21,3.454815208
hek293t,12969,1,10,GCTACCTCTCCCCTTCAGTGCATTGACGATGGCAGAGCAACATCTCGGCAATCACGGCGGGCACAGAAAAAAATTCTAGTTGGTTTAACGCGTAACTAG,GCTACCTCTCCCCTTCAGTGCATTGACGATGGCAGATCCATGTTAGGCAACATCTCGGCAATCACGGCGGGCACAGAAAAAAATTCTAGTTGGTTTAAC,10,30,14,27,27,47,27,57,27,37,37,47,47,57,60.21,23.5265339
hek293t,12977,1,8,CAATTAATAAGCTGGTTTGGTACAAGCACAGGAGGAAACAAAACACAGTTTACTGGAGCAAAGCCCCTAAAAAAATTCTAGTTGGTTTAACGCGTAACT,CAATTAATAAGCTGGTTTGGTACAAGCACAGTCGAGCCAGAGGAAACAAAACACAGTTTACTGGAGCAAAGCCCCTAAAAAAATTCTAGTTGGTTTAAC,10,30,14,27,27,47,27,55,27,32,32,47,40,55,54.45,13.92261262
hek293t,12977,1,8,TGTCTAATAAGCTGGTTTGGTACAAGCACAGGAGGAAACAAAACACAGTTTACTGGAGCAAAGCCCCTGTACAAAAAAAATTCTAGTTGGTTTAACGCG,TGTCTAATAAGCTGGTTTGGTACAAGCACAGTCGAGCCAGAGGAAACAAAACACAGTTTACTGGAGCAAAGCCCCTGTACAAAAAAAATTCTAGTTGGT,10,30,14,27,27,42,27,50,27,32,32,42,40,50,54.45,30.6233901
hek293t,12980,1,11,GGGCCAGGCTCTTTCTTTCCAAGTTCTTGTGGGGTTGCAGTAAAACTAAAAATATGGTGCTAGGACATGTGTCAAAAAAATTCTAGTTGGTTTAACGCG,GGGCCAGGCTCTTTCTTTCCAAGTTCTTGTGTCGTTAGGAGTGGGTTGCAGTAAAACTAAAAATATGGTGCTAGGACATGTGTCAAAAAAATTCTAGTT,10,30,14,27,27,39,27,50,27,32,32,39,43,50,17.7,0.981483115
hek293t,12980,1,11,CCACAAGGCTCTTTCTTTCCAAGTTCTTGTGGGGTTGCAGTAAAACTAAAAATATGGTGCTAGGAAAAAAAATTCTAGTTGGTTTAACGCGTAACTAGA,CCACAAGGCTCTTTCTTTCCAAGTTCTTGTGTCGTTAGGAGTGGGTTGCAGTAAAACTAAAAATATGGTGCTAGGAAAAAAAATTCTAGTTGGTTTAAC,10,30,14,27,27,47,27,58,27,32,32,47,43,58,17.7,1.181380906
hek293t,12982,1,7,TGACGTTTATTTGCATTCTCTGTGAAGACAGGTGAAAAGAGCATTAACCTGACAAAGCAGTGTAAGGGGAAGCCAAAAAAATTCTAGTTGGTTTAACGC,TGACGTTTATTTGCATTCTCTGTGAATGGAACCGACAGGTGAAAAGAGCATTAACCTGACAAAGCAGTGTAAGGGGAAGCCAAAAAAATTCTAGTTGGT,10,30,14,27,27,42,27,49,27,27,27,42,34,49,31.37,11.80644257
hek293t,12982,1,7,TGTAATTTATTTGCATTCTCTGTGAAGACAGGTGAAAAGAGCATTAACCTGACAAAGCAGTGTAAGGGGAAGCCACAGAAAGAACTAAAAAAATTCTAG,TGTAATTTATTTGCATTCTCTGTGAATGGAACCGACAGGTGAAAAGAGCATTAACCTGACAAAGCAGTGTAAGGGGAAGCCACAGAAAGAACTAAAAAA,10,30,14,27,27,30,27,37,27,27,27,30,34,37,31.37,0.0
hek293t,12984,1,6,ACTTAGCTGGATCACAAAAAGAAAGAAAGAGGAATTACTATGGCTTTTCAGTTATCTACATGAAAACTAAAAAGTCAGAGCTAAAAAAATTCTAGTTGG,ACTTAGCTGGATCACAAAAAGAAAGAAAGAGGGTGTAGAATTACTATGGCTTTTCAGTTATCTACATGAAAACTAAAAAGTCAGAGCTAAAAAAATTCT,10,30,14,27,27,35,27,41,27,32,32,35,38,41,50.21,0.0
hek293t,12984,1,6,TGGGGGCTGGATCACAAAAAGAAAGAAAGAGGAATTACTATGGCTTTTCAGTTATCTACATGAAAACTAAAAAGTAAAAAAATTCTAGTTGGTTTAACG,TGGGGGCTGGATCACAAAAAGAAAGAAAGAGGGTGTAGAATTACTATGGCTTTTCAGTTATCTACATGAAAACTAAAAAGTAAAAAAATTCTAGTTGGT,10,30,14,27,27,42,27,48,27,32,32,42,38,48,50.21,0.024446889
hek293t,12986,1,4,TATGTCCTGTTTGCTGTAAGAGCAGTTTGAGGAAAGGACACCGTCCAGCTGAATGAAAAACCAAACACGCAGCAGAAAAAAATTCTAGTTGGTTTAACG,TATGTCCTGTTTGCTGTAAGAGCAGTTTGAGGAAAGGACACCTGCCGTCCAGCTGAATGAAAAACCAAACACGCAGCAGAAAAAAATTCTAGTTGGTTT,10,30,14,27,27,44,27,48,27,41,41,44,45,48,51.99,5.065493289
hek293t,12987,1,6,TTCCATGTGCCTGTGACAATGGGTGTGCTTGGCTTCAGCATCTCTCTTTCTCTCTGTGGCTCCTCCAGCAGGTCTAAATGAAAAAAATTCTAGTTGGTT,TTCCATGTGCCTGTGACAATGGGTGTATCGCAGCTTGGCTTCAGCATCTCTCTTTCTCTCTGTGGCTCCTCCAGCAGGTCTAAATGAAAAAAATTCTAG,10,30,14,27,27,37,27,43,27,27,27,37,33,43,42.18,77.44815304
hek293t,12987,1,6,GAGGGTGTGCCTGTGACAATGGGTGTGCTTGGCTTCAGCATCTCTCTTTCTCTCTGTGGCTCCTCCAGCAGGTCTAAATGAGGTTAAAAAAAAATTCTA,GAGGGTGTGCCTGTGACAATGGGTGTATCGCAGCTTGGCTTCAGCATCTCTCTTTCTCTCTGTGGCTCCTCCAGCAGGTCTAAATGAGGTTAAAAAAAA,10,30,14,27,27,30,27,36,27,27,27,30,33,36,42.18,7.934937073
hek293t,12991,1,9,AAGCCTTAAATGATTTTGAAAAACTGACCTGGAGGGGCATGTTTGTTTACAATTCAGTCTTCACCCCCCAAAAAAATTCTAGTTGGTTTAACGCGTAAC,AAGCCTTAAATGATTTTGAAAAACTGACCTAGAGGTGTTGGAGGGGCATGTTTGTTTACAATTCAGTCTTCACCCCCCAAAAAAATTCTAGTTGGTTTA,10,30,14,27,27,45,27,54,27,30,30,45,39,54,27.82,0.039494471
hek293t,12993,1,5,TTACTGTGTAGAGTGACATATGTATCAAAAGGAAAGTAAAAATTATTTAATATTCCTAATGAAAGTCATAAATTAAAAAAATTCTAGTTGGTTTAACGC,TTACTGTGTAGAGTGACATATGTATCAAAAGGAAAGTAAAAACAAAATTATTTAATATTCCTAATGAAAGTCATAAATTAAAAAAATTCTAGTTGGTTT,10,30,14,27,27,44,27,49,27,41,41,44,46,49,47.39,0.0
hek293t,12993,1,5,GAAACGTGTAGAGTGACATATGTATCAAAAGGAAAGTAAAAATTATTTAATATTCCTAATGAAAGTCAAAAAAATTCTAGTTGGTTTAACGCGTAACTA,GAAACGTGTAGAGTGACATATGTATCAAAAGGAAAGTAAAAACAAAATTATTTAATATTCCTAATGAAAGTCAAAAAAATTCTAGTTGGTTTAACGCGT,10,30,14,27,27,51,27,56,27,41,41,51,46,56,47.39,0.0
hek293t,12995,1,1,CTCGCGTTGTTAACAAACAGAGAAGGAGGAGGATTTTATTGGTATTCAATTTTTTCACCCTTCTATTGCAAAACAAAAAAATTCTAGTTGGTTTAACGC,CTCGCGTTGTTAACAAACAGAGAAGGAGGAGGATTTTCATTGGTATTCAATTTTTTCACCCTTCTATTGCAAAACAAAAAAATTCTAGTTGGTTTAACG,10,30,14,27,27,48,27,49,27,38,38,48,39,49,58.75,18.3769262
hek293t,12995,1,1,CCGACGTTGTTAACAAACAGAGAAGGAGGAGGATTTTATTGGTATTCAATTTTTTCACCCTTCTATTGCAAAACATCAAAAAAATTCTAGTTGGTTTAA,CCGACGTTGTTAACAAACAGAGAAGGAGGAGGATTTTCATTGGTATTCAATTTTTTCACCCTTCTATTGCAAAACATCAAAAAAATTCTAGTTGGTTTA,10,30,14,27,27,45,27,46,27,38,38,45,39,46,58.75,24.84639426
hek293t,12997,1,11,GGAACCACTTGATACAGATAGGTATCTAATGGGATATCAAATATTGACTTTATATGGGAGTGAGCAAGATGTTTGCCCTCAAAAAAATTCTAGTTGGTT,GGAACCACTTGATACAGATAGGTATCTATTCTTCTCCTTATGGGATATCAAATATTGACTTTATATGGGAGTGAGCAAGATGTTTGCCCTCAAAAAAAT,10,30,14,27,27,32,27,43,27,29,29,32,40,43,26.54,0.0
hek293t,12997,1,11,CAACCCACTTGATACAGATAGGTATCTAATGGGATATCAAATATTGACTTTATATGGGAGTGAGCAAGATGTTAAAAAAATTCTAGTTGGTTTAACGCG,CAACCCACTTGATACAGATAGGTATCTATTCTTCTCCTTATGGGATATCAAATATTGACTTTATATGGGAGTGAGCAAGATGTTAAAAAAATTCTAGTT,10,30,14,27,27,39,27,50,27,29,29,39,40,50,26.54,15.0239423
hek293t,12999,1,15,GTTTTATATCAGCAGCCCTCGGCTCAGCCTGGTAAGCATGGTGAGCATTTGTATGAACAGATACCGGTGAAAAAAATTCTAGTTGGTTTAACGCGTAAC,GTTTTATATCAGCAGCCCTCGGCTCAGCGGAATCATCGACGGCCTGGTAAGCATGGTGAGCATTTGTATGAACAGATACCGGTGAAAAAAATTCTAGTT,10,30,14,27,27,39,27,54,27,29,29,39,44,54,39.91,1.390070103
hek293t,13001,1,3,CTAGGTGTGGTTGAATTCTCCTTTATGGGTGGCCTTGTTACATAGAGAGCCTGCAGGTATTTAGTGGGCCAAGGCAAATAGGGAGGAAAAAAATTCTAG,CTAGGTGTGGTTGAATTCTCCTTTATGGGTTAGGGCCTTGTTACATAGAGAGCCTGCAGGTATTTAGTGGGCCAAGGCAAATAGGGAGGAAAAAAATTC,10,30,14,27,27,34,27,37,27,31,31,34,34,37,51.26,1.801541969
hek293t,13001,1,3,TCATGTGTGGTTGAATTCTCCTTTATGGGTGGCCTTGTTACATAGAGAGCCTGCAGGTATTTAGTGGGCCAAGGAAAAAAATTCTAGTTGGTTTAACGC,TCATGTGTGGTTGAATTCTCCTTTATGGGTTAGGGCCTTGTTACATAGAGAGCCTGCAGGTATTTAGTGGGCCAAGGAAAAAAATTCTAGTTGGTTTAA,10,30,14,27,27,46,27,49,27,31,31,46,34,49,51.26,72.62583011
hek293t,13003,1,3,CGACAAAAATGTTTCAGTCTTTCGGAAAGTGGGAACGTTTTCTTCCCCGGCCCTGGAGAAGCACACGCCAACACAGGCAAGATAAAAAAAATTCTAGTT,CGACAAAAATGTTTCAGTCTTTCGGAAAGTGGTTGGAACGTTTTCTTCCCCGGCCCTGGAGAAGCACACGCCAACACAGGCAAGATAAAAAAAATTCTA,10,30,14,27,27,36,27,39,27,33,33,36,36,39,7.22,0.642673522
hek293t,13003,1,3,AACTCAAAATGTTTCAGTCTTTCGGAAAGTGGGAACGTTTTCTTCCCCGGCCCTGGAGAAGCACACGCCAACAAAAAAATTCTAGTTGGTTTAACGCGT,AACTCAAAATGTTTCAGTCTTTCGGAAAGTGGTTGGAACGTTTTCTTCCCCGGCCCTGGAGAAGCACACGCCAACAAAAAAATTCTAGTTGGTTTAACG,10,30,14,27,27,48,27,51,27,33,33,48,36,51,7.22,72.96239689
hek293t,13005,1,3,GGTTACATAGCATATGAGCAATATTCTCTAGGTAAACCGTGTGATAACATGGTACTGAACTGAGAAAAAAATTCTAGTTGGTTTAACGCGTAACTAGAT,GGTTACATAGCATATGAGCAATATTCTCTAGGTAAACCGTACTGTGATAACATGGTACTGAACTGAGAAAAAAATTCTAGTTGGTTTAACGCGTAACTA,10,30,14,27,27,56,27,59,27,41,41,56,44,59,27.06,52.28841914
hek293t,13005,1,3,CAATGCATAGCATATGAGCAATATTCTCTAGGTAAACCGTGTGATAACATGGTACTGAACTGAGCACTGACAAAAAAAATTCTAGTTGGTTTAACGCGT,CAATGCATAGCATATGAGCAATATTCTCTAGGTAAACCGTACTGTGATAACATGGTACTGAACTGAGCACTGACAAAAAAAATTCTAGTTGGTTTAACG,10,30,14,27,27,48,27,51,27,41,41,48,44,51,27.06,73.73858526
hek293t,13007,1,9,GCCTCTTAGTGATTTTAGCAGCAATGTCCTGGGAACCATTTTGGTACAAAAACTCTAATAAGGAAAAAAGCAAAAAAAATTCTAGTTGGTTTAACGCGT,GCCTCTTAGTGATTTTAGCAGCAATGTCCTGTACCCGAGCGGAACCATTTTGGTACAAAAACTCTAATAAGGAAAAAAGCAAAAAAAATTCTAGTTGGT,10,30,14,27,27,42,27,51,27,32,32,42,41,51,30.35,9.302031356
hek293t,13007,1,9,AGGGTTTAGTGATTTTAGCAGCAATGTCCTGGGAACCATTTTGGTACAAAAACTCTAATAAGGAAAAAAGCAGGGTGACAAAAAAATTCTAGTTGGTTT,AGGGTTTAGTGATTTTAGCAGCAATGTCCTGTACCCGAGCGGAACCATTTTGGTACAAAAACTCTAATAAGGAAAAAAGCAGGGTGACAAAAAAATTCT,10,30,14,27,27,35,27,44,27,32,32,35,41,44,30.35,0.0
hek293t,13009,1,10,AGTTGCATAATATCAAACATTATCTTCTGTGGTGAAATGTAAAACCTAAACCTGCTCTTACTCCCAAAAAAATTCTAGTTGGTTTAACGCGTAACTAGA,AGTTGCATAATATCAAACATTATCTTCTGTGGTGAAAGATACTCACATGTAAAACCTAAACCTGCTCTTACTCCCAAAAAAATTCTAGTTGGTTTAACG,10,30,14,27,27,48,27,58,27,38,38,48,48,58,34.07,1.288137961
hek293t,13010,1,10,TGCTATTCATGCATAAATAAATGATAAGGAGGGCCACTGATCTTCTCTTGAGAAAGACGGCTATGTCTCCTGTCATATCAGAAAAAAATTCTAGTTGGT,TGCTATTCATGCATAAATAAATGATAAGCTTGTGGGCCGAGGGCCACTGATCTTCTCTTGAGAAAGACGGCTATGTCTCCTGTCATATCAGAAAAAAAT,10,30,14,27,27,32,27,42,27,29,29,32,39,42,39.2,0.0
hek293t,13010,1,10,ACTTGTTCATGCATAAATAAATGATAAGGAGGGCCACTGATCTTCTCTTGAGAAAGACGGCTATGTCTCCTGTCAAAAAAATTCTAGTTGGTTTAACGC,ACTTGTTCATGCATAAATAAATGATAAGCTTGTGGGCCGAGGGCCACTGATCTTCTCTTGAGAAAGACGGCTATGTCTCCTGTCAAAAAAATTCTAGTT,10,30,14,27,27,39,27,49,27,29,29,39,39,49,39.2,1.037810105
hek293t,13014,1,5,AGTCGGAACAGGCTACGCTACCTGAGCTGTGGATAACACAGAGCCAAACTGAACACTTTAAATATTTCTATTTTGACAGAAAAAAATTCTAGTTGGTTT,AGTCGGAACAGGCTACGCTACCTGAGCTGTGAGAACGATAACACAGAGCCAAACTGAACACTTTAAATATTTCTATTTTGACAGAAAAAAATTCTAGTT,10,30,14,27,27,39,27,44,27,32,32,39,37,44,68.46,11.07976604
hek293t,13016,1,4,CCATGACCAGTCTGGTGAACTGATTTATGCGGGAGAGCAGGGGAAAAACAGGATTACGGAAACTCTTCGACCTAGAAAAAAAATTCTAGTTGGTTTAAC,CCATGACCAGTCTGGTGAACTGATTTATGCGGCTAGGAGAGCAGGGGAAAAACAGGATTACGGAAACTCTTCGACCTAGAAAAAAAATTCTAGTTGGTT,10,30,14,27,27,43,27,47,27,33,33,43,37,47,48.96,66.96637248
hek293t,13016,1,4,GGTGCACCAGTCTGGTGAACTGATTTATGCGGGAGAGCAGGGGAAAAACAGGATTACGGAAACTCTTCGACAAAAAAATTCTAGTTGGTTTAACGCGTA,GGTGCACCAGTCTGGTGAACTGATTTATGCGGCTAGGAGAGCAGGGGAAAAACAGGATTACGGAAACTCTTCGACAAAAAAATTCTAGTTGGTTTAACG,10,30,14,27,27,48,27,52,27,33,33,48,37,52,48.96,61.42840159
hek293t,13018,1,7,GGTGGAATCAGCTTTCCTAATAGGTCTTCTGGCTCTGGAAATACTGTCAGAGTTCTTAAAGCCATCAGCTGGATCCTCACCAGCAAAAAAATTCTAGTT,GGTGGAATCAGCTTTCCTAATAGGTCTTTTGGGAGCTGGCTCTGGAAATACTGTCAGAGTTCTTAAAGCCATCAGCTGGATCCTCACCAGCAAAAAAAT,10,30,14,27,27,32,27,39,27,29,29,32,36,39,3.56,44.19806446
hek293t,13018,1,7,ATGGCAATCAGCTTTCCTAATAGGTCTTCTGGCTCTGGAAATACTGTCAGAGTTCTTAAAGCCATCAGCTGGATCCTAAAAAAATTCTAGTTGGTTTAA,ATGGCAATCAGCTTTCCTAATAGGTCTTTTGGGAGCTGGCTCTGGAAATACTGTCAGAGTTCTTAAAGCCATCAGCTGGATCCTAAAAAAATTCTAGTT,10,30,14,27,27,39,27,46,27,29,29,39,36,46,3.56,32.60688555
hek293t,13020,1,6,AGAGAGTGTATTCAGCTCTTCTATAATTTAGGTCTTGCTTTGCATCAGATTGGTCCCCAAACACATTTTTGAAAAAAAAATTCTAGTTGGTTTAACGCG,AGAGAGTGTATTCAGCTCTTCTATAATTTAGGTCTTCAGGCAGCTTTGCATCAGATTGGTCCCCAAACACATTTTTGAAAAAAAAATTCTAGTTGGTTT,10,30,14,27,27,44,27,50,27,37,37,44,43,50,8.23,31.88215928
hek293t,13020,1,6,GCGCTGTGTATTCAGCTCTTCTATAATTTAGGTCTTGCTTTGCATCAGATTGGTCCCCAAACACAAAAAAAATTCTAGTTGGTTTAACGCGTAACTAGA,GCGCTGTGTATTCAGCTCTTCTATAATTTAGGTCTTCAGGCAGCTTTGCATCAGATTGGTCCCCAAACACAAAAAAAATTCTAGTTGGTTTAACGCGTA,10,30,14,27,27,52,27,58,27,37,37,52,43,58,8.23,58.82486662
hek293t,13022,1,3,CGTGCATTCTTGCTGAAATAGTCCTTAACTGGGGAAGGAGGTCGAAATCCTACATACAGGACAGGGGCCATTTGCTCAAGCAGAAAAAAATTCTAGTTG,CGTGCATTCTTGCTGAAATAGTCCTTTTCAACTGGGGAAGGAGGTCGAAATCCTACATACAGGACAGGGGCCATTTGCTCAAGCAGAAAAAAATTCTAG,10,30,14,27,27,37,27,40,27,27,27,37,30,40,7.87,68.96859079
hek293t,13022,1,3,TGAGAATTCTTGCTGAAATAGTCCTTAACTGGGGAAGGAGGTCGAAATCCTACATACAGGACAGGGGCCATTTGCTCAAGCAGCGGAAAAAAATTCTAG,TGAGAATTCTTGCTGAAATAGTCCTTTTCAACTGGGGAAGGAGGTCGAAATCCTACATACAGGACAGGGGCCATTTGCTCAAGCAGCGGAAAAAAATTC,10,30,14,27,27,34,27,37,27,27,27,34,30,37,7.87,50.91217557
hek293t,13024,1,7,GGAAATATTTTGTAGAGTTACTGAAGAGAAGGTTTTGATGGAGAAAATACTGAGAATGTATAAATGAAAAAAATTCTAGTTGGTTTAACGCGTAACTAG,GGAAATATTTTGTAGAGTTACTGAAGAGAAGGTTGGGGCACTTGATGGAGAAAATACTGAGAATGTATAAATGAAAAAAATTCTAGTTGGTTTAACGCG,10,30,14,27,27,50,27,57,27,35,35,50,42,57,41.35,5.147856506
hek293t,13024,1,7,AGGTATATTTTGTAGAGTTACTGAAGAGAAGGTTTTGATGGAGAAAATACTGAGAATGTATAAATGGATTTTATAAAAAAATTCTAGTTGGTTTAACGC,AGGTATATTTTGTAGAGTTACTGAAGAGAAGGTTGGGGCACTTGATGGAGAAAATACTGAGAATGTATAAATGGATTTTATAAAAAAATTCTAGTTGGT,10,30,14,27,27,42,27,49,27,35,35,42,42,49,41.35,1.852831017
hek293t,13026,1,8,TGATGATAATCTCACTTGAAAAAGATTTCAGGGAAAAGCAAAAATGAAGAGCTGAAGAGCACTGGTCATAAAAAAATTCTAGTTGGTTTAACGCGTAAC,TGATGATAATCTCACTTGAAAAAGATTTCAGGGAAAAGAGTAGGAGCAAAAATGAAGAGCTGAAGAGCACTGGTCATAAAAAAATTCTAGTTGGTTTAA,10,30,14,27,27,46,27,54,27,39,39,46,47,54,1.76,0.0
hek293t,14898,1,7,CATAGTTTGGAAGTAGCTGAGAAGGGAGAAGGCGGCTGGGCTGGCAGAGGCAGCGTTAGGCGTTCGGCACAGCAAAAAAAATTCTAGTTGGTTTAACGC,CATAGTTTGGAAGTAGCTGAGAAGGGAGAAGGCGGCTGTGATAGGGGCTGGCAGAGGCAGCGTTAGGCGTTCGGCACAGCAAAAAAAATTCTAGTTGGT,10,30,14,27,27,42,27,49,27,39,39,42,46,49,48.41,1.876597513
hek293t,14898,1,7,ATTAATTTGGAAGTAGCTGAGAAGGGAGAAGGCGGCTGGGCTGGCAGAGGCAGCGTTAGGCGTTCGGAAAAAAATTCTAGTTGGTTTAACGCGTAACTA,ATTAATTTGGAAGTAGCTGAGAAGGGAGAAGGCGGCTGTGATAGGGGCTGGCAGAGGCAGCGTTAGGCGTTCGGAAAAAAATTCTAGTTGGTTTAACGC,10,30,14,27,27,49,27,56,27,39,39,49,46,56,48.41,2.449806329
hek293t,13029,1,1,AGCATAGCATTCTGCCAGCAGAGAATTGGAGGATGAAGACAACAAAAGACTCACATGAAACTAACAGATTAAACTGTATCAGGTGGAAAAAAAATTCTA,AGCATAGCATTCTGCCAGCAGAGAATTGGAGCGATGAAGACAACAAAAGACTCACATGAAACTAACAGATTAAACTGTATCAGGTGGAAAAAAAATTCT,10,30,14,27,27,35,27,36,27,32,32,35,33,36,64.81,46.5947519
hek293t,13029,1,1,GATAAAGCATTCTGCCAGCAGAGAATTGGAGGATGAAGACAACAAAAGACTCACATGAAACTAACAGATTAAACTGTATCAGGAAAAAAATTCTAGTTG,GATAAAGCATTCTGCCAGCAGAGAATTGGAGCGATGAAGACAACAAAAGACTCACATGAAACTAACAGATTAAACTGTATCAGGAAAAAAATTCTAGTT,10,30,14,27,27,39,27,40,27,32,32,39,33,40,64.81,79.19730168
hek293t,13033,1,15,TAAGCTATCTGGCTCACATAGAAGAAAATTGGCGCAATGCTGCTACAGGTGTTAATTTAATCATGAAAAAAATTCTAGTTGGTTTAACGCGTAACTAGA,TAAGCTATCTGGCTCACATAGAAGAAAATTGGCGCAATGACTGTGTACTTCACGCTGCTACAGGTGTTAATTTAATCATGAAAAAAATTCTAGTTGGTT,10,30,14,27,27,43,27,58,27,40,40,43,55,58,18.22,0.0
hek293t,13034,1,2,CTCCGCATAATGCTCAAATGTCCTATAGGAGGCCATGGTTATATCATTTCATGTAAAGAAAAGTGGTAGTCTTACTTGGAAAAAAATTCTAGTTGGTTT,CTCCGCATAATGCTCAAATGTCCTATAGGAGCCGCCATGGTTATATCATTTCATGTAAAGAAAAGTGGTAGTCTTACTTGGAAAAAAATTCTAGTTGGT,10,30,14,27,27,42,27,44,27,32,32,42,34,44,57.1,90.00545556
hek293t,13034,1,2,AGGGTCATAATGCTCAAATGTCCTATAGGAGGCCATGGTTATATCATTTCATGTAAAGAAAAGTGGTAGTCTTAAAAAAAATTCTAGTTGGTTTAACGC,AGGGTCATAATGCTCAAATGTCCTATAGGAGCCGCCATGGTTATATCATTTCATGTAAAGAAAAGTGGTAGTCTTAAAAAAAATTCTAGTTGGTTTAAC,10,30,14,27,27,47,27,49,27,32,32,47,34,49,57.1,85.52660137
hek293t,13036,1,13,ATACTGAAAACTGTCTTGAAAATGAGCTTAGGCAAGGGTATTCAGCCATTTCCAATCACTGCTTAAAGGCAATAAAAAAAATTCTAGTTGGTTTAACGC,ATACTGAAAACTGTCTTGAAAATGAGCTTAGGACTGGAACTATTTCAAGGGTATTCAGCCATTTCCAATCACTGCTTAAAGGCAATAAAAAAAATTCTA,10,30,14,27,27,36,27,49,27,33,33,36,46,49,53.89,0.176866587
hek293t,13036,1,13,GGCTCGAAAACTGTCTTGAAAATGAGCTTAGGCAAGGGTATTCAGCCATTTCCAATCACTGCTTAAAGGCAAAAAAATTCTAGTTGGTTTAACGCGTAA,GGCTCGAAAACTGTCTTGAAAATGAGCTTAGGACTGGAACTATTTCAAGGGTATTCAGCCATTTCCAATCACTGCTTAAAGGCAAAAAAATTCTAGTTG,10,30,14,27,27,40,27,53,27,33,33,40,46,53,53.89,0.291065375
hek293t,13038,1,14,CACTAAACTGATCAAGTGTTGTCAGCCAAAGGGAGATTTACACTGAAGACTTCTGTTTCCACCATAACGAAAAAAATTCTAGTTGGTTTAACGCGTAAC,CACTAAACTGATCAAGTGTTGTCAGCCAAAGGGAGAAGCTTTTAGGGCTATTTACACTGAAGACTTCTGTTTCCACCATAACGAAAAAAATTCTAGTTG,10,30,14,27,27,40,27,54,27,37,37,40,51,54,35.2,0.020951184
hek293t,13039,1,8,AAGCAGAAAAGACAAGCTGACAAGGCTGAAGGGTCTCCTGTTACCAAGTCTCTGTTTCCTTTGTGACAAAAAAATTCTAGTTGGTTTAACGCGTAACTA,AAGCAGAAAAGACAAGCTGACAAGGCTGAAGGGAAACCCAGTCTCCTGTTACCAAGTCTCTGTTTCCTTTGTGACAAAAAAATTCTAGTTGGTTTAACG,10,30,14,27,27,48,27,56,27,33,33,48,41,56,45.07,34.103924
hek293t,13039,1,8,TCTTAGAAAAGACAAGCTGACAAGGCTGAAGGGTCTCCTGTTACCAAGTCTCTGTTTCCTTTGTGACCTTAGAAAAAAATTCTAGTTGGTTTAACGCGT,TCTTAGAAAAGACAAGCTGACAAGGCTGAAGGGAAACCCAGTCTCCTGTTACCAAGTCTCTGTTTCCTTTGTGACCTTAGAAAAAAATTCTAGTTGGTT,10,30,14,27,27,43,27,51,27,33,33,43,41,51,45.07,47.94333247
hek293t,13041,1,8,GATAAGTCCAAGGAGGGTTAGGTGATACATGGAAGTAGAAAGTTTTCAGGAGTGATCTGAATTTGGAGAGTTTTAAAAAAAAATTCTAGTTGGTTTAAC,GATAAGTCCAAGGAGGGTTAGGTGATACCGGCGGAGATGGAAGTAGAAAGTTTTCAGGAGTGATCTGAATTTGGAGAGTTTTAAAAAAAAATTCTAGTT,10,30,14,27,27,39,27,47,27,29,29,39,37,47,73.91,15.99351467
hek293t,13041,1,8,CGAGTGTCCAAGGAGGGTTAGGTGATACATGGAAGTAGAAAGTTTTCAGGAGTGATCTGAATTTGGAGAGTTTTAATGAAAAAAAATTCTAGTTGGTTT,CGAGTGTCCAAGGAGGGTTAGGTGATACCGGCGGAGATGGAAGTAGAAAGTTTTCAGGAGTGATCTGAATTTGGAGAGTTTTAATGAAAAAAAATTCTA,10,30,14,27,27,36,27,44,27,29,29,36,37,44,73.91,9.224068111
hek293t,13043,1,14,CAACGTTTTAAATATGTAGCAACTCTACTTGGGTCATCTGAGGTAACTTTTTGACCTTTTGGTCCATGGTCTGGTTAAAAAAATTCTAGTTGGTTTAAC,CAACGTTTTAAATATGTAGCAACTCTACTGCATCAACTTTGTTTGGGTCATCTGAGGTAACTTTTTGACCTTTTGGTCCATGGTCTGGTTAAAAAAATT,10,30,14,27,27,33,27,47,27,30,30,33,44,47,19.57,0.240384615
hek293t,13043,1,14,ATAGATTTTAAATATGTAGCAACTCTACTTGGGTCATCTGAGGTAACTTTTTGACCTTTTGGTCCATGGAAAAAAATTCTAGTTGGTTTAACGCGTAAC,ATAGATTTTAAATATGTAGCAACTCTACTGCATCAACTTTGTTTGGGTCATCTGAGGTAACTTTTTGACCTTTTGGTCCATGGAAAAAAATTCTAGTTG,10,30,14,27,27,40,27,54,27,30,30,40,44,54,19.57,11.5145991
hek293t,13045,1,13,AACGTTCATAAAACTGAGGAGAAAAGCTTAGGAAACAGCACTGCTTCATTAAAAGATCATTTCTCTCTCTATGAAAAAAATTCTAGTTGGTTTAACGCG,AACGTTCATAAAACTGAGGAGAAAAGCTTCTCTGCCTCGTTGAGGAAACAGCACTGCTTCATTAAAAGATCATTTCTCTCTCTATGAAAAAAATTCTAG,10,30,14,27,27,37,27,50,27,30,30,37,43,50,43.96,0.471889193
hek293t,13045,1,13,CTCGTTCATAAAACTGAGGAGAAAAGCTTAGGAAACAGCACTGCTTCATTAAAAGATCATTTCTCTCTCTAAAAAAATTCTAGTTGGTTTAACGCGTAA,CTCGTTCATAAAACTGAGGAGAAAAGCTTCTCTGCCTCGTTGAGGAAACAGCACTGCTTCATTAAAAGATCATTTCTCTCTCTAAAAAAATTCTAGTTG,10,30,14,27,27,40,27,53,27,30,30,40,43,53,43.96,13.30324204
hek293t,13047,1,5,AACCGCTAAAGTTGTGTCATACAGTACCATGGCTGAAGAAATGGATGAGGACTTTAGCTGTAAGATTAAGCCACTACCCTGTAAAAAAAATTCTAGTTG,AACCGCTAAAGTTGTGTCATACAGTACCATGAGCTAGCTGAAGAAATGGATGAGGACTTTAGCTGTAAGATTAAGCCACTACCCTGTAAAAAAAATTCT,10,30,14,27,27,35,27,40,27,32,32,35,37,40,68.64,2.159439723
hek293t,13047,1,5,AATGGCTAAAGTTGTGTCATACAGTACCATGGCTGAAGAAATGGATGAGGACTTTAGCTGTAAGATTAAGCCACTACCCAAAAAAATTCTAGTTGGTTT,AATGGCTAAAGTTGTGTCATACAGTACCATGAGCTAGCTGAAGAAATGGATGAGGACTTTAGCTGTAAGATTAAGCCACTACCCAAAAAAATTCTAGTT,10,30,14,27,27,39,27,44,27,32,32,39,37,44,68.64,38.43390824
hek293t,13049,1,8,GTGGCGTTGTGATTGTTTGTGTCTGAGGCTGGAAGGCTGCCACTTTCCTTCCTTTTGTTCTGCTTCCTTTGCTGAATAGAAAAAAATTCTAGTTGGTTT,GTGGCGTTGTGATTGTTTGTGTCTGAGGCTGGAGTTCATCAAGGCTGCCACTTTCCTTCCTTTTGTTCTGCTTCCTTTGCTGAATAGAAAAAAATTCTA,10,30,14,27,27,36,27,44,27,33,33,36,41,44,21.38,0.0
hek293t,13049,1,8,GCGTGGTTGTGATTGTTTGTGTCTGAGGCTGGAAGGCTGCCACTTTCCTTCCTTTTGTTCTGCTTCCTTTGCAAAAAAATTCTAGTTGGTTTAACGCGT,GCGTGGTTGTGATTGTTTGTGTCTGAGGCTGGAGTTCATCAAGGCTGCCACTTTCCTTCCTTTTGTTCTGCTTCCTTTGCAAAAAAATTCTAGTTGGTT,10,30,14,27,27,43,27,51,27,33,33,43,41,51,21.38,4.340977374
hek293t,13051,1,14,TGGGTGCAGCCTGATCTACATAAGCTACATGGAGGTGCCTCTTAAGCAACAGCAGAGCCAGACAAGACAAAAAAATTCTAGTTGGTTTAACGCGTAACT,TGGGTGCAGCCTGATCTACATAAGCTACATTAACGCTTTAATAGGGAGGTGCCTCTTAAGCAACAGCAGAGCCAGACAAGACAAAAAAATTCTAGTTGG,10,30,14,27,27,41,27,55,27,31,31,41,45,55,60.39,2.567301491
hek293t,13051,1,14,CTAGGGCAGCCTGATCTACATAAGCTACATGGAGGTGCCTCTTAAGCAACAGCAGAGCCAGACAAGACCAGAAAAAAATTCTAGTTGGTTTAACGCGTA,CTAGGGCAGCCTGATCTACATAAGCTACATTAACGCTTTAATAGGGAGGTGCCTCTTAAGCAACAGCAGAGCCAGACAAGACCAGAAAAAAATTCTAGT,10,30,14,27,27,38,27,52,27,31,31,38,45,52,60.39,0.558390788
hek293t,13053,1,11,TGTTGGATTGTCCTTCTTGAAAGGAGAAGAGGTCCATAACTGGGCCTGCTGCCTATCAAGAAGCCATATAGCCTAAAAAAAAATTCTAGTTGGTTTAAC,TGTTGGATTGTCCTTCTTGAAAGGAGAAGAGGCAGGCATTTTGTCCATAACTGGGCCTGCTGCCTATCAAGAAGCCATATAGCCTAAAAAAAAATTCTA,10,30,14,27,27,36,27,47,27,33,33,36,44,47,37.37,0.321285141
hek293t,13053,1,11,TAATTGATTGTCCTTCTTGAAAGGAGAAGAGGTCCATAACTGGGCCTGCTGCCTATCAAGAAGCAAAAAAATTCTAGTTGGTTTAACGCGTAACTAGAT,TAATTGATTGTCCTTCTTGAAAGGAGAAGAGGCAGGCATTTTGTCCATAACTGGGCCTGCTGCCTATCAAGAAGCAAAAAAATTCTAGTTGGTTTAACG,10,30,14,27,27,48,27,59,27,33,33,48,44,59,37.37,17.80048234
hek293t,13055,1,7,GGAATTGAGATGCCCCCCCAAATAAGGCCTGGAGGTTCCAGGCCTATATCCAGGAATACAACATTAAAAAAATTCTAGTTGGTTTAACGCGTAACTAGA,GGAATTGAGATGCCCCCCCAAATAAGGCCTGGAGGTCGGCATTTCCAGGCCTATATCCAGGAATACAACATTAAAAAAATTCTAGTTGGTTTAACGCGT,10,30,14,27,27,51,27,58,27,36,36,51,43,58,41.42,0.250958719
hek293t,13057,1,4,CGGAAACTACTGATTTATAGAGTCTCAAAAGGTGAGTTGCCAGGTTCCTGTATCTTGAAGGGACTTAAAAAAATTCTAGTTGGTTTAACGCGTAACTAG,CGGAAACTACTGATTTATAGAGTCTCAAAAGGTGAGTTCCATGCCAGGTTCCTGTATCTTGAAGGGACTTAAAAAAATTCTAGTTGGTTTAACGCGTAA,10,30,14,27,27,53,27,57,27,38,38,53,42,57,19.04,8.336607028
hek293t,13057,1,4,GTAACACTACTGATTTATAGAGTCTCAAAAGGTGAGTTGCCAGGTTCCTGTATCTTGAAGGGACTTGAACATTTAAAAAAATTCTAGTTGGTTTAACGC,GTAACACTACTGATTTATAGAGTCTCAAAAGGTGAGTTCCATGCCAGGTTCCTGTATCTTGAAGGGACTTGAACATTTAAAAAAATTCTAGTTGGTTTA,10,30,14,27,27,45,27,49,27,38,38,45,42,49,19.04,1.970066584
hek293t,13059,1,2,TACTACCCAAAAGATTTGTGAACTGTCACTGGAGCATGTATAACCCTGACCTACAATAAGCCAATCAAAAAAATTCTAGTTGGTTTAACGCGTAACTAG,TACTACCCAAAAGATTTGTGAACTGTCACTGGAGCATGTCCATAACCCTGACCTACAATAAGCCAATCAAAAAAATTCTAGTTGGTTTAACGCGTAACT,10,30,14,27,27,55,27,57,27,40,40,55,42,57,24.52,80.37481106
hek293t,13061,1,2,TTATGCAGGCATGGTGCTAATACAGCACCTGGCAACTACATCAGTACTTTTTGTAGAACTGAAGATGGTTCATTAAAAAAATTCTAGTTGGTTTAACGC,TTATGCAGGCATGGTGCTAATACAGCACCTGTTGCAACTACATCAGTACTTTTTGTAGAACTGAAGATGGTTCATTAAAAAAATTCTAGTTGGTTTAAC,10,30,14,27,27,47,27,49,27,32,32,47,34,49,62.07,75.5830509
hek293t,13061,1,2,CTATGCAGGCATGGTGCTAATACAGCACCTGGCAACTACATCAGTACTTTTTGTAGAACTGAAGATGGTTCATTATGGCAATAAAGAAAAAAATTCTAG,CTATGCAGGCATGGTGCTAATACAGCACCTGTTGCAACTACATCAGTACTTTTTGTAGAACTGAAGATGGTTCATTATGGCAATAAAGAAAAAAATTCT,10,30,14,27,27,35,27,37,27,32,32,35,34,37,62.07,0.79851627
hek293t,13063,1,5,TCGGATGTTTCCGTTATGCTAATCTACTAAGGATGACAAGAAAAATTGAGCCCCCCCGAACTTTTCCGATGCAGAAATCAACTAAAAAAATTCTAGTTG,TCGGATGTTTCCGTTATGCTAATCTACTAAGTCCGGGATGACAAGAAAAATTGAGCCCCCCCGAACTTTTCCGATGCAGAAATCAACTAAAAAAATTCT,10,30,14,27,27,35,27,40,27,32,32,35,37,40,35.26,0.0
hek293t,13063,1,5,CGTAATGTTTCCGTTATGCTAATCTACTAAGGATGACAAGAAAAATTGAGCCCCCCCGAACTTTTCCGATGAAAAAAATTCTAGTTGGTTTAACGCGTA,CGTAATGTTTCCGTTATGCTAATCTACTAAGTCCGGGATGACAAGAAAAATTGAGCCCCCCCGAACTTTTCCGATGAAAAAAATTCTAGTTGGTTTAAC,10,30,14,27,27,47,27,52,27,32,32,47,37,52,35.26,0.0
hek293t,13065,1,9,GTGAAGTTTATCTTAGCTTCTGAACATTTTGGTGGAATATTATGCTATCCACATTTATTCTCAAAGCCTTTTGCGGTTTGAAAAAAATTCTAGTTGGTT,GTGAAGTTTATCTTAGCTTCTGAACATTTACAACATTTTGGTGGAATATTATGCTATCCACATTTATTCTCAAAGCCTTTTGCGGTTTGAAAAAAATTC,10,30,14,27,27,34,27,43,27,27,27,34,36,43,5.93,12.07366009
hek293t,13065,1,9,TGGTTGTTTATCTTAGCTTCTGAACATTTTGGTGGAATATTATGCTATCCACATTTATTCTCAAAGCCTTTTGCGGTAAAAAAATTCTAGTTGGTTTAA,TGGTTGTTTATCTTAGCTTCTGAACATTTACAACATTTTGGTGGAATATTATGCTATCCACATTTATTCTCAAAGCCTTTTGCGGTAAAAAAATTCTAG,10,30,14,27,27,37,27,46,27,27,27,37,36,46,5.93,23.18689672
hek293t,13067,1,5,TTGGAAATATCTTAATTTACCAGTCCCTTTGGCTTCTTTTCCAAATAATGTCTAATGATGTTTCACAAGAAGCCCAAAAAATACGAAAAAAATTCTAGT,TTGGAAATATCTTAATTTACCAGTCCCTTACTGATGGCTTCTTTTCCAAATAATGTCTAATGATGTTTCACAAGAAGCCCAAAAAATACGAAAAAAATT,10,30,14,27,27,33,27,38,27,30,30,33,35,38,14.93,0.028105677
hek293t,13067,1,5,CCGCGAATATCTTAATTTACCAGTCCCTTTGGCTTCTTTTCCAAATAATGTCTAATGATGTTTCACAAGAAGCAAAAAAATTCTAGTTGGTTTAACGCG,CCGCGAATATCTTAATTTACCAGTCCCTTACTGATGGCTTCTTTTCCAAATAATGTCTAATGATGTTTCACAAGAAGCAAAAAAATTCTAGTTGGTTTA,10,30,14,27,27,45,27,50,27,30,30,45,35,50,14.93,49.65827651
hek293t,13069,1,15,AATATCTCAATAATGGTACTAATAGGTTCTGGCTCCTCCATTTTCATTAAACTTATAGGAATTTGAAAAAAATTCTAGTTGGTTTAACGCGTAACTAGA,AATATCTCAATAATGGTACTAATAGGTTCTGGCTCCTTTCTCCCACGAATCTCCATTTTCATTAAACTTATAGGAATTTGAAAAAAATTCTAGTTGGTT,10,30,14,27,27,43,27,58,27,36,36,43,51,58,49.21,0.0
hek293t,13070,1,12,ACGTTCATGGCTGGTGGCTGGTTTTTGGAAGGACAAGTAGTCACTAGATGCTGGTTCGATCCTACAGATTCCTTAAAAAAATTCTAGTTGGTTTAACGC,ACGTTCATGGCTGGTGGCTGGTTTTTTCTAACAGGGCAGGAAGGACAAGTAGTCACTAGATGCTGGTTCGATCCTACAGATTCCTTAAAAAAATTCTAG,10,30,14,27,27,37,27,49,27,27,27,37,39,49,46.79,15.03150033
hek293t,13070,1,12,CAACCCATGGCTGGTGGCTGGTTTTTGGAAGGACAAGTAGTCACTAGATGCTGGTTCGATCCTACAGATAAAAAAATTCTAGTTGGTTTAACGCGTAAC,CAACCCATGGCTGGTGGCTGGTTTTTTCTAACAGGGCAGGAAGGACAAGTAGTCACTAGATGCTGGTTCGATCCTACAGATAAAAAAATTCTAGTTGGT,10,30,14,27,27,42,27,54,27,27,27,42,39,54,46.79,10.30779984
hek293t,13072,1,8,CCGTAGAGAACACCCTCCAGAACATCATGAGGTAGAAGTACTTCTCTTGAGACAGTTGTACGCCAGACTTGGAAAAAAATTCTAGTTGGTTTAACGCGT,CCGTAGAGAACACCCTCCAGAACATCATGAGGTAGAAGTTAGCCTGCACTTCTCTTGAGACAGTTGTACGCCAGACTTGGAAAAAAATTCTAGTTGGTT,10,30,14,27,27,43,27,51,27,40,40,43,48,51,66.04,0.795228628
hek293t,13072,1,8,ACGCCGAGAACACCCTCCAGAACATCATGAGGTAGAAGTACTTCTCTTGAGACAGTTGTACGCCAGACAAAAAAATTCTAGTTGGTTTAACGCGTAACT,ACGCCGAGAACACCCTCCAGAACATCATGAGGTAGAAGTTAGCCTGCACTTCTCTTGAGACAGTTGTACGCCAGACAAAAAAATTCTAGTTGGTTTAAC,10,30,14,27,27,47,27,55,27,40,40,47,48,55,66.04,1.364537344
hek293t,13074,1,6,CAACGCCTTTAAACACACACACAGTAGAGTGGCACTGACCGTTCCGGACCGCCGCGGCTGCTATTCAGGAAACAAAAAAATTCTAGTTGGTTTAACGCG,CAACGCCTTTAAACACACACACAGTAGAGTGGCACTGACCGTCGACGTTCCGGACCGCCGCGGCTGCTATTCAGGAAACAAAAAAATTCTAGTTGGTTT,10,30,14,27,27,44,27,50,27,41,41,44,47,50,64.74,0.0
hek293t,13074,1,6,CGATGCCTTTAAACACACACACAGTAGAGTGGCACTGACCGTTCCGGACCGCCGCGGCTGCTATTCAAAAAAATTCTAGTTGGTTTAACGCGTAACTAG,CGATGCCTTTAAACACACACACAGTAGAGTGGCACTGACCGTCGACGTTCCGGACCGCCGCGGCTGCTATTCAAAAAAATTCTAGTTGGTTTAACGCGT,10,30,14,27,27,51,27,57,27,41,41,51,47,57,64.74,3.655829743
hek293t,13078,1,3,CGGTGCTGCCACACGACAGAGCAGGAGTGAGGAAGCTGGGTGCTGCTCTGCACACAGGGCCCGCAGCCTCAAAAAAATTCTAGTTGGTTTAACGCGTAA,CGGTGCTGCCACACGACAGAGCAGGAGTGAGGAAGACGCTGGGTGCTGCTCTGCACACAGGGCCCGCAGCCTCAAAAAAATTCTAGTTGGTTTAACGCG,10,30,14,27,27,50,27,53,27,35,35,50,38,53,66.88,86.06649739
hek293t,13078,1,3,ATCGACTGCCACACGACAGAGCAGGAGTGAGGAAGCTGGGTGCTGCTCTGCACACAGGGCCCGCAGCCTCTCTGCTGCAAAAAAATTCTAGTTGGTTTA,ATCGACTGCCACACGACAGAGCAGGAGTGAGGAAGACGCTGGGTGCTGCTCTGCACACAGGGCCCGCAGCCTCTCTGCTGCAAAAAAATTCTAGTTGGT,10,30,14,27,27,42,27,45,27,35,35,42,38,45,66.88,77.57464226
hek293t,13080,1,3,GAGAAGAAAAGATGGGAATTTTTTCTGGCAGGGTTCTTTGCTGGTTGGTTTGCCCCCCCAATATAAGACCAAAAAAATTCTAGTTGGTTTAACGCGTAA,GAGAAGAAAAGATGGGAATTTTTTCTGGCAGGGTACCTCTTTGCTGGTTGGTTTGCCCCCCCAATATAAGACCAAAAAAATTCTAGTTGGTTTAACGCG,10,30,14,27,27,50,27,53,27,35,35,50,38,53,8.23,0.463402548
hek293t,13084,1,3,TATCACACACGAGGATGCAAGTGGCAGACTGGAAGGACGTTGATAACCAAACCTGAGGCCAGGATTCAGCAAGGAAAAAAATTCTAGTTGGTTTAACGC,TATCACACACGAGGATGCAAGTGGCAGACTGGAAGGACCGGGTTGATAACCAAACCTGAGGCCAGGATTCAGCAAGGAAAAAAATTCTAGTTGGTTTAA,10,30,14,27,27,46,27,49,27,39,39,46,42,49,40.78,79.3322375
hek293t,13084,1,3,GACGGCACACGAGGATGCAAGTGGCAGACTGGAAGGACGTTGATAACCAAACCTGAGGCCAGGATTCAGCAAGGGACCAAAAAAATTCTAGTTGGTTTA,GACGGCACACGAGGATGCAAGTGGCAGACTGGAAGGACCGGGTTGATAACCAAACCTGAGGCCAGGATTCAGCAAGGGACCAAAAAAATTCTAGTTGGT,10,30,14,27,27,42,27,45,27,39,39,42,42,45,40.78,3.062803198
hek293t,13086,1,13,TGGCAAGAGTGGGCACAGAAACAAGATGAAGGATTTGCATCTTCCAGATGAAGTCCCTGAATTTTGTAAAAAAATTCTAGTTGGTTTAACGCGTAACTA,TGGCAAGAGTGGGCACAGAAACAAGATGGCTTTAAATAAAGAAGGATTTGCATCTTCCAGATGAAGTCCCTGAATTTTGTAAAAAAATTCTAGTTGGTT,10,30,14,27,27,43,27,56,27,28,28,43,41,56,68.54,0.960401693
hek293t,13086,1,13,AGAACAGAGTGGGCACAGAAACAAGATGAAGGATTTGCATCTTCCAGATGAAGTCCCTGAATTTTGTCCCCCCCTTTGCAAAAAAATTCTAGTTGGTTT,AGAACAGAGTGGGCACAGAAACAAGATGGCTTTAAATAAAGAAGGATTTGCATCTTCCAGATGAAGTCCCTGAATTTTGTCCCCCCCTTTGCAAAAAAA,10,30,14,27,27,31,27,44,27,28,28,31,41,44,68.54,0.0
hek293t,13089,1,10,TGAACGTTGATTCAGCTTGTGGTCAGCACAGGCATCCCTCCTTGAAGCTCTGAGTAAAGACAGTGGTAAAAAAATTCTAGTTGGTTTAACGCGTAACTA,TGAACGTTGATTCAGCTTGTGGTCAGCACAGGCATGGTTGGGCTTCCCTCCTTGAAGCTCTGAGTAAAGACAGTGGTAAAAAAATTCTAGTTGGTTTAA,10,30,14,27,27,46,27,56,27,36,36,46,46,56,52.54,8.109109925
hek293t,13089,1,10,GAGTCGTTGATTCAGCTTGTGGTCAGCACAGGCATCCCTCCTTGAAGCTCTGAGTAAAGACAGTGGTTGATTCAAAAAAAATTCTAGTTGGTTTAACGC,GAGTCGTTGATTCAGCTTGTGGTCAGCACAGGCATGGTTGGGCTTCCCTCCTTGAAGCTCTGAGTAAAGACAGTGGTTGATTCAAAAAAAATTCTAGTT,10,30,14,27,27,39,27,49,27,36,36,39,46,49,52.54,0.671351409
hek293t,13091,1,7,TCCGAGTAACCCTCTTCAGGTCTGGGGGACGGATCAGTAGAAGCCCCTCTGCACCTCCTGAAAGGGACGCCACACAGGTATTGTAAAAAAATTCTAGTT,TCCGAGTAACCCTCTTCAGGTCTGGGGGTTGGTAGACGGATCAGTAGAAGCCCCTCTGCACCTCCTGAAAGGGACGCCACACAGGTATTGTAAAAAAAT,10,30,14,27,27,32,27,39,27,29,29,32,36,39,27.08,0.0
hek293t,13091,1,7,GCACAGTAACCCTCTTCAGGTCTGGGGGACGGATCAGTAGAAGCCCCTCTGCACCTCCTGAAAGGGACGCCAAAAAAAATTCTAGTTGGTTTAACGCGT,GCACAGTAACCCTCTTCAGGTCTGGGGGTTGGTAGACGGATCAGTAGAAGCCCCTCTGCACCTCCTGAAAGGGACGCCAAAAAAAATTCTAGTTGGTTT,10,30,14,27,27,44,27,51,27,29,29,44,36,51,27.08,49.95364176
hek293t,13093,1,11,CAACGACCTAAAATGACACACTGCACGGGAGGTGCCCCCCCCCTGTAGGATCTTTGTTGAAAGAAAATTAAAAAAATTCTAGTTGGTTTAACGCGTAAC,CAACGACCTAAAATGACACACTGCACGGGAGGTGCCCCCCACAATTTCTTCCCCTGTAGGATCTTTGTTGAAAGAAAATTAAAAAAATTCTAGTTGGTT,10,30,14,27,27,43,27,54,27,40,40,43,51,54,54.21,0.643500644
hek293t,13094,1,5,TGAGCAAAATCCGGTGGAGATGTTTTCATAGGTGTGATGTTCTACTGCCTGCCACTGTGACATCCCACTCGACTAAGTGCATCCTAAAAAAATTCTAGT,TGAGCAAAATCCGGTGGAGATGTTTTCATAAAAAAGGTGTGATGTTCTACTGCCTGCCACTGTGACATCCCACTCGACTAAGTGCATCCTAAAAAAATT,10,30,14,27,27,33,27,38,27,30,30,33,35,38,25.95,0.0
hek293t,13094,1,5,TTGCTAAAATCCGGTGGAGATGTTTTCATAGGTGTGATGTTCTACTGCCTGCCACTGTGACATCCCACTCGACTAAGTGCAAAAAAAATTCTAGTTGGT,TTGCTAAAATCCGGTGGAGATGTTTTCATAAAAAAGGTGTGATGTTCTACTGCCTGCCACTGTGACATCCCACTCGACTAAGTGCAAAAAAAATTCTAG,10,30,14,27,27,37,27,42,27,30,30,37,35,42,25.95,0.0
hek293t,13096,1,5,CAAACTCAGAGCATTTTTGGCATTGAGTTAGGAGCATATATGGAGTTAACTCTGAATATATGAAAAATAGAGAGGTAAAAAAAAATTCTAGTTGGTTTA,CAAACTCAGAGCATTTTTGGCATTGAGTTAGGGTCAAAGCATATATGGAGTTAACTCTGAATATATGAAAAATAGAGAGGTAAAAAAAAATTCTAGTTG,10,30,14,27,27,40,27,45,27,33,33,40,38,45,10.04,18.69897536
hek293t,13096,1,5,CTGAATCAGAGCATTTTTGGCATTGAGTTAGGAGCATATATGGAGTTAACTCTGAATATATGAAAAATAGAGAGGAAAAAAATTCTAGTTGGTTTAACG,CTGAATCAGAGCATTTTTGGCATTGAGTTAGGGTCAAAGCATATATGGAGTTAACTCTGAATATATGAAAAATAGAGAGGAAAAAAATTCTAGTTGGTT,10,30,14,27,27,43,27,48,27,33,33,43,38,48,10.04,24.06636833
hek293t,13098,1,6,TTAAGCTAAAGAGGATTTTCCATTTGTGGAGGGTAGGGTACATTCTGATCAAGTCTATCCAGAACTTGATCACAAAAAAATTCTAGTTGGTTTAACGCG,TTAAGCTAAAGAGGATTTTCCATTTGTGGAACCCGAGGGTAGGGTACATTCTGATCAAGTCTATCCAGAACTTGATCACAAAAAAATTCTAGTTGGTTT,10,30,14,27,27,44,27,50,27,29,29,44,35,50,45.14,46.27592319
hek293t,13098,1,6,AGTGCCTAAAGAGGATTTTCCATTTGTGGAGGGTAGGGTACATTCTGATCAAGTCTATCCAGAACTTGATCACATGATTTTAAAAAAATTCTAGTTGGT,AGTGCCTAAAGAGGATTTTCCATTTGTGGAACCCGAGGGTAGGGTACATTCTGATCAAGTCTATCCAGAACTTGATCACATGATTTTAAAAAAATTCTA,10,30,14,27,27,36,27,42,27,29,29,36,35,42,45.14,61.85967629
hek293t,13100,1,11,CGCCAGTCCAGGGAAGAGATGCTGAGCTCAGGTGGAGACATGTAAGCCCACTTGCATCTGTAACCTCTTCAAAAAGGTGATAAAAAAATTCTAGTTGGT,CGCCAGTCCAGGGAAGAGATGCTGAGCCTCGTCATATATCAGGTGGAGACATGTAAGCCCACTTGCATCTGTAACCTCTTCAAAAAGGTGATAAAAAAA,10,30,14,27,27,31,27,42,27,28,28,31,39,42,68.0,1.22113973
hek293t,13104,1,3,TTGCGTCAGTCATCAGTAACTCCAAGAGCAGGGAAGCCCTGGGAAGCTTTCACTCTACTCCGTTTATCTTTCCATTAAAAAAATTCTAGTTGGTTTAAC,TTGCGTCAGTCATCAGTAACTCCAAGAGCAGGGAAGCCCTAAGGGGAAGCTTTCACTCTACTCCGTTTATCTTTCCATTAAAAAAATTCTAGTTGGTTT,10,30,14,27,27,44,27,47,27,41,41,44,44,47,55.09,3.905979475
hek293t,13104,1,3,GTGAATCAGTCATCAGTAACTCCAAGAGCAGGGAAGCCCTGGGAAGCTTTCACTCTACTCCGTTAAAAAAATTCTAGTTGGTTTAACGCGTAACTAGAT,GTGAATCAGTCATCAGTAACTCCAAGAGCAGGGAAGCCCTAAGGGGAAGCTTTCACTCTACTCCGTTAAAAAAATTCTAGTTGGTTTAACGCGTAACTA,10,30,14,27,27,56,27,59,27,41,41,56,44,59,55.09,78.90951281
hek293t,13106,1,3,GATGGCTACTAAGTAAGGGGAAATCAACATGGGTAGCTGGGCTCCCCACGACGTGATTCTCCAGCATAATTAAAAAAAAAATTCTAGTTGGTTTAACGC,GATGGCTACTAAGTAAGGGGAAATCAACATGGGTACCTGCTGGGCTCCCCACGACGTGATTCTCCAGCATAATTAAAAAAAAAATTCTAGTTGGTTTAA,10,30,14,27,27,46,27,49,27,36,36,46,39,49,54.04,66.24748609
hek293t,13106,1,3,TCTAGCTACTAAGTAAGGGGAAATCAACATGGGTAGCTGGGCTCCCCACGACGTGATTCTCCAGCATAATTAAACCTTCACAAAAAAATTCTAGTTGGT,TCTAGCTACTAAGTAAGGGGAAATCAACATGGGTACCTGCTGGGCTCCCCACGACGTGATTCTCCAGCATAATTAAACCTTCACAAAAAAATTCTAGTT,10,30,14,27,27,39,27,42,27,36,36,39,39,42,54.04,3.366791161
hek293t,13108,1,13,TCGGCTGGCTCAGCCTAACATCAGCAAGCAGGAACCTAACAGCTAGAAATAAGACTTTCGGAACCACAGAAAAAAATTCTAGTTGGTTTAACGCGTAAC,TCGGCTGGCTCAGCCTAACATCAGCAAGCAGGAACCTCAGCCGCTCGGACAACAGCTAGAAATAAGACTTTCGGAACCACAGAAAAAAATTCTAGTTGG,10,30,14,27,27,41,27,54,27,38,38,41,51,54,51.65,0.919284781
hek293t,13109,1,15,CCATGGACCTATTTCAGCCCGCTACCGGGGGGTCTCCAAGGAGACCACTATAAAGTAGGGACCTTCCGAGCCCCTGGAAAAAAATTCTAGTTGGTTTAA,CCATGGACCTATTTCAGCCCGCTACCGCTACTAGACTTGAGCGGGGGTCTCCAAGGAGACCACTATAAAGTAGGGACCTTCCGAGCCCCTGGAAAAAAA,10,30,14,27,27,31,27,46,27,28,28,31,43,46,63.95,0.0
hek293t,13109,1,15,TTCAGGACCTATTTCAGCCCGCTACCGGGGGGTCTCCAAGGAGACCACTATAAAGTAGGGACCTTCCGAGAAAAAAATTCTAGTTGGTTTAACGCGTAA,TTCAGGACCTATTTCAGCCCGCTACCGCTACTAGACTTGAGCGGGGGTCTCCAAGGAGACCACTATAAAGTAGGGACCTTCCGAGAAAAAAATTCTAGT,10,30,14,27,27,38,27,53,27,28,28,38,43,53,63.95,43.83835776
hek293t,13111,1,7,GCCGCGGGATAATGTAACCTTGCAGAAGGCGGAGGGCAAAACATGAGAACTGTAAAACTATTTTTAAAAAAAAAATTCTAGTTGGTTTAACGCGTAACT,GCCGCGGGATAATGTAACCTTGCAGAAGGCGGAGGGCGTCCAAGAAAACATGAGAACTGTAAAACTATTTTTAAAAAAAAAATTCTAGTTGGTTTAACG,10,30,14,27,27,48,27,55,27,38,38,48,45,55,49.25,0.915224778
hek293t,13111,1,7,TTTCAGGGATAATGTAACCTTGCAGAAGGCGGAGGGCAAAACATGAGAACTGTAAAACTATTTTTAAAATGAAAAAAATTCTAGTTGGTTTAACGCGTA,TTTCAGGGATAATGTAACCTTGCAGAAGGCGGAGGGCGTCCAAGAAAACATGAGAACTGTAAAACTATTTTTAAAATGAAAAAAATTCTAGTTGGTTTA,10,30,14,27,27,45,27,52,27,38,38,45,45,52,49.25,2.5259126
hek293t,13113,1,1,CTCACTTAGCTTATGCTCTTTCAATTAGTAGGACAAATTTCTTGTATTGCTCATTTACTGGCTTATTTTCTGCTGCACAAAAAAATTCTAGTTGGTTTA,CTCACTTAGCTTATGCTCTTTCAATTAGTAGGAACAAATTTCTTGTATTGCTCATTTACTGGCTTATTTTCTGCTGCACAAAAAAATTCTAGTTGGTTT,10,30,14,27,27,44,27,45,27,34,34,44,35,45,8.75,66.38023658
hek293t,13113,1,1,GGGGGTTAGCTTATGCTCTTTCAATTAGTAGGACAAATTTCTTGTATTGCTCATTTACTGGCTTATTTTCTGCAAAAAAATTCTAGTTGGTTTAACGCG,GGGGGTTAGCTTATGCTCTTTCAATTAGTAGGAACAAATTTCTTGTATTGCTCATTTACTGGCTTATTTTCTGCAAAAAAATTCTAGTTGGTTTAACGC,10,30,14,27,27,49,27,50,27,34,34,49,35,50,8.75,64.55345472
hek293t,13115,1,5,TGTAGGGATAATAATATATTAAAGGTAATAGGAGGGAGGAAGGAAAGAGGGAGGGTTTCACTCAATCACCTTCAAAAAAAAATTCTAGTTGGTTTAACG,TGTAGGGATAATAATATATTAAAGGTAGCGCTATAGGAGGGAGGAAGGAAAGAGGGAGGGTTTCACTCAATCACCTTCAAAAAAAAATTCTAGTTGGTT,10,30,14,27,27,43,27,48,27,28,28,43,33,48,3.67,3.505235247
hek293t,13115,1,5,CGGCAGGATAATAATATATTAAAGGTAATAGGAGGGAGGAAGGAAAGAGGGAGGGTTTCACTCAATCACCTTCAAAGATCATTAAAAAAATTCTAGTTG,CGGCAGGATAATAATATATTAAAGGTAGCGCTATAGGAGGGAGGAAGGAAAGAGGGAGGGTTTCACTCAATCACCTTCAAAGATCATTAAAAAAATTCT,10,30,14,27,27,35,27,40,27,28,28,35,33,40,3.67,6.68963117
hek293t,13117,1,2,AACACAAACAGCAGAGTAAGTAAAAAGATAGGAAAATGAAGCTCTGGCGTATTAAACCTAAAGCTATATAAAGACTGGAAAAAAAATTCTAGTTGGTTT,AACACAAACAGCAGAGTAAGTAAAAAAAGATAGGAAAATGAAGCTCTGGCGTATTAAACCTAAAGCTATATAAAGACTGGAAAAAAAATTCTAGTTGGT,10,30,14,27,27,42,27,44,27,27,27,42,29,44,51.15,0.0
hek293t,13117,1,2,TTGTCAAACAGCAGAGTAAGTAAAAAGATAGGAAAATGAAGCTCTGGCGTATTAAACCTAAAGCTATATAAAGACTGGATAAAAATATTTTAAAAAAAT,TTGTCAAACAGCAGAGTAAGTAAAAAAAGATAGGAAAATGAAGCTCTGGCGTATTAAACCTAAAGCTATATAAAGACTGGATAAAAATATTTTAAAAAA,10,30,14,27,27,30,27,32,27,27,27,30,29,32,51.15,0.0
hek293t,13119,1,3,CCTGTAACCATGCTATAGTCTTACAAAAATGGAAGAGTGGCTTTCCAGCTAAGTTGCCACTGATTCTTTAAAAAAATTCTAGTTGGTTTAACGCGTAAC,CCTGTAACCATGCTATAGTCTTACAAAAATGGAAGTCAAGTGGCTTTCCAGCTAAGTTGCCACTGATTCTTTAAAAAAATTCTAGTTGGTTTAACGCGT,10,30,14,27,27,51,27,54,27,36,36,51,39,54,17.88,7.043200186
hek293t,13119,1,3,AGGATAACCATGCTATAGTCTTACAAAAATGGAAGAGTGGCTTTCCAGCTAAGTTGCCACTGATTCTTTGATTTGATTTTGAAAAAAATTCTAGTTGGT,AGGATAACCATGCTATAGTCTTACAAAAATGGAAGTCAAGTGGCTTTCCAGCTAAGTTGCCACTGATTCTTTGATTTGATTTTGAAAAAAATTCTAGTT,10,30,14,27,27,39,27,42,27,36,36,39,39,42,17.88,0.0
hek293t,13123,1,7,GTTCGCTGATAAAAGATAAAACTTACTAATGGCATCATGTTTTATCTTTTCCCAGGAGAACATTTAAAACAAAAGTTTCTAAAAAAATTCTAGTTGGTT,GTTCGCTGATAAAAGATAAAACTTACTAATGGATACGCTCATCATGTTTTATCTTTTCCCAGGAGAACATTTAAAACAAAAGTTTCTAAAAAAATTCTA,10,30,14,27,27,36,27,43,27,33,33,36,40,43,31.75,0.0
hek293t,13123,1,7,GCGGGCTGATAAAAGATAAAACTTACTAATGGCATCATGTTTTATCTTTTCCCAGGAGAACATTTAAAACAAAAGTAAAAAAATTCTAGTTGGTTTAAC,GCGGGCTGATAAAAGATAAAACTTACTAATGGATACGCTCATCATGTTTTATCTTTTCCCAGGAGAACATTTAAAACAAAAGTAAAAAAATTCTAGTTG,10,30,14,27,27,40,27,47,27,33,33,40,40,47,31.75,0.0
hek293t,13127,1,8,CGGACCAAAAGAGGATCTGGCACCTGCAGAGGTCATCAAGCCTGAGAGAAAACTTTCTCAGTGTGCACGGCAAAAAAAATTCTAGTTGGTTTAACGCGT,CGGACCAAAAGAGGATCTGGCACCTGCAGAGGTCATCAAAAACATCTGCCTGAGAGAAAACTTTCTCAGTGTGCACGGCAAAAAAAATTCTAGTTGGTT,10,30,14,27,27,43,27,51,27,40,40,43,48,51,49.02,0.0
hek293t,13128,1,11,TAGTTTCTAATGGAAGAACCATTCTTACAAGGATGGAAGTATGAAACTTCCTTAGCTTTCCTGTTGCAAAAAAAATTCTAGTTGGTTTAACGCGTAACT,TAGTTTCTAATGGAAGAACCATTCTTACCTGAAAGGGCTAAGGATGGAAGTATGAAACTTCCTTAGCTTTCCTGTTGCAAAAAAAATTCTAGTTGGTTT,10,30,14,27,27,44,27,55,27,29,29,44,40,55,29.09,1.095158797
hek293t,13128,1,11,CTAGCTCTAATGGAAGAACCATTCTTACAAGGATGGAAGTATGAAACTTCCTTAGCTTTCCTGTTGCAAAGAAGATTAAAAAAAAAATTCTAGTTGGTT,CTAGCTCTAATGGAAGAACCATTCTTACCTGAAAGGGCTAAGGATGGAAGTATGAAACTTCCTTAGCTTTCCTGTTGCAAAGAAGATTAAAAAAAAAAT,10,30,14,27,27,32,27,43,27,29,29,32,40,43,29.09,0.061500615
hek293t,13130,1,2,TCCTGAAATGATTTTGATTCCCATGAAAGAGGATAACCTCCTAGATTGCAACAGTGAAATGCTGCTACAATATTCTGTGAAAAAAATTCTAGTTGGTTT,TCCTGAAATGATTTTGATTCCCATGAAAGAGGATAACCCATCCTAGATTGCAACAGTGAAATGCTGCTACAATATTCTGTGAAAAAAATTCTAGTTGGT,10,30,14,27,27,42,27,44,27,39,39,42,41,44,38.09,0.868369898
hek293t,13130,1,2,ATCTTAAATGATTTTGATTCCCATGAAAGAGGATAACCTCCTAGATTGCAACAGTGAAATGCTGCTACAATATTCAAAAAAATTCTAGTTGGTTTAACG,ATCTTAAATGATTTTGATTCCCATGAAAGAGGATAACCCATCCTAGATTGCAACAGTGAAATGCTGCTACAATATTCAAAAAAATTCTAGTTGGTTTAA,10,30,14,27,27,46,27,48,27,39,39,46,41,48,38.09,68.90353708
hek293t,13132,1,10,GCTGGAGCTTTTAAGCATAAGGTAACCACTGGCGCATAATTTTGACAAAACAGTGTGGTGTTCCTTTCAGCAAAAAAATTCTAGTTGGTTTAACGCGTA,GCTGGAGCTTTTAAGCATAAGGTAACCACTGTACATGCTTTGCGCATAATTTTGACAAAACAGTGTGGTGTTCCTTTCAGCAAAAAAATTCTAGTTGGT,10,30,14,27,27,42,27,52,27,32,32,42,42,52,58.64,4.045360572
hek293t,13132,1,10,TGATGAGCTTTTAAGCATAAGGTAACCACTGGCGCATAATTTTGACAAAACAGTGTGGTGTTCCTTTCAGCTAGTGATAAAAAAATTCTAGTTGGTTTA,TGATGAGCTTTTAAGCATAAGGTAACCACTGTACATGCTTTGCGCATAATTTTGACAAAACAGTGTGGTGTTCCTTTCAGCTAGTGATAAAAAAATTCT,10,30,14,27,27,35,27,45,27,32,32,35,42,45,58.64,0.0
hek293t,13134,1,7,TCATCTTGTTTGCTCGCCTTTTTACTCGAAGGAAAGCTGCTGTGATAGATGCAATGCAGGGAGAAGTAGGAAGATTTGAAAAAAAATTCTAGTTGGTTT,TCATCTTGTTTGCTCGCCTTTTTACTCGAGTGCGCTAGGAAAGCTGCTGTGATAGATGCAATGCAGGGAGAAGTAGGAAGATTTGAAAAAAAATTCTAG,10,30,14,27,27,37,27,44,27,30,30,37,37,44,7.41,0.081499593
hek293t,13134,1,7,TTCGCTTGTTTGCTCGCCTTTTTACTCGAAGGAAAGCTGCTGTGATAGATGCAATGCAGGGAGAAGTAGGAAGATTTGAGTTGAAAAAAATTCTAGTTG,TTCGCTTGTTTGCTCGCCTTTTTACTCGAGTGCGCTAGGAAAGCTGCTGTGATAGATGCAATGCAGGGAGAAGTAGGAAGATTTGAGTTGAAAAAAATT,10,30,14,27,27,33,27,40,27,30,30,33,37,40,7.41,0.0
hek293t,13136,1,15,ATGCTGCAGAACCAAATTTTAAAAATTAAAGGCTCAATGCTAATTATGATCAATGCATTCCACAAACATCCCCAAAAAAATTCTAGTTGGTTTAACGCG,ATGCTGCAGAACCAAATTTTAAAAATTGTACGTGGGTTAGACAAAGGCTCAATGCTAATTATGATCAATGCATTCCACAAACATCCCCAAAAAAATTCT,10,30,14,27,27,35,27,50,27,28,28,35,43,50,-1.25,0.0
hek293t,13136,1,15,CATATGCAGAACCAAATTTTAAAAATTAAAGGCTCAATGCTAATTATGATCAATGCATTCCACAAACATCCCCATACAAAAAAATTCTAGTTGGTTTAA,CATATGCAGAACCAAATTTTAAAAATTGTACGTGGGTTAGACAAAGGCTCAATGCTAATTATGATCAATGCATTCCACAAACATCCCCATACAAAAAAA,10,30,14,27,27,31,27,46,27,28,28,31,43,46,-1.25,0.0
hek293t,13138,1,9,TCTCAGTATTCTCTGGAAATGCTCTGGTTTGGAGAGATTACTTCAGAGGCACAGTGACCCCCCCCACACAAAGAAAAAAATTCTAGTTGGTTTAACGCG,TCTCAGTATTCTCTGGAAATGCTCTGGTTTGGACAGGCATATGAGATTACTTCAGAGGCACAGTGACCCCCCCCACACAAAGAAAAAAATTCTAGTTGG,10,30,14,27,27,41,27,50,27,34,34,41,43,50,52.14,1.725509594
hek293t,13138,1,9,CAGTTGTATTCTCTGGAAATGCTCTGGTTTGGAGAGATTACTTCAGAGGCACAGTGACCCCCCCCACACAAAAAAAATTCTAGTTGGTTTAACGCGTAA,CAGTTGTATTCTCTGGAAATGCTCTGGTTTGGACAGGCATATGAGATTACTTCAGAGGCACAGTGACCCCCCCCACACAAAAAAAATTCTAGTTGGTTT,10,30,14,27,27,44,27,53,27,34,34,44,43,53,52.14,23.85298398
hek293t,13140,1,2,ACCTGGAAGACTAGAAAGCTTCTTACTCTTGGATATCTGTTGTTCTTACCAAGAATTTGTTAGCTTGTGAAAAAAAAATTCTAGTTGGTTTAACGCGTA,ACCTGGAAGACTAGAAAGCTTCTTACTCTTGGATGGATCTGTTGTTCTTACCAAGAATTTGTTAGCTTGTGAAAAAAAAATTCTAGTTGGTTTAACGCG,10,30,14,27,27,50,27,52,27,35,35,50,37,52,30.98,85.36642575
hek293t,13140,1,2,CCGGAGAAGACTAGAAAGCTTCTTACTCTTGGATATCTGTTGTTCTTACCAAGAATTTGTTAGCTTGTGAATTTCCAAAAAAATTCTAGTTGGTTTAAC,CCGGAGAAGACTAGAAAGCTTCTTACTCTTGGATGGATCTGTTGTTCTTACCAAGAATTTGTTAGCTTGTGAATTTCCAAAAAAATTCTAGTTGGTTTA,10,30,14,27,27,45,27,47,27,35,35,45,37,47,30.98,81.51068621
hek293t,13142,1,7,CTCATGTGTCCCTGCCGCTCCAAGGGGCCAGGATCACACCTGCTCGCTGTCCTCCTGCTGCTCACTCCTACCCAGCAAAAAAATTCTAGTTGGTTTAAC,CTCATGTGTCCCTGCCGCTCCAAGGGGCCCTACCAAAGGATCACACCTGCTCGCTGTCCTCCTGCTGCTCACTCCTACCCAGCAAAAAAATTCTAGTTG,10,30,14,27,27,40,27,47,27,30,30,40,37,47,23.42,28.38558599
hek293t,13144,1,4,AAGTTATACACAACTGTATTCATATTCCTTGGTGATGTTAAACTTTCTGTTGTTGAAGGGGAAGTGCTGGGCTTGCTAAACACATAAAAAAATTCTAGT,AAGTTATACACAACTGTATTCATATTCCTTCGCGGGTGATGTTAAACTTTCTGTTGTTGAAGGGGAAGTGCTGGGCTTGCTAAACACATAAAAAAATTC,10,30,14,27,27,34,27,38,27,31,31,34,35,38,44.15,0.16064257
hek293t,13144,1,4,GAACTATACACAACTGTATTCATATTCCTTGGTGATGTTAAACTTTCTGTTGTTGAAGGGGAAGTGCTGGGCTTGCTAAACAAAAAAATTCTAGTTGGT,GAACTATACACAACTGTATTCATATTCCTTCGCGGGTGATGTTAAACTTTCTGTTGTTGAAGGGGAAGTGCTGGGCTTGCTAAACAAAAAAATTCTAGT,10,30,14,27,27,38,27,42,27,31,31,38,35,42,44.15,36.31021484
hek293t,10089,1,2,ACCGCTTCTGGTTTACGCTGGTATTTTGTAGGCAGGTAGGAACGAACTGCCTGAGTTCTGCTGCAGCCTAATATGAGCTCAAAAAAATTCTAGTTGGTT,ACCGCTTCTGGTTTACGCTGGTATTTTGTAGGCAGGTGGAGGAACGAACTGCCTGAGTTCTGCTGCAGCCTAATATGAGCTCAAAAAAATTCTAGTTGG,10,30,14,27,27,41,27,43,27,38,38,41,40,43,34.51,0.078431373
hek293t,10089,1,2,GCCTGTTCTGGTTTACGCTGGTATTTTGTAGGCAGGTAGGAACGAACTGCCTGAGTTCTGCTGCAGCCAAAAAAATTCTAGTTGGTTTAACGCGTAACT,GCCTGTTCTGGTTTACGCTGGTATTTTGTAGGCAGGTGGAGGAACGAACTGCCTGAGTTCTGCTGCAGCCAAAAAAATTCTAGTTGGTTTAACGCGTAA,10,30,14,27,27,53,27,55,27,38,38,53,40,55,34.51,57.95026442
hek293t,13148,1,8,CCGTCTGATTTTAACAGAACGATTGTTTTAGGTCAAAGAGGGAAACTGGTTATCTCATGAATTTATGATAAAAAAATTCTAGTTGGTTTAACGCGTAAC,CCGTCTGATTTTAACAGAACGATTGTTTTAGGTCAAAGGCTAGACTAGGGAAACTGGTTATCTCATGAATTTATGATAAAAAAATTCTAGTTGGTTTAA,10,30,14,27,27,46,27,54,27,39,39,46,47,54,0.24,0.0
hek293t,13151,1,11,ATGCCCAAGTATTTACCTGCAGTGGCATCTGGAAGGGCTTCAGTGTCACTGTCCTTGACCCCAAACAAAAAAATTCTAGTTGGTTTAACGCGTAACTAG,ATGCCCAAGTATTTACCTGCAGTGGCATCTTTAACTTATGCGGAAGGGCTTCAGTGTCACTGTCCTTGACCCCAAACAAAAAAATTCTAGTTGGTTTAA,10,30,14,27,27,46,27,57,27,31,31,46,42,57,32.44,7.904905854
hek293t,13151,1,11,AATTACAAGTATTTACCTGCAGTGGCATCTGGAAGGGCTTCAGTGTCACTGTCCTTGACCCCAAACTGTATTTCAAAAAAAAAAATTCTAGTTGGTTTA,AATTACAAGTATTTACCTGCAGTGGCATCTTTAACTTATGCGGAAGGGCTTCAGTGTCACTGTCCTTGACCCCAAACTGTATTTCAAAAAAAAAAATTC,10,30,14,27,27,34,27,45,27,31,31,34,42,45,32.44,0.0
hek293t,13153,1,3,TTGAAGGTTAATCTATGACAGGACCAAACAGGAACTACAGAAATCCATATCATGAAATGATGAATCTAAAAAAAAATTCTAGTTGGTTTAACGCGTAAC,TTGAAGGTTAATCTATGACAGGACCAAACAGGAACTACAGCCTAAATCCATATCATGAAATGATGAATCTAAAAAAAAATTCTAGTTGGTTTAACGCGT,10,30,14,27,27,51,27,54,27,41,41,51,44,54,31.42,77.55127639
hek293t,13153,1,3,CTAAGGGTTAATCTATGACAGGACCAAACAGGAACTACAGAAATCCATATCATGAAATGATGAATCTAAGATAAAAAAATTCTAGTTGGTTTAACGCGT,CTAAGGGTTAATCTATGACAGGACCAAACAGGAACTACAGCCTAAATCCATATCATGAAATGATGAATCTAAGATAAAAAAATTCTAGTTGGTTTAACG,10,30,14,27,27,48,27,51,27,41,41,48,44,51,31.42,74.40500229
hek293t,13155,1,14,GGCACTGGGGTTTAGGCAGGATAGTGTTTTGGCCCACTTGCTTACATTAAGAGCTTGATCCTGGGAGATGCTGAGCGCAAAAAAATTCTAGTTGGTTTA,GGCACTGGGGTTTAGGCAGGATAGTGTGGAGGCGACCACATTTTGGCCCACTTGCTTACATTAAGAGCTTGATCCTGGGAGATGCTGAGCGCAAAAAAA,10,30,14,27,27,31,27,45,27,28,28,31,42,45,38.39,3.129996874
hek293t,13155,1,14,TAAACTGGGGTTTAGGCAGGATAGTGTTTTGGCCCACTTGCTTACATTAAGAGCTTGATCCTGGGAGATGCAAAAAAATTCTAGTTGGTTTAACGCGTA,TAAACTGGGGTTTAGGCAGGATAGTGTGGAGGCGACCACATTTTGGCCCACTTGCTTACATTAAGAGCTTGATCCTGGGAGATGCAAAAAAATTCTAGT,10,30,14,27,27,38,27,52,27,28,28,38,42,52,38.39,5.99820175
hek293t,13157,1,10,CTTACCTGAAAAAAGCCCTAGATTTTCCGTGGCTTGGCTGGCGGGCACCACAGGAACCTGAAAATCCTCAGAAAAAAATTCTAGTTGGTTTAACGCGTA,CTTACCTGAAAAAAGCCCTAGATTTTCCGTGGCTTGGCAAGGGCCGTGTGGCGGGCACCACAGGAACCTGAAAATCCTCAGAAAAAAATTCTAGTTGGT,10,30,14,27,27,42,27,52,27,39,39,42,49,52,44.07,0.0
hek293t,13157,1,10,TAGACCTGAAAAAAGCCCTAGATTTTCCGTGGCTTGGCTGGCGGGCACCACAGGAACCTGAAAATCCAAAAAAATTCTAGTTGGTTTAACGCGTAACTA,TAGACCTGAAAAAAGCCCTAGATTTTCCGTGGCTTGGCAAGGGCCGTGTGGCGGGCACCACAGGAACCTGAAAATCCAAAAAAATTCTAGTTGGTTTAA,10,30,14,27,27,46,27,56,27,39,39,46,49,56,44.07,0.48830822
hek293t,13161,1,10,AGGGTCGGCTATTTATAAAGCCTTTAACTTGGTCTCTGATTTACACACCAGATTTCTCAGAGGGCAACTGTCAAACTGATGAAAAAAATTCTAGTTGGT,AGGGTCGGCTATTTATAAAGCCTTTAACGTACACTTAATTGGTCTCTGATTTACACACCAGATTTCTCAGAGGGCAACTGTCAAACTGATGAAAAAAAT,10,30,14,27,27,32,27,42,27,29,29,32,39,42,18.59,0.0
hek293t,2749,1,4,TTCTGTAAAATAATATTTTGAACTTATAATGGTGTGGCGGACAGGACTTTTGCCTTAAACATTTCTTGGTAAAAAAAATTCTAGTTGGTTTAACGCGTA,TTCTGTAAAATAATATTTTGAACTTATAATGGCCAATGTGGCGGACAGGACTTTTGCCTTAAACATTTCTTGGTAAAAAAAATTCTAGTTGGTTTAACG,10,30,14,27,27,48,27,52,27,33,33,48,37,52,-0.08,19.47189199
hek293t,2749,1,4,CCCCCTAAAATAATATTTTGAACTTATAATGGTGTGGCGGACAGGACTTTTGCCTTAAACATTTCTTGGTACATAAAAAAAAATTCTAGTTGGTTTAAC,CCCCCTAAAATAATATTTTGAACTTATAATGGCCAATGTGGCGGACAGGACTTTTGCCTTAAACATTTCTTGGTACATAAAAAAAAATTCTAGTTGGTT,10,30,14,27,27,43,27,47,27,33,33,43,37,47,-0.08,10.74230541
hek293t,13164,1,6,TTGGGCTGTGTTCCTCCTCCAGCTTTGATCGGACAGAATTTCCCATTGCTAGCTCCAGACTCACTAAAAAAATTCTAGTTGGTTTAACGCGTAACTAGA,TTGGGCTGTGTTCCTCCTCCAGCTTTGATCGGACAGCAATAAAATTTCCCATTGCTAGCTCCAGACTCACTAAAAAAATTCTAGTTGGTTTAACGCGTA,10,30,14,27,27,52,27,58,27,37,37,52,43,58,47.28,36.03782526
hek293t,13164,1,6,ATCAACTGTGTTCCTCCTCCAGCTTTGATCGGACAGAATTTCCCATTGCTAGCTCCAGACTCACTGAAGGAAAAAAATTCTAGTTGGTTTAACGCGTAA,ATCAACTGTGTTCCTCCTCCAGCTTTGATCGGACAGCAATAAAATTTCCCATTGCTAGCTCCAGACTCACTGAAGGAAAAAAATTCTAGTTGGTTTAAC,10,30,14,27,27,47,27,53,27,37,37,47,43,53,47.28,14.66925058
hek293t,13166,1,13,TTAGCCCCCCCACAAATTGCTATAAGTGTTGGTCATTGCTATCTATTCTAAAGTTAATAATGGTTACGTTTACAAAAAAAATTCTAGTTGGTTTAACGC,TTAGCCCCCCCACAAATTGCTATAAGTGTTGGATATCAGTCGGTTTCATTGCTATCTATTCTAAAGTTAATAATGGTTACGTTTACAAAAAAAATTCTA,10,30,14,27,27,36,27,49,27,33,33,36,46,49,45.1,0.0
hek293t,13166,1,13,CAGGTCCCCCCACAAATTGCTATAAGTGTTGGTCATTGCTATCTATTCTAAAGTTAATAATGGTTACAAAAAAATTCTAGTTGGTTTAACGCGTAACTA,CAGGTCCCCCCACAAATTGCTATAAGTGTTGGATATCAGTCGGTTTCATTGCTATCTATTCTAAAGTTAATAATGGTTACAAAAAAATTCTAGTTGGTT,10,30,14,27,27,43,27,56,27,33,33,43,46,56,45.1,0.681464245
hek293t,13168,1,15,GCACCTGTGTGGTGCCCGTAACCACTCTGAGGCCACTTCGGCTTTGGCCTGGGCAGGTGGCATAAGAAATAAAAAAAATTCTAGTTGGTTTAACGCGTA,GCACCTGTGTGGTGCCCGTAACCACTCTGAGGCCTCCTACCCCCCGTGCACTTCGGCTTTGGCCTGGGCAGGTGGCATAAGAAATAAAAAAAATTCTAG,10,30,14,27,27,37,27,52,27,34,34,37,49,52,66.29,0.0
hek293t,13169,1,10,CACGAATTTCTTTCAAAGAAAATAAATACTGGGAGCTAATGTTCTCAGGGAATCAGTATGTGGATGTAAAAAAAAAATTCTAGTTGGTTTAACGCGTAA,CACGAATTTCTTTCAAAGAAAATAAATACTGGGAGCTAATTTACCCGCCTGTTCTCAGGGAATCAGTATGTGGATGTAAAAAAAAAATTCTAGTTGGTT,10,30,14,27,27,43,27,53,27,40,40,43,50,53,1.36,0.0
hek293t,13171,1,12,CGTTTTTCAACTTCTTCCCCGGTGCGGGAAGGGCTCTTGGGACCCTTTGTGCCCCAAAACTTTTGGGGAAAAAAATTCTAGTTGGTTTAACGCGTAACT,CGTTTTTCAACTTCTTCCCCGGTGCGGGAAGGTGAGCTGCAGGGGCTCTTGGGACCCTTTGTGCCCCAAAACTTTTGGGGAAAAAAATTCTAGTTGGTT,10,30,14,27,27,43,27,55,27,33,33,43,45,55,38.49,10.70790978
hek293t,13172,1,6,CACAACTGAATGCTTTCTGTTGTCACTTCAGGGCAGGTGGAACCATAACAACTGTGGAACAAAAGGCGCTAAAAAAAAATTCTAGTTGGTTTAACGCGT,CACAACTGAATGCTTTCTGTTGTCACTTCCGCTACAGGGCAGGTGGAACCATAACAACTGTGGAACAAAAGGCGCTAAAAAAAAATTCTAGTTGGTTTA,10,30,14,27,27,45,27,51,27,30,30,45,36,51,9.05,46.50961734
hek293t,13172,1,6,GTCGGCTGAATGCTTTCTGTTGTCACTTCAGGGCAGGTGGAACCATAACAACTGTGGAACAAAAGGCGCTAACCTTTAAAAAAATTCTAGTTGGTTTAA,GTCGGCTGAATGCTTTCTGTTGTCACTTCCGCTACAGGGCAGGTGGAACCATAACAACTGTGGAACAAAAGGCGCTAACCTTTAAAAAAATTCTAGTTG,10,30,14,27,27,40,27,46,27,30,30,40,36,46,9.05,72.72480265
hek293t,13174,1,4,AGGGCAAAACAATCAAACTGGGGAAAACATGGCAACAGAATAAATGTGCAAATAAAGAGAAGGCATTCTGGAAGCAAAAAAAATTCTAGTTGGTTTAAC,AGGGCAAAACAATCAAACTGGGGAAAACATGGGGGCCAACAGAATAAATGTGCAAATAAAGAGAAGGCATTCTGGAAGCAAAAAAAATTCTAGTTGGTT,10,30,14,27,27,43,27,47,27,33,33,43,37,47,36.33,33.29628288
hek293t,13174,1,4,CCGCAAAAACAATCAAACTGGGGAAAACATGGCAACAGAATAAATGTGCAAATAAAGAGAAGGCATTCTGGAAGCAGCCAAAAAAATTCTAGTTGGTTT,CCGCAAAAACAATCAAACTGGGGAAAACATGGGGGCCAACAGAATAAATGTGCAAATAAAGAGAAGGCATTCTGGAAGCAGCCAAAAAAATTCTAGTTG,10,30,14,27,27,40,27,44,27,33,33,40,37,44,36.33,29.34380267
hek293t,13176,1,2,AAGCCTGAAGAAATACATTACAGACGGTAAGGTACACAGACAGCATGGGACATTAAAGGGGGCACCTCAAAGGCAAAGACAAAAAAATTCTAGTTGGTT,AAGCCTGAAGAAATACATTACAGACGGTAAGGTGCACACAGACAGCATGGGACATTAAAGGGGGCACCTCAAAGGCAAAGACAAAAAAATTCTAGTTGG,10,30,14,27,27,41,27,43,27,34,34,41,36,43,37.41,17.07259769
hek293t,13176,1,2,GCCAATGAAGAAATACATTACAGACGGTAAGGTACACAGACAGCATGGGACATTAAAGGGGGCACCTCAAAGAAAAAAATTCTAGTTGGTTTAACGCGT,GCCAATGAAGAAATACATTACAGACGGTAAGGTGCACACAGACAGCATGGGACATTAAAGGGGGCACCTCAAAGAAAAAAATTCTAGTTGGTTTAACGC,10,30,14,27,27,49,27,51,27,34,34,49,36,51,37.41,70.50756737
hek293t,13179,1,13,AGGCTAAGACGAGGCATCTCAGGATGTAGTGGAGTCCCGAGTACTTACTCGCGCCAAAGTAGAAGCGACCAAAAAAATTCTAGTTGGTTTAACGCGTAA,AGGCTAAGACGAGGCATCTCAGGATGTAGTGGTACCACACTCTCAAGTCCCGAGTACTTACTCGCGCCAAAGTAGAAGCGACCAAAAAAATTCTAGTTG,10,30,14,27,27,40,27,53,27,33,33,40,46,53,50.33,0.685871056
hek293t,13179,1,13,GTTTTAAGACGAGGCATCTCAGGATGTAGTGGAGTCCCGAGTACTTACTCGCGCCAAAGTAGAAGCGACCAGTGAAAAAAATTCTAGTTGGTTTAACGC,GTTTTAAGACGAGGCATCTCAGGATGTAGTGGTACCACACTCTCAAGTCCCGAGTACTTACTCGCGCCAAAGTAGAAGCGACCAGTGAAAAAAATTCTA,10,30,14,27,27,36,27,49,27,33,33,36,46,49,50.33,0.065167807
hek293t,13181,1,4,CCGGCTCGTCGGCAATGGAATACTTAACCTGGCAACAAACTGGGTTATAGCTAAACCAAGGGAGCTACAGAAGGGCGTACATCAAAAAAATTCTAGTTG,CCGGCTCGTCGGCAATGGAATACTTAACTTTTCTGGCAACAAACTGGGTTATAGCTAAACCAAGGGAGCTACAGAAGGGCGTACATCAAAAAAATTCTA,10,30,14,27,27,36,27,40,27,29,29,36,33,40,47.03,41.73010291
hek293t,13181,1,4,TAGCATCGTCGGCAATGGAATACTTAACCTGGCAACAAACTGGGTTATAGCTAAACCAAGGGAGCTACAGAAGGGCGTACAAAAAAATTCTAGTTGGTT,TAGCATCGTCGGCAATGGAATACTTAACTTTTCTGGCAACAAACTGGGTTATAGCTAAACCAAGGGAGCTACAGAAGGGCGTACAAAAAAATTCTAGTT,10,30,14,27,27,39,27,43,27,29,29,39,33,43,47.03,45.55661053
hek293t,13183,1,11,CGACTGTTAAAATAATTTCCCAGATGTGTTGGAAAAAACAATTTCTGTTTCATATGACAAAGTAAAAAAAATTCTAGTTGGTTTAACGCGTAACTAGAT,CGACTGTTAAAATAATTTCCCAGATGTGTTGGAAAAATGGTAAAATACACAATTTCTGTTTCATATGACAAAGTAAAAAAAATTCTAGTTGGTTTAACG,10,30,14,27,27,48,27,59,27,38,38,48,49,59,27.9,0.0
hek293t,13183,1,11,AACCTGTTAAAATAATTTCCCAGATGTGTTGGAAAAAACAATTTCTGTTTCATATGACAAAGTAGAAAAAAAAATTCTAGTTGGTTTAACGCGTAACTA,AACCTGTTAAAATAATTTCCCAGATGTGTTGGAAAAATGGTAAAATACACAATTTCTGTTTCATATGACAAAGTAGAAAAAAAAATTCTAGTTGGTTTA,10,30,14,27,27,45,27,56,27,38,38,45,49,56,27.9,0.0
hek293t,13185,1,11,GTTCGTATGATACAGTGAGTTAAAAATAATGGGAAAGTCTTGGTACCAAGATGTTTCATTTTACGTAGGAAAAAAATTCTAGTTGGTTTAACGCGTAAC,GTTCGTATGATACAGTGAGTTAAAAATAATGGGAAAGTAGCGGCTAAGTCTTGGTACCAAGATGTTTCATTTTACGTAGGAAAAAAATTCTAGTTGGTT,10,30,14,27,27,43,27,54,27,36,36,43,47,54,20.08,0.0
hek293t,13186,1,13,CACATCACAGCCTTCGCGCAGAAACACGATGGTAGTGGTGGCATAGCATTCCCATACTTCTGTTTCAGTGGAAAAAAATTCTAGTTGGTTTAACGCGTA,CACATCACAGCCTTCGCGCAGAAACACGATGGTAGTATTCCACCGTTGTGGTGGCATAGCATTCCCATACTTCTGTTTCAGTGGAAAAAAATTCTAGTT,10,30,14,27,27,39,27,52,27,36,36,39,49,52,76.05,0.0
hek293t,13188,1,14,GCGTCATCAGAAACAAATGTGTTGTCACCTGGCCCTAGATATAAGATCTAATCTCTAAAATCTTGTGCACTTAAAAAAATTCTAGTTGGTTTAACGCGT,GCGTCATCAGAAACAAATGTGTTGTCACCTGGCAGACGGTTATAACCCCTAGATATAAGATCTAATCTCTAAAATCTTGTGCACTTAAAAAAATTCTAG,10,30,14,27,27,37,27,51,27,34,34,37,48,51,31.93,0.0
hek293t,13190,1,5,AGCATATCAGCATCATACAAATTAATTAATGGGCAAAGTATCTATGAGACAGCACAGAATCTTTTTCTATCTAAAAAAATTCTAGTTGGTTTAACGCGT,AGCATATCAGCATCATACAAATTAATTAATGGGCAAAGACTCTTATCTATGAGACAGCACAGAATCTTTTTCTATCTAAAAAAATTCTAGTTGGTTTAA,10,30,14,27,27,46,27,51,27,39,39,46,44,51,7.88,0.131752306
hek293t,13190,1,5,TAAAAATCAGCATCATACAAATTAATTAATGGGCAAAGTATCTATGAGACAGCACAGAATCTTTTTCTAAAAAAAATTCTAGTTGGTTTAACGCGTAAC,TAAAAATCAGCATCATACAAATTAATTAATGGGCAAAGACTCTTATCTATGAGACAGCACAGAATCTTTTTCTAAAAAAAATTCTAGTTGGTTTAACGC,10,30,14,27,27,49,27,54,27,39,39,49,44,54,7.88,0.218850314
hek293t,13192,1,14,TTCCCCTAAAGGCTGAATTTCACACACAAAGGTAATGAAAAATCACTTCACCAAATCTGTTCTCTAAAAAAATTCTAGTTGGTTTAACGCGTAACTAGA,TTCCCCTAAAGGCTGAATTTCACACACAAAGGTAATGAAAAAGGATGGACCAGCAATCACTTCACCAAATCTGTTCTCTAAAAAAATTCTAGTTGGTTT,10,30,14,27,27,44,27,58,27,41,41,44,55,58,37.91,0.0
hek293t,13193,1,5,CATCCAGGATAATAGCATAGTACTGAAAGGGGTGAGGGGGATGAAATGAAGGAATTGCCATACCAAAGCAGAACTGCAAAAAAAAATTCTAGTTGGTTT,CATCCAGGATAATAGCATAGTACTGAAAAGTGCGGGGTGAGGGGGATGAAATGAAGGAATTGCCATACCAAAGCAGAACTGCAAAAAAAAATTCTAGTT,10,30,14,27,27,39,27,44,27,29,29,39,34,44,54.53,15.80682374
hek293t,13193,1,5,TCCCGAGGATAATAGCATAGTACTGAAAGGGGTGAGGGGGATGAAATGAAGGAATTGCCATACCAAAGCAGAACTGCAATCAATCTAAAAAAATTCTAG,TCCCGAGGATAATAGCATAGTACTGAAAAGTGCGGGGTGAGGGGGATGAAATGAAGGAATTGCCATACCAAAGCAGAACTGCAATCAATCTAAAAAAAT,10,30,14,27,27,32,27,37,27,29,29,32,34,37,54.53,10.49263661
hek293t,13195,1,6,AGAACCAATTTCTGAGAGATTCACAAAGCAGGTTCCTCAGCTCAGCAGTGCTGTTTTCCAATTCACTGCTTGCTCATGGCAAAAAAATTCTAGTTGGTT,AGAACCAATTTCTGAGAGATTCACAAAGCAGGTCCCTGATCCTCAGCTCAGCAGTGCTGTTTTCCAATTCACTGCTTGCTCATGGCAAAAAAATTCTAG,10,30,14,27,27,37,27,43,27,34,34,37,40,43,30.38,2.227939592
hek293t,13195,1,6,CATATCAATTTCTGAGAGATTCACAAAGCAGGTTCCTCAGCTCAGCAGTGCTGTTTTCCAATTCACTGCTTGCTCAAAAAAAATTCTAGTTGGTTTAAC,CATATCAATTTCTGAGAGATTCACAAAGCAGGTCCCTGATCCTCAGCTCAGCAGTGCTGTTTTCCAATTCACTGCTTGCTCAAAAAAAATTCTAGTTGG,10,30,14,27,27,41,27,47,27,34,34,41,40,47,30.38,1.977107502
hek293t,13199,1,6,GCCTCCTGCTATGCTGTCATTGTTTTGTAAGGTAGTGAACTATGCTTAGCAAGCAGACTTCTGTGGAAAAAAATTCTAGTTGGTTTAACGCGTAACTAG,GCCTCCTGCTATGCTGTCATTGTTTTGTAAGGTAGTAACTCTGAACTATGCTTAGCAAGCAGACTTCTGTGGAAAAAAATTCTAGTTGGTTTAACGCGT,10,30,14,27,27,51,27,57,27,36,36,51,42,57,37.67,12.77828288
hek293t,13199,1,6,ACTGACTGCTATGCTGTCATTGTTTTGTAAGGTAGTGAACTATGCTTAGCAAGCAGACTTCTGTGGAAAGTCAGGGCTAAAAAAATTCTAGTTGGTTTA,ACTGACTGCTATGCTGTCATTGTTTTGTAAGGTAGTAACTCTGAACTATGCTTAGCAAGCAGACTTCTGTGGAAAGTCAGGGCTAAAAAAATTCTAGTT,10,30,14,27,27,39,27,45,27,36,36,39,42,45,37.67,0.170174055
hek293t,13201,1,8,GTGGCTTGAATCAAAGCATACCTACAAGCAGGAGTTTGTTTGGCATGAATGGAAGTCAGTCTGAAATCAGAGAGAGCTGGAAGATAAAAAAATTCTAGT,GTGGCTTGAATCAAAGCATACCTACACGACATAGAGCAGGAGTTTGTTTGGCATGAATGGAAGTCAGTCTGAAATCAGAGAGAGCTGGAAGATAAAAAA,10,30,14,27,27,30,27,38,27,27,27,30,35,38,59.3,0.846521974
hek293t,13201,1,8,AAGATTTGAATCAAAGCATACCTACAAGCAGGAGTTTGTTTGGCATGAATGGAAGTCAGTCTGAAATCAGAGAAAAAAAATTCTAGTTGGTTTAACGCG,AAGATTTGAATCAAAGCATACCTACACGACATAGAGCAGGAGTTTGTTTGGCATGAATGGAAGTCAGTCTGAAATCAGAGAAAAAAAATTCTAGTTGGT,10,30,14,27,27,42,27,50,27,27,27,42,35,50,59.3,36.69093072
hek293t,13203,1,14,TCGTACCTCTGTCCAAGGCTTGAAGCAGGAGGCACTTAATTTGCAGATAAAGAACAGGCTCAAACTTTCCAAAAAAATTCTAGTTGGTTTAACGCGTAA,TCGTACCTCTGTCCAAGGCTTGAAGCAGGAGGCACTGTATCAAGTGCTTTTAATTTGCAGATAAAGAACAGGCTCAAACTTTCCAAAAAAATTCTAGTT,10,30,14,27,27,39,27,53,27,36,36,39,50,53,60.64,0.0
hek293t,13204,1,8,GGAATTAGAGTTTGACTTGGAGTAGAGGCTGGGGATATTGTGCTGACCACTGTCCAGCAGAGAGCAGGATAAAAAAAATTCTAGTTGGTTTAACGCGTA,GGAATTAGAGTTTGACTTGGAGTAGAGGCTGGGGATGTGCTGTTATTGTGCTGACCACTGTCCAGCAGAGAGCAGGATAAAAAAAATTCTAGTTGGTTT,10,30,14,27,27,44,27,52,27,37,37,44,45,52,42.84,0.662075298
hek293t,13204,1,8,CGAGTTAGAGTTTGACTTGGAGTAGAGGCTGGGGATATTGTGCTGACCACTGTCCAGCAGAGAGCAGGATACAGCAAAAAAATTCTAGTTGGTTTAACG,CGAGTTAGAGTTTGACTTGGAGTAGAGGCTGGGGATGTGCTGTTATTGTGCTGACCACTGTCCAGCAGAGAGCAGGATACAGCAAAAAAATTCTAGTTG,10,30,14,27,27,40,27,48,27,37,37,40,45,48,42.84,0.0
hek293t,13206,1,11,GGGATTTCATTAGCATATTCATCCTAATGTGGATTCTCAATTTATTTACATTGCATAAACTGACTGGGAAAAAAAATTCTAGTTGGTTTAACGCGTAAC,GGGATTTCATTAGCATATTCATCCTAATGTGGAGGGAGCTACAATTCTCAATTTATTTACATTGCATAAACTGACTGGGAAAAAAAATTCTAGTTGGTT,10,30,14,27,27,43,27,54,27,33,33,43,44,54,43.84,3.116144013
hek293t,13206,1,11,CCCAATTCATTAGCATATTCATCCTAATGTGGATTCTCAATTTATTTACATTGCATAAACTGACTGGGAAAAGCATAAAAAAATTCTAGTTGGTTTAAC,CCCAATTCATTAGCATATTCATCCTAATGTGGAGGGAGCTACAATTCTCAATTTATTTACATTGCATAAACTGACTGGGAAAAGCATAAAAAAATTCTA,10,30,14,27,27,36,27,47,27,33,33,36,44,47,43.84,0.287466425
hek293t,13208,1,13,ATCTGCTCACCTGTCTGGAGCTCTGGAGCTGGGCAGGGCCAGCCAGCTCTGCAGGGCACTTCTCACCTTTGCAAAAAAAATTCTAGTTGGTTTAACGCG,ATCTGCTCACCTGTCTGGAGCTCTGGAGCTGGGCTAGATAGTGAGACAGGGCCAGCCAGCTCTGCAGGGCACTTCTCACCTTTGCAAAAAAAATTCTAG,10,30,14,27,27,37,27,50,27,34,34,37,47,50,45.35,1.019516663
hek293t,13209,1,3,TCTATTCGAAAATGATACTTTCTGATGATAGGATAGCTCTGCATCTCTCATTCAGGCGTAATCAGGTTATGGGGAGAAAAAAATTCTAGTTGGTTTAAC,TCTATTCGAAAATGATACTTTCTGATGATAGGATAGAGACTCTGCATCTCTCATTCAGGCGTAATCAGGTTATGGGGAGAAAAAAATTCTAGTTGGTTT,10,30,14,27,27,44,27,47,27,37,37,44,40,47,24.99,60.76369617
hek293t,13209,1,3,GTGCGTCGAAAATGATACTTTCTGATGATAGGATAGCTCTGCATCTCTCATTCAGGCGTAATCAGGTTATGGGAAAAAAATTCTAGTTGGTTTAACGCG,GTGCGTCGAAAATGATACTTTCTGATGATAGGATAGAGACTCTGCATCTCTCATTCAGGCGTAATCAGGTTATGGGAAAAAAATTCTAGTTGGTTTAAC,10,30,14,27,27,47,27,50,27,37,37,47,40,50,24.99,73.01521738
hek293t,13211,1,6,CTATTAACAATAAGTGGGCATAAGCCCGCAGGCCAAATAGATTTAGTCTACAAAATAAGGGCATAGACAAAAAAAATTCTAGTTGGTTTAACGCGTAAC,CTATTAACAATAAGTGGGCATAAGCCCGCAGGAGTGCACCAAATAGATTTAGTCTACAAAATAAGGGCATAGACAAAAAAAATTCTAGTTGGTTTAACG,10,30,14,27,27,48,27,54,27,33,33,48,39,54,52.49,4.376448101
hek293t,13211,1,6,GAAGAAACAATAAGTGGGCATAAGCCCGCAGGCCAAATAGATTTAGTCTACAAAATAAGGGCATAGACAAGTAATAGACTAAAAAAAATTCTAGTTGGT,GAAGAAACAATAAGTGGGCATAAGCCCGCAGGAGTGCACCAAATAGATTTAGTCTACAAAATAAGGGCATAGACAAGTAATAGACTAAAAAAAATTCTA,10,30,14,27,27,36,27,42,27,33,33,36,39,42,52.49,0.371402043
hek293t,13213,1,15,CCAGGGCAGTAATTACTGGTTTGTTAGATCGGGTGTGTGAGCAGCAGGAGTTGGTCTGCGGAGGTACAAAAAAAATTCTAGTTGGTTTAACGCGTAACT,CCAGGGCAGTAATTACTGGTTTGTTAGATCGGGTGTTAATATGATAAGGTAGTGAGCAGCAGGAGTTGGTCTGCGGAGGTACAAAAAAAATTCTAGTTG,10,30,14,27,27,40,27,55,27,37,37,40,52,55,16.49,0.0
hek293t,13214,1,8,GAGCTTTGCTGCTTGTGCCAGTGAAGGAGTGGAAAATGCAAACTAGTTCCACTCCTTTTTCCAGAACCTTATAGAAAAAAATTCTAGTTGGTTTAACGC,GAGCTTTGCTGCTTGTGCCAGTGAAGGAGTGGATTTGAAGGAAATGCAAACTAGTTCCACTCCTTTTTCCAGAACCTTATAGAAAAAAATTCTAGTTGG,10,30,14,27,27,41,27,49,27,34,34,41,42,49,61.7,12.81595315
hek293t,13214,1,8,TTCACTTGCTGCTTGTGCCAGTGAAGGAGTGGAAAATGCAAACTAGTTCCACTCCTTTTTCCAGAACCTTATAGCACAAAAAAAATTCTAGTTGGTTTA,TTCACTTGCTGCTTGTGCCAGTGAAGGAGTGGATTTGAAGGAAATGCAAACTAGTTCCACTCCTTTTTCCAGAACCTTATAGCACAAAAAAAATTCTAG,10,30,14,27,27,37,27,45,27,34,34,37,42,45,61.7,0.657624332
hek293t,13216,1,12,AGGCCAAAGGTCTTTAAAAAGTTGAAACCAGGAAAGATAAGTAATCTTTGGAGCCTAATTTTTAAACAATTGGAAAAAAAAATTCTAGTTGGTTTAACG,AGGCCAAAGGTCTTTAAAAAGTTGAAACGTTAAACATTCTCAGGAAAGATAAGTAATCTTTGGAGCCTAATTTTTAAACAATTGGAAAAAAAAATTCTA,10,30,14,27,27,36,27,48,27,29,29,36,41,48,38.14,0.0
hek293t,13216,1,12,GCATCAAAGGTCTTTAAAAAGTTGAAACCAGGAAAGATAAGTAATCTTTGGAGCCTAATTTTTAAACAAAAAAATTCTAGTTGGTTTAACGCGTAACTA,GCATCAAAGGTCTTTAAAAAGTTGAAACGTTAAACATTCTCAGGAAAGATAAGTAATCTTTGGAGCCTAATTTTTAAACAAAAAAATTCTAGTTGGTTT,10,30,14,27,27,44,27,56,27,29,29,44,41,56,38.14,0.068941744
hek293t,13218,1,13,ATGACGCAGAACCATTGTTTCTGGATCATTGGTTTCTTGCTCAACTTTCATGACTAATTAACTTATAAAAAAAATTCTAGTTGGTTTAACGCGTAACTA,ATGACGCAGAACCATTGTTTCTGGATCATTGGTTTCTTGTGGAAGCGGTCTTCTCAACTTTCATGACTAATTAACTTATAAAAAAAATTCTAGTTGGTT,10,30,14,27,27,43,27,56,27,40,40,43,53,56,15.68,0.060606061
hek293t,13219,1,14,ACCGGATTTGGTTTCTTCTTTTGCTCACTAGGATGGTTATCCTGACTTCCAGGACACAGTCCAAAAAAAAATTCTAGTTGGTTTAACGCGTAACTAGAT,ACCGGATTTGGTTTCTTCTTTTGCTCACTAGGATGGTGGCTCCCTAAGACCTATCCTGACTTCCAGGACACAGTCCAAAAAAAAATTCTAGTTGGTTTA,10,30,14,27,27,45,27,59,27,38,38,45,52,59,9.53,0.0
hek293t,13220,1,7,CCCCCAATTAAGTAAATCATGCTTGTAAGGGGTCACAGTATAACCAGATTTGTTTGCAATAGAGGTGTAAAAATGGGAGAAAAAAATTCTAGTTGGTTT,CCCCCAATTAAGTAAATCATGCTTGTAAGCTCAATTGGGTCACAGTATAACCAGATTTGTTTGCAATAGAGGTGTAAAAATGGGAGAAAAAAATTCTAG,10,30,14,27,27,37,27,44,27,30,30,37,37,44,45.02,23.18018657
hek293t,13220,1,7,GTCGTAATTAAGTAAATCATGCTTGTAAGGGGTCACAGTATAACCAGATTTGTTTGCAATAGAGGTGTAAAAAAAAAATTCTAGTTGGTTTAACGCGTA,GTCGTAATTAAGTAAATCATGCTTGTAAGCTCAATTGGGTCACAGTATAACCAGATTTGTTTGCAATAGAGGTGTAAAAAAAAAATTCTAGTTGGTTTA,10,30,14,27,27,45,27,52,27,30,30,45,37,52,45.02,35.04062306
hek293t,13222,1,6,CATTCTTTGCTTGATCTCTAATAAAGGGATGGAGAGGGAAATAATGAGATGAGAAAACTCTCAATACAAACATAAAAAAATTCTAGTTGGTTTAACGCG,CATTCTTTGCTTGATCTCTAATAAAGGGATGGAGAGCCATCCGGAAATAATGAGATGAGAAAACTCTCAATACAAACATAAAAAAATTCTAGTTGGTTT,10,30,14,27,27,44,27,50,27,37,37,44,43,50,34.2,0.016268098
hek293t,13222,1,6,ACTTGTTTGCTTGATCTCTAATAAAGGGATGGAGAGGGAAATAATGAGATGAGAAAACTCTCAATAAAAAAATTCTAGTTGGTTTAACGCGTAACTAGA,ACTTGTTTGCTTGATCTCTAATAAAGGGATGGAGAGCCATCCGGAAATAATGAGATGAGAAAACTCTCAATAAAAAAATTCTAGTTGGTTTAACGCGTA,10,30,14,27,27,52,27,58,27,37,37,52,43,58,34.2,0.0
hek293t,2540,1,4,GCGATAGCTCTTTCTTATACATTTGATTAAGGGTAAACATGTAGAGTGATAGGGAGGCTGGAAAAAAAAAATTCTAGTTGGTTTAACGCGTAACTAGAT,GCGATAGCTCTTTCTTATACATTTGATTAAGGGTAAACAACCTTGTAGAGTGATAGGGAGGCTGGAAAAAAAAAATTCTAGTTGGTTTAACGCGTAACT,10,30,14,27,27,55,27,59,27,40,40,55,44,59,2.07,0.395710307
hek293t,2540,1,4,CGGATAGCTCTTTCTTATACATTTGATTAAGGGTAAACATGTAGAGTGATAGGGAGGCTGGAAACCTGTGTTAGCAAAAAAAATTCTAGTTGGTTTAAC,CGGATAGCTCTTTCTTATACATTTGATTAAGGGTAAACAACCTTGTAGAGTGATAGGGAGGCTGGAAACCTGTGTTAGCAAAAAAAATTCTAGTTGGTT,10,30,14,27,27,43,27,47,27,40,40,43,44,47,2.07,0.0
hek293t,13226,1,6,CACCGAGCGCCCTCGCAGACGCGGCAGGACGGGCAGCCGCGCGGGCCGGGAGCGGCCTTCCCCCTCGGAGCTCCGCAGCCGCACGTAAAAAAATTCTAG,CACCGAGCGCCCTCGCAGACGCGGCAGCATGGTGACGGGCAGCCGCGCGGGCCGGGAGCGGCCTTCCCCCTCGGAGCTCCGCAGCCGCACGTAAAAAAA,10,30,14,27,27,31,27,37,27,28,28,31,34,37,48.58,1.19047619
hek293t,13228,1,14,AGGGGAATTAGGATGGTTATTTTTTGCTGTGGAATCCTGGCCGCAGACTGTGTTCAGTTGTTTCTTCCTGTGAAAAAAAAATTCTAGTTGGTTTAACGC,AGGGGAATTAGGATGGTTATTTTTTGCTGTGGGTTATAGGTTCCAGAATCCTGGCCGCAGACTGTGTTCAGTTGTTTCTTCCTGTGAAAAAAAAATTCT,10,30,14,27,27,35,27,49,27,32,32,35,46,49,30.82,0.0
hek293t,13228,1,14,CATAAAATTAGGATGGTTATTTTTTGCTGTGGAATCCTGGCCGCAGACTGTGTTCAGTTGTTTCTTCCTGAAAAAAATTCTAGTTGGTTTAACGCGTAA,CATAAAATTAGGATGGTTATTTTTTGCTGTGGGTTATAGGTTCCAGAATCCTGGCCGCAGACTGTGTTCAGTTGTTTCTTCCTGAAAAAAATTCTAGTT,10,30,14,27,27,39,27,53,27,32,32,39,46,53,30.82,0.0
hek293t,13230,1,5,AGAGGCTTTGTACAATATTCTAAGCCTGTTGGTGGCTTAGATGTTGGCAGGGTGGTCCTCTTTTTAGATCCAAAAAAATTCTAGTTGGTTTAACGCGTA,AGAGGCTTTGTACAATATTCTAAGCCTGTTGGTGGCTTACGGACGATGTTGGCAGGGTGGTCCTCTTTTTAGATCCAAAAAAATTCTAGTTGGTTTAAC,10,30,14,27,27,47,27,52,27,40,40,47,45,52,39.48,33.30370008
hek293t,13230,1,5,GATCGCTTTGTACAATATTCTAAGCCTGTTGGTGGCTTAGATGTTGGCAGGGTGGTCCTCTTTTTAGAAAAAAAATTCTAGTTGGTTTAACGCGTAACT,GATCGCTTTGTACAATATTCTAAGCCTGTTGGTGGCTTACGGACGATGTTGGCAGGGTGGTCCTCTTTTTAGAAAAAAAATTCTAGTTGGTTTAACGCG,10,30,14,27,27,50,27,55,27,40,40,50,45,55,39.48,25.34245293
hek293t,13234,1,5,TGAGCCTGGAAGTAAATAAATATGTATGATGGTATACTAAATATATTTTGTTGTGACATACATTCTGAGCAAGAAAAAAAATTCTAGTTGGTTTAACGC,TGAGCCTGGAAGTAAATAAATATGTATGATGGTATACCCTGCTAAATATATTTTGTTGTGACATACATTCTGAGCAAGAAAAAAAATTCTAGTTGGTTT,10,30,14,27,27,44,27,49,27,37,37,44,42,49,46.16,0.0
hek293t,13234,1,5,CATTGCTGGAAGTAAATAAATATGTATGATGGTATACTAAATATATTTTGTTGTGACATACATTCTAAAAAAATTCTAGTTGGTTTAACGCGTAACTAG,CATTGCTGGAAGTAAATAAATATGTATGATGGTATACCCTGCTAAATATATTTTGTTGTGACATACATTCTAAAAAAATTCTAGTTGGTTTAACGCGTA,10,30,14,27,27,52,27,57,27,37,37,52,42,57,46.16,0.0
hek293t,13236,1,6,AGGGCATCAAGAAATATTTTTCAGTGTAAAGGTGCAATCCATAGTTTGTAGATAGTGAGACAGTCACTACAAAAAAATTCTAGTTGGTTTAACGCGTAA,AGGGCATCAAGAAATATTTTTCAGTGTAAAGGTTCCTGTGCAATCCATAGTTTGTAGATAGTGAGACAGTCACTACAAAAAAATTCTAGTTGGTTTAAC,10,30,14,27,27,47,27,53,27,32,32,47,38,53,-2.63,6.816015206
hek293t,13236,1,6,TTTGGATCAAGAAATATTTTTCAGTGTAAAGGTGCAATCCATAGTTTGTAGATAGTGAGACAGTCACTACCTTCGGTAAAAAAAATTCTAGTTGGTTTA,TTTGGATCAAGAAATATTTTTCAGTGTAAAGGTTCCTGTGCAATCCATAGTTTGTAGATAGTGAGACAGTCACTACCTTCGGTAAAAAAAATTCTAGTT,10,30,14,27,27,39,27,45,27,32,32,39,38,45,-2.63,1.310024711
hek293t,13238,1,11,ACAGTGTAGTTCAGCCAGCAACTGGTGACTGGGGGCTGTCTGAGTTGGAGGTTGCATTTGGACAAAAAAAATTCTAGTTGGTTTAACGCGTAACTAGAT,ACAGTGTAGTTCAGCCAGCAACTGGTGACTGGTCATGGAATAGGGGCTGTCTGAGTTGGAGGTTGCATTTGGACAAAAAAAATTCTAGTTGGTTTAACG,10,30,14,27,27,48,27,59,27,33,33,48,44,59,34.56,1.188846133
hek293t,13238,1,11,CCCTGGTAGTTCAGCCAGCAACTGGTGACTGGGGGCTGTCTGAGTTGGAGGTTGCATTTGGACAGATCTAAAAAAATTCTAGTTGGTTTAACGCGTAAC,CCCTGGTAGTTCAGCCAGCAACTGGTGACTGGTCATGGAATAGGGGCTGTCTGAGTTGGAGGTTGCATTTGGACAGATCTAAAAAAATTCTAGTTGGTT,10,30,14,27,27,43,27,54,27,33,33,43,44,54,34.56,2.753495552
hek293t,13240,1,15,GGGAGGTTATCCAAATACATCCAACTTCTTGGAGGTTTACAACTGATAAAATTAATTATGCGTTATGACAATACAAAAAAATTCTAGTTGGTTTAACGC,GGGAGGTTATCCAAATACATCCAACTTGATTAAGACTAGTGTCTTGGAGGTTTACAACTGATAAAATTAATTATGCGTTATGACAATACAAAAAAATTC,10,30,14,27,27,34,27,49,27,27,27,34,42,49,11.48,0.518623291
hek293t,13240,1,15,AAAGCGTTATCCAAATACATCCAACTTCTTGGAGGTTTACAACTGATAAAATTAATTATGCGTTATAAAAAAATTCTAGTTGGTTTAACGCGTAACTAG,AAAGCGTTATCCAAATACATCCAACTTGATTAAGACTAGTGTCTTGGAGGTTTACAACTGATAAAATTAATTATGCGTTATAAAAAAATTCTAGTTGGT,10,30,14,27,27,42,27,57,27,27,27,42,42,57,11.48,15.83091432
hek293t,13242,1,1,CCTGTTCACAGTTTACTTTTACTTCAAAGTGGTCCTTGAGGCACTTCAGTCCCTTCATCTCGGCCATTCACTACACAGCTGCCTTTTAAAAAAATTCTA,CCTGTTCACAGTTTACTTTTACTTCAATAGTGGTCCTTGAGGCACTTCAGTCCCTTCATCTCGGCCATTCACTACACAGCTGCCTTTTAAAAAAATTCT,10,30,14,27,27,35,27,36,27,28,28,35,29,36,25.45,7.770280422
hek293t,13243,1,11,CGTAGTCCATTTCCTATACTGTAGTGGGTAGGAGAACAAGACACGAGTTTCAATTTCAGCACGACAGATTCAGATTAGTAAAAAAATTCTAGTTGGTTT,CGTAGTCCATTTCCTATACTGTAGTGGGTTGAGGAGTTGTAGGAGAACAAGACACGAGTTTCAATTTCAGCACGACAGATTCAGATTAGTAAAAAAATT,10,30,14,27,27,33,27,44,27,30,30,33,41,44,48.45,0.172585342
hek293t,13243,1,11,ACGGTTCCATTTCCTATACTGTAGTGGGTAGGAGAACAAGACACGAGTTTCAATTTCAGCACGACAGAAAAAAATTCTAGTTGGTTTAACGCGTAACTA,ACGGTTCCATTTCCTATACTGTAGTGGGTTGAGGAGTTGTAGGAGAACAAGACACGAGTTTCAATTTCAGCACGACAGAAAAAAATTCTAGTTGGTTTA,10,30,14,27,27,45,27,56,27,30,30,45,41,56,48.45,20.30826439
hek293t,13245,1,2,CTCGAAAAATGACAGTGCCTGAATGGAAAAGGGTGCTTAGCCTGTCATCTATTGATTTGTATGGGATCAAAAAAATTCTAGTTGGTTTAACGCGTAACT,CTCGAAAAATGACAGTGCCTGAATGGAAAAGGGTGCTTGTAGCCTGTCATCTATTGATTTGTATGGGATCAAAAAAATTCTAGTTGGTTTAACGCGTAA,10,30,14,27,27,53,27,55,27,38,38,53,40,55,29.64,63.73674003
hek293t,13245,1,2,ATGTAAAAATGACAGTGCCTGAATGGAAAAGGGTGCTTAGCCTGTCATCTATTGATTTGTATGGGATCAAAATAAAAAAATTCTAGTTGGTTTAACGCG,ATGTAAAAATGACAGTGCCTGAATGGAAAAGGGTGCTTGTAGCCTGTCATCTATTGATTTGTATGGGATCAAAATAAAAAAATTCTAGTTGGTTTAACG,10,30,14,27,27,48,27,50,27,38,38,48,40,50,29.64,53.33988439
hek293t,13247,1,4,CATAGCTTTACAGACCCAGAAGGTCACATTGGAGTTTACATTCACTGCTGGCGATTAAAGGGGGTCGCTAGCACAGGCAAAAAAAATTCTAGTTGGTTT,CATAGCTTTACAGACCCAGAAGGTCACATTCTATGGAGTTTACATTCACTGCTGGCGATTAAAGGGGGTCGCTAGCACAGGCAAAAAAAATTCTAGTTG,10,30,14,27,27,40,27,44,27,30,30,40,34,44,58.55,83.50318501
hek293t,13247,1,4,TTCAGCTTTACAGACCCAGAAGGTCACATTGGAGTTTACATTCACTGCTGGCGATTAAAGGGGGTCGCTAGCACAGGCACAGAAAAAAATTCTAGTTGG,TTCAGCTTTACAGACCCAGAAGGTCACATTCTATGGAGTTTACATTCACTGCTGGCGATTAAAGGGGGTCGCTAGCACAGGCACAGAAAAAAATTCTAG,10,30,14,27,27,37,27,41,27,30,30,37,34,41,58.55,63.31494577
hek293t,13249,1,1,CACATAGTTATGACCTACCAGTGAAAGACAGGGTGAAGTAACACTTTGATGATGGTGTTGGGTTGGAGTGGGCAAAAAAAATTCTAGTTGGTTTAACGC,CACATAGTTATGACCTACCAGTGAAAGACAGGGTGAATGTAACACTTTGATGATGGTGTTGGGTTGGAGTGGGCAAAAAAAATTCTAGTTGGTTTAACG,10,30,14,27,27,48,27,49,27,38,38,48,39,49,56.28,70.86429319
hek293t,13249,1,1,GACGAAGTTATGACCTACCAGTGAAAGACAGGGTGAAGTAACACTTTGATGATGGTGTTGGGTTGGAGTGGGCAAAAAAAAAAATTCTAGTTGGTTTAA,GACGAAGTTATGACCTACCAGTGAAAGACAGGGTGAATGTAACACTTTGATGATGGTGTTGGGTTGGAGTGGGCAAAAAAAAAAATTCTAGTTGGTTTA,10,30,14,27,27,45,27,46,27,38,38,45,39,46,56.28,66.05761017
hek293t,13251,1,5,GTACGAGCACAAAGTCGATATAACCAGCAAGGGGAAACGCCGGCCTGCTCTGGTGCTTGCTGAAGCACAACTGAAGCCGCTCAAAAAAATTCTAGTTGG,GTACGAGCACAAAGTCGATATAACCAGCAAGGAGGGTGGAAACGCCGGCCTGCTCTGGTGCTTGCTGAAGCACAACTGAAGCCGCTCAAAAAAATTCTA,10,30,14,27,27,36,27,41,27,33,33,36,38,41,37.47,0.161550889
hek293t,13251,1,5,AATGGAGCACAAAGTCGATATAACCAGCAAGGGGAAACGCCGGCCTGCTCTGGTGCTTGCTGAAGCACAACTGAAGCCAAAAAAATTCTAGTTGGTTTA,AATGGAGCACAAAGTCGATATAACCAGCAAGGAGGGTGGAAACGCCGGCCTGCTCTGGTGCTTGCTGAAGCACAACTGAAGCCAAAAAAATTCTAGTTG,10,30,14,27,27,40,27,45,27,33,33,40,38,45,37.47,0.907945385
hek293t,13253,1,6,ACAAGATATTGCAGTTTTACATACCAAACTGGCTTGCTTGCAAGGCTTAGTTCTTGGAACTAAAATCCAAAAAAAATTCTAGTTGGTTTAACGCGTAAC,ACAAGATATTGCAGTTTTACATACCAAACTGGCTTGCTTGTATGGGCAAGGCTTAGTTCTTGGAACTAAAATCCAAAAAAAATTCTAGTTGGTTTAACG,10,30,14,27,27,48,27,54,27,41,41,48,47,54,8.77,1.718055614
hek293t,13254,1,1,CGGCACATACAAGTAGAAAAGATTGCGGAAGGGCATTACTGTCTGTAAATGTTTAGGCTTTCAAATCCCTTAGATGGGGAAATAAAAAAAAAATTCTAG,CGGCACATACAAGTAGAAAAGATTGCGGGAAGGGCATTACTGTCTGTAAATGTTTAGGCTTTCAAATCCCTTAGATGGGGAAATAAAAAAAAAATTCTA,10,30,14,27,27,36,27,37,27,29,29,36,30,37,35.34,1.364671493
hek293t,13254,1,1,TCATTCATACAAGTAGAAAAGATTGCGGAAGGGCATTACTGTCTGTAAATGTTTAGGCTTTCAAATCCCTTAGATGGGAAAAAAATTCTAGTTGGTTTA,TCATTCATACAAGTAGAAAAGATTGCGGGAAGGGCATTACTGTCTGTAAATGTTTAGGCTTTCAAATCCCTTAGATGGGAAAAAAATTCTAGTTGGTTT,10,30,14,27,27,44,27,45,27,29,29,44,30,45,35.34,0.361946585
hek293t,13256,1,3,TGGCCTTGCTACAGAGATGCTTGCATATCAGGCTCTAAAATGATGGGCAGTGAAGGCAGATGAAGCACTTACAGGAATATTTCTGAAAAAAATTCTAGT,TGGCCTTGCTACAGAGATGCTTGCATATCTTCAGGCTCTAAAATGATGGGCAGTGAAGGCAGATGAAGCACTTACAGGAATATTTCTGAAAAAAATTCT,10,30,14,27,27,35,27,38,27,28,28,35,31,38,12.76,57.04030254
hek293t,13256,1,3,CAGGTTTGCTACAGAGATGCTTGCATATCAGGCTCTAAAATGATGGGCAGTGAAGGCAGATGAAGCACTTACAGGAATATTTCTGTGGTAAAAAAATTC,CAGGTTTGCTACAGAGATGCTTGCATATCTTCAGGCTCTAAAATGATGGGCAGTGAAGGCAGATGAAGCACTTACAGGAATATTTCTGTGGTAAAAAAA,10,30,14,27,27,31,27,34,27,28,28,31,31,34,12.76,0.600949803
hek293t,13258,1,11,CGCGTCAACGCAACAATAAATCTTCCAGTAGGTTTAAACAAAAGATCAATCGCACTGCTCATAAACGTTATTTAAAAAAAATTCTAGTTGGTTTAACGC,CGCGTCAACGCAACAATAAATCTTCCAGTAGGTTAATTCCTACCTTAAACAAAAGATCAATCGCACTGCTCATAAACGTTATTTAAAAAAAATTCTAGT,10,30,14,27,27,38,27,49,27,35,35,38,46,49,40.53,0.412654746
hek293t,13259,1,6,ATCGCGTACAAAGGTATATCCTTTGCACAAGGAAATAAATTGGTCTCTGGATCTTACCAGTGTCTTTCCTAAGTCCAAAAAAATTCTAGTTGGTTTAAC,ATCGCGTACAAAGGTATATCCTTTGCACAAGGAAATAGGCATTAATTGGTCTCTGGATCTTACCAGTGTCTTTCCTAAGTCCAAAAAAATTCTAGTTGG,10,30,14,27,27,41,27,47,27,38,38,41,44,47,38.92,0.5521049
hek293t,13259,1,6,GTAGCGTACAAAGGTATATCCTTTGCACAAGGAAATAAATTGGTCTCTGGATCTTACCAGTGTCTTTCCTAAAAAAAAATTCTAGTTGGTTTAACGCGT,GTAGCGTACAAAGGTATATCCTTTGCACAAGGAAATAGGCATTAATTGGTCTCTGGATCTTACCAGTGTCTTTCCTAAAAAAAAATTCTAGTTGGTTTA,10,30,14,27,27,45,27,51,27,38,38,45,44,51,38.92,5.05287078
hek293t,13261,1,11,CTAATTCTTATTTCTACCATTCGCTACCATGGTTTTCCAAATTACTGAGAGAAAAGAGGCAGACAGAGGTCACAAAAAAAAATTCTAGTTGGTTTAACG,CTAATTCTTATTTCTACCATTCGCTATCGGCGGGTGTCCATGGTTTTCCAAATTACTGAGAGAAAAGAGGCAGACAGAGGTCACAAAAAAAAATTCTAG,10,30,14,27,27,37,27,48,27,27,27,37,38,48,42.56,11.78797218
hek293t,13261,1,11,GTTTATCTTATTTCTACCATTCGCTACCATGGTTTTCCAAATTACTGAGAGAAAAGAGGCAGACAGAGGTAAAAAAATTCTAGTTGGTTTAACGCGTAA,GTTTATCTTATTTCTACCATTCGCTATCGGCGGGTGTCCATGGTTTTCCAAATTACTGAGAGAAAAGAGGCAGACAGAGGTAAAAAAATTCTAGTTGGT,10,30,14,27,27,42,27,53,27,27,27,42,38,53,42.56,3.603615247
hek293t,13263,1,9,TCACAACAGCAAACGTGCTCCAGGACCCAAGGAAGGTCCATAGGTTATTTTGTTCTTTATGGACTGTAAAAAAATTCTAGTTGGTTTAACGCGTAACTA,TCACAACAGCAAACGTGCTCCAGGACCCAAGGAAGGATGGAGGCGTCCATAGGTTATTTTGTTCTTTATGGACTGTAAAAAAATTCTAGTTGGTTTAAC,10,30,14,27,27,47,27,56,27,37,37,47,46,56,56.66,6.969240275
hek293t,13263,1,9,CCACGACAGCAAACGTGCTCCAGGACCCAAGGAAGGTCCATAGGTTATTTTGTTCTTTATGGACTGTATCCATTAAAAAAATTCTAGTTGGTTTAACGC,CCACGACAGCAAACGTGCTCCAGGACCCAAGGAAGGATGGAGGCGTCCATAGGTTATTTTGTTCTTTATGGACTGTATCCATTAAAAAAATTCTAGTTG,10,30,14,27,27,40,27,49,27,37,37,40,46,49,56.66,0.0
hek293t,13265,1,9,CAGTATGTGCATCTTTGTGTCTTCTCTTTTGGCTGTTCAATCCACAGAATTTGTAAGCACGTGAGAGTGAAAAAAAAATTCTAGTTGGTTTAACGCGTA,CAGTATGTGCATCTTTGTGTCTTCTCTAACTTTACATTTGGCTGTTCAATCCACAGAATTTGTAAGCACGTGAGAGTGAAAAAAAAATTCTAGTTGGTT,10,30,14,27,27,43,27,52,27,28,28,43,37,52,1.91,13.3542818
hek293t,13267,1,8,TGCCTATATAGAATTACTAAAATTCTTTGGGGACTGTGTTCTGTGAAGTCAGTGAAACGCAGAAATATTAAAAAAAATTCTAGTTGGTTTAACGCGTAA,TGCCTATATAGAATTACTAAAATTCTTTGCCGGGTTGGGGACTGTGTTCTGTGAAGTCAGTGAAACGCAGAAATATTAAAAAAAATTCTAGTTGGTTTA,10,30,14,27,27,45,27,53,27,30,30,45,38,53,23.44,0.059417706
hek293t,13267,1,8,CAAAGATATAGAATTACTAAAATTCTTTGGGGACTGTGTTCTGTGAAGTCAGTGAAACGCAGAAATATTATCCAGAAAAAAATTCTAGTTGGTTTAACG,CAAAGATATAGAATTACTAAAATTCTTTGCCGGGTTGGGGACTGTGTTCTGTGAAGTCAGTGAAACGCAGAAATATTATCCAGAAAAAAATTCTAGTTG,10,30,14,27,27,40,27,48,27,30,30,40,38,48,23.44,0.0
hek293t,13269,1,4,CCTCAATACCTCTGAACAGCGCGAGGGCATGGTGAGGACATGGTGGCCAGCGCGGGCGCGTGCTTTGATGTGCAAAAAAATTCTAGTTGGTTTAACGCG,CCTCAATACCTCTGAACAGCGCGAGGGCATGGTGAGCCTGGACATGGTGGCCAGCGCGGGCGCGTGCTTTGATGTGCAAAAAAATTCTAGTTGGTTTAA,10,30,14,27,27,46,27,50,27,36,36,46,40,50,13.69,6.148942874
hek293t,13269,1,4,GACCCATACCTCTGAACAGCGCGAGGGCATGGTGAGGACATGGTGGCCAGCGCGGGCGCGTGCTTTGAAAAAAAATTCTAGTTGGTTTAACGCGTAACT,GACCCATACCTCTGAACAGCGCGAGGGCATGGTGAGCCTGGACATGGTGGCCAGCGCGGGCGCGTGCTTTGAAAAAAAATTCTAGTTGGTTTAACGCGT,10,30,14,27,27,51,27,55,27,36,36,51,40,55,13.69,3.041076175
hek293t,13271,1,8,TAGACTTCCACTAATGGGATCACCTTCACAGGAGACTGAGCCAGTGATAAACACACCGTGCTCTGCAAAGCAAAAAAATTCTAGTTGGTTTAACGCGTA,TAGACTTCCACTAATGGGATCACCTTCAATGATGAGCAGGAGACTGAGCCAGTGATAAACACACCGTGCTCTGCAAAGCAAAAAAATTCTAGTTGGTTT,10,30,14,27,27,44,27,52,27,29,29,44,37,52,44.6,36.7974685
hek293t,13271,1,8,AAGGATTCCACTAATGGGATCACCTTCACAGGAGACTGAGCCAGTGATAAACACACCGTGCTCTGCAAAGCCAGCAAAAAAAATTCTAGTTGGTTTAAC,AAGGATTCCACTAATGGGATCACCTTCAATGATGAGCAGGAGACTGAGCCAGTGATAAACACACCGTGCTCTGCAAAGCCAGCAAAAAAAATTCTAGTT,10,30,14,27,27,39,27,47,27,29,29,39,37,47,44.6,15.95423588
hek293t,10560,1,2,CTTGGATTTAAGCAGGCAGGGAATGGGGCTGGGATGACGGAAGGGTCTCATGGAAAATCGTTCTCCTCGGGCTCAACCCCCAAAAAAATTCTAGTTGGT,CTTGGATTTAAGCAGGCAGGGAATGGGGCAGTGGGATGACGGAAGGGTCTCATGGAAAATCGTTCTCCTCGGGCTCAACCCCCAAAAAAATTCTAGTTG,10,30,14,27,27,40,27,42,27,30,30,40,32,42,28.77,71.75507178
hek293t,10560,1,2,CTGTCATTTAAGCAGGCAGGGAATGGGGCTGGGATGACGGAAGGGTCTCATGGAAAATCGTTCTCCTCGGGCTCAACCCCCTGGAAAAAAATTCTAGTT,CTGTCATTTAAGCAGGCAGGGAATGGGGCAGTGGGATGACGGAAGGGTCTCATGGAAAATCGTTCTCCTCGGGCTCAACCCCCTGGAAAAAAATTCTAG,10,30,14,27,27,37,27,39,27,30,30,37,32,39,28.77,57.17768433
hek293t,13275,1,10,GAAACAGCTTCAGAGTCATTTCACCCTCTAGGCTGCTGTAGGTCAAAGCTCAAAGCTTTTGTACATCAAAAAAATTCTAGTTGGTTTAACGCGTAACTA,GAAACAGCTTCAGAGTCATTTCACCCTCTAGGCTGGCCCAAATAGCTGTAGGTCAAAGCTCAAAGCTTTTGTACATCAAAAAAATTCTAGTTGGTTTAA,10,30,14,27,27,46,27,56,27,36,36,46,46,56,38.41,5.551540587
hek293t,13277,1,11,ATCACAGCCTTTAGTTATGTTGTTTTAATTGGTGAAAACACATTCTCCTTCCCCTCAGTTTTACGTTCTAAAAAAATTCTAGTTGGTTTAACGCGTAAC,ATCACAGCCTTTAGTTATGTTGTTTTAATTGGTGAGGGAACAATAGAAACACATTCTCCTTCCCCTCAGTTTTACGTTCTAAAAAAATTCTAGTTGGTT,10,30,14,27,27,43,27,54,27,36,36,43,47,54,-0.01,0.0
hek293t,13277,1,11,CTGGCAGCCTTTAGTTATGTTGTTTTAATTGGTGAAAACACATTCTCCTTCCCCTCAGTTTTACGTAAAAAAATTCTAGTTGGTTTAACGCGTAACTAG,CTGGCAGCCTTTAGTTATGTTGTTTTAATTGGTGAGGGAACAATAGAAACACATTCTCCTTCCCCTCAGTTTTACGTAAAAAAATTCTAGTTGGTTTAA,10,30,14,27,27,46,27,57,27,36,36,46,47,57,-0.01,0.0
hek293t,13279,1,1,TCAGGTCTTACAATTTCTACAAAGTTTACTGGGAACTTACCTAACTTTGAAAGTGTAAGTAGTGTTATTTTTACAAAAAAAATTCTAGTTGGTTTAACG,TCAGGTCTTACAATTTCTACAAAGTTTACTGGGAACCTTACCTAACTTTGAAAGTGTAAGTAGTGTTATTTTTACAAAAAAAATTCTAGTTGGTTTAAC,10,30,14,27,27,47,27,48,27,37,37,47,38,48,1.77,10.02395955
hek293t,13279,1,1,CCGGTTCTTACAATTTCTACAAAGTTTACTGGGAACTTACCTAACTTTGAAAGTGTAAGTAGTGTTATTTTTACATTGCTTTAAAAAAATTCTAGTTGG,CCGGTTCTTACAATTTCTACAAAGTTTACTGGGAACCTTACCTAACTTTGAAAGTGTAAGTAGTGTTATTTTTACATTGCTTTAAAAAAATTCTAGTTG,10,30,14,27,27,40,27,41,27,37,37,40,38,41,1.77,0.883435095
hek293t,13281,1,8,GTCGCCCCCCCGTATCATACATGCAGACTTGGAGAGGGATTCAGAGGGGCATGCTAAGGGACTGTAGATGACTGTGTAAAAAAAATTCTAGTTGGTTTA,GTCGCCCCCCCGTATCATACATGCAGGACTCCATACTTGGAGAGGGATTCAGAGGGGCATGCTAAGGGACTGTAGATGACTGTGTAAAAAAAATTCTAG,10,30,14,27,27,37,27,45,27,27,27,37,35,45,40.62,69.73809237
hek293t,13281,1,8,TGACGCCCCCCGTATCATACATGCAGACTTGGAGAGGGATTCAGAGGGGCATGCTAAGGGACTGTAGATGACTAAAAAAATTCTAGTTGGTTTAACGCG,TGACGCCCCCCGTATCATACATGCAGGACTCCATACTTGGAGAGGGATTCAGAGGGGCATGCTAAGGGACTGTAGATGACTAAAAAAATTCTAGTTGGT,10,30,14,27,27,42,27,50,27,27,27,42,35,50,40.62,47.08824479
hek293t,13283,1,6,ATTGTTTGTTAGCGTTGTAAAGAGCTACTTGGTTATTTTCCTCTCCTGACCAAATCATCTTGTAAATTGGATCTTCTGACAAAAAAATTCTAGTTGGTT,ATTGTTTGTTAGCGTTGTAAAGAGCTACTTGGTTTTAATTATTTTCCTCTCCTGACCAAATCATCTTGTAAATTGGATCTTCTGACAAAAAAATTCTAG,10,30,14,27,27,37,27,43,27,34,34,37,40,43,52.97,0.0
hek293t,13283,1,6,CCATATTGTTAGCGTTGTAAAGAGCTACTTGGTTATTTTCCTCTCCTGACCAAATCATCTTGTAAATTGGATCTTCAAAAAAATTCTAGTTGGTTTAAC,CCATATTGTTAGCGTTGTAAAGAGCTACTTGGTTTTAATTATTTTCCTCTCCTGACCAAATCATCTTGTAAATTGGATCTTCAAAAAAATTCTAGTTGG,10,30,14,27,27,41,27,47,27,34,34,41,40,47,52.97,2.029114676
hek293t,13285,1,1,AGACAATGCTCTCACCCCATTGGGAAAGGTGGGGGTAACGATACTTGCCTTTGTAAAAACATGACGGAGCTTTGTGAAGGGTTGCTGTGAAAAAAAATT,AGACAATGCTCTCACCCCATTGGGAAAGTGTGGGGGTAACGATACTTGCCTTTGTAAAAACATGACGGAGCTTTGTGAAGGGTTGCTGTGAAAAAAAAT,10,30,14,27,27,32,27,33,27,29,29,32,30,33,50.35,6.081387772
hek293t,13285,1,1,ACTTGATGCTCTCACCCCATTGGGAAAGGTGGGGGTAACGATACTTGCCTTTGTAAAAACATGACGGAGCTTTGTGAAAAAAAAATTCTAGTTGGTTTA,ACTTGATGCTCTCACCCCATTGGGAAAGTGTGGGGGTAACGATACTTGCCTTTGTAAAAACATGACGGAGCTTTGTGAAAAAAAAATTCTAGTTGGTTT,10,30,14,27,27,44,27,45,27,29,29,44,30,45,50.35,43.02136341
hek293t,13287,1,12,ACAAATTAATAAAAATACACTTGAAGCCTTGGTCATTGCAGCTTTCTTAGGTTTTCAAATAAGTAATCACCTAAAAAAAATTCTAGTTGGTTTAACGCG,ACAAATTAATAAAAATACACTTGAAGCCTTCATGAGGAGAGGGGTCATTGCAGCTTTCTTAGGTTTTCAAATAAGTAATCACCTAAAAAAAATTCTAGT,10,30,14,27,27,38,27,50,27,31,31,38,43,50,27.76,0.093802219
hek293t,13287,1,12,TTTCGTTAATAAAAATACACTTGAAGCCTTGGTCATTGCAGCTTTCTTAGGTTTTCAAATAAGTAATCACAAAAAAATTCTAGTTGGTTTAACGCGTAA,TTTCGTTAATAAAAATACACTTGAAGCCTTCATGAGGAGAGGGGTCATTGCAGCTTTCTTAGGTTTTCAAATAAGTAATCACAAAAAAATTCTAGTTGG,10,30,14,27,27,41,27,53,27,31,31,41,43,53,27.76,0.0
hek293t,13289,1,2,GCGTTAACTCAAAGTTAAATCACACTTTATGGAAACTTGCATTTCTTTTTTGCTTTGAATCCCTGTTCACAGCACTTAGGGTACAAAAAAATTCTAGTT,GCGTTAACTCAAAGTTAAATCACACTTCTTATGGAAACTTGCATTTCTTTTTTGCTTTGAATCCCTGTTCACAGCACTTAGGGTACAAAAAAATTCTAG,10,30,14,27,27,37,27,39,27,27,27,37,29,39,-0.65,0.0
hek293t,13289,1,2,AATATAACTCAAAGTTAAATCACACTTTATGGAAACTTGCATTTCTTTTTTGCTTTGAATCCCTGTTCACAGCACTTAGGGTACTGGAAAAAAATTCTA,AATATAACTCAAAGTTAAATCACACTTCTTATGGAAACTTGCATTTCTTTTTTGCTTTGAATCCCTGTTCACAGCACTTAGGGTACTGGAAAAAAATTC,10,30,14,27,27,34,27,36,27,27,27,34,29,36,-0.65,0.0
hek293t,13291,1,7,ATATAACTTGCAGGAAAGGGCATTTGGGATGGATCAATGACATGATGGAGGTTTAAATCTTGCTTGCTGCAGTGATGAAAAAAATTCTAGTTGGTTTAA,ATATAACTTGCAGGAAAGGGCATTTGGGCGGAGGCATGGATCAATGACATGATGGAGGTTTAAATCTTGCTTGCTGCAGTGATGAAAAAAATTCTAGTT,10,30,14,27,27,39,27,46,27,29,29,39,36,46,41.16,37.13124972
hek293t,13291,1,7,CAAGGACTTGCAGGAAAGGGCATTTGGGATGGATCAATGACATGATGGAGGTTTAAATCTTGCTTGCTGCAGTGATGCCTTTGAAAAAAAATTCTAGTT,CAAGGACTTGCAGGAAAGGGCATTTGGGCGGAGGCATGGATCAATGACATGATGGAGGTTTAAATCTTGCTTGCTGCAGTGATGCCTTTGAAAAAAAAT,10,30,14,27,27,32,27,39,27,29,29,32,36,39,41.16,2.696785178
hek293t,13293,1,12,AATCCTATAAGGCAATTGGTATTGAAAAGAGGGACTGATATGACATAGACACATGTTTGAAAACAAAAAAAATTCTAGTTGGTTTAACGCGTAACTAGA,AATCCTATAAGGCAATTGGTATTGAAAAGAGGGACCGGGAGCTTATTTGATATGACATAGACACATGTTTGAAAACAAAAAAAATTCTAGTTGGTTTAA,10,30,14,27,27,46,27,58,27,36,36,46,48,58,39.02,0.504972106
hek293t,13293,1,12,GACTCTATAAGGCAATTGGTATTGAAAAGAGGGACTGATATGACATAGACACATGTTTGAAAACATGGCTCTAAAAAAATTCTAGTTGGTTTAACGCGT,GACTCTATAAGGCAATTGGTATTGAAAAGAGGGACCGGGAGCTTATTTGATATGACATAGACACATGTTTGAAAACATGGCTCTAAAAAAATTCTAGTT,10,30,14,27,27,39,27,51,27,36,36,39,48,51,39.02,0.0
hek293t,13296,1,5,ACAATAAAGACAAAACTTATTTGCCAGATTGGCTTTCTTCCACAAAGCCTAACGACTCCAATGCTCAGAGCTTGTTAGGACAAAAAAATTCTAGTTGGT,ACAATAAAGACAAAACTTATTTGCCATACTCGATTGGCTTTCTTCCACAAAGCCTAACGACTCCAATGCTCAGAGCTTGTTAGGACAAAAAAATTCTAG,10,30,14,27,27,37,27,42,27,27,27,37,32,42,0.66,38.77228062
hek293t,13296,1,5,GACAGAAAGACAAAACTTATTTGCCAGATTGGCTTTCTTCCACAAAGCCTAACGACTCCAATGCTCAGAGCTTGTTAGGACTGAAAAAAAATTCTAGTT,GACAGAAAGACAAAACTTATTTGCCATACTCGATTGGCTTTCTTCCACAAAGCCTAACGACTCCAATGCTCAGAGCTTGTTAGGACTGAAAAAAAATTC,10,30,14,27,27,34,27,39,27,27,27,34,32,39,0.66,26.35261336
hek293t,18153,1,10,GCATACCCCAAAATTATGTTGTTATGCTGTGGAAATCCTTAGTAAACACTGCTGTACTTTGCTATTTTGTATGCCTCAGAAAAAAAATTCTAGTTGGTT,GCATACCCCAAAATTATGTTGTTATGCTGATGAGGTTCCTGGAAATCCTTAGTAAACACTGCTGTACTTTGCTATTTTGTATGCCTCAGAAAAAAAATT,10,30,14,27,27,33,27,43,27,30,30,33,40,43,32.78,0.0
hek293t,18153,1,10,GACCGCCCCAAAATTATGTTGTTATGCTGTGGAAATCCTTAGTAAACACTGCTGTACTTTGCTATTTTGTATGCCTAAAAAAATTCTAGTTGGTTTAAC,GACCGCCCCAAAATTATGTTGTTATGCTGATGAGGTTCCTGGAAATCCTTAGTAAACACTGCTGTACTTTGCTATTTTGTATGCCTAAAAAAATTCTAG,10,30,14,27,27,37,27,47,27,30,30,37,40,47,32.78,0.763173492
hek293t,13300,1,10,TAGCTCATCTATATTACTAAGAAATTAATTGGCTTACAGTAGAATCTATAACTGTGTCATTTGTTAAAAAAAATTCTAGTTGGTTTAACGCGTAACTAG,TAGCTCATCTATATTACTAAGAAATTAATTGGCTTAGAGGTTTATTCAGTAGAATCTATAACTGTGTCATTTGTTAAAAAAAATTCTAGTTGGTTTAAC,10,30,14,27,27,47,27,57,27,37,37,47,47,57,2.08,0.150829563
hek293t,13301,1,11,TGATTGGTTAGAATCTGTGCGAATAGATTAGGAAACATTAGTTGGACCCCATCAGATACAGGGAATGAATCCTAGATCTTTTAAAAAAATTCTAGTTGG,TGATTGGTTAGAATCTGTGCGAATAGTGTGCTGTACCATTAGGAAACATTAGTTGGACCCCATCAGATACAGGGAATGAATCCTAGATCTTTTAAAAAA,10,30,14,27,27,30,27,41,27,27,27,30,38,41,17.33,4.347457598
hek293t,13301,1,11,ATGTGGGTTAGAATCTGTGCGAATAGATTAGGAAACATTAGTTGGACCCCATCAGATACAGGGAATGAATCCTAGATCAAAAAAATTCTAGTTGGTTTA,ATGTGGGTTAGAATCTGTGCGAATAGTGTGCTGTACCATTAGGAAACATTAGTTGGACCCCATCAGATACAGGGAATGAATCCTAGATCAAAAAAATTC,10,30,14,27,27,34,27,45,27,27,27,34,38,45,17.33,1.024397556
hek293t,13305,1,4,CGGATAATTTCCAGACATGAGTCCAGTGAAGGCTTTGACAAATCTGGGTTCTGCTCCACATCGGAGCTGGAGCTGGGGGAAAAAAATTCTAGTTGGTTT,CGGATAATTTCCAGACATGAGTCCAGTGAAGGCCTTCTTTGACAAATCTGGGTTCTGCTCCACATCGGAGCTGGAGCTGGGGGAAAAAAATTCTAGTTG,10,30,14,27,27,40,27,44,27,33,33,40,37,44,54.29,81.69211376
hek293t,13305,1,4,GGTTCAATTTCCAGACATGAGTCCAGTGAAGGCTTTGACAAATCTGGGTTCTGCTCCACATCGGAGCTGGAGCTGGGGGCAGCAAAAAAATTCTAGTTG,GGTTCAATTTCCAGACATGAGTCCAGTGAAGGCCTTCTTTGACAAATCTGGGTTCTGCTCCACATCGGAGCTGGAGCTGGGGGCAGCAAAAAAATTCTA,10,30,14,27,27,36,27,40,27,33,33,36,37,40,54.29,0.639110594
hek293t,22515,1,9,CTCATGCTTTCCCCAGGGTAGGGAGCTGGAGGGGCAGGAGCCCGAGAAGCCCAGTGCTCTGCCTGCGGTAAAAAAATTCTAGTTGGTTTAACGCGTAAC,CTCATGCTTTCCCCAGGGTAGGGAGCTGGAGGGGCAGCGCACCTGGGAGCCCGAGAAGCCCAGTGCTCTGCCTGCGGTAAAAAAATTCTAGTTGGTTTA,10,30,14,27,27,45,27,54,27,38,38,45,47,54,52.47,8.028397583
hek293t,22515,1,9,AAATAGCTTTCCCCAGGGTAGGGAGCTGGAGGGGCAGGAGCCCGAGAAGCCCAGTGCTCTGCCTGCAAAAAAATTCTAGTTGGTTTAACGCGTAACTAG,AAATAGCTTTCCCCAGGGTAGGGAGCTGGAGGGGCAGCGCACCTGGGAGCCCGAGAAGCCCAGTGCTCTGCCTGCAAAAAAATTCTAGTTGGTTTAACG,10,30,14,27,27,48,27,57,27,38,38,48,47,57,52.47,5.969135802
hek293t,13309,1,2,ATGCTTCTCTTCGACATTATTATAAACGAAGGCATCACCTTTGGAACCAGGGTTGTTGGCCGTGAAATCCTGTTTAATAGAAAGAAAAAAATTCTAGTT,ATGCTTCTCTTCGACATTATTATAAACGATAAGGCATCACCTTTGGAACCAGGGTTGTTGGCCGTGAAATCCTGTTTAATAGAAAGAAAAAAATTCTAG,10,30,14,27,27,37,27,39,27,30,30,37,32,39,50.92,0.0
hek293t,13309,1,2,TTATCTCTCTTCGACATTATTATAAACGAAGGCATCACCTTTGGAACCAGGGTTGTTGGCCGTGAAATCCTGTTTAAAAAAAATTCTAGTTGGTTTAAC,TTATCTCTCTTCGACATTATTATAAACGATAAGGCATCACCTTTGGAACCAGGGTTGTTGGCCGTGAAATCCTGTTTAAAAAAAATTCTAGTTGGTTTA,10,30,14,27,27,45,27,47,27,30,30,45,32,47,50.92,0.227485435
hek293t,13311,1,1,AATATGTTAAAAACAGTGCGGGGATGGGAAGGGAGATAAATTGGAGCAAATATGCCCTAGCCCTCCCACCCCCTGGCACCCAGCAAAAAAATTCTAGTT,AATATGTTAAAAACAGTGCGGGGATGGGAAGGGATGATAAATTGGAGCAAATATGCCCTAGCCCTCCCACCCCCTGGCACCCAGCAAAAAAATTCTAGT,10,30,14,27,27,38,27,39,27,35,35,38,36,39,47.24,1.877303511
hek293t,13311,1,1,GGAAAGTTAAAAACAGTGCGGGGATGGGAAGGGAGATAAATTGGAGCAAATATGCCCTAGCCCTCCCACCCCAAAAAAATTCTAGTTGGTTTAACGCGT,GGAAAGTTAAAAACAGTGCGGGGATGGGAAGGGATGATAAATTGGAGCAAATATGCCCTAGCCCTCCCACCCCAAAAAAATTCTAGTTGGTTTAACGCG,10,30,14,27,27,50,27,51,27,35,35,50,36,51,47.24,34.97674447
hek293t,13313,1,13,TGTTGAGATGCCAGAAGATTCTCTGATCTAGGCATCTGGGAATTAAAATCTTCCTGAGCATAATTAAAAAAAATTCTAGTTGGTTTAACGCGTAACTAG,TGTTGAGATGCCAGAAGATTCTCTGATCTAGGCGCCACGATCGATTATCTGGGAATTAAAATCTTCCTGAGCATAATTAAAAAAAATTCTAGTTGGTTT,10,30,14,27,27,44,27,57,27,34,34,44,47,57,36.97,8.356845441
hek293t,13313,1,13,ATGCAAGATGCCAGAAGATTCTCTGATCTAGGCATCTGGGAATTAAAATCTTCCTGAGCATAATTAAAGTGTTAAAAAAATTCTAGTTGGTTTAACGCG,ATGCAAGATGCCAGAAGATTCTCTGATCTAGGCGCCACGATCGATTATCTGGGAATTAAAATCTTCCTGAGCATAATTAAAGTGTTAAAAAAATTCTAG,10,30,14,27,27,37,27,50,27,34,34,37,47,50,36.97,0.0
hek293t,13315,1,8,GATTACAAAGTCAAAAGCAACTATAACACAGGTCGGATTTTCAGGTCAGTGTACTTAACAAAAAATTCCAAAAAAATTCTAGTTGGTTTAACGCGTAAC,GATTACAAAGTCAAAAGCAACTATAACACAGGTCCTTCGGTCGGATTTTCAGGTCAGTGTACTTAACAAAAAATTCCAAAAAAATTCTAGTTGGTTTAA,10,30,14,27,27,46,27,54,27,31,31,46,39,54,62.34,6.366530593
hek293t,13315,1,8,TACGCCAAAGTCAAAAGCAACTATAACACAGGTCGGATTTTCAGGTCAGTGTACTTAACAAAAAATTCCCATTGAAAAAAATTCTAGTTGGTTTAACGC,TACGCCAAAGTCAAAAGCAACTATAACACAGGTCCTTCGGTCGGATTTTCAGGTCAGTGTACTTAACAAAAAATTCCCATTGAAAAAAATTCTAGTTGG,10,30,14,27,27,41,27,49,27,31,31,41,39,49,62.34,9.883777945
hek293t,13317,1,11,GTCTTACTGGGCTGCTGCGACCCCTGAGATGGTCTCCCTGCAACCACCCGGGACACACCGAGCCTAAAAAAATTCTAGTTGGTTTAACGCGTAACTAGA,GTCTTACTGGGCTGCTGCGACCCCTGAGATGGTCTCCCTCTAGGGTCCTGGCAACCACCCGGGACACACCGAGCCTAAAAAAATTCTAGTTGGTTTAAC,10,30,14,27,27,47,27,58,27,40,40,47,51,58,51.7,0.0
hek293t,13318,1,9,CGCTCCTCAGAAACCTGCAAGAACTACACAGGGAACGCCAGCTTACAACCAGACCTGGTTTGTTCTTTGAAGTGGAAAAAAAAATTCTAGTTGGTTTAA,CGCTCCTCAGAAACCTGCAAGAACTACACCATATTTCGAGGGAACGCCAGCTTACAACCAGACCTGGTTTGTTCTTTGAAGTGGAAAAAAAAATTCTAG,10,30,14,27,27,37,27,46,27,30,30,37,39,46,52.37,44.77193503
hek293t,13320,1,5,AGCATCTGTTGCATTCCACTGCTTCTAGTAGGAATTGCTTTCAGAAATTGTGGTTCAATCAGTTTTGTCTTAGAGGAAGAACACGATAAAAAAAATTCT,AGCATCTGTTGCATTCCACTGCTTCTCACACAGTAGGAATTGCTTTCAGAAATTGTGGTTCAATCAGTTTTGTCTTAGAGGAAGAACACGATAAAAAAA,10,30,14,27,27,30,27,35,27,27,27,30,32,35,33.29,2.328420145
hek293t,13320,1,5,TCACCCTGTTGCATTCCACTGCTTCTAGTAGGAATTGCTTTCAGAAATTGTGGTTCAATCAGTTTTGTCTTAGAGGAAAAAAATTCTAGTTGGTTTAAC,TCACCCTGTTGCATTCCACTGCTTCTCACACAGTAGGAATTGCTTTCAGAAATTGTGGTTCAATCAGTTTTGTCTTAGAGGAAAAAAATTCTAGTTGGT,10,30,14,27,27,42,27,47,27,27,27,42,32,47,33.29,80.12925012
hek293t,13322,1,6,CCCTGGGCTTTAGGAAGGCACAGTTCTTTTGGGGGAGCAAAACTTATACCAAGCAAGAAATAGACAAAAAAATTCTAGTTGGTTTAACGCGTAACTAGA,CCCTGGGCTTTAGGAAGGCACAGTTCTTTTGGGGGAGCAAATGCAAAACTTATACCAAGCAAGAAATAGACAAAAAAATTCTAGTTGGTTTAACGCGTA,10,30,14,27,27,52,27,58,27,37,37,52,43,58,8.9,0.230443244
hek293t,13322,1,6,CTAGAGGCTTTAGGAAGGCACAGTTCTTTTGGGGGAGCAAAACTTATACCAAGCAAGAAATAGACTTGACAAAAAAATTCTAGTTGGTTTAACGCGTAA,CTAGAGGCTTTAGGAAGGCACAGTTCTTTTGGGGGAGCAAATGCAAAACTTATACCAAGCAAGAAATAGACTTGACAAAAAAATTCTAGTTGGTTTAAC,10,30,14,27,27,47,27,53,27,37,37,47,43,53,8.9,0.0
hek293t,13326,1,9,GTCTACCTGAACTATCTCATGTGAGGAGGAGGTCAGTGACTGGGATAGCTGGATAATCCTGGCGGATTTTGGCGGAAAAAAAATTCTAGTTGGTTTAAC,GTCTACCTGAACTATCTCATGTGAGGAGGAGGTCTGGGTTGGGAGTGACTGGGATAGCTGGATAATCCTGGCGGATTTTGGCGGAAAAAAAATTCTAGT,10,30,14,27,27,38,27,47,27,35,35,38,44,47,46.13,2.362300172
hek293t,13326,1,9,TAGTGCCTGAACTATCTCATGTGAGGAGGAGGTCAGTGACTGGGATAGCTGGATAATCCTGGCGGATTTTGGAAAAAAATTCTAGTTGGTTTAACGCGT,TAGTGCCTGAACTATCTCATGTGAGGAGGAGGTCTGGGTTGGGAGTGACTGGGATAGCTGGATAATCCTGGCGGATTTTGGAAAAAAATTCTAGTTGGT,10,30,14,27,27,42,27,51,27,35,35,42,44,51,46.13,3.586299433
hek293t,13328,1,2,TTAGGGAAATCACAACAAGCTCTGGAGGGAGGACCCAAGTAGCTACACTCTTCCAAGAATCTAGCATTGCAACTGGAAAAAAATTCTAGTTGGTTTAAC,TTAGGGAAATCACAACAAGCTCTGGAGGGAGAGGACCCAAGTAGCTACACTCTTCCAAGAATCTAGCATTGCAACTGGAAAAAAATTCTAGTTGGTTTA,10,30,14,27,27,45,27,47,27,30,30,45,32,47,52.7,82.23384267
hek293t,13328,1,2,TCATAGAAATCACAACAAGCTCTGGAGGGAGGACCCAAGTAGCTACACTCTTCCAAGAATCTAGCATTGCAACTGGAAGATAAAAAAATTCTAGTTGGT,TCATAGAAATCACAACAAGCTCTGGAGGGAGAGGACCCAAGTAGCTACACTCTTCCAAGAATCTAGCATTGCAACTGGAAGATAAAAAAATTCTAGTTG,10,30,14,27,27,40,27,42,27,30,30,40,32,42,52.7,80.50193047
hek293t,13331,1,2,AACCGATGCTGAGTGTGACCTTTGCTATTTGGTTACAAATCTATTAGATCCATAATGAAATGGCAATCTTGGAAATCAAAAAAATTCTAGTTGGTTTAA,AACCGATGCTGAGTGTGACCTTTGCTATCCTTGGTTACAAATCTATTAGATCCATAATGAAATGGCAATCTTGGAAATCAAAAAAATTCTAGTTGGTTT,10,30,14,27,27,44,27,46,27,29,29,44,31,46,11.07,78.12837175
hek293t,13331,1,2,CGGCTATGCTGAGTGTGACCTTTGCTATTTGGTTACAAATCTATTAGATCCATAATGAAATGGCAATCTTGGAAATCAAAAAATAAAAAAAATTCTAGT,CGGCTATGCTGAGTGTGACCTTTGCTATCCTTGGTTACAAATCTATTAGATCCATAATGAAATGGCAATCTTGGAAATCAAAAAATAAAAAAAATTCTA,10,30,14,27,27,36,27,38,27,29,29,36,31,38,11.07,41.14230203
hek293t,13333,1,13,GGAAGAGTTGCCAGGTTCCTGTATCTTGAAGGGACTTGAACATTTGTACCAAGTCTACCAAATATCACAAAAAAATTCTAGTTGGTTTAACGCGTAACT,GGAAGAGTTGCCAGGTTCCTGTATCTGCAGTCTCGTGAATGAAGGGACTTGAACATTTGTACCAAGTCTACCAAATATCACAAAAAAATTCTAGTTGGT,10,30,14,27,27,42,27,55,27,27,27,42,40,55,23.67,31.66956369
hek293t,13335,1,1,AGTCGGGGCAGTTTCTTTTCCATCACCCCTGGAGATCTGGCTAAGGGCTAATCATCACCTCTCCATCTCTCCTGAAAAAAAATTCTAGTTGGTTTAACG,AGTCGGGGCAGTTTCTTTTCCATCACCCCTGGAGATGCTGGCTAAGGGCTAATCATCACCTCTCCATCTCTCCTGAAAAAAAATTCTAGTTGGTTTAAC,10,30,14,27,27,47,27,48,27,37,37,47,38,48,49.29,64.38368612
hek293t,13335,1,1,GCCGAGGGCAGTTTCTTTTCCATCACCCCTGGAGATCTGGCTAAGGGCTAATCATCACCTCTCCATCTCTAAAAAAATTCTAGTTGGTTTAACGCGTAA,GCCGAGGGCAGTTTCTTTTCCATCACCCCTGGAGATGCTGGCTAAGGGCTAATCATCACCTCTCCATCTCTAAAAAAATTCTAGTTGGTTTAACGCGTA,10,30,14,27,27,52,27,53,27,37,37,52,38,53,49.29,71.6161107
hek293t,13337,1,4,TCACAGATTTATTAATGGATGGACTGCTCTGGTGCTTATTAGAATGAACAGAGTCCTTGTCCTCCTGTAAAAAAAATTCTAGTTGGTTTAACGCGTAAC,TCACAGATTTATTAATGGATGGACTGCTCTGGTGCCTGCTTATTAGAATGAACAGAGTCCTTGTCCTCCTGTAAAAAAAATTCTAGTTGGTTTAACGCG,10,30,14,27,27,50,27,54,27,35,35,50,39,54,39.53,60.94748587
hek293t,13337,1,4,TCTGCGATTTATTAATGGATGGACTGCTCTGGTGCTTATTAGAATGAACAGAGTCCTTGTCCTCCTGTATGTTCAAAAAAATTCTAGTTGGTTTAACGC,TCTGCGATTTATTAATGGATGGACTGCTCTGGTGCCTGCTTATTAGAATGAACAGAGTCCTTGTCCTCCTGTATGTTCAAAAAAATTCTAGTTGGTTTA,10,30,14,27,27,45,27,49,27,35,35,45,39,49,39.53,76.56228114
hek293t,13339,1,9,GATTGATAGATTTTTGTCTTGTTAGCTGGTGGCTCTCGGTTTATTGGCATAAAAATGTACCAGAAATCTCTTTTGCTTCCAATAAAAAAATTCTAGTTG,GATTGATAGATTTTTGTCTTGTTAGCTGCCACAATTGGTGGCTCTCGGTTTATTGGCATAAAAATGTACCAGAAATCTCTTTTGCTTCCAATAAAAAAA,10,30,14,27,27,31,27,40,27,28,28,31,37,40,25.37,0.0
hek293t,13339,1,9,CCTAAATAGATTTTTGTCTTGTTAGCTGGTGGCTCTCGGTTTATTGGCATAAAAATGTACCAGAAATCTCTAAAAAAATTCTAGTTGGTTTAACGCGTA,CCTAAATAGATTTTTGTCTTGTTAGCTGCCACAATTGGTGGCTCTCGGTTTATTGGCATAAAAATGTACCAGAAATCTCTAAAAAAATTCTAGTTGGTT,10,30,14,27,27,43,27,52,27,28,28,43,37,52,25.37,2.730676558
hek293t,13341,1,4,CTGGCGAATCTTAGTCATTTTAAAATTTGAGGTCTAATTTGAGCTAGTTGCCTAGACTCCTCTGGTAGTCAATGGATGGGTACATAAAAAAATTCTAGT,CTGGCGAATCTTAGTCATTTTAAAATTTACTTGAGGTCTAATTTGAGCTAGTTGCCTAGACTCCTCTGGTAGTCAATGGATGGGTACATAAAAAAATTC,10,30,14,27,27,34,27,38,27,27,27,34,31,38,-0.81,0.0
hek293t,13343,1,2,AGCTTTAAACATTCTCCCTCAGACTTACCTGGGTTTGAGACATGTGATAATGAACTGTTAATTGATCGTAGTACAAAAGAAGTTCAAAATAAAAAAATT,AGCTTTAAACATTCTCCCTCAGACTTAAACCTGGGTTTGAGACATGTGATAATGAACTGTTAATTGATCGTAGTACAAAAGAAGTTCAAAATAAAAAAA,10,30,14,27,27,31,27,33,27,28,28,31,30,33,15.07,2.90233516
hek293t,13343,1,2,ATACCTAAACATTCTCCCTCAGACTTACCTGGGTTTGAGACATGTGATAATGAACTGTTAATTGATCGTAGTACAAAAGAAGTAAAAAAATTCTAGTTG,ATACCTAAACATTCTCCCTCAGACTTAAACCTGGGTTTGAGACATGTGATAATGAACTGTTAATTGATCGTAGTACAAAAGAAGTAAAAAAATTCTAGT,10,30,14,27,27,38,27,40,27,28,28,38,30,40,15.07,55.04221084
hek293t,13345,1,9,CGCGGTATAAGTTAATTGTGTAAGCTAATAGGAGTGGTGCTCACAATGTCATTTTGAAAGTTAAAGAGGAAATGGAAAAAAAATTCTAGTTGGTTTAAC,CGCGGTATAAGTTAATTGTGTAAGCTAATTAATTGGATAGGAGTGGTGCTCACAATGTCATTTTGAAAGTTAAAGAGGAAATGGAAAAAAAATTCTAGT,10,30,14,27,27,38,27,47,27,28,28,38,37,47,17.16,36.73764497
hek293t,13345,1,9,GCGCCTATAAGTTAATTGTGTAAGCTAATAGGAGTGGTGCTCACAATGTCATTTTGAAAGTTAAAGAGGAAATGGATGAGAATAAAAAAATTCTAGTTG,GCGCCTATAAGTTAATTGTGTAAGCTAATTAATTGGATAGGAGTGGTGCTCACAATGTCATTTTGAAAGTTAAAGAGGAAATGGATGAGAATAAAAAAA,10,30,14,27,27,31,27,40,27,28,28,31,37,40,17.16,0.283171521
hek293t,13349,1,13,ACGCTACTGACAACCTCCCTACTGGCATTTGGGATTCAATATTACTACATATAAAACTGATTTTTGGAAAAAAATTCTAGTTGGTTTAACGCGTAACTA,ACGCTACTGACAACCTCCCTACTGGCATTTGGGATTCAAACGGAAAGACATTTATTACTACATATAAAACTGATTTTTGGAAAAAAATTCTAGTTGGTT,10,30,14,27,27,43,27,56,27,40,40,43,53,56,21.22,0.132496457
hek293t,13350,1,3,CCCATCTGGAGTACAGCACAGTTGGCCTCAGGCTCCGATTTCTGTACTTAGAATTTAAAACTAGAAAATTGCAAAAAAATTCTAGTTGGTTTAACGCGT,CCCATCTGGAGTACAGCACAGTTGGCCTCAGGCTCCGCGAATTTCTGTACTTAGAATTTAAAACTAGAAAATTGCAAAAAAATTCTAGTTGGTTTAACG,10,30,14,27,27,48,27,51,27,38,38,48,41,51,56.29,84.8325756
hek293t,13352,1,12,AAAGTCTGTCTTTAATATCAAGCAAACTACGGCTTTGGTCAAGAGAGAAAGCAGCTACAACCAGAAATTAAAAAAATTCTAGTTGGTTTAACGCGTAAC,AAAGTCTGTCTTTAATATCAAGCAAACTACGGCTCTTTCTCAACGGTTGGTCAAGAGAGAAAGCAGCTACAACCAGAAATTAAAAAAATTCTAGTTGGT,10,30,14,27,27,42,27,54,27,35,35,42,47,54,38.64,0.0
hek293t,13354,1,13,TTTAAGCAGTGTTGGGCAGCCCTTCCAAGGGGCTTATTTGGAAATCAGCAAGAACCCCAAGTACAAAAAGAAAAAAATTCTAGTTGGTTTAACGCGTAA,TTTAAGCAGTGTTGGGCAGCCCTTCCAAGGGGCTTATGTGCAAGTCTGATTTGGAAATCAGCAAGAACCCCAAGTACAAAAAGAAAAAAATTCTAGTTG,10,30,14,27,27,40,27,53,27,37,37,40,50,53,62.98,0.0
hek293t,13358,1,7,CAAGGAGTTCCAAGCAAACATTATTTCTCAGGATTTCGTAAGATCATCTTATGGAGTAAATAGCATTTAAAAAAAAATTCTAGTTGGTTTAACGCGTAA,CAAGGAGTTCCAAGCAAACATTATTTCTCAGGATTCCCTTCTTCGTAAGATCATCTTATGGAGTAAATAGCATTTAAAAAAAAATTCTAGTTGGTTTAA,10,30,14,27,27,46,27,53,27,36,36,46,43,53,4.23,1.84948933
hek293t,13358,1,7,GGATCAGTTCCAAGCAAACATTATTTCTCAGGATTTCGTAAGATCATCTTATGGAGTAAATAGCATTTAATCATGACAAAAAAATTCTAGTTGGTTTAA,GGATCAGTTCCAAGCAAACATTATTTCTCAGGATTCCCTTCTTCGTAAGATCATCTTATGGAGTAAATAGCATTTAATCATGACAAAAAAATTCTAGTT,10,30,14,27,27,39,27,46,27,36,36,39,43,46,4.23,0.0
hek293t,13360,1,3,ATCCTGACCCCAGCTGATTCTTTCTTTGCAGGGAAGGGAACTGCATGAAAAAATACCAAGAGTAATACACATCTGAGGTACAGAAAAAAAATTCTAGTT,ATCCTGACCCCAGCTGATTCTTTCTTTGCAGGTCGGAAGGGAACTGCATGAAAAAATACCAAGAGTAATACACATCTGAGGTACAGAAAAAAAATTCTA,10,30,14,27,27,36,27,39,27,33,33,36,36,39,9.2,0.149560666
hek293t,13360,1,3,CGGGGGACCCCAGCTGATTCTTTCTTTGCAGGGAAGGGAACTGCATGAAAAAATACCAAGAGTAATACACATCTGAGGTAAAAAAAATTCTAGTTGGTT,CGGGGGACCCCAGCTGATTCTTTCTTTGCAGGTCGGAAGGGAACTGCATGAAAAAATACCAAGAGTAATACACATCTGAGGTAAAAAAAATTCTAGTTG,10,30,14,27,27,40,27,43,27,33,33,40,36,43,9.2,43.1592051
hek293t,13364,1,1,AAACCGATGTTCTAATTGCCAAACTAAGAAGGTACTCAATGTTAAAATGTTACCCTTTCCTCAGGTTAAAAGGATTCACTGGTTAAAAAAATTCTAGTT,AAACCGATGTTCTAATTGCCAAACTAAAGAAGGTACTCAATGTTAAAATGTTACCCTTTCCTCAGGTTAAAAGGATTCACTGGTTAAAAAAATTCTAGT,10,30,14,27,27,38,27,39,27,28,28,38,29,39,13.5,5.171496494
hek293t,13364,1,1,TAATCGATGTTCTAATTGCCAAACTAAGAAGGTACTCAATGTTAAAATGTTACCCTTTCCTCAGGTTAAAAGGATTCACAAAAAAATTCTAGTTGGTTT,TAATCGATGTTCTAATTGCCAAACTAAAGAAGGTACTCAATGTTAAAATGTTACCCTTTCCTCAGGTTAAAAGGATTCACAAAAAAATTCTAGTTGGTT,10,30,14,27,27,43,27,44,27,28,28,43,29,44,13.5,7.634018456
hek293t,13366,1,13,GTCTTTTATTACCCATTTACTTTTAATTCAGGTTCCAATCCTCCATTATGGCAAAAATAAAATCAAAAAAATTCTAGTTGGTTTAACGCGTAACTAGAT,GTCTTTTATTACCCATTTACTTTTAATTCAGGTTCAGAATTCGGCATCCAATCCTCCATTATGGCAAAAATAAAATCAAAAAAATTCTAGTTGGTTTAA,10,30,14,27,27,46,27,59,27,36,36,46,49,59,3.23,0.0
hek293t,13366,1,13,AGTGATTATTACCCATTTACTTTTAATTCAGGTTCCAATCCTCCATTATGGCAAAAATAAAATCTTCAAAAAAATTCTAGTTGGTTTAACGCGTAACTA,AGTGATTATTACCCATTTACTTTTAATTCAGGTTCAGAATTCGGCATCCAATCCTCCATTATGGCAAAAATAAAATCTTCAAAAAAATTCTAGTTGGTT,10,30,14,27,27,43,27,56,27,36,36,43,49,56,3.23,0.0
hek293t,13368,1,11,CACTGGCAGTGCTCCCTGAATTTTAGGCTCGGTAGGAGAGCTCTAAAAGCCGTGCGAGGAAAGCGAGTTAAAAAAAATTCTAGTTGGTTTAACGCGTAA,CACTGGCAGTGCTCCCTGAATTTTAGGCTCGGTAGGAGCAGTATCTCTGAGCTCTAAAAGCCGTGCGAGGAAAGCGAGTTAAAAAAAATTCTAGTTGGT,10,30,14,27,27,42,27,53,27,39,39,42,50,53,33.63,0.0
hek293t,13373,1,8,TTCTTATACCTGCAGTTCCTCAGAAAGGCTGGCCTGATGACTATGCGGTTGATGCCAGTGTTTTAAAAAAATTCTAGTTGGTTTAACGCGTAACTAGAT,TTCTTATACCTGCAGTTCCTCAGAAAGGCTGGCCTGATGAAGCTTAGACTATGCGGTTGATGCCAGTGTTTTAAAAAAATTCTAGTTGGTTTAACGCGT,10,30,14,27,27,51,27,59,27,41,41,51,49,59,33.97,8.606892584
hek293t,13374,1,7,CCTTCTGAAGAGGGCCTTCCCAAATTCTTAGGGCTTGTATGTGACAACTAGCAGACACAAATGAAGAACTAAAAAAATTCTAGTTGGTTTAACGCGTAA,CCTTCTGAAGAGGGCCTTCCCAAATTCTTACACCAAGGGGCTTGTATGTGACAACTAGCAGACACAAATGAAGAACTAAAAAAATTCTAGTTGGTTTAA,10,30,14,27,27,46,27,53,27,31,31,46,38,53,8.67,61.96567591
hek293t,13374,1,7,TCTTGTGAAGAGGGCCTTCCCAAATTCTTAGGGCTTGTATGTGACAACTAGCAGACACAAATGAAGAACTGATAGGAAAAAAAAATTCTAGTTGGTTTA,TCTTGTGAAGAGGGCCTTCCCAAATTCTTACACCAAGGGGCTTGTATGTGACAACTAGCAGACACAAATGAAGAACTGATAGGAAAAAAAAATTCTAGT,10,30,14,27,27,38,27,45,27,31,31,38,38,45,8.67,18.83840471
hek293t,13376,1,13,CCTCTGTTCGCACAAAAGGCTGGAAGATATGGAGCAGGACTGATGAGTAACATTTCGTCAAGAAGATTCAAAAAAAATTCTAGTTGGTTTAACGCGTAA,CCTCTGTTCGCACAAAAGGCTGGAAGATAAGAAATGTGGCGTTGGAGCAGGACTGATGAGTAACATTTCGTCAAGAAGATTCAAAAAAAATTCTAGTTG,10,30,14,27,27,40,27,53,27,30,30,40,43,53,23.51,0.937797871
hek293t,13376,1,13,CATCCGTTCGCACAAAAGGCTGGAAGATATGGAGCAGGACTGATGAGTAACATTTCGTCAAGAAGATTCATTCATAGAAAAAAATTCTAGTTGGTTTAA,CATCCGTTCGCACAAAAGGCTGGAAGATAAGAAATGTGGCGTTGGAGCAGGACTGATGAGTAACATTTCGTCAAGAAGATTCATTCATAGAAAAAAATT,10,30,14,27,27,33,27,46,27,30,30,33,43,46,23.51,0.0
hek293t,13378,1,8,CGGGATCCAATTTAGTGGTTATTTAGACATGGAGTTACTTATAATATATGCAGTACATTGGTTTGGCTGTTAAAAAAATTCTAGTTGGTTTAACGCGTA,CGGGATCCAATTTAGTGGTTATTTAGACATGGAGTTGTGACGTTACTTATAATATATGCAGTACATTGGTTTGGCTGTTAAAAAAATTCTAGTTGGTTT,10,30,14,27,27,44,27,52,27,34,34,44,42,52,30.48,3.653272259
hek293t,13378,1,8,ATTCATCCAATTTAGTGGTTATTTAGACATGGAGTTACTTATAATATATGCAGTACATTGGTTTGGAAAAAAATTCTAGTTGGTTTAACGCGTAACTAG,ATTCATCCAATTTAGTGGTTATTTAGACATGGAGTTGTGACGTTACTTATAATATATGCAGTACATTGGTTTGGAAAAAAATTCTAGTTGGTTTAACGC,10,30,14,27,27,49,27,57,27,34,34,49,42,57,30.48,3.68152996
hek293t,20101,1,7,CAACAATTGGACCTGAAAGGGGCGGACAGAGGCAAACAGGAAAAAGACTAGCACAGAGAAAGGTCCTGTGTAAAAAAATTCTAGTTGGTTTAACGCGTA,CAACAATTGGACCTGAAAGGGGCGGACAGAGGCAAACGACAGTTAGGAAAAAGACTAGCACAGAGAAAGGTCCTGTGTAAAAAAATTCTAGTTGGTTTA,10,30,14,27,27,45,27,52,27,38,38,45,45,52,41.13,0.741398756
hek293t,20101,1,7,CTCCTATTGGACCTGAAAGGGGCGGACAGAGGCAAACAGGAAAAAGACTAGCACAGAGAAAGGTCCTGAAAAAAATTCTAGTTGGTTTAACGCGTAACT,CTCCTATTGGACCTGAAAGGGGCGGACAGAGGCAAACGACAGTTAGGAAAAAGACTAGCACAGAGAAAGGTCCTGAAAAAAATTCTAGTTGGTTTAACG,10,30,14,27,27,48,27,55,27,38,38,48,45,55,41.13,2.842285326
hek293t,13382,1,11,AGCATTATCCCCCAAGTATCTTTGTTTAGTGGCTCTGCACAACAGATGGAATTTTATGTCATGCAGCAAAAAAATTCTAGTTGGTTTAACGCGTAACTA,AGCATTATCCCCCAAGTATCTTTGTTTAGTGGCTCTGAGGTCCGGGATCACAACAGATGGAATTTTATGTCATGCAGCAAAAAAATTCTAGTTGGTTTA,10,30,14,27,27,45,27,56,27,38,38,45,49,56,8.33,1.318758582
hek293t,13383,1,5,AGTTCCTGAAATGTGCTTCCCATCAAAACAGGGCAGCAAGGGAGACTGTGGGAGGAGGGTGCTCTAATGCAAAAAAATTCTAGTTGGTTTAACGCGTAA,AGTTCCTGAAATGTGCTTCCCATCAAAACAGGGCAGCAAGGCGTAGGAGACTGTGGGAGGAGGGTGCTCTAATGCAAAAAAATTCTAGTTGGTTTAACG,10,30,14,27,27,48,27,53,27,41,41,48,46,53,30.54,3.829542473
hek293t,13384,1,10,GTCCCTAATGCACAGATCTTCTCTAATGGTGGAAAAGTGAAAGGTTTGTTGTGAAAAGCTTTTCTATCCAAAAAAATTCTAGTTGGTTTAACGCGTAAC,GTCCCTAATGCACAGATCTTCTCTAATGGTGGAAAAGTGACGTGGAATAGAAGGTTTGTTGTGAAAAGCTTTTCTATCCAAAAAAATTCTAGTTGGTTT,10,30,14,27,27,44,27,54,27,41,41,44,51,54,59.68,0.0
hek293t,13385,1,3,CATTTTTAATGGCCAGGGGCTATGGTCAATGGTTGGACAAGCAAGGTTTGCACTGGATAACCTTCATCTACCCAGAACCTGCAAAAAAATTCTAGTTGG,CATTTTTAATGGCCAGGGGCTATGGTCAATGGTTATCGGACAAGCAAGGTTTGCACTGGATAACCTTCATCTACCCAGAACCTGCAAAAAAATTCTAGT,10,30,14,27,27,38,27,41,27,35,35,38,38,41,37.59,0.0
hek293t,13385,1,3,CAACTTTAATGGCCAGGGGCTATGGTCAATGGTTGGACAAGCAAGGTTTGCACTGGATAACCTTCATCTAAAAAAAATTCTAGTTGGTTTAACGCGTAA,CAACTTTAATGGCCAGGGGCTATGGTCAATGGTTATCGGACAAGCAAGGTTTGCACTGGATAACCTTCATCTAAAAAAAATTCTAGTTGGTTTAACGCG,10,30,14,27,27,50,27,53,27,35,35,50,38,53,37.59,3.990264633
hek293t,13387,1,2,GAAGCCCTTACTCTAAGGAGTTTCTCGTCTGGGACAGAAATGGGGTTCCTAGTCCCAGAGTTGGCAAAAAAATTCTAGTTGGTTTAACGCGTAACTAGA,GAAGCCCTTACTCTAAGGAGTTTCTCGTCTGGGACAGAAATTTGGGGTTCCTAGTCCCAGAGTTGGCAAAAAAATTCTAGTTGGTTTAACGCGTAACTA,10,30,14,27,27,56,27,58,27,41,41,56,43,58,13.33,69.05271729
hek293t,2898,1,9,ATTACGTTTGTGCCTTGTGGTCTGCTTTCAGGACAGTAATAACCATATTATGACAGCAAGAATCACATTGAGTAAAAAAATTCTAGTTGGTTTAACGCG,ATTACGTTTGTGCCTTGTGGTCTGCTTTCAGACTATGGAGGACAGTAATAACCATATTATGACAGCAAGAATCACATTGAGTAAAAAAATTCTAGTTGG,10,30,14,27,27,41,27,50,27,31,31,41,40,50,5.57,40.843912
hek293t,2898,1,9,CAGATGTTTGTGCCTTGTGGTCTGCTTTCAGGACAGTAATAACCATATTATGACAGCAAGAATCACATTGAGTTCATTGCAAAAAAATTCTAGTTGGTT,CAGATGTTTGTGCCTTGTGGTCTGCTTTCAGACTATGGAGGACAGTAATAACCATATTATGACAGCAAGAATCACATTGAGTTCATTGCAAAAAAATTC,10,30,14,27,27,34,27,43,27,31,31,34,40,43,5.57,0.35868893
hek293t,13391,1,6,AAAACATTTATGAAAGTGACTTTTTTGCATGGTGGTTACAGCATTCTCTTGGCACATGGAAAGCCTCAGTTCAATCCTATGTTAAAAAAATTCTAGTTG,AAAACATTTATGAAAGTGACTTTTTTGCATACAACAGGTGGTTACAGCATTCTCTTGGCACATGGAAAGCCTCAGTTCAATCCTATGTTAAAAAAATTC,10,30,14,27,27,34,27,40,27,31,31,34,37,40,25.81,0.0
hek293t,13391,1,6,AGCGAATTTATGAAAGTGACTTTTTTGCATGGTGGTTACAGCATTCTCTTGGCACATGGAAAGCCTCAGTTCAATCCTAAAAAAAATTCTAGTTGGTTT,AGCGAATTTATGAAAGTGACTTTTTTGCATACAACAGGTGGTTACAGCATTCTCTTGGCACATGGAAAGCCTCAGTTCAATCCTAAAAAAAATTCTAGT,10,30,14,27,27,38,27,44,27,31,31,38,37,44,25.81,0.310835975
hek293t,13393,1,11,GTATCAAAATAAACTCTGTTCAAAGATTCTGGAGCCATGATATGAGAATTCCAATAAGTTTTTAAAAAAAATTCTAGTTGGTTTAACGCGTAACTAGAT,GTATCAAAATAAACTCTGTTCAAAGATTCTGGAGCCATGATGACAATTATTTATGAGAATTCCAATAAGTTTTTAAAAAAAATTCTAGTTGGTTTAACG,10,30,14,27,27,48,27,59,27,41,41,48,52,59,12.55,0.0
hek293t,13396,1,2,TATTCCACAGGTAAATAAATCATGGTGTGAGGAACATTTACATAACTATTAGCAACTGAAAATGTTAGTATAGATAAAAAAATTCTAGTTGGTTTAACG,TATTCCACAGGTAAATAAATCATGGTGTGACGGGAACATTTACATAACTATTAGCAACTGAAAATGTTAGTATAGATAAAAAAATTCTAGTTGGTTTAA,10,30,14,27,27,46,27,48,27,31,31,46,33,48,59.42,21.14290243
hek293t,13396,1,2,GACACCACAGGTAAATAAATCATGGTGTGAGGAACATTTACATAACTATTAGCAACTGAAAATGTTAGTATAGATTTCCTTCTAAAAAAATTCTAGTTG,GACACCACAGGTAAATAAATCATGGTGTGACGGGAACATTTACATAACTATTAGCAACTGAAAATGTTAGTATAGATTTCCTTCTAAAAAAATTCTAGT,10,30,14,27,27,38,27,40,27,31,31,38,33,40,59.42,37.85623218
hek293t,13398,1,13,GAGTTTAGGTTTGGGATGTGTCTTCCAACAGGCTGCAGAGAACTAAGAGCAGTGTAATAATGAAAATAAAAAAAAATTCTAGTTGGTTTAACGCGTAAC,GAGTTTAGGTTTGGGATGTGTCTTCCAACAGAACACCTGAAACGGCTGCAGAGAACTAAGAGCAGTGTAATAATGAAAATAAAAAAAAATTCTAGTTGG,10,30,14,27,27,41,27,54,27,31,31,41,44,54,40.91,3.784787047
hek293t,13398,1,13,CTGGCTAGGTTTGGGATGTGTCTTCCAACAGGCTGCAGAGAACTAAGAGCAGTGTAATAATGAAAATAAACCTTTCAAAAAAATTCTAGTTGGTTTAAC,CTGGCTAGGTTTGGGATGTGTCTTCCAACAGAACACCTGAAACGGCTGCAGAGAACTAAGAGCAGTGTAATAATGAAAATAAACCTTTCAAAAAAATTC,10,30,14,27,27,34,27,47,27,31,31,34,44,47,40.91,0.0
hek293t,13402,1,15,GCCTATCGGGTGAGCAACGAATGTGGGACTGGCCATGTAGGTTTGTAAATAACTAAGCTAAACAAAAAAAATTCTAGTTGGTTTAACGCGTAACTAGAT,GCCTATCGGGTGAGCAACGAATGTGGGATAGGCCAACCTTACGCTGGCCATGTAGGTTTGTAAATAACTAAGCTAAACAAAAAAAATTCTAGTTGGTTT,10,30,14,27,27,44,27,59,27,29,29,44,44,59,34.53,15.99630009
hek293t,13402,1,15,AAAACTCGGGTGAGCAACGAATGTGGGACTGGCCATGTAGGTTTGTAAATAACTAAGCTAAACAACAGTGAAAAAAAAATTCTAGTTGGTTTAACGCGT,AAAACTCGGGTGAGCAACGAATGTGGGATAGGCCAACCTTACGCTGGCCATGTAGGTTTGTAAATAACTAAGCTAAACAACAGTGAAAAAAAAATTCTA,10,30,14,27,27,36,27,51,27,29,29,36,44,51,34.53,0.30686613
hek293t,23025,1,2,CACTTCAAAAATGAAGAGCTGAAGAGCACTGGTCATGGGAGAAACCACCAAAAAGCAAGAAGCTTGGTATGTTCCCAGAACTGAAAAAAATTCTAGTTG,CACTTCAAAAATGAAGAGCTGAAGAGCACTAGGGTCATGGGAGAAACCACCAAAAAGCAAGAAGCTTGGTATGTTCCCAGAACTGAAAAAAATTCTAGT,10,30,14,27,27,38,27,40,27,31,31,38,33,40,65.06,76.59080409
hek293t,23025,1,2,AGCCGCAAAAATGAAGAGCTGAAGAGCACTGGTCATGGGAGAAACCACCAAAAAGCAAGAAGCTTGGTATGTTCCAAAAAAATTCTAGTTGGTTTAACG,AGCCGCAAAAATGAAGAGCTGAAGAGCACTAGGGTCATGGGAGAAACCACCAAAAAGCAAGAAGCTTGGTATGTTCCAAAAAAATTCTAGTTGGTTTAA,10,30,14,27,27,46,27,48,27,31,31,46,33,48,65.06,77.76778939
hek293t,20518,1,1,TAATCCATACTTGATGGCCTGGGACAGGTTGGCAGGCCCCCCCGGAAATTATTAACCTCAAGCCAAGTCTGTTAAGAAGAAAAAAATTCTAGTTGGTTT,TAATCCATACTTGATGGCCTGGGACAGGTTGGCAGGCCCCCCCCGGAAATTATTAACCTCAAGCCAAGTCTGTTAAGAAGAAAAAAATTCTAGTTGGTT,10,30,14,27,27,43,27,44,27,40,40,43,41,44,48.02,0.0
hek293t,13408,1,8,CCTATCATGACTTCATCAGGTAGTTTTATTGGCTTACCTGATTTCTCTTCTGTCATGTGCTTGGAACTACAATAAAAAAATTCTAGTTGGTTTAACGCG,CCTATCATGACTTCATCAGGTAGTTTTATTGTCAAGGGAGCTTACCTGATTTCTCTTCTGTCATGTGCTTGGAACTACAATAAAAAAATTCTAGTTGGT,10,30,14,27,27,42,27,50,27,32,32,42,40,50,9.48,8.676244419
hek293t,13408,1,8,GGCTCCATGACTTCATCAGGTAGTTTTATTGGCTTACCTGATTTCTCTTCTGTCATGTGCTTGGAACTAAAAAAATTCTAGTTGGTTTAACGCGTAACT,GGCTCCATGACTTCATCAGGTAGTTTTATTGTCAAGGGAGCTTACCTGATTTCTCTTCTGTCATGTGCTTGGAACTAAAAAAATTCTAGTTGGTTTAAC,10,30,14,27,27,47,27,55,27,32,32,47,40,55,9.48,11.7617129
hek293t,13410,1,15,TGGCCTGAAGTTCAGTCGGCTCCAGATACAGGCCCCCTCCGCTCAAAATGCTCGATAAACTGCTAACATGCAAAAAAATTCTAGTTGGTTTAACGCGTA,TGGCCTGAAGTTCAGTCGGCTCCAGAACTACAAAAAGACGCTACAGGCCCCCTCCGCTCAAAATGCTCGATAAACTGCTAACATGCAAAAAAATTCTAG,10,30,14,27,27,37,27,52,27,27,27,37,42,52,39.79,12.98091733
hek293t,13410,1,15,TATAGTGAAGTTCAGTCGGCTCCAGATACAGGCCCCCTCCGCTCAAAATGCTCGATAAACTGCTAACATGCTTTTCTTAAAAAAATTCTAGTTGGTTTA,TATAGTGAAGTTCAGTCGGCTCCAGAACTACAAAAAGACGCTACAGGCCCCCTCCGCTCAAAATGCTCGATAAACTGCTAACATGCTTTTCTTAAAAAA,10,30,14,27,27,30,27,45,27,27,27,30,42,45,39.79,0.86177834
hek293t,13412,1,15,CGAGCCTGCCTGTTCCAGAGCCAGGCGAGAGGCACTGGGATTAAGAAACTGGCACTGAAAATATTAGAGACATTAAAAAAATTCTAGTTGGTTTAACGC,CGAGCCTGCCTGTTCCAGAGCCAGGCGAGAGAAAATTGAGCATCTGGCACTGGGATTAAGAAACTGGCACTGAAAATATTAGAGACATTAAAAAAATTC,10,30,14,27,27,34,27,49,27,31,31,34,46,49,59.43,0.0
hek293t,13413,1,4,ACATCGTGAGGGTAAGAAATGACCTGGCCAGGGCATACGCCCCGAAGTGCTCAATAGCAATCCAAAATGCTTAAAAAAATTCTAGTTGGTTTAACGCGT,ACATCGTGAGGGTAAGAAATGACCTGGCCAGGGCATACGGGAACCCCGAAGTGCTCAATAGCAATCCAAAATGCTTAAAAAAATTCTAGTTGGTTTAAC,10,30,14,27,27,47,27,51,27,40,40,47,44,51,27.48,45.7843812
hek293t,13415,1,8,ATGGCACAAAACCAACAGTAGATATTATGAGGAAACCATTTATTATATGATGACTATTATTGAATTCTTTAAAAAAATTCTAGTTGGTTTAACGCGTAA,ATGGCACAAAACCAACAGTAGATATTATGAGGAAACCCTCGCGCAATTTATTATATGATGACTATTATTGAATTCTTTAAAAAAATTCTAGTTGGTTTA,10,30,14,27,27,45,27,53,27,38,38,45,46,53,40.33,0.0
hek293t,13416,1,10,CTGAGATCTCAGTGCTACATTGCTTCTACAGGTTTTGGAACTTAGTATCAGCTTAATAATAACAGTTAAAAAAATTCTAGTTGGTTTAACGCGTAACTA,CTGAGATCTCAGTGCTACATTGCTTCTACACACGCTCGCAGGTTTTGGAACTTAGTATCAGCTTAATAATAACAGTTAAAAAAATTCTAGTTGGTTTAA,10,30,14,27,27,46,27,56,27,31,31,46,41,56,25.38,34.06650399
hek293t,13420,1,3,ATGGACCAGCCTGCAGTGCTCCAGACGTATGGAGGGAGGCGTAGGAGGAACGGTCAGGCACAGGACTGGTGCAGCTTTGAAAAAAAAAATTCTAGTTGG,ATGGACCAGCCTGCAGTGCTCCAGACGTATGGAGTGTGGAGGCGTAGGAGGAACGGTCAGGCACAGGACTGGTGCAGCTTTGAAAAAAAAAATTCTAGT,10,30,14,27,27,38,27,41,27,35,35,38,38,41,59.91,1.90752298
hek293t,13422,1,8,CCAGGCTAATGCTGCTTTTAATGTAGTTGGGGTCTCTGTCATGTTGACAGTGCCACATGGGCCCGCTCCTCCGAAAAAAAAATTCTAGTTGGTTTAACG,CCAGGCTAATGCTGCTTTTAATGTAGTTGGGGTCTCCAGTCCCTTGTCATGTTGACAGTGCCACATGGGCCCGCTCCTCCGAAAAAAAAATTCTAGTTG,10,30,14,27,27,40,27,48,27,37,37,40,45,48,16.36,0.0
hek293t,13423,1,4,AGCGCGACTAGAGTAACTACATACGCTTTTGGGATTTGTGGTTTTAATTAGGCTTATAATTTCTGCAATTAAAGCCATAGAAAAAAATTCTAGTTGGTT,AGCGCGACTAGAGTAACTACATACGCTTTTGGGATAGCCTTGTGGTTTTAATTAGGCTTATAATTTCTGCAATTAAAGCCATAGAAAAAAATTCTAGTT,10,30,14,27,27,39,27,43,27,36,36,39,40,43,26.59,0.537634409
hek293t,13423,1,4,CGTGTGACTAGAGTAACTACATACGCTTTTGGGATTTGTGGTTTTAATTAGGCTTATAATTTCTGCAATTAAAAAAAAAATTCTAGTTGGTTTAACGCG,CGTGTGACTAGAGTAACTACATACGCTTTTGGGATAGCCTTGTGGTTTTAATTAGGCTTATAATTTCTGCAATTAAAAAAAAAATTCTAGTTGGTTTAA,10,30,14,27,27,46,27,50,27,36,36,46,40,50,26.59,61.3127842
hek293t,13425,1,6,TAACATGATCACTACTTGGATTGATGTTTTGGGTAGACTTTTCAGTCTTGCTGTACTTAATGACAGGTAACACTCAAAAAAATTCTAGTTGGTTTAACG,TAACATGATCACTACTTGGATTGATGTTTTGGGTAGACGAGGCCTTTTCAGTCTTGCTGTACTTAATGACAGGTAACACTCAAAAAAATTCTAGTTGGT,10,30,14,27,27,42,27,48,27,39,39,42,45,48,6.03,0.252187632
hek293t,13426,1,1,TCGGAACATGAGCTTTCTGGTGATATTTGAGGGAAAGTAGAATGAAGGCGCCCCATTGTCTTCATTTAACTTTCTTCGAAAAAAAATTCTAGTTGGTTT,TCGGAACATGAGCTTTCTGGTGATATTTGAGGGAATAGTAGAATGAAGGCGCCCCATTGTCTTCATTTAACTTTCTTCGAAAAAAAATTCTAGTTGGTT,10,30,14,27,27,43,27,44,27,36,36,43,37,44,29.27,44.54894127
hek293t,13426,1,1,CAAGGACATGAGCTTTCTGGTGATATTTGAGGGAAAGTAGAATGAAGGCGCCCCATTGTCTTCATTTAACTTTCTTCGAATTGAAAAAAATTCTAGTTG,CAAGGACATGAGCTTTCTGGTGATATTTGAGGGAATAGTAGAATGAAGGCGCCCCATTGTCTTCATTTAACTTTCTTCGAATTGAAAAAAATTCTAGTT,10,30,14,27,27,39,27,40,27,36,36,39,37,40,29.27,1.124315516
hek293t,13428,1,10,AGTTATAAGTGCTAATGCTATGCAGGAGCAGGAAAAAGGACACAAGCAAATCAGAGGCCCCCCCGGAAAGGAAAAAAATTCTAGTTGGTTTAACGCGTA,AGTTATAAGTGCTAATGCTATGCAGGAGCAGGAAAAAGTGAGACCGTCGACACAAGCAAATCAGAGGCCCCCCCGGAAAGGAAAAAAATTCTAGTTGGT,10,30,14,27,27,42,27,52,27,39,39,42,49,52,41.34,0.0
hek293t,13428,1,10,CATCTTAAGTGCTAATGCTATGCAGGAGCAGGAAAAAGGACACAAGCAAATCAGAGGCCCCCCCGGAAAAAAAATTCTAGTTGGTTTAACGCGTAACTA,CATCTTAAGTGCTAATGCTATGCAGGAGCAGGAAAAAGTGAGACCGTCGACACAAGCAAATCAGAGGCCCCCCCGGAAAAAAAATTCTAGTTGGTTTAA,10,30,14,27,27,46,27,56,27,39,39,46,49,56,41.34,0.404802568
hek293t,13430,1,5,GTTACTCGAGCATTGATACGGGCGAGATTTGGGGAGGGGAGAGAAGGGAAGTGTGGCAAAGGAAACATTTCCAGCCCCCCCCCCAAAAAAATTCTAGTT,GTTACTCGAGCATTGATACGGGCGAGATTTCCTTGGGGGAGGGGAGAGAAGGGAAGTGTGGCAAAGGAAACATTTCCAGCCCCCCCCCCAAAAAAATTC,10,30,14,27,27,34,27,39,27,31,31,34,36,39,14.51,6.5780508
hek293t,13430,1,5,TCTGTTCGAGCATTGATACGGGCGAGATTTGGGGAGGGGAGAGAAGGGAAGTGTGGCAAAGGAAACATTTCCAAAAAAATTCTAGTTGGTTTAACGCGT,TCTGTTCGAGCATTGATACGGGCGAGATTTCCTTGGGGGAGGGGAGAGAAGGGAAGTGTGGCAAAGGAAACATTTCCAAAAAAATTCTAGTTGGTTTAA,10,30,14,27,27,46,27,51,27,31,31,46,36,51,14.51,74.78396267
hek293t,13432,1,3,TTTGATGTGATCATGGTCTTTCTCTGAACTGGTAATAGAGCTAGAACTTAAACACAGAATTCTTGAACGTTTCTGTAAAAAAATTCTAGTTGGTTTAAC,TTTGATGTGATCATGGTCTTTCTCTGAATCCCTGGTAATAGAGCTAGAACTTAAACACAGAATTCTTGAACGTTTCTGTAAAAAAATTCTAGTTGGTTT,10,30,14,27,27,44,27,47,27,29,29,44,32,47,30.54,44.20001072
hek293t,13432,1,3,ACAGCTGTGATCATGGTCTTTCTCTGAACTGGTAATAGAGCTAGAACTTAAACACAGAATTCTTGAACGTTTCTGTGTGGGAATCTTCAAAAAAATTCT,ACAGCTGTGATCATGGTCTTTCTCTGAATCCCTGGTAATAGAGCTAGAACTTAAACACAGAATTCTTGAACGTTTCTGTGTGGGAATCTTCAAAAAAAT,10,30,14,27,27,32,27,35,27,29,29,32,32,35,30.54,8.418994805
hek293t,13434,1,12,ATGGGGCCACCAGCAAAGGGCACAGGACCTGGTGCACAGCAAAAGGGAGGACCTGGAGACTATCCGTGCCAAAAAAATTCTAGTTGGTTTAACGCGTAA,ATGGGGCCACCAGCAAAGGGCACAGGACCTGGTGCACGATAGCTCCTATAGCAAAAGGGAGGACCTGGAGACTATCCGTGCCAAAAAAATTCTAGTTGG,10,30,14,27,27,41,27,53,27,38,38,41,50,53,47.86,0.152905199
hek293t,13434,1,12,GAAGTGCCACCAGCAAAGGGCACAGGACCTGGTGCACAGCAAAAGGGAGGACCTGGAGACTATCCGAAAAAAATTCTAGTTGGTTTAACGCGTAACTAG,GAAGTGCCACCAGCAAAGGGCACAGGACCTGGTGCACGATAGCTCCTATAGCAAAAGGGAGGACCTGGAGACTATCCGAAAAAAATTCTAGTTGGTTTA,10,30,14,27,27,45,27,57,27,38,38,45,50,57,47.86,0.0
hek293t,13436,1,3,CACACATCTGATTTATCACTGTAGAGGAGGGGTCCCAGGTAGCCCTGTTAGGGTATATGGCAGCTGATTTCTAATTCAGTCATTGCAAAAAAATTCTAG,CACACATCTGATTTATCACTGTAGAGTCTGAGGGGTCCCAGGTAGCCCTGTTAGGGTATATGGCAGCTGATTTCTAATTCAGTCATTGCAAAAAAATTC,10,30,14,27,27,34,27,37,27,27,27,34,30,37,48.89,83.16401901
hek293t,13436,1,3,TGAGTATCTGATTTATCACTGTAGAGGAGGGGTCCCAGGTAGCCCTGTTAGGGTATATGGCAGCTGATTTCTAATTCAGTCATTGCATGAAAAAAAATT,TGAGTATCTGATTTATCACTGTAGAGTCTGAGGGGTCCCAGGTAGCCCTGTTAGGGTATATGGCAGCTGATTTCTAATTCAGTCATTGCATGAAAAAAA,10,30,14,27,27,30,27,33,27,27,27,30,30,33,48.89,9.733384978
hek293t,13438,1,3,GCACAGATCTCCTTCCCTTCCTCCCTCAGGGGAGGCCTTTGTCAGTTTAAACGATTTTCCCAGCAGTGCCTCAAAAAAATTCTAGTTGGTTTAACGCGT,GCACAGATCTCCTTCCCTTCCTCCCTCAGGGGAGGCCGTCTTTGTCAGTTTAAACGATTTTCCCAGCAGTGCCTCAAAAAAATTCTAGTTGGTTTAACG,10,30,14,27,27,48,27,51,27,38,38,48,41,51,63.24,70.55156574
hek293t,5009,1,13,ATTCGATTGTCACTTTGTAGCAGTGCCTATGGTCTGGTAAGAAGAGAATCATCTGCAAAACAGCACAAAAAAATTCTAGTTGGTTTAACGCGTAACTAG,ATTCGATTGTCACTTTGTAGCAGTGCCTATGGTGACGGGTTATTATCTGGTAAGAAGAGAATCATCTGCAAAACAGCACAAAAAAATTCTAGTTGGTTT,10,30,14,27,27,44,27,57,27,34,34,44,47,57,29.1,5.997875675
hek293t,5009,1,13,CTAAGATTGTCACTTTGTAGCAGTGCCTATGGTCTGGTAAGAAGAGAATCATCTGCAAAACAGCACGCTAAAAAAATTCTAGTTGGTTTAACGCGTAAC,CTAAGATTGTCACTTTGTAGCAGTGCCTATGGTGACGGGTTATTATCTGGTAAGAAGAGAATCATCTGCAAAACAGCACGCTAAAAAAATTCTAGTTGG,10,30,14,27,27,41,27,54,27,34,34,41,47,54,29.1,1.009216171
hek293t,13442,1,8,GGACCACTTCATACTGCTTTTGTAACTACTGGAATGTAAAAATAAACTTAATGCATATACAGGCTTACCAGGAAAAAAATTCTAGTTGGTTTAACGCGT,GGACCACTTCATACTGCTTTTGTAACTACTGGAATACTGCACTGTAAAAATAAACTTAATGCATATACAGGCTTACCAGGAAAAAAATTCTAGTTGGTT,10,30,14,27,27,43,27,51,27,36,36,43,44,51,11.2,0.326797386
hek293t,13442,1,8,CTGCCACTTCATACTGCTTTTGTAACTACTGGAATGTAAAAATAAACTTAATGCATATACAGGCAAAAAAATTCTAGTTGGTTTAACGCGTAACTAGAT,CTGCCACTTCATACTGCTTTTGTAACTACTGGAATACTGCACTGTAAAAATAAACTTAATGCATATACAGGCAAAAAAATTCTAGTTGGTTTAACGCGT,10,30,14,27,27,51,27,59,27,36,36,51,44,59,11.2,0.021150592
hek293t,13444,1,2,TCACAATTACACTCATCTGGTGGATGTGTCGGTTCATCAACTTCATAAGCTAATGGTTCTCAGTTTGCAAATTGGTATTTAAAAAAAATTCTAGTTGGT,TCACAATTACACTCATCTGGTGGATGTGTCGGTTCAGGTCAACTTCATAAGCTAATGGTTCTCAGTTTGCAAATTGGTATTTAAAAAAAATTCTAGTTG,10,30,14,27,27,40,27,42,27,37,37,40,39,42,47.64,0.192678227
hek293t,13444,1,2,GGCGAATTACACTCATCTGGTGGATGTGTCGGTTCATCAACTTCATAAGCTAATGGTTCTCAGTTTGCAAATTGAAAAAAATTCTAGTTGGTTTAACGC,GGCGAATTACACTCATCTGGTGGATGTGTCGGTTCAGGTCAACTTCATAAGCTAATGGTTCTCAGTTTGCAAATTGAAAAAAATTCTAGTTGGTTTAAC,10,30,14,27,27,47,27,49,27,37,37,47,39,49,47.64,82.65595909
hek293t,13446,1,11,GGAACTAACGGAGACCTCACAGAGTAAAAAGGTCTTACATGGTCCACACAACGTCACAGCTGCATTTGAAAAAAATTCTAGTTGGTTTAACGCGTAACT,GGAACTAACGGAGACCTCACAGAGTAAAAAGGTCTTACATCGATGAAATTGGGTCCACACAACGTCACAGCTGCATTTGAAAAAAATTCTAGTTGGTTT,10,30,14,27,27,44,27,55,27,41,41,44,52,55,26.02,0.0
hek293t,13447,1,14,CTTAAACTTCTCATGTGTCTCTAGACTACAGGAAGGTTGCTGATGGCTTGGAGTTCCCATATTCTAAAAAAATTCTAGTTGGTTTAACGCGTAACTAGA,CTTAAACTTCTCATGTGTCTCTAGACTACAGGAAGGTTGCATTAGAGGAGGATCTGATGGCTTGGAGTTCCCATATTCTAAAAAAATTCTAGTTGGTTT,10,30,14,27,27,44,27,58,27,41,41,44,55,58,36.13,0.0
hek293t,13448,1,4,CCCTTAACGAGATGCTGGGATTGCAAAGCAGGGACTCGGCAACTTATGCAAACTGCTCTCAGTTGGAGGCCTCAAAAAAAATTCTAGTTGGTTTAACGC,CCCTTAACGAGATGCTGGGATTGCAAAGCAGGGACTCTCTCGGCAACTTATGCAAACTGCTCTCAGTTGGAGGCCTCAAAAAAAATTCTAGTTGGTTTA,10,30,14,27,27,45,27,49,27,35,35,45,39,49,42.26,82.72511652
hek293t,13449,1,9,GAGAGTGGGACATACCTGGCTTCATAATCTGGAAAATATGCTATAGATCAGTAATGGAATTGATGTAGACTGATATAAAAAAATTCTAGTTGGTTTAAC,GAGAGTGGGACATACCTGGCTTCATAATTCGCGTACTCTGGAAAATATGCTATAGATCAGTAATGGAATTGATGTAGACTGATATAAAAAAATTCTAGT,10,30,14,27,27,38,27,47,27,28,28,38,37,47,16.44,11.99362019
hek293t,13449,1,9,GGCCATGGGACATACCTGGCTTCATAATCTGGAAAATATGCTATAGATCAGTAATGGAATTGATGTAGACTAAAAAAATTCTAGTTGGTTTAACGCGTA,GGCCATGGGACATACCTGGCTTCATAATTCGCGTACTCTGGAAAATATGCTATAGATCAGTAATGGAATTGATGTAGACTAAAAAAATTCTAGTTGGTT,10,30,14,27,27,43,27,52,27,28,28,43,37,52,16.44,10.62348828
hek293t,13451,1,7,GGGACGAAAAAAGAAAGCAATTCTGGAACAGGAAGCGGCTGTGCGGCAAAGAGGCGGGGGCTCCGCGCCGGGCAGCAAAAAAATTCTAGTTGGTTTAAC,GGGACGAAAAAAGAAAGCAATTCTGGAACAGGGCATGGGAAGCGGCTGTGCGGCAAAGAGGCGGGGGCTCCGCGCCGGGCAGCAAAAAAATTCTAGTTG,10,30,14,27,27,40,27,47,27,33,33,40,40,47,27.03,43.63674661
hek293t,13451,1,7,TACAAGAAAAAAGAAAGCAATTCTGGAACAGGAAGCGGCTGTGCGGCAAAGAGGCGGGGGCTCCGCGCCGGGCAGCCGGAAAAAAAATTCTAGTTGGTT,TACAAGAAAAAAGAAAGCAATTCTGGAACAGGGCATGGGAAGCGGCTGTGCGGCAAAGAGGCGGGGGCTCCGCGCCGGGCAGCCGGAAAAAAAATTCTA,10,30,14,27,27,36,27,43,27,33,33,36,40,43,27.03,2.22971984
hek293t,5876,1,12,TGATGGTGCTATGCAGAACACCTATATTGAGGAGATATAGAACTGTGTGGGAGATTAGCTCAAAAAAAAAAATTCTAGTTGGTTTAACGCGTAACTAGA,TGATGGTGCTATGCAGAACACCTATATTGAGGAGATATCTACCTGGCGACAGAACTGTGTGGGAGATTAGCTCAAAAAAAAAAATTCTAGTTGGTTTAA,10,30,14,27,27,46,27,58,27,39,39,46,51,58,74.47,0.0
hek293t,234,1,5,ACAAACCTTTTTGTACTTAAACTATCATTTGGGGGAAATTGGGAAAATTAAATGGGAATAATTAAAATACTCTGTTAAAAAAAAATTCTAGTTGGTTTA,ACAAACCTTTTTGTACTTAAACTATCATTTGGGGGGAGGGAAATTGGGAAAATTAAATGGGAATAATTAAAATACTCTGTTAAAAAAAAATTCTAGTTG,10,30,14,27,27,40,27,45,27,33,33,40,38,45,4.04,0.0
hek293t,234,1,5,ACAAACCTTTTTGTACTTAAACTATCATTTGGGGGAAATTGGGAAAATTAAATGGGAATAATTAAAATACAAAAAAATTCTAGTTGGTTTAACGCGTAA,ACAAACCTTTTTGTACTTAAACTATCATTTGGGGGGAGGGAAATTGGGAAAATTAAATGGGAATAATTAAAATACAAAAAAATTCTAGTTGGTTTAACG,10,30,14,27,27,48,27,53,27,33,33,48,38,53,4.04,1.917191201
hek293t,13456,1,5,GGTCCAAGTCAGGCCTTAAACTTTATATATGGGGCAGTTCTACTGAAAACTAGTATTACCCCAGTAGTAAAAAAAATTCTAGTTGGTTTAACGCGTAAC,GGTCCAAGTCAGGCCTTAAACTTTATATATGGGGCAGTCAATGTCTACTGAAAACTAGTATTACCCCAGTAGTAAAAAAAATTCTAGTTGGTTTAACGC,10,30,14,27,27,49,27,54,27,39,39,49,44,54,10.48,2.812525389
hek293t,13456,1,5,CACTGAAGTCAGGCCTTAAACTTTATATATGGGGCAGTTCTACTGAAAACTAGTATTACCCCAGTAGTATTTTTACAAAAAAATTCTAGTTGGTTTAAC,CACTGAAGTCAGGCCTTAAACTTTATATATGGGGCAGTCAATGTCTACTGAAAACTAGTATTACCCCAGTAGTATTTTTACAAAAAAATTCTAGTTGGT,10,30,14,27,27,42,27,47,27,39,39,42,44,47,10.48,0.0
hek293t,13458,1,7,GCATTTTCTGTTAAACTGGAGCATGTGTGAGGACAAATCCAGAAGATAAACCATAGCTGAGATGATTTATACTCTTAAAAAAATTCTAGTTGGTTTAAC,GCATTTTCTGTTAAACTGGAGCATGTGTGAGGACAATTCCTCTATCCAGAAGATAAACCATAGCTGAGATGATTTATACTCTTAAAAAAATTCTAGTTG,10,30,14,27,27,40,27,47,27,37,37,40,44,47,60.5,1.933255819
hek293t,13458,1,7,CTAGATTCTGTTAAACTGGAGCATGTGTGAGGACAAATCCAGAAGATAAACCATAGCTGAGATGAAAAAAATTCTAGTTGGTTTAACGCGTAACTAGAT,CTAGATTCTGTTAAACTGGAGCATGTGTGAGGACAATTCCTCTATCCAGAAGATAAACCATAGCTGAGATGAAAAAAATTCTAGTTGGTTTAACGCGTA,10,30,14,27,27,52,27,59,27,37,37,52,44,59,60.5,6.343545666
hek293t,13460,1,15,CTAGTATTTACTACAGCTCATTCACAACTAGGTTGCACTTCAGGGATATTACATTATGCATGACAAAAAAAATTCTAGTTGGTTTAACGCGTAACTAGA,CTAGTATTTACTACAGCTCATTCACAAGCATGCGGCGCGAAGCTAGGTTGCACTTCAGGGATATTACATTATGCATGACAAAAAAAATTCTAGTTGGTT,10,30,14,27,27,43,27,58,27,28,28,43,43,58,55.01,30.33568042
hek293t,13460,1,15,TGGCGATTTACTACAGCTCATTCACAACTAGGTTGCACTTCAGGGATATTACATTATGCATGACACAAGACAGAAAAAAATTCTAGTTGGTTTAACGCG,TGGCGATTTACTACAGCTCATTCACAAGCATGCGGCGCGAAGCTAGGTTGCACTTCAGGGATATTACATTATGCATGACACAAGACAGAAAAAAATTCT,10,30,14,27,27,35,27,50,27,28,28,35,43,50,55.01,57.03562142
hek293t,13462,1,5,CTACTCAGATATCAAAGACAAGGAAGAAGAGGTCTGATCCAGCCTTACTGAAGCAGAAAGGACTATTTTGTAGCTAAAAAAAATTCTAGTTGGTTTAAC,CTACTCAGATATCAAAGACAAGGAAGAAGAGGTCTGATGAACCCCAGCCTTACTGAAGCAGAAAGGACTATTTTGTAGCTAAAAAAAATTCTAGTTGGT,10,30,14,27,27,42,27,47,27,39,39,42,44,47,61.41,0.0
hek293t,13462,1,5,ATATACAGATATCAAAGACAAGGAAGAAGAGGTCTGATCCAGCCTTACTGAAGCAGAAAGGACTATTTTAAAAAAATTCTAGTTGGTTTAACGCGTAAC,ATATACAGATATCAAAGACAAGGAAGAAGAGGTCTGATGAACCCCAGCCTTACTGAAGCAGAAAGGACTATTTTAAAAAAATTCTAGTTGGTTTAACGC,10,30,14,27,27,49,27,54,27,39,39,49,44,54,61.41,11.2461531
hek293t,13466,1,8,GGTCTACAAATGAATACAATTGGTGTCTGTGGTCTGTATTTATTCGCTATAGTGGTAGAGATGGTGCAAAAAAATTCTAGTTGGTTTAACGCGTAACTA,GGTCTACAAATGAATACAATTGGTGTCTGTGGTCTGTCCACACGCATTTATTCGCTATAGTGGTAGAGATGGTGCAAAAAAATTCTAGTTGGTTTAACG,10,30,14,27,27,48,27,56,27,38,38,48,46,56,46.54,16.34441625
hek293t,13466,1,8,TCGCAACAAATGAATACAATTGGTGTCTGTGGTCTGTATTTATTCGCTATAGTGGTAGAGATGGTGCTAAAAAAAAATTCTAGTTGGTTTAACGCGTAA,TCGCAACAAATGAATACAATTGGTGTCTGTGGTCTGTCCACACGCATTTATTCGCTATAGTGGTAGAGATGGTGCTAAAAAAAAATTCTAGTTGGTTTA,10,30,14,27,27,45,27,53,27,38,38,45,46,53,46.54,0.298579752
hek293t,13468,1,11,AGGGACATGAAAGCAAAGAAGTGCTTCTGTGGAAAGAAGCATTTGAGGAAGTATAGTTGATATTCAAAAAAAAATTCTAGTTGGTTTAACGCGTAACTA,AGGGACATGAAAGCAAAGAAGTGCTTCTGGTGCCGTAACTTGGAAAGAAGCATTTGAGGAAGTATAGTTGATATTCAAAAAAAAATTCTAGTTGGTTTA,10,30,14,27,27,45,27,56,27,30,30,45,41,56,41.7,15.21403214
hek293t,13468,1,11,GTGGGCATGAAAGCAAAGAAGTGCTTCTGTGGAAAGAAGCATTTGAGGAAGTATAGTTGATATTCAATGTTTTATCTCCAAAAAAATTCTAGTTGGTTT,GTGGGCATGAAAGCAAAGAAGTGCTTCTGGTGCCGTAACTTGGAAAGAAGCATTTGAGGAAGTATAGTTGATATTCAATGTTTTATCTCCAAAAAAATT,10,30,14,27,27,33,27,44,27,30,30,33,41,44,41.7,0.0
hek293t,13470,1,2,GCTGAGCTGGCTTTGTCTCATCAGAAATGTGGAAGAACTCTAGCGTTTCTTTTAGATAGAAACTTATCTAAATATGGAATAAAAAAATTCTAGTTGGTT,GCTGAGCTGGCTTTGTCTCATCAGAAATGTGGAAGAAACCTCTAGCGTTTCTTTTAGATAGAAACTTATCTAAATATGGAATAAAAAAATTCTAGTTGG,10,30,14,27,27,41,27,43,27,38,38,41,40,43,62.05,1.999283644
hek293t,13470,1,2,CCTTCGCTGGCTTTGTCTCATCAGAAATGTGGAAGAACTCTAGCGTTTCTTTTAGATAGAAACTTATCTAAATATGAAAAAAATTCTAGTTGGTTTAAC,CCTTCGCTGGCTTTGTCTCATCAGAAATGTGGAAGAAACCTCTAGCGTTTCTTTTAGATAGAAACTTATCTAAATATGAAAAAAATTCTAGTTGGTTTA,10,30,14,27,27,45,27,47,27,38,38,45,40,47,62.05,57.04697763
hek293t,13472,1,10,TTATCATTTCCATAACAGTTTGGCGACCCAGGTGGGACCCTAGGTGACCACTGTCGGGGCCTCTCGTAAAAAAATTCTAGTTGGTTTAACGCGTAACTA,TTATCATTTCCATAACAGTTTGGCGACCCAAATGTAGTTAGGTGGGACCCTAGGTGACCACTGTCGGGGCCTCTCGTAAAAAAATTCTAGTTGGTTTAA,10,30,14,27,27,46,27,56,27,31,31,46,41,56,56.72,23.8443501
hek293t,13473,1,5,GTCATCATCCCTTTGTAATATTCACCAATAGGTGGCATTGGCAATACCCAGTTGTTTGCAATTTGCAGTCATTTTGATACAAAAAAATTCTAGTTGGTT,GTCATCATCCCTTTGTAATATTCACCAATACATATGGTGGCATTGGCAATACCCAGTTGTTTGCAATTTGCAGTCATTTTGATACAAAAAAATTCTAGT,10,30,14,27,27,38,27,43,27,31,31,38,36,43,14.68,0.789242816
hek293t,13473,1,5,CCAATCATCCCTTTGTAATATTCACCAATAGGTGGCATTGGCAATACCCAGTTGTTTGCAATTTGCAGTCATTTTGAAAAAAAATTCTAGTTGGTTTAA,CCAATCATCCCTTTGTAATATTCACCAATACATATGGTGGCATTGGCAATACCCAGTTGTTTGCAATTTGCAGTCATTTTGAAAAAAAATTCTAGTTGG,10,30,14,27,27,41,27,46,27,31,31,41,36,46,14.68,3.407192871
hek293t,13475,1,15,TAGTTAGATAGGTGTCATAGCCATGATGCAGGCTCATGGAAAGTCTTCCCTGAGATTTTGCTCCGTCTTGAAAAAAATTCTAGTTGGTTTAACGCGTAA,TAGTTAGATAGGTGTCATAGCCATGATGACATCGCCACAAACGCAGGCTCATGGAAAGTCTTCCCTGAGATTTTGCTCCGTCTTGAAAAAAATTCTAGT,10,30,14,27,27,38,27,53,27,28,28,38,43,53,63.18,34.99274799
hek293t,13479,1,4,ACGCTGAGCTTTTGCCCCCCCTCCTAGTTTGGAGCTGTTTATCTTTTTGGAATGGGCTTGTGGTTTTTCACTGAGAAAAAAAATTCTAGTTGGTTTAAC,ACGCTGAGCTTTTGCCCCCCCTCCTAGTTTGGAGCTGTTACCGTATCTTTTTGGAATGGGCTTGTGGTTTTTCACTGAGAAAAAAAATTCTAGTTGGTT,10,30,14,27,27,43,27,47,27,40,40,43,44,47,4.72,0.0
hek293t,13481,1,3,GGCTATGAGGCTTTGACAAGCTGCAACTATGGGAAGCAAAGCTATTCCCAAACTGAAAAAGCATTCACCAAAGTTTTATGTGCATAAAAAAAATTCTAG,GGCTATGAGGCTTTGACAAGCTGCAACTATGAGGGGAAGCAAAGCTATTCCCAAACTGAAAAAGCATTCACCAAAGTTTTATGTGCATAAAAAAAATTC,10,30,14,27,27,34,27,37,27,31,31,34,34,37,49.82,20.56108365
hek293t,13481,1,3,TCTCGTGAGGCTTTGACAAGCTGCAACTATGGGAAGCAAAGCTATTCCCAAACTGAAAAAGCATTCACCAAAGTTTTATAAAAAAATTCTAGTTGGTTT,TCTCGTGAGGCTTTGACAAGCTGCAACTATGAGGGGAAGCAAAGCTATTCCCAAACTGAAAAAGCATTCACCAAAGTTTTATAAAAAAATTCTAGTTGG,10,30,14,27,27,41,27,44,27,31,31,41,34,44,49.82,78.11766893
hek293t,13483,1,5,TAACGAACTGTAATAGAGATGAAAGTAGATGGTCATAGGCTAACATTGCGCATAATTTAATGGCTTTCTTGAAATAAAAAAAATTCTAGTTGGTTTAAC,TAACGAACTGTAATAGAGATGAAAGTTCCCGAGATGGTCATAGGCTAACATTGCGCATAATTTAATGGCTTTCTTGAAATAAAAAAAATTCTAGTTGGT,10,30,14,27,27,42,27,47,27,27,27,42,32,47,47.41,53.33554067
hek293t,13483,1,5,TAGCGAACTGTAATAGAGATGAAAGTAGATGGTCATAGGCTAACATTGCGCATAATTTAATGGCTTTCTTGAAATACTGAATTCCTTTAAAAAAATTCT,TAGCGAACTGTAATAGAGATGAAAGTTCCCGAGATGGTCATAGGCTAACATTGCGCATAATTTAATGGCTTTCTTGAAATACTGAATTCCTTTAAAAAA,10,30,14,27,27,30,27,35,27,27,27,30,32,35,47.41,0.558755168
hek293t,13489,1,3,GATGGTTACGGCTTTCTGAGTCTTAGTTATGGTCACACTGTGCTCCAGGAGCAATGCAGAAGGGACAAATGGCCAAAAAAATTCTAGTTGGTTTAACGC,GATGGTTACGGCTTTCTGAGTCTTAGTTATATTGGTCACACTGTGCTCCAGGAGCAATGCAGAAGGGACAAATGGCCAAAAAAATTCTAGTTGGTTTAA,10,30,14,27,27,46,27,49,27,31,31,46,34,49,36.92,78.97766913
hek293t,13489,1,3,CATTCTTACGGCTTTCTGAGTCTTAGTTATGGTCACACTGTGCTCCAGGAGCAATGCAGAAGGGACAAATGGCCCTCACTTGGACTAAAAAAATTCTAG,CATTCTTACGGCTTTCTGAGTCTTAGTTATATTGGTCACACTGTGCTCCAGGAGCAATGCAGAAGGGACAAATGGCCCTCACTTGGACTAAAAAAATTC,10,30,14,27,27,34,27,37,27,31,31,34,34,37,36.92,6.192911547
hek293t,13491,1,2,GTTGACTTATGCAACCATTGCCAGTCTGCAGGCTGCAAAGAAGAATGTATAAAATAGGAATTAAGTCACTAATTATTAGCTGAAAAAAATTCTAGTTGG,GTTGACTTATGCAACCATTGCCAGTCTGCAGATGCTGCAAAGAAGAATGTATAAAATAGGAATTAAGTCACTAATTATTAGCTGAAAAAAATTCTAGTT,10,30,14,27,27,39,27,41,27,32,32,39,34,41,34.18,81.91967064
hek293t,13491,1,2,ATCAGCTTATGCAACCATTGCCAGTCTGCAGGCTGCAAAGAAGAATGTATAAAATAGGAATTAAGTCACTAATTAAAAAAATTCTAGTTGGTTTAACGC,ATCAGCTTATGCAACCATTGCCAGTCTGCAGATGCTGCAAAGAAGAATGTATAAAATAGGAATTAAGTCACTAATTAAAAAAATTCTAGTTGGTTTAAC,10,30,14,27,27,47,27,49,27,32,32,47,34,49,34.18,58.62398515
hek293t,13495,1,2,ATCGATTGATGCTGTCTGAATGCCTGCTTTGGCAATAAAATTGCAGGTAAATCCATTCCTCCATAACTTGATGAAGTCCAGTGAGGAAAAAAAAAATTC,ATCGATTGATGCTGTCTGAATGCCTGCTTGTTGGCAATAAAATTGCAGGTAAATCCATTCCTCCATAACTTGATGAAGTCCAGTGAGGAAAAAAAAAAT,10,30,14,27,27,32,27,34,27,29,29,32,31,34,36.85,1.165780631
hek293t,13497,1,14,AGCCGATGTCAGTTAGGCACCAGCTTGAAAGGCAAGAGGCAAGTGATTTTAGGCATGATCTCCCTTGTGTCTGGAAAAAAAATTCTAGTTGGTTTAACG,AGCCGATGTCAGTTAGGCACCAGCTTGAAAAATTTACCGTGCAAGGCAAGAGGCAAGTGATTTTAGGCATGATCTCCCTTGTGTCTGGAAAAAAAATTC,10,30,14,27,27,34,27,48,27,31,31,34,45,48,30.55,0.0
hek293t,13497,1,14,CGTCAATGTCAGTTAGGCACCAGCTTGAAAGGCAAGAGGCAAGTGATTTTAGGCATGATCTCCCTTGTGTCAAAAAAATTCTAGTTGGTTTAACGCGTA,CGTCAATGTCAGTTAGGCACCAGCTTGAAAAATTTACCGTGCAAGGCAAGAGGCAAGTGATTTTAGGCATGATCTCCCTTGTGTCAAAAAAATTCTAGT,10,30,14,27,27,38,27,52,27,31,31,38,45,52,30.55,0.979228808
hek293t,13501,1,4,TGTCTTGTTAGAGCTAACACCAGTGGCTGTGGTATTGGTTCAGTGGAGATAAAACCCCAAAGTGCAGGCCATTGCCATGTAAGCAAAAAAAATTCTAGT,TGTCTTGTTAGAGCTAACACCAGTGGCTGTGATGGGTATTGGTTCAGTGGAGATAAAACCCCAAAGTGCAGGCCATTGCCATGTAAGCAAAAAAAATTC,10,30,14,27,27,34,27,38,27,31,31,34,35,38,58.53,4.726623318
hek293t,13501,1,4,TAAAATGTTAGAGCTAACACCAGTGGCTGTGGTATTGGTTCAGTGGAGATAAAACCCCAAAGTGCAGGCCATTGCCATGTAAAAAAAATTCTAGTTGGT,TAAAATGTTAGAGCTAACACCAGTGGCTGTGATGGGTATTGGTTCAGTGGAGATAAAACCCCAAAGTGCAGGCCATTGCCATGTAAAAAAAATTCTAGT,10,30,14,27,27,38,27,42,27,31,31,38,35,42,58.53,62.15478362
hek293t,13503,1,6,TGTCCTGCAAGTTTCCTGGGCCTGCAAATAGGCTCTGTACGCAAATTCTCTTGCTTTTTCATCTCCACTCCTTTTCTAAAAAAATTCTAGTTGGTTTAA,TGTCCTGCAAGTTTCCTGGGCCTGCAAATAGGCTCTTTTCCTGTACGCAAATTCTCTTGCTTTTTCATCTCCACTCCTTTTCTAAAAAAATTCTAGTTG,10,30,14,27,27,40,27,46,27,37,37,40,43,46,27.3,0.486618005
hek293t,13503,1,6,AAAGATGCAAGTTTCCTGGGCCTGCAAATAGGCTCTGTACGCAAATTCTCTTGCTTTTTCATCTCCACTCAAAAAAATTCTAGTTGGTTTAACGCGTAA,AAAGATGCAAGTTTCCTGGGCCTGCAAATAGGCTCTTTTCCTGTACGCAAATTCTCTTGCTTTTTCATCTCCACTCAAAAAAATTCTAGTTGGTTTAAC,10,30,14,27,27,47,27,53,27,37,37,47,43,53,27.3,25.4136052
hek293t,8076,1,12,AACCGAATCAAGATGAAGTGAGTGGAAGGAGGTAAACATTGGCAAGCAGAGAAAAAGGAGCTGATAAAAAAATTCTAGTTGGTTTAACGCGTAACTAGA,AACCGAATCAAGATGAAGTGAGTGGAAGGAGTTTTCTGTGTGGGTAAACATTGGCAAGCAGAGAAAAAGGAGCTGATAAAAAAATTCTAGTTGGTTTAA,10,30,14,27,27,46,27,58,27,31,31,46,43,58,62.81,36.598457
hek293t,8076,1,12,GCGATAATCAAGATGAAGTGAGTGGAAGGAGGTAAACATTGGCAAGCAGAGAAAAAGGAGCTGATTTGTGAAGAAAAAAATTCTAGTTGGTTTAACGCG,GCGATAATCAAGATGAAGTGAGTGGAAGGAGTTTTCTGTGTGGGTAAACATTGGCAAGCAGAGAAAAAGGAGCTGATTTGTGAAGAAAAAAATTCTAGT,10,30,14,27,27,38,27,50,27,31,31,38,43,50,62.81,1.22315487
hek293t,13507,1,5,CGCAGTTGAGTTTTTCCATATGTATAATGAGGTTTCATCCTCCGAGTCCTTTGGTTAGTCCAGACAGCATTAAAAAAATTCTAGTTGGTTTAACGCGTA,CGCAGTTGAGTTTTTCCATATGTATAATGAGGTTTCCTTCTATCCTCCGAGTCCTTTGGTTAGTCCAGACAGCATTAAAAAAATTCTAGTTGGTTTAAC,10,30,14,27,27,47,27,52,27,37,37,47,42,52,42.09,13.9756522
hek293t,13509,1,6,ACCAGCACAATGGAGAGAGGTTCCCAGAATGGTATGAAACGGTTGAATGCAGATAATTATCTCACAATAAAAAAAATTCTAGTTGGTTTAACGCGTAAC,ACCAGCACAATGGAGAGAGGTTCCCAGAATGGCGAGTGTATGAAACGGTTGAATGCAGATAATTATCTCACAATAAAAAAAATTCTAGTTGGTTTAACG,10,30,14,27,27,48,27,54,27,33,33,48,39,54,63.22,9.099258502
hek293t,13509,1,6,ACGGTCACAATGGAGAGAGGTTCCCAGAATGGTATGAAACGGTTGAATGCAGATAATTATCTCACAATACAAGTAAAAAAATTCTAGTTGGTTTAACGC,ACGGTCACAATGGAGAGAGGTTCCCAGAATGGCGAGTGTATGAAACGGTTGAATGCAGATAATTATCTCACAATACAAGTAAAAAAATTCTAGTTGGTT,10,30,14,27,27,43,27,49,27,33,33,43,39,49,63.22,42.81850101
hek293t,13511,1,2,AACAGTAATGGCCTCTTAAAGGGAGACAGTGGGAATATTTCAAACTGAAACAAGAGCTCTATAATACACAGTTTCCCACCATAATAAAAAAATTCTAGT,AACAGTAATGGCCTCTTAAAGGGAGACAGTGGTTGAATATTTCAAACTGAAACAAGAGCTCTATAATACACAGTTTCCCACCATAATAAAAAAATTCTA,10,30,14,27,27,36,27,38,27,33,33,36,35,38,43.22,0.033806626
hek293t,13511,1,2,TACTATAATGGCCTCTTAAAGGGAGACAGTGGGAATATTTCAAACTGAAACAAGAGCTCTATAATACACAGTTTCCCAAAAAAAATTCTAGTTGGTTTA,TACTATAATGGCCTCTTAAAGGGAGACAGTGGTTGAATATTTCAAACTGAAACAAGAGCTCTATAATACACAGTTTCCCAAAAAAAATTCTAGTTGGTT,10,30,14,27,27,43,27,45,27,33,33,43,35,45,43.22,75.3316403
hek293t,13513,1,10,CATCACCATGCTGTGTTACAGCCAAGTTTTGGGTTTTGCTTTCTGAGTCTGGCGGATTCAGTCATGCAGGAAAAAAAATTCTAGTTGGTTTAACGCGTA,CATCACCATGCTGTGTTACAGCCAAGTTTTGGGTAATCCTTGGTTTTGCTTTCTGAGTCTGGCGGATTCAGTCATGCAGGAAAAAAAATTCTAGTTGGT,10,30,14,27,27,42,27,52,27,35,35,42,45,52,32.41,4.062981193
hek293t,13513,1,10,CCATCCCATGCTGTGTTACAGCCAAGTTTTGGGTTTTGCTTTCTGAGTCTGGCGGATTCAGTCATGCAGGAAGATAAAAAAATTCTAGTTGGTTTAACG,CCATCCCATGCTGTGTTACAGCCAAGTTTTGGGTAATCCTTGGTTTTGCTTTCTGAGTCTGGCGGATTCAGTCATGCAGGAAGATAAAAAAATTCTAGT,10,30,14,27,27,38,27,48,27,35,35,38,45,48,32.41,3.19424388
hek293t,13515,1,1,AAACTTTGGAGTCTTACCTGGAAGAATGGAGGGAACAAGCAGTGATTTGTTTAAAATGCAAGTGCTTGTTTGTACAAGTGTATACCAAAAAAATTCTAG,AAACTTTGGAGTCTTACCTGGAAGAATGGAGGGGAACAAGCAGTGATTTGTTTAAAATGCAAGTGCTTGTTTGTACAAGTGTATACCAAAAAAATTCTA,10,30,14,27,27,36,27,37,27,33,33,36,34,37,63.81,2.699964495
hek293t,13515,1,1,AAATATTGGAGTCTTACCTGGAAGAATGGAGGGAACAAGCAGTGATTTGTTTAAAATGCAAGTGCTTGTTTGTAAAAAAAATTCTAGTTGGTTTAACGC,AAATATTGGAGTCTTACCTGGAAGAATGGAGGGGAACAAGCAGTGATTTGTTTAAAATGCAAGTGCTTGTTTGTAAAAAAAATTCTAGTTGGTTTAACG,10,30,14,27,27,48,27,49,27,33,33,48,34,49,63.81,33.93035835
hek293t,13517,1,9,CTAGGCTTGGCAAGAAATTTGAATGCAAAAGGGTAAGCTGTTCTAATTGTTGCTGTTAACTACTTTGCAGCAAAGAAAAAAATTCTAGTTGGTTTAACG,CTAGGCTTGGCAAGAAATTTGAATGCAAAAGGGTAAGGCTCCCCAGCTGTTCTAATTGTTGCTGTTAACTACTTTGCAGCAAAGAAAAAAATTCTAGTT,10,30,14,27,27,39,27,48,27,36,36,39,45,48,0.85,0.0
hek293t,13517,1,9,GGGCTCTTGGCAAGAAATTTGAATGCAAAAGGGTAAGCTGTTCTAATTGTTGCTGTTAACTACTTTGCAAAAAAATTCTAGTTGGTTTAACGCGTAACT,GGGCTCTTGGCAAGAAATTTGAATGCAAAAGGGTAAGGCTCCCCAGCTGTTCTAATTGTTGCTGTTAACTACTTTGCAAAAAAATTCTAGTTGGTTTAA,10,30,14,27,27,46,27,55,27,36,36,46,45,55,0.85,0.054430952
hek293t,13519,1,15,AATCGACAACCATTGTGCGGAGAATAACCTGGAGCCCATAACGCAAGAGATCTACCACCACAGTTTCCCTCAAAAAAATTCTAGTTGGTTTAACGCGTA,AATCGACAACCATTGTGCGGAGAATAACCTGGAAGTACACGAATCTCTGCCCATAACGCAAGAGATCTACCACCACAGTTTCCCTCAAAAAAATTCTAG,10,30,14,27,27,37,27,52,27,34,34,37,49,52,56.8,0.286738351
hek293t,20309,1,7,GCTATCAAGGGACATTATAGACCAAGGGCAGGGCAATTGTCTGCATAGCTATAAAATAACCTTCACCTTTTCTAGAAAAAAATTCTAGTTGGTTTAACG,GCTATCAAGGGACATTATAGACCAAGGGCAGGGGACCATGCAATTGTCTGCATAGCTATAAAATAACCTTCACCTTTTCTAGAAAAAAATTCTAGTTGG,10,30,14,27,27,41,27,48,27,34,34,41,41,48,38.91,10.00616792
hek293t,20309,1,7,GGGAGCAAGGGACATTATAGACCAAGGGCAGGGCAATTGTCTGCATAGCTATAAAATAACCTTCACCAAAAAAATTCTAGTTGGTTTAACGCGTAACTA,GGGAGCAAGGGACATTATAGACCAAGGGCAGGGGACCATGCAATTGTCTGCATAGCTATAAAATAACCTTCACCAAAAAAATTCTAGTTGGTTTAACGC,10,30,14,27,27,49,27,56,27,34,34,49,41,56,38.91,23.1862895
hek293t,13524,1,7,CTAGACTGTATTTATGTTATAGTCTTCCTAGGCAAAATGTTTCACTGGATAAACAAATCTTTAATTCCTTATGCTTTATAAAAAAATTCTAGTTGGTTT,CTAGACTGTATTTATGTTATAGTCTTCCTATCTACCAGGCAAAATGTTTCACTGGATAAACAAATCTTTAATTCCTTATGCTTTATAAAAAAATTCTAG,10,30,14,27,27,37,27,44,27,30,30,37,37,44,26.57,6.567561784
hek293t,13524,1,7,CCTAACTGTATTTATGTTATAGTCTTCCTAGGCAAAATGTTTCACTGGATAAACAAATCTTTAATTCCTTATGCTTTATTAAAAAAAAAATTCTAGTTG,CCTAACTGTATTTATGTTATAGTCTTCCTATCTACCAGGCAAAATGTTTCACTGGATAAACAAATCTTTAATTCCTTATGCTTTATTAAAAAAAAAATT,10,30,14,27,27,33,27,40,27,30,30,33,37,40,26.57,0.0
hek293t,13526,1,11,AATCAACAAGCGTCACTCCATCCACGGTGGGGGGAATATCGCTAGGTGGCATCTCACCGCGTCAGGCAAAAAAATTCTAGTTGGTTTAACGCGTAACTA,AATCAACAAGCGTCACTCCATCCACGGTGGCGCAGTCGAGGGGGGAATATCGCTAGGTGGCATCTCACCGCGTCAGGCAAAAAAATTCTAGTTGGTTTA,10,30,14,27,27,45,27,56,27,30,30,45,41,56,57.15,19.25333662
hek293t,13526,1,11,TTAGAACAAGCGTCACTCCATCCACGGTGGGGGGAATATCGCTAGGTGGCATCTCACCGCGTCAGGCTGAGGAGGCTACAAAAAAATTCTAGTTGGTTT,TTAGAACAAGCGTCACTCCATCCACGGTGGCGCAGTCGAGGGGGGAATATCGCTAGGTGGCATCTCACCGCGTCAGGCTGAGGAGGCTACAAAAAAATT,10,30,14,27,27,33,27,44,27,30,30,33,41,44,57.15,4.820642776
hek293t,13528,1,5,GTCCCTGCCACTTCCCTTCAGAAAATTTGGGGGAAAACAGACATTAGTGAAAATACTGAAAAAATAGAAGGAAAAAAATTCTAGTTGGTTTAACGCGTA,GTCCCTGCCACTTCCCTTCAGAAAATTTGGGCTAACGGAAAACAGACATTAGTGAAAATACTGAAAAAATAGAAGGAAAAAAATTCTAGTTGGTTTAAC,10,30,14,27,27,47,27,52,27,32,32,47,37,52,30.86,1.516094635
hek293t,13528,1,5,ATGCGTGCCACTTCCCTTCAGAAAATTTGGGGGAAAACAGACATTAGTGAAAATACTGAAAAAATAGAAGGTCTATAAAAAAATTCTAGTTGGTTTAAC,ATGCGTGCCACTTCCCTTCAGAAAATTTGGGCTAACGGAAAACAGACATTAGTGAAAATACTGAAAAAATAGAAGGTCTATAAAAAAATTCTAGTTGGT,10,30,14,27,27,42,27,47,27,32,32,42,37,47,30.86,2.982228193
hek293t,13530,1,5,TGGTGTAGGTATTTTACGAATTCATTTTCTGGATACTGTGCAGAACCAGTCCATTAAAGAAAGAAAGAAAACAAAAAAAAATTCTAGTTGGTTTAACGC,TGGTGTAGGTATTTTACGAATTCATTTTCTGGATACGATACTGTGCAGAACCAGTCCATTAAAGAAAGAAAGAAAACAAAAAAAAATTCTAGTTGGTTT,10,30,14,27,27,44,27,49,27,34,34,44,39,49,-0.13,0.298507463
hek293t,13530,1,5,AGTAGTAGGTATTTTACGAATTCATTTTCTGGATACTGTGCAGAACCAGTCCATTAAAGAAAGAAAGAAAAAAAAATTCTAGTTGGTTTAACGCGTAAC,AGTAGTAGGTATTTTACGAATTCATTTTCTGGATACGATACTGTGCAGAACCAGTCCATTAAAGAAAGAAAGAAAAAAAAATTCTAGTTGGTTTAACGC,10,30,14,27,27,49,27,54,27,34,34,49,39,54,-0.13,1.357999384
hek293t,13532,1,11,AAATTTAAAGATTTGTGTTGCTGCCCCTGTGGGAAATAAGCCAAACTAACGAGGAAAAATATTGAAAGAAAAAAAATTCTAGTTGGTTTAACGCGTAAC,AAATTTAAAGATTTGTGTTGCTGCCCCTAATGAAACGGTGTGGGAAATAAGCCAAACTAACGAGGAAAAATATTGAAAGAAAAAAAATTCTAGTTGGTT,10,30,14,27,27,43,27,54,27,28,28,43,39,54,39.24,5.784705111
hek293t,13532,1,11,AGTCTTAAAGATTTGTGTTGCTGCCCCTGTGGGAAATAAGCCAAACTAACGAGGAAAAATATTGAAAGATATTCCATTCTCAAAAAAATTCTAGTTGGT,AGTCTTAAAGATTTGTGTTGCTGCCCCTAATGAAACGGTGTGGGAAATAAGCCAAACTAACGAGGAAAAATATTGAAAGATATTCCATTCTCAAAAAAA,10,30,14,27,27,31,27,42,27,28,28,31,39,42,39.24,0.975862613
hek293t,13534,1,10,GTTAAGGGAGCAACAGAAATGCTGCAGAGAGGAGAGGTGGTTTTAGCTGACTTTCTTGCCTACATGTAGGAAAAAAATTCTAGTTGGTTTAACGCGTAA,GTTAAGGGAGCAACAGAAATGCTGCAGAGAGGAGATTGCAGGCGGGGTGGTTTTAGCTGACTTTCTTGCCTACATGTAGGAAAAAAATTCTAGTTGGTT,10,30,14,27,27,43,27,53,27,36,36,43,46,53,73.61,6.245964397
hek293t,13534,1,10,GGGTTGGGAGCAACAGAAATGCTGCAGAGAGGAGAGGTGGTTTTAGCTGACTTTCTTGCCTACATGTAGGGAGCAAAAAAATTCTAGTTGGTTTAACGC,GGGTTGGGAGCAACAGAAATGCTGCAGAGAGGAGATTGCAGGCGGGGTGGTTTTAGCTGACTTTCTTGCCTACATGTAGGGAGCAAAAAAATTCTAGTT,10,30,14,27,27,39,27,49,27,36,36,39,46,49,73.61,1.501646768
hek293t,13536,1,7,GCTCCTAACAGGCCTCATCAGCGAGGTTGTGGCCCATCTAGTCTGTAAATACAGATAAAATATTAATGACAATGAAAAAAATTCTAGTTGGTTTAACGC,GCTCCTAACAGGCCTCATCAGCGAGGTTGTGCCCGGCAGCCCATCTAGTCTGTAAATACAGATAAAATATTAATGACAATGAAAAAAATTCTAGTTGGT,10,30,14,27,27,42,27,49,27,32,32,42,39,49,46.66,40.0528113
hek293t,13536,1,7,ATCCCTAACAGGCCTCATCAGCGAGGTTGTGGCCCATCTAGTCTGTAAATACAGATAAAATATTAATGAAAAAAAATTCTAGTTGGTTTAACGCGTAAC,ATCCCTAACAGGCCTCATCAGCGAGGTTGTGCCCGGCAGCCCATCTAGTCTGTAAATACAGATAAAATATTAATGAAAAAAAATTCTAGTTGGTTTAAC,10,30,14,27,27,47,27,54,27,32,32,47,39,54,46.66,35.29594039
hek293t,13538,1,1,CCCTGCACTCAGGCACACAATAGCACAGATGGTCAGGAGGCAGCAACAGGAAGGGCAGTTCTGGCATTTTTTAAAAAAATTCTAGTTGGTTTAACGCGT,CCCTGCACTCAGGCACACAATAGCACAGATGGTCCAGGAGGCAGCAACAGGAAGGGCAGTTCTGGCATTTTTTAAAAAAATTCTAGTTGGTTTAACGCG,10,30,14,27,27,50,27,51,27,35,35,50,36,51,52.51,67.46903488
hek293t,13538,1,1,CTAACCACTCAGGCACACAATAGCACAGATGGTCAGGAGGCAGCAACAGGAAGGGCAGTTCTGGCATTTTTTGCATTCATCCACAAAAAAATTCTAGTT,CTAACCACTCAGGCACACAATAGCACAGATGGTCCAGGAGGCAGCAACAGGAAGGGCAGTTCTGGCATTTTTTGCATTCATCCACAAAAAAATTCTAGT,10,30,14,27,27,38,27,39,27,35,35,38,36,39,52.51,2.38867709
hek293t,13540,1,5,CGTCCCACTGTATTCATTTGTAGTAGGTATGGAGATGCTTTGCAATGTTCTCTGTCATTTTGTCCCTCTCAAAAAAATTCTAGTTGGTTTAACGCGTAA,CGTCCCACTGTATTCATTTGTAGTAGGTATGGTCAAAAGATGCTTTGCAATGTTCTCTGTCATTTTGTCCCTCTCAAAAAAATTCTAGTTGGTTTAACG,10,30,14,27,27,48,27,53,27,33,33,48,38,53,40.67,4.690913822
hek293t,13542,1,14,ATGCGCTCCTTTTCTTTCTCATAAATATTAGGTACATTTTCAACCAAAAAATCCAGATCCCATGAAAAAAAATTCTAGTTGGTTTAACGCGTAACTAGA,ATGCGCTCCTTTTCTTTCTCATAAATATTAGGTACAAACGTTAAGATTCCTTTTCAACCAAAAAATCCAGATCCCATGAAAAAAAATTCTAGTTGGTTT,10,30,14,27,27,44,27,58,27,37,37,44,51,58,2.75,0.0
hek293t,13543,1,1,TCCCCCTATCTTTAATACCTTCAGCATTCAGGGAACATGATTCATCTTTTTCTTCCTCTCAGCTGAGCAAGTGCTCCATTAAAAAAATTCTAGTTGGTT,TCCCCCTATCTTTAATACCTTCAGCATTCAGGGATACATGATTCATCTTTTTCTTCCTCTCAGCTGAGCAAGTGCTCCATTAAAAAAATTCTAGTTGGT,10,30,14,27,27,42,27,43,27,35,35,42,36,43,6.16,55.62414238
hek293t,13543,1,1,GCGTTCTATCTTTAATACCTTCAGCATTCAGGGAACATGATTCATCTTTTTCTTCCTCTCAGCTGAGCAAGTGCTCCATTAAGGAAAAAAATTCTAGTT,GCGTTCTATCTTTAATACCTTCAGCATTCAGGGATACATGATTCATCTTTTTCTTCCTCTCAGCTGAGCAAGTGCTCCATTAAGGAAAAAAATTCTAGT,10,30,14,27,27,38,27,39,27,35,35,38,36,39,6.16,2.063180828
hek293t,13545,1,4,TGGCCAGTGTATCTCGGCGTCGCCAGCTGTGGCTCAGGCTGCAGAAATGTTGCAGGTATCGTACTGCTGTCAAAAAAATTCTAGTTGGTTTAACGCGTA,TGGCCAGTGTATCTCGGCGTCGCCAGCTGTGGCTCAGGCTTGGTGCAGAAATGTTGCAGGTATCGTACTGCTGTCAAAAAAATTCTAGTTGGTTTAACG,10,30,14,27,27,48,27,52,27,41,41,48,45,52,52.48,59.19611076
hek293t,13545,1,4,GCCAGAGTGTATCTCGGCGTCGCCAGCTGTGGCTCAGGCTGCAGAAATGTTGCAGGTATCGTACTGCTGTCTGGGAAAAAAATTCTAGTTGGTTTAACG,GCCAGAGTGTATCTCGGCGTCGCCAGCTGTGGCTCAGGCTTGGTGCAGAAATGTTGCAGGTATCGTACTGCTGTCTGGGAAAAAAATTCTAGTTGGTTT,10,30,14,27,27,44,27,48,27,41,41,44,45,48,52.48,1.38334867
hek293t,13547,1,1,AACGAATCATCTAGTTTAAATTGCCACTGAGGAGCTGGTCTTACATTTTATGCTAATAGACTTCTACATTTTAGAAAAAAATTCTAGTTGGTTTAACGC,AACGAATCATCTAGTTTAAATTGCCACTGAGGAGCTGAGTCTTACATTTTATGCTAATAGACTTCTACATTTTAGAAAAAAATTCTAGTTGGTTTAACG,10,30,14,27,27,48,27,49,27,38,38,48,39,49,57.01,69.50836067
hek293t,13549,1,8,TCAGATAGATAGATTATTGAGAACTCTTCAGGCTTTAGGATAAAGCTGCACTCTGAGGGGTAAAAGGCAGAGAAAAAAATTCTAGTTGGTTTAACGCGT,TCAGATAGATAGATTATTGAGAACTCTCGATTTACTCAGGCTTTAGGATAAAGCTGCACTCTGAGGGGTAAAAGGCAGAGAAAAAAATTCTAGTTGGTT,10,30,14,27,27,43,27,51,27,28,28,43,36,51,15.39,1.790184275
hek293t,13549,1,8,CTCAATAGATAGATTATTGAGAACTCTTCAGGCTTTAGGATAAAGCTGCACTCTGAGGGGTAAAAGGCAGAGTATTCTATAAAAAAATTCTAGTTGGTT,CTCAATAGATAGATTATTGAGAACTCTCGATTTACTCAGGCTTTAGGATAAAGCTGCACTCTGAGGGGTAAAAGGCAGAGTATTCTATAAAAAAATTCT,10,30,14,27,27,35,27,43,27,28,28,35,36,43,15.39,5.925914695
hek293t,13551,1,10,TGAGTTAACTGCTCAGCTGTACTTACCTCAGGACTTCGAAGCTTCAGTTCCCAAACATAGAAGTTAGTGAGGTAATTCTCCAAAAAAATTCTAGTTGGT,TGAGTTAACTGCTCAGCTGTACTTACCTGTGGTGTCGCCAGGACTTCGAAGCTTCAGTTCCCAAACATAGAAGTTAGTGAGGTAATTCTCCAAAAAAAT,10,30,14,27,27,32,27,42,27,29,29,32,39,42,39.53,0.013524627
hek293t,13551,1,10,TTGACTAACTGCTCAGCTGTACTTACCTCAGGACTTCGAAGCTTCAGTTCCCAAACATAGAAGTTAGTGAGGTAATTAAAAAAATTCTAGTTGGTTTAA,TTGACTAACTGCTCAGCTGTACTTACCTGTGGTGTCGCCAGGACTTCGAAGCTTCAGTTCCCAAACATAGAAGTTAGTGAGGTAATTAAAAAAATTCTA,10,30,14,27,27,36,27,46,27,29,29,36,39,46,39.53,0.7059696
hek293t,13553,1,14,GAGGACATACTGTCAACTGATCAGTTTGCAGGCAAACAGCAAGGAAAGGGCTGGTACAAGTCAGGCTGAGTAAAAAAATTCTAGTTGGTTTAACGCGTA,GAGGACATACTGTCAACTGATCAGTTTGCAACATTGCACGGTCGGGCAAACAGCAAGGAAAGGGCTGGTACAAGTCAGGCTGAGTAAAAAAATTCTAGT,10,30,14,27,27,38,27,52,27,31,31,38,45,52,23.66,0.132538105
hek293t,13553,1,14,GTTGCCATACTGTCAACTGATCAGTTTGCAGGCAAACAGCAAGGAAAGGGCTGGTACAAGTCAGGCTGAGTGCTGAAAAAAATTCTAGTTGGTTTAACG,GTTGCCATACTGTCAACTGATCAGTTTGCAACATTGCACGGTCGGGCAAACAGCAAGGAAAGGGCTGGTACAAGTCAGGCTGAGTGCTGAAAAAAATTC,10,30,14,27,27,34,27,48,27,31,31,34,45,48,23.66,0.0
hek293t,13555,1,1,GCAATCCTGACTGAGCAATTTTCCAGTTAAGGTGAAAACAATGTAATACACAAAGAGATAATGATTGGAGAGATTGGATGAAAAAAAATTCTAGTTGGT,GCAATCCTGACTGAGCAATTTTCCAGTTAAGGGTGAAAACAATGTAATACACAAAGAGATAATGATTGGAGAGATTGGATGAAAAAAAATTCTAGTTGG,10,30,14,27,27,41,27,42,27,31,31,41,32,42,11.29,74.07981122
hek293t,13555,1,1,ATAGACCTGACTGAGCAATTTTCCAGTTAAGGTGAAAACAATGTAATACACAAAGAGATAATGATTGGAGAGATTGGATGAAACTCAAAAAAAAATTCT,ATAGACCTGACTGAGCAATTTTCCAGTTAAGGGTGAAAACAATGTAATACACAAAGAGATAATGATTGGAGAGATTGGATGAAACTCAAAAAAAAATTC,10,30,14,27,27,34,27,35,27,31,31,34,32,35,11.29,5.196257947
hek293t,13557,1,15,GACACTTGATGGACAGTACAAACCTTCGCAGGGTTATAATACATGGCTTCTTGTGCAGTTAAGGGAATAAAAAAATTCTAGTTGGTTTAACGCGTAACT,GACACTTGATGGACAGTACAAACCTTCGCAGGGCTTAGACTGTGATCGTTATAATACATGGCTTCTTGTGCAGTTAAGGGAATAAAAAAATTCTAGTTG,10,30,14,27,27,40,27,55,27,33,33,40,48,55,46.9,0.0
hek293t,13557,1,15,AGTGATTGATGGACAGTACAAACCTTCGCAGGGTTATAATACATGGCTTCTTGTGCAGTTAAGGGAATCCTGAAAAAAATTCTAGTTGGTTTAACGCGT,AGTGATTGATGGACAGTACAAACCTTCGCAGGGCTTAGACTGTGATCGTTATAATACATGGCTTCTTGTGCAGTTAAGGGAATCCTGAAAAAAATTCTA,10,30,14,27,27,36,27,51,27,33,33,36,48,51,46.9,0.0
hek293t,13559,1,14,CGGACCCCTTTTTACAACCAGAATGCCTCAGGAAAATGTAGTTGTCACATGTTCTGACAGATAGGAAAAAAAATTCTAGTTGGTTTAACGCGTAACTAG,CGGACCCCTTTTTACAACCAGAATGCCTCAGGAAAGCTGTTGAAGTTTTATGTAGTTGTCACATGTTCTGACAGATAGGAAAAAAAATTCTAGTTGGTT,10,30,14,27,27,43,27,57,27,36,36,43,50,57,19.54,0.04938019
hek293t,13560,1,6,GGATTGTACAATGCTGTTATCAATCCACATGGACTAATCAACCACTTACTTTGCACTAGGGAAACTCTAACACACATAAAAAAATTCTAGTTGGTTTAA,GGATTGTACAATGCTGTTATCAATCCACATGGAACTGGACTAATCAACCACTTACTTTGCACTAGGGAAACTCTAACACACATAAAAAAATTCTAGTTG,10,30,14,27,27,40,27,46,27,33,33,40,39,46,57.17,1.401851501
hek293t,13560,1,6,GGCACGTACAATGCTGTTATCAATCCACATGGACTAATCAACCACTTACTTTGCACTAGGGAAACTCTAACACAAAAAAAATTCTAGTTGGTTTAACGC,GGCACGTACAATGCTGTTATCAATCCACATGGAACTGGACTAATCAACCACTTACTTTGCACTAGGGAAACTCTAACACAAAAAAAATTCTAGTTGGTT,10,30,14,27,27,43,27,49,27,33,33,43,39,49,57.17,6.378939863
hek293t,13562,1,3,GCAGCTGACCAGAACTGGAATATAATCTTTGGACTTTAAAAAGGAATGTGTTGTCAGTCCAACCCAGAGCAGTCCTAGCTGTCTAAAGGAAAAAAAATT,GCAGCTGACCAGAACTGGAATATAATACGCTTTGGACTTTAAAAAGGAATGTGTTGTCAGTCCAACCCAGAGCAGTCCTAGCTGTCTAAAGGAAAAAAA,10,30,14,27,27,30,27,33,27,27,27,30,30,33,32.81,0.402144772
hek293t,13562,1,3,ATGTCTGACCAGAACTGGAATATAATCTTTGGACTTTAAAAAGGAATGTGTTGTCAGTCCAACCCAGAGCAGTCCTAGCTGTCAAAAAAATTCTAGTTG,ATGTCTGACCAGAACTGGAATATAATACGCTTTGGACTTTAAAAAGGAATGTGTTGTCAGTCCAACCCAGAGCAGTCCTAGCTGTCAAAAAAATTCTAG,10,30,14,27,27,37,27,40,27,27,27,37,30,40,32.81,55.5426916
hek293t,13564,1,9,TATTGACTTCTCCCTTGGAGCAGATCTAAAGGTATGTCTTTCACATATGCTACAGCTATGAAAGAGCAACAAAAAAATTCTAGTTGGTTTAACGCGTAA,TATTGACTTCTCCCTTGGAGCAGATCTAAAGGTATGCTCTCAAGTTCTTTCACATATGCTACAGCTATGAAAGAGCAACAAAAAAATTCTAGTTGGTTT,10,30,14,27,27,44,27,53,27,37,37,44,46,53,18.44,0.0
hek293t,13565,1,12,GGCCGGGTGCTTAATGAGAAAGGGCATTTAGGGAACAGAGCAGGTGAGAATTAGCCAGCGTGGGCCAAAAAAATTCTAGTTGGTTTAACGCGTAACTAG,GGCCGGGTGCTTAATGAGAAAGGGCATTTAGGGACCGCGCTGCGTTACAGAGCAGGTGAGAATTAGCCAGCGTGGGCCAAAAAAATTCTAGTTGGTTTA,10,30,14,27,27,45,27,57,27,35,35,45,47,57,10.86,5.145176353
hek293t,13565,1,12,CTGACGGTGCTTAATGAGAAAGGGCATTTAGGGAACAGAGCAGGTGAGAATTAGCCAGCGTGGGCCACTAAAAAAATTCTAGTTGGTTTAACGCGTAAC,CTGACGGTGCTTAATGAGAAAGGGCATTTAGGGACCGCGCTGCGTTACAGAGCAGGTGAGAATTAGCCAGCGTGGGCCACTAAAAAAATTCTAGTTGGT,10,30,14,27,27,42,27,54,27,35,35,42,47,54,10.86,1.118125655
hek293t,13567,1,9,TATCATGCACTAGTTGCTATCAGGAGAAAAGGACAACTCCTGTGATGCAGTTTACACAGTATCTACAAAGCACACTTAAAAAAATTCTAGTTGGTTTAA,TATCATGCACTAGTTGCTATCAGGAGAAACCTTAGAGGAGGACAACTCCTGTGATGCAGTTTACACAGTATCTACAAAGCACACTTAAAAAAATTCTAG,10,30,14,27,27,37,27,46,27,30,30,37,39,46,39.05,21.2478882
hek293t,13567,1,9,TCCATTGCACTAGTTGCTATCAGGAGAAAAGGACAACTCCTGTGATGCAGTTTACACAGTATCTACAAAGCACACTTCCATAAAAAAATTCTAGTTGGT,TCCATTGCACTAGTTGCTATCAGGAGAAACCTTAGAGGAGGACAACTCCTGTGATGCAGTTTACACAGTATCTACAAAGCACACTTCCATAAAAAAATT,10,30,14,27,27,33,27,42,27,30,30,33,39,42,39.05,0.023826543
hek293t,13569,1,5,CCGGATTACTGTGAAGAGCTTGTCCCTTCAGGAGTTTCAACAGAGAAACTGGGGAGAACTTGCAGCCTTGTTTAAAAAAAATTCTAGTTGGTTTAACGC,CCGGATTACTGTGAAGAGCTTGTCCCTTCAGGAGTTTCAATGGTACAGAGAAACTGGGGAGAACTTGCAGCCTTGTTTAAAAAAAATTCTAGTTGGTTT,10,30,14,27,27,44,27,49,27,41,41,44,46,49,20.25,0.106666667
hek293t,13569,1,5,GTTCTTTACTGTGAAGAGCTTGTCCCTTCAGGAGTTTCAACAGAGAAACTGGGGAGAACTTGCAGCCTTGAAAAAAATTCTAGTTGGTTTAACGCGTAA,GTTCTTTACTGTGAAGAGCTTGTCCCTTCAGGAGTTTCAATGGTACAGAGAAACTGGGGAGAACTTGCAGCCTTGAAAAAAATTCTAGTTGGTTTAACG,10,30,14,27,27,48,27,53,27,41,41,48,46,53,20.25,36.91438894
hek293t,22814,1,15,ATACCGGAAAAGGAAAGGGGGAATAATTATGGGTTAATATAGTCTCTTCTTTTTTCCTGAAGAATGTAGGTAAAAAAATTCTAGTTGGTTTAACGCGTA,ATACCGGAAAAGGAAAGGGGGAATAATTATGGGCATAGAGGACAGTCATTAATATAGTCTCTTCTTTTTTCCTGAAGAATGTAGGTAAAAAAATTCTAG,10,30,14,27,27,37,27,52,27,34,34,37,49,52,25.81,0.023116043
hek293t,13572,1,12,GTTCCATTGGTGAGCTTGAGTTTCCTCTCTGGTGAGATGGTAACGTCTATCATAACAAATAAGATAACTGAGCAAAAAAAAATTCTAGTTGGTTTAACG,GTTCCATTGGTGAGCTTGAGTTTCCTCTCTGGTCCATGTAATGATGAGATGGTAACGTCTATCATAACAAATAAGATAACTGAGCAAAAAAAAATTCTA,10,30,14,27,27,36,27,48,27,33,33,36,45,48,35.73,0.289245596
hek293t,7675,1,4,CTATCGGTGGCAATAGCTATATTTGAGGTTGGTTTGTTTTTTAAGCAATGAGTACACATTTTGTGATATCAGAATAAAAAAATTCTAGTTGGTTTAACG,CTATCGGTGGCAATAGCTATATTTGAGGTTGGTTTGCAGATTTTTTAAGCAATGAGTACACATTTTGTGATATCAGAATAAAAAAATTCTAGTTGGTTT,10,30,14,27,27,44,27,48,27,37,37,44,41,48,26.54,17.55728587
hek293t,7675,1,4,AAGCGGGTGGCAATAGCTATATTTGAGGTTGGTTTGTTTTTTAAGCAATGAGTACACATTTTGTGATATCAGAATAAACAAAAAAATTCTAGTTGGTTT,AAGCGGGTGGCAATAGCTATATTTGAGGTTGGTTTGCAGATTTTTTAAGCAATGAGTACACATTTTGTGATATCAGAATAAACAAAAAAATTCTAGTTG,10,30,14,27,27,40,27,44,27,37,37,40,41,44,26.54,0.427350427
hek293t,13577,1,11,CCTGGGGAAACTGGGAGTGAATCCCAGATAGGAGCTTTACTACAGCAGCTACAGGCTGCTTAGAATAAAAAAATTCTAGTTGGTTTAACGCGTAACTAG,CCTGGGGAAACTGGGAGTGAATCCCAGATAGGAGCTTTAGCGTTGGTGGACTACAGCAGCTACAGGCTGCTTAGAATAAAAAAATTCTAGTTGGTTTAA,10,30,14,27,27,46,27,57,27,39,39,46,50,57,57.18,1.615808635
hek293t,13577,1,11,GTCTTGGAAACTGGGAGTGAATCCCAGATAGGAGCTTTACTACAGCAGCTACAGGCTGCTTAGAATCCCAAAAAAAATTCTAGTTGGTTTAACGCGTAA,GTCTTGGAAACTGGGAGTGAATCCCAGATAGGAGCTTTAGCGTTGGTGGACTACAGCAGCTACAGGCTGCTTAGAATCCCAAAAAAAATTCTAGTTGGT,10,30,14,27,27,42,27,53,27,39,39,42,50,53,57.18,0.0
hek293t,13579,1,9,GCGAGGAACAATTTACTCAGAGCCATCTATGGAAGAGAACTGTACCTGAAGTCTGCCAAAGAGTGCATTTTTCTTAAAAAAATTCTAGTTGGTTTAACG,GCGAGGAACAATTTACTCAGAGCCATCTATGGAAGACCAAGATGAGAACTGTACCTGAAGTCTGCCAAAGAGTGCATTTTTCTTAAAAAAATTCTAGTT,10,30,14,27,27,39,27,48,27,36,36,39,45,48,37.88,0.153139357
hek293t,13579,1,9,GGCAGGAACAATTTACTCAGAGCCATCTATGGAAGAGAACTGTACCTGAAGTCTGCCAAAGAGTGCATTTTAAAAAAATTCTAGTTGGTTTAACGCGTA,GGCAGGAACAATTTACTCAGAGCCATCTATGGAAGACCAAGATGAGAACTGTACCTGAAGTCTGCCAAAGAGTGCATTTTAAAAAAATTCTAGTTGGTT,10,30,14,27,27,43,27,52,27,36,36,43,45,52,37.88,1.67093232
hek293t,13581,1,12,ACACCACCCCATTTAGAGACTGTGTCCCTCGGCACCCATCAAAGGGTTCAAAATGCCTTTGATGGTGAAAAAAATTCTAGTTGGTTTAACGCGTAACTA,ACACCACCCCATTTAGAGACTGTGTCCCTTATGAACTGCCTCGGCACCCATCAAAGGGTTCAAAATGCCTTTGATGGTGAAAAAAATTCTAGTTGGTTT,10,30,14,27,27,44,27,56,27,29,29,44,41,56,49.08,35.08719439
hek293t,13581,1,12,CATTCACCCCATTTAGAGACTGTGTCCCTCGGCACCCATCAAAGGGTTCAAAATGCCTTTGATGGTGTCATCTCTTTAGAAAAAAATTCTAGTTGGTTT,CATTCACCCCATTTAGAGACTGTGTCCCTTATGAACTGCCTCGGCACCCATCAAAGGGTTCAAAATGCCTTTGATGGTGTCATCTCTTTAGAAAAAAAT,10,30,14,27,27,32,27,44,27,29,29,32,41,44,49.08,3.202665631
hek293t,13583,1,2,AACGTATTATGTGCACTACAGAAAAAAGTCGGAAATCATAAATTAACTTGGTTACAAAGTGTGAGGGAAAAGGTAACAAAAAAATTCTAGTTGGTTTAA,AACGTATTATGTGCACTACAGAAAAAAGTCGGACAAATCATAAATTAACTTGGTTACAAAGTGTGAGGGAAAAGGTAACAAAAAAATTCTAGTTGGTTT,10,30,14,27,27,44,27,46,27,34,34,44,36,46,51.11,1.497420726
hek293t,13583,1,2,AGCCCATTATGTGCACTACAGAAAAAAGTCGGAAATCATAAATTAACTTGGTTACAAAGTGTGAGGGAAAAGGTAACATCTATGAAAAAAATTCTAGTT,AGCCCATTATGTGCACTACAGAAAAAAGTCGGACAAATCATAAATTAACTTGGTTACAAAGTGTGAGGGAAAAGGTAACATCTATGAAAAAAATTCTAG,10,30,14,27,27,37,27,39,27,34,34,37,36,39,51.11,0.0
hek293t,13585,1,9,CTTTACCTGCAGAACCCGCTGTCGTAAACTGGTACAAAGGCCAAACACACAGAGGGATGCCCAAACTAAAAAAAATTCTAGTTGGTTTAACGCGTAACT,CTTTACCTGCAGAACCCGCTGTCGTAAACTGGTACAAAGAATGACGTGGCCAAACACACAGAGGGATGCCCAAACTAAAAAAAATTCTAGTTGGTTTAA,10,30,14,27,27,46,27,55,27,39,39,46,48,55,18.33,0.318232843
hek293t,13586,1,12,AACATCATAATGGTAATTTTAGAGAATTTAGGTCTCCAGCAACCACACTCCTCCCTATATTCCCCCTCAAAAAAATTCTAGTTGGTTTAACGCGTAACT,AACATCATAATGGTAATTTTAGAGAATCAGCGCCCTTTCTTAGGTCTCCAGCAACCACACTCCTCCCTATATTCCCCCTCAAAAAAATTCTAGTTGGTT,10,30,14,27,27,43,27,55,27,28,28,43,40,55,9.68,4.592631209
hek293t,13586,1,12,CAACGCATAATGGTAATTTTAGAGAATTTAGGTCTCCAGCAACCACACTCCTCCCTATATTCCCCCTCCTTCACAGTAGTAAAAAAATTCTAGTTGGTT,CAACGCATAATGGTAATTTTAGAGAATCAGCGCCCTTTCTTAGGTCTCCAGCAACCACACTCCTCCCTATATTCCCCCTCCTTCACAGTAGTAAAAAAA,10,30,14,27,27,31,27,43,27,28,28,31,40,43,9.68,0.0
hek293t,13588,1,5,CTCCGAGTTCTTTGCAGAGCTTTTTATAAAGGAAAAAGTAACAGACCAAACTAAAAATATAGGAAGGCCCCCCCAGGGTTCGAAAAAAATTCTAGTTGG,CTCCGAGTTCTTTGCAGAGCTTTTTATAAAGGTCACTAAAAAGTAACAGACCAAACTAAAAATATAGGAAGGCCCCCCCAGGGTTCGAAAAAAATTCTA,10,30,14,27,27,36,27,41,27,33,33,36,38,41,-0.45,0.0
hek293t,13590,1,14,TCCTGTTTTGCATGTGGTGTTTCAGTTTTTGGGGGTTGCACTTTGCCCCCCCCCCTTATGATGTTAAAAAAATTCTAGTTGGTTTAACGCGTAACTAGA,TCCTGTTTTGCATGTGGTGTTTCAGTTTTTGGGGGTCAGCTCCCCCACCCTGCACTTTGCCCCCCCCCCTTATGATGTTAAAAAAATTCTAGTTGGTTT,10,30,14,27,27,44,27,58,27,37,37,44,51,58,-3.07,0.0
hek293t,13592,1,4,GTCGAACCGTCTTCAAGTCGGAGCGTTACTGGAGAGGGCAGAACCTGAGAAATCCTCCCCCCCCCAATGCGACAATAAAAAAAATTCTAGTTGGTTTAA,GTCGAACCGTCTTCAAGTCGGAGCGTCTTATACTGGAGAGGGCAGAACCTGAGAAATCCTCCCCCCCCCAATGCGACAATAAAAAAAATTCTAGTTGGT,10,30,14,27,27,42,27,46,27,27,27,42,31,46,15.81,85.00777925
hek293t,13592,1,4,GTAGAACCGTCTTCAAGTCGGAGCGTTACTGGAGAGGGCAGAACCTGAGAAATCCTCCCCCCCCCAATGCGACAATAAGCATAAAAAAATTCTAGTTGG,GTAGAACCGTCTTCAAGTCGGAGCGTCTTATACTGGAGAGGGCAGAACCTGAGAAATCCTCCCCCCCCCAATGCGACAATAAGCATAAAAAAATTCTAG,10,30,14,27,27,37,27,41,27,27,27,37,31,41,15.81,93.10451511
hek293t,13594,1,11,CCTGCGGGGACTTCCAGGAGCAGGGGCGACGGCTGCGGGGAGGCTCCTCCAGGTGCCACTGCTCCGAGTCGCGGCAAAAAAATTCTAGTTGGTTTAACG,CCTGCGGGGACTTCCAGGAGCAGGGGCGATATCCTACGCCCGGCTGCGGGGAGGCTCCTCCAGGTGCCACTGCTCCGAGTCGCGGCAAAAAAATTCTAG,10,30,14,27,27,37,27,48,27,30,30,37,41,48,41.35,6.743786639
hek293t,13596,1,15,TTGTATATAAGCTGCTATAGAGGAAAGCCCGGTTGCTTTCATTTCCCCATTACACCTCCAGGCCTGAAAAAAATTCTAGTTGGTTTAACGCGTAACTAG,TTGTATATAAGCTGCTATAGAGGAAAGTAGAAAGCGCCAATGCCCGGTTGCTTTCATTTCCCCATTACACCTCCAGGCCTGAAAAAAATTCTAGTTGGT,10,30,14,27,27,42,27,57,27,27,27,42,42,57,50.96,33.29455025
hek293t,13596,1,15,AATATTATAAGCTGCTATAGAGGAAAGCCCGGTTGCTTTCATTTCCCCATTACACCTCCAGGCCTGGATCTAAAAAAATTCTAGTTGGTTTAACGCGTA,AATATTATAAGCTGCTATAGAGGAAAGTAGAAAGCGCCAATGCCCGGTTGCTTTCATTTCCCCATTACACCTCCAGGCCTGGATCTAAAAAAATTCTAG,10,30,14,27,27,37,27,52,27,27,27,37,42,52,50.96,23.82646071
hek293t,13598,1,8,GTGATGAGAATTGAAAGTGCGTGGCAATCCGGCCAGCCAGCCTGTTCCCAAAACCGCCAAAAGATTTACAGAAAAAAATTCTAGTTGGTTTAACGCGTA,GTGATGAGAATTGAAAGTGCGTGGCAATCCGGCTTGCGCGGCAGCCAGCCTGTTCCCAAAACCGCCAAAAGATTTACAGAAAAAAATTCTAGTTGGTTT,10,30,14,27,27,44,27,52,27,34,34,44,42,52,25.68,55.9859052
hek293t,13598,1,8,GAATCGAGAATTGAAAGTGCGTGGCAATCCGGCCAGCCAGCCTGTTCCCAAAACCGCCAAAAGATTTACAGAGAAAAAAAATTCTAGTTGGTTTAACGC,GAATCGAGAATTGAAAGTGCGTGGCAATCCGGCTTGCGCGGCAGCCAGCCTGTTCCCAAAACCGCCAAAAGATTTACAGAGAAAAAAAATTCTAGTTGG,10,30,14,27,27,41,27,49,27,34,34,41,42,49,25.68,12.86696517
hek293t,13600,1,13,CGGAGAAATAACTGTGCGCTTGCCATGAGCGGACCGTCATCCAGCACCGGCGCGTCCCCGACCCGGCCAAAAAAATTCTAGTTGGTTTAACGCGTAACT,CGGAGAAATAACTGTGCGCTTGCCATCGAGTACTGTACAGAGCGGACCGTCATCCAGCACCGGCGCGTCCCCGACCCGGCCAAAAAAATTCTAGTTGGT,10,30,14,27,27,42,27,55,27,27,27,42,40,55,46.08,28.89610497
hek293t,13600,1,13,AGGTGAAATAACTGTGCGCTTGCCATGAGCGGACCGTCATCCAGCACCGGCGCGTCCCCGACCCGGCCGGCTGCTGAAAAAAATTCTAGTTGGTTTAAC,AGGTGAAATAACTGTGCGCTTGCCATCGAGTACTGTACAGAGCGGACCGTCATCCAGCACCGGCGCGTCCCCGACCCGGCCGGCTGCTGAAAAAAATTC,10,30,14,27,27,34,27,47,27,27,27,34,40,47,46.08,8.061215836
hek293t,13602,1,7,CCTGTGGCGCTGCCTCCCGTCAGAAGGCGCGGCAGGAGGACCTGCTTCCTCCCGCTGCTCTTGGGTAACAACCCAAAAAAATTCTAGTTGGTTTAACGC,CCTGTGGCGCTGCCTCCCGTCAGAAGAAGGTCAGCGCGGCAGGAGGACCTGCTTCCTCCCGCTGCTCTTGGGTAACAACCCAAAAAAATTCTAGTTGGT,10,30,14,27,27,42,27,49,27,27,27,42,34,49,52.78,7.117533386
hek293t,13604,1,2,GCCCTATACTGACCACCAGTTCTGGAACTTGGTTCTTAGTTCAACTTATACATCCATTTCACTTTAAGAACTCATTCAAAAAAAATTCTAGTTGGTTTA,GCCCTATACTGACCACCAGTTCTGGAACTTGGTTTTCTTAGTTCAACTTATACATCCATTTCACTTTAAGAACTCATTCAAAAAAAATTCTAGTTGGTT,10,30,14,27,27,43,27,45,27,33,33,43,35,45,50.51,80.21210618
hek293t,13604,1,2,AGGTAATACTGACCACCAGTTCTGGAACTTGGTTCTTAGTTCAACTTATACATCCATTTCACTTTAAGAACTCATTCAAAAAAAAAAATTCTAGTTGGT,AGGTAATACTGACCACCAGTTCTGGAACTTGGTTTTCTTAGTTCAACTTATACATCCATTTCACTTTAAGAACTCATTCAAAAAAAAAAATTCTAGTTG,10,30,14,27,27,40,27,42,27,33,33,40,35,42,50.51,81.008557
hek293t,13606,1,3,CACATTATATTATGTCCAATTTGGCAATTTGGGGTTAAAATAGCCTTTCAAGGGTAATTTCAGAGAAAGAAAAACAAAGACAAAAAAAAATTCTAGTTG,CACATTATATTATGTCCAATTTGGCAGTCATTTGGGGTTAAAATAGCCTTTCAAGGGTAATTTCAGAGAAAGAAAAACAAAGACAAAAAAAAATTCTAG,10,30,14,27,27,37,27,40,27,27,27,37,30,40,0.32,11.37878945
hek293t,13606,1,3,AGACATATATTATGTCCAATTTGGCAATTTGGGGTTAAAATAGCCTTTCAAGGGTAATTTCAGAGAAAGAAAAACAAAGACAACAAAAAAAAATTCTAG,AGACATATATTATGTCCAATTTGGCAGTCATTTGGGGTTAAAATAGCCTTTCAAGGGTAATTTCAGAGAAAGAAAAACAAAGACAACAAAAAAAAATTC,10,30,14,27,27,34,27,37,27,27,27,34,30,37,0.32,7.07317678
hek293t,13608,1,7,AAATGTGCAGGTAAGTGTCCTGATATATCTGGACATCTTCGAAGGAGTTATTCTCCCTATAGTTCCTGCTGCAAAAAAATTCTAGTTGGTTTAACGCGT,AAATGTGCAGGTAAGTGTCCTGATATATTTCTAGACTGGACATCTTCGAAGGAGTTATTCTCCCTATAGTTCCTGCTGCAAAAAAATTCTAGTTGGTTT,10,30,14,27,27,44,27,51,27,29,29,44,36,51,19.34,54.62041806
hek293t,13612,1,7,TCCGACACTGTGAAATACGCATTTGGCTAAGGCTTTAATGGTTTCCTGAATTCCCCCCCTAAAACAAACAAAAAAAATTCTAGTTGGTTTAACGCGTAA,TCCGACACTGTGAAATACGCATTTGGCTAAGGCTTTAACACTTAATGGTTTCCTGAATTCCCCCCCTAAAACAAACAAAAAAAATTCTAGTTGGTTTAA,10,30,14,27,27,46,27,53,27,36,36,46,43,53,24.01,18.97566504
hek293t,13612,1,7,GCGTGCACTGTGAAATACGCATTTGGCTAAGGCTTTAATGGTTTCCTGAATTCCCCCCCTAAAACAAAAAAATTCTAGTTGGTTTAACGCGTAACTAGA,GCGTGCACTGTGAAATACGCATTTGGCTAAGGCTTTAACACTTAATGGTTTCCTGAATTCCCCCCCTAAAACAAAAAAATTCTAGTTGGTTTAACGCGT,10,30,14,27,27,51,27,58,27,36,36,51,43,58,24.01,12.96980964
hek293t,13614,1,6,TAGGCTAAATATGGCATTGTTACTAAATTCGGACACTTGTATCCTTAACCTGGCTTATCTGTAAAGAAAGGAAAAAAATTCTAGTTGGTTTAACGCGTA,TAGGCTAAATATGGCATTGTTACTAAATTCCGCACGGGACACTTGTATCCTTAACCTGGCTTATCTGTAAAGAAAGGAAAAAAATTCTAGTTGGTTTAA,10,30,14,27,27,46,27,52,27,31,31,46,37,52,10.35,23.12394939
hek293t,13614,1,6,TGTCTTAAATATGGCATTGTTACTAAATTCGGACACTTGTATCCTTAACCTGGCTTATCTGTAAAGAAAGGAAAGAAAAAAAATTCTAGTTGGTTTAAC,TGTCTTAAATATGGCATTGTTACTAAATTCCGCACGGGACACTTGTATCCTTAACCTGGCTTATCTGTAAAGAAAGGAAAGAAAAAAAATTCTAGTTGG,10,30,14,27,27,41,27,47,27,31,31,41,37,47,10.35,30.46964834
hek293t,13616,1,5,GACCTAGCTTGCTTCCCTCTTACTTAGGCAGGATCAAGCACCAACCCCGGGCTCCCAAACCGTCCCTGACTGACAGGAGAAAAAAATTCTAGTTGGTTT,GACCTAGCTTGCTTCCCTCTTACTTAGGGCTTGCAGGATCAAGCACCAACCCCGGGCTCCCAAACCGTCCCTGACTGACAGGAGAAAAAAATTCTAGTT,10,30,14,27,27,39,27,44,27,29,29,39,34,44,19.57,12.42569346
hek293t,13616,1,5,TAGTCAGCTTGCTTCCCTCTTACTTAGGCAGGATCAAGCACCAACCCCGGGCTCCCAAACCGTCCCTGACTGACAGGAGACACTGCAAAAAAATTCTAG,TAGTCAGCTTGCTTCCCTCTTACTTAGGGCTTGCAGGATCAAGCACCAACCCCGGGCTCCCAAACCGTCCCTGACTGACAGGAGACACTGCAAAAAAAT,10,30,14,27,27,32,27,37,27,29,29,32,34,37,19.57,0.236966825
hek293t,13619,1,2,TGTCGATCAATGGGAGTGTGCACTCTTCCTGGATATGATTTAGTTGCTAGGGTTTCTTACAGAGAACCCTAAAAAAATTCTAGTTGGTTTAACGCGTAA,TGTCGATCAATGGGAGTGTGCACTCTTCCTGGATAGCTGATTTAGTTGCTAGGGTTTCTTACAGAGAACCCTAAAAAAATTCTAGTTGGTTTAACGCGT,10,30,14,27,27,51,27,53,27,36,36,51,38,53,26.99,77.70811092
hek293t,13619,1,2,CTTGAATCAATGGGAGTGTGCACTCTTCCTGGATATGATTTAGTTGCTAGGGTTTCTTACAGAGAACCCTGCTAATGGAAAAAAATTCTAGTTGGTTTA,CTTGAATCAATGGGAGTGTGCACTCTTCCTGGATAGCTGATTTAGTTGCTAGGGTTTCTTACAGAGAACCCTGCTAATGGAAAAAAATTCTAGTTGGTT,10,30,14,27,27,43,27,45,27,36,36,43,38,45,26.99,85.90810824
hek293t,13621,1,4,TTAATTATTCACCAGCATACCACCATATGTGGTCACATATTAACTCCTACTAACTTCCTGAGCTCTATCTTCTAAAAAAAATTCTAGTTGGTTTAACGC,TTAATTATTCACCAGCATACCACCATATGTGGTCACATATATATTAACTCCTACTAACTTCCTGAGCTCTATCTTCTAAAAAAAATTCTAGTTGGTTTA,10,30,14,27,27,45,27,49,27,38,38,45,42,49,45.82,0.0
hek293t,13623,1,1,TGAACAAAAGAAGCCATATAATTTGGTGTTGGCAAACTTCTCAGTTTATCCAGTTATTCATAGGAAAGGAATTTATTAGAGCTAAAAAAATTCTAGTTG,TGAACAAAAGAAGCCATATAATTTGGTGTTGGGCAAACTTCTCAGTTTATCCAGTTATTCATAGGAAAGGAATTTATTAGAGCTAAAAAAATTCTAGTT,10,30,14,27,27,39,27,40,27,32,32,39,33,40,38.41,81.94254718
hek293t,13623,1,1,CCTAGAAAAGAAGCCATATAATTTGGTGTTGGCAAACTTCTCAGTTTATCCAGTTATTCATAGGAAAGGAATTTAAAAAAAATTCTAGTTGGTTTAACG,CCTAGAAAAGAAGCCATATAATTTGGTGTTGGGCAAACTTCTCAGTTTATCCAGTTATTCATAGGAAAGGAATTTAAAAAAAATTCTAGTTGGTTTAAC,10,30,14,27,27,47,27,48,27,32,32,47,33,48,38.41,85.38763503
hek293t,13625,1,7,ATATAGTTGAGAAAGCATATAGCCTGCTTCGGGGTTTCAGTTGGATCTGAAGATCATTTAGCCATATTTGTATTGTGCTGCAAAAAAATTCTAGTTGGT,ATATAGTTGAGAAAGCATATAGCCTGCTTCGCGAATAAGGGTTTCAGTTGGATCTGAAGATCATTTAGCCATATTTGTATTGTGCTGCAAAAAAATTCT,10,30,14,27,27,35,27,42,27,32,32,35,39,42,37.99,0.264550265
hek293t,13625,1,7,TCCTGGTTGAGAAAGCATATAGCCTGCTTCGGGGTTTCAGTTGGATCTGAAGATCATTTAGCCATATTTGTATTAAAAAAATTCTAGTTGGTTTAACGC,TCCTGGTTGAGAAAGCATATAGCCTGCTTCGCGAATAAGGGTTTCAGTTGGATCTGAAGATCATTTAGCCATATTTGTATTAAAAAAATTCTAGTTGGT,10,30,14,27,27,42,27,49,27,32,32,42,39,49,37.99,64.12856759
hek293t,13627,1,4,TAAGATATTTTTGTGAAAATAAGGAATAAAGGCACATCTGAGACAGCAGTTCACAGAATAGATGAGCTCCCAGGGGGAAAAAAATTCTAGTTGGTTTAA,TAAGATATTTTTGTGAAAATAAGGAATAAAGGCACTGACATCTGAGACAGCAGTTCACAGAATAGATGAGCTCCCAGGGGGAAAAAAATTCTAGTTGGT,10,30,14,27,27,42,27,46,27,35,35,42,39,46,17.3,1.084833491
hek293t,13628,1,13,CAGCGGGCCAGAAGTGATTTCACTTGAACAGGTTAAAACCTCAGAATAACTTATTAGCTAGTACCTTTTTGTTGAAAAAAATTCTAGTTGGTTTAACGC,CAGCGGGCCAGAAGTGATTTCACTTGAAATTAACAACAAGCCAGGTTAAAACCTCAGAATAACTTATTAGCTAGTACCTTTTTGTTGAAAAAAATTCTA,10,30,14,27,27,36,27,49,27,29,29,36,42,49,16.65,0.595950901
hek293t,13628,1,13,CCGTCGGCCAGAAGTGATTTCACTTGAACAGGTTAAAACCTCAGAATAACTTATTAGCTAGTACCTTTTTGAAAAAAATTCTAGTTGGTTTAACGCGTA,CCGTCGGCCAGAAGTGATTTCACTTGAAATTAACAACAAGCCAGGTTAAAACCTCAGAATAACTTATTAGCTAGTACCTTTTTGAAAAAAATTCTAGTT,10,30,14,27,27,39,27,52,27,29,29,39,42,52,16.65,1.76317134
hek293t,13630,1,7,TTGACCTGCAACGCTAGTTCGCTCTGCTTTGGTTTGAAGAATTTGACAAAGAGTGGAATGGAATTACAATTAAAAAAAATTCTAGTTGGTTTAACGCGT,TTGACCTGCAACGCTAGTTCGCTCTGCTTTGGTTTGAAGACGAGGGGATTTGACAAAGAGTGGAATGGAATTACAATTAAAAAAAATTCTAGTTGGTTT,10,30,14,27,27,44,27,51,27,41,41,44,48,51,53.46,1.431525202
hek293t,13631,1,14,AGTTACCCACTGATTAAAACCACGTCCTTTGGGTTATGAAGTATTGTTGGATGACAGAACTAAGACAAACTGCAAAAAAATTCTAGTTGGTTTAACGCG,AGTTACCCACTGATTAAAACCACGTCCTTTGGTTTTACGACGCCTAGTTATGAAGTATTGTTGGATGACAGAACTAAGACAAACTGCAAAAAAATTCTA,10,30,14,27,27,36,27,50,27,33,33,36,47,50,14.94,0.0
hek293t,13632,1,5,TGGTCGCTGCGGGGAATGGGGGACATGGCAGGATGCTGGGCAGGATGGCGAGAACTGTCGCTTTCCCCGCAGCCTAAAAAAATTCTAGTTGGTTTAACG,TGGTCGCTGCGGGGAATGGGGGACATGGCAGGATGGGCCTCTGGGCAGGATGGCGAGAACTGTCGCTTTCCCCGCAGCCTAAAAAAATTCTAGTTGGTT,10,30,14,27,27,43,27,48,27,36,36,43,41,48,28.21,60.67428722
hek293t,13632,1,5,GTAATGCTGCGGGGAATGGGGGACATGGCAGGATGCTGGGCAGGATGGCGAGAACTGTCGCTTTCCCCGCAGCCTTCGCAAAAAAATTCTAGTTGGTTT,GTAATGCTGCGGGGAATGGGGGACATGGCAGGATGGGCCTCTGGGCAGGATGGCGAGAACTGTCGCTTTCCCCGCAGCCTTCGCAAAAAAATTCTAGTT,10,30,14,27,27,39,27,44,27,36,36,39,41,44,28.21,0.0
hek293t,13634,1,7,CACTCTTATGGTAACTAGATCTGAAGTTCAGGAAGATAAACCCTATGTTTCCAGAACGGGTTTTACAGAAAGGCAAAAAAATTCTAGTTGGTTTAACGC,CACTCTTATGGTAACTAGATCTGAAGTTCAGGAAGAGAGCTGATAAACCCTATGTTTCCAGAACGGGTTTTACAGAAAGGCAAAAAAATTCTAGTTGGT,10,30,14,27,27,42,27,49,27,35,35,42,42,49,44.84,0.152207002
hek293t,13634,1,7,CCAATTTATGGTAACTAGATCTGAAGTTCAGGAAGATAAACCCTATGTTTCCAGAACGGGTTTTACAGAAAAAAAAAATTCTAGTTGGTTTAACGCGTA,CCAATTTATGGTAACTAGATCTGAAGTTCAGGAAGAGAGCTGATAAACCCTATGTTTCCAGAACGGGTTTTACAGAAAAAAAAAATTCTAGTTGGTTTA,10,30,14,27,27,45,27,52,27,35,35,45,42,52,44.84,22.60331486
hek293t,13636,1,9,GGTATTAATTGCATTGGCCATGTTGAAGATGGACTGACTGATGAGTGATAAAAAGTTCAGACATGTTTGATGAAAAAAATTCTAGTTGGTTTAACGCGT,GGTATTAATTGCATTGGCCATGTTGAAGATGAAACGTCAGGACTGACTGATGAGTGATAAAAAGTTCAGACATGTTTGATGAAAAAAATTCTAGTTGGT,10,30,14,27,27,42,27,51,27,32,32,42,41,51,21.77,41.26839333
hek293t,13636,1,9,GAACGTAATTGCATTGGCCATGTTGAAGATGGACTGACTGATGAGTGATAAAAAGTTCAGACATGTTAAAAAAATTCTAGTTGGTTTAACGCGTAACTA,GAACGTAATTGCATTGGCCATGTTGAAGATGAAACGTCAGGACTGACTGATGAGTGATAAAAAGTTCAGACATGTTAAAAAAATTCTAGTTGGTTTAAC,10,30,14,27,27,47,27,56,27,32,32,47,41,56,21.77,43.84704804
hek293t,13638,1,8,ACGGTCTGAAACAGCAGCAGCATGTGCAGTGGTTTCGCACTTGTGGAGGGAAAAGTTTTATCCCTGAAAAAAAATTCTAGTTGGTTTAACGCGTAACTA,ACGGTCTGAAACAGCAGCAGCATGTGCAGTGGGCACGGACTTTCGCACTTGTGGAGGGAAAAGTTTTATCCCTGAAAAAAAATTCTAGTTGGTTTAACG,10,30,14,27,27,48,27,56,27,33,33,48,41,56,49.17,7.341255563
hek293t,13638,1,8,TTGGCCTGAAACAGCAGCAGCATGTGCAGTGGTTTCGCACTTGTGGAGGGAAAAGTTTTATCCCTGAATTTTAAAAAAATTCTAGTTGGTTTAACGCGT,TTGGCCTGAAACAGCAGCAGCATGTGCAGTGGGCACGGACTTTCGCACTTGTGGAGGGAAAAGTTTTATCCCTGAATTTTAAAAAAATTCTAGTTGGTT,10,30,14,27,27,43,27,51,27,33,33,43,41,51,49.17,19.15491171
hek293t,13640,1,6,ACATCATGCGTGATGTGATGGGGCTTCTGGGGATGTGCCCAGTAGTTGGCTTTTAAGACATCTGTTTAAAAAAATTCTAGTTGGTTTAACGCGTAACTA,ACATCATGCGTGATGTGATGGGGCTTCTGGGGATGTGCCATGACTCAGTAGTTGGCTTTTAAGACATCTGTTTAAAAAAATTCTAGTTGGTTTAACGCG,10,30,14,27,27,50,27,56,27,40,40,50,46,56,51.93,14.38498577
hek293t,13640,1,6,TTCGCATGCGTGATGTGATGGGGCTTCTGGGGATGTGCCCAGTAGTTGGCTTTTAAGACATCTGTTTAAGCAGAAAAAAAATTCTAGTTGGTTTAACGC,TTCGCATGCGTGATGTGATGGGGCTTCTGGGGATGTGCCATGACTCAGTAGTTGGCTTTTAAGACATCTGTTTAAGCAGAAAAAAAATTCTAGTTGGTT,10,30,14,27,27,43,27,49,27,40,40,43,46,49,51.93,8.539938215
hek293t,13642,1,4,ATTGATACTTTCTGGCTTGCATACGTTGTTGGAAATAATTTGACATGATTGCTTTTCGTTTGCTCCTTTGTCGGAAAAAAAATTCTAGTTGGTTTAACG,ATTGATACTTTCTGGCTTGCATACGTTGCCATTTGGAAATAATTTGACATGATTGCTTTTCGTTTGCTCCTTTGTCGGAAAAAAAATTCTAGTTGGTTT,10,30,14,27,27,44,27,48,27,29,29,44,33,48,26.47,3.667419172
hek293t,13642,1,4,CCATATACTTTCTGGCTTGCATACGTTGTTGGAAATAATTTGACATGATTGCTTTTCGTTTGCTCCTTTGTCGGACACTTAAAAAAATTCTAGTTGGTT,CCATATACTTTCTGGCTTGCATACGTTGCCATTTGGAAATAATTTGACATGATTGCTTTTCGTTTGCTCCTTTGTCGGACACTTAAAAAAATTCTAGTT,10,30,14,27,27,39,27,43,27,29,29,39,33,43,26.47,41.68702147
hek293t,13644,1,14,CCAGATGCGTAGTGTTTATGTAGAGCAGATGGCACAACCTGGTATTAGAAGCTCTGCTGGGAAGAGGCAAAAAAATTCTAGTTGGTTTAACGCGTAACT,CCAGATGCGTAGTGTTTATGTAGAGCAGATGGCACAATATCACCTGTAATGCCTGGTATTAGAAGCTCTGCTGGGAAGAGGCAAAAAAATTCTAGTTGG,10,30,14,27,27,41,27,55,27,38,38,41,52,55,36.57,0.104353011
hek293t,13645,1,14,GACTCGCCTGTAGTAGTATGTTGTCTGCTTGGTGTTATGTCTAATTGCGAGTGCTAGCCGTTCCTCAGCTGAGGAGCAGAAAAAAATTCTAGTTGGTTT,GACTCGCCTGTAGTAGTATGTTGTCTCTGCGCGAAGTGATGCTTGGTGTTATGTCTAATTGCGAGTGCTAGCCGTTCCTCAGCTGAGGAGCAGAAAAAA,10,30,14,27,27,30,27,44,27,27,27,30,41,44,54.55,1.844435845
hek293t,13647,1,1,GCAGTTCTGGCACAGATGAATTATTTTATAGGACACAAACCTTCCCACACAACTTCAGCTCATGTCTTTGGCAACTCAGCTAACCCCTGTTCAAAAAAA,GCAGTTCTGGCACAGATGAATTATTTATATAGGACACAAACCTTCCCACACAACTTCAGCTCATGTCTTTGGCAACTCAGCTAACCCCTGTTCAAAAAA,10,30,14,27,27,30,27,31,27,27,27,30,28,31,6.24,0.0
hek293t,13649,1,11,TAAGATCCTTCCTCTTTAGCAAGTGTTCACGGTCTACTCCAGGCCTACAAAACTTGTCCTTCTGCAAAAAAAAAATTCTAGTTGGTTTAACGCGTAACT,TAAGATCCTTCCTCTTTAGCAAGTGTTCACGGTCTAGGACAGGAGCTCTCCAGGCCTACAAAACTTGTCCTTCTGCAAAAAAAAAATTCTAGTTGGTTT,10,30,14,27,27,44,27,55,27,37,37,44,48,55,17.87,0.0
hek293t,10095,1,6,TCGAGAAAACAAAAACCTAACCATTGCCATGGCACCAGGAAGAGGTATACACTTGAGACCAAGGTCTGCAGTTAAAAAAATTCTAGTTGGTTTAACGCG,TCGAGAAAACAAAAACCTAACCATTGCCATGGCACCATGCGAAGGAAGAGGTATACACTTGAGACCAAGGTCTGCAGTTAAAAAAATTCTAGTTGGTTT,10,30,14,27,27,44,27,50,27,37,37,44,43,50,51.82,2.246585786
hek293t,10095,1,6,TGCAAAAAACAAAAACCTAACCATTGCCATGGCACCAGGAAGAGGTATACACTTGAGACCAAGGTAAAAAAATTCTAGTTGGTTTAACGCGTAACTAGA,TGCAAAAAACAAAAACCTAACCATTGCCATGGCACCATGCGAAGGAAGAGGTATACACTTGAGACCAAGGTAAAAAAATTCTAGTTGGTTTAACGCGTA,10,30,14,27,27,52,27,58,27,37,37,52,43,58,51.82,1.595046492
hek293t,13652,1,4,CCGACAGCATGTTCCTTTTCCATGAACTTTGGAGTGATGGTTCTTCCCATGGGAACTCAAACAAGCAAAGCAAATCCTAAGAAGCAACAAAAAAATTCT,CCGACAGCATGTTCCTTTTCCATGAACCAGTTTTGGAGTGATGGTTCTTCCCATGGGAACTCAAACAAGCAAAGCAAATCCTAAGAAGCAACAAAAAAA,10,30,14,27,27,31,27,35,27,28,28,31,32,35,46.46,0.854971939
hek293t,13652,1,4,CGAAGAGCATGTTCCTTTTCCATGAACTTTGGAGTGATGGTTCTTCCCATGGGAACTCAAACAAGCAAAGCAAATCCTAAGAAGAAAAAAATTCTAGTT,CGAAGAGCATGTTCCTTTTCCATGAACCAGTTTTGGAGTGATGGTTCTTCCCATGGGAACTCAAACAAGCAAAGCAAATCCTAAGAAGAAAAAAATTCT,10,30,14,27,27,35,27,39,27,28,28,35,32,39,46.46,81.97271098
hek293t,13654,1,10,TAGAGCGCCAGGTACTGTCTGATTTCCATAGGAAAGCTGTCATCATACAGCTGGTGAACTTGTTCCAAAAAAAAAATTCTAGTTGGTTTAACGCGTAAC,TAGAGCGCCAGGTACTGTCTGATTTCCATAGGAAAGTCGATACACCCTGTCATCATACAGCTGGTGAACTTGTTCCAAAAAAAAAATTCTAGTTGGTTT,10,30,14,27,27,44,27,54,27,37,37,44,47,54,38.85,0.247904219
hek293t,13655,1,10,ACGGGTGCTGACTGGTAAATGAACATTACAGGTCCTGTGCATGTGGTGGGGGTTTTGGAATTGTTAAAAAAATTCTAGTTGGTTTAACGCGTAACTAGA,ACGGGTGCTGACTGGTAAATGAACATTACAGGTCTTTTTTCCTCCTGTGCATGTGGTGGGGGTTTTGGAATTGTTAAAAAAATTCTAGTTGGTTTAACG,10,30,14,27,27,48,27,58,27,33,33,48,43,58,15.26,8.34529782
hek293t,13655,1,10,TATCTTGCTGACTGGTAAATGAACATTACAGGTCCTGTGCATGTGGTGGGGGTTTTGGAATTGTTGTTCAAAAAAAATTCTAGTTGGTTTAACGCGTAA,TATCTTGCTGACTGGTAAATGAACATTACAGGTCTTTTTTCCTCCTGTGCATGTGGTGGGGGTTTTGGAATTGTTGTTCAAAAAAAATTCTAGTTGGTT,10,30,14,27,27,43,27,53,27,33,33,43,43,53,15.26,20.5438001
hek293t,13657,1,9,GAACTTGATCGCAAAAGAATGATATTGGCTGGGTTTCTCTCATGGATGATTTTGAACTATGGCAGCAAAAAAATTCTAGTTGGTTTAACGCGTAACTAG,GAACTTGATCGCAAAAGAATGATATTGGCTGGGTTTCTCTTAACAATGACATGGATGATTTTGAACTATGGCAGCAAAAAAATTCTAGTTGGTTTAACG,10,30,14,27,27,48,27,57,27,41,41,48,50,57,12.55,0.036390102
hek293t,13658,1,2,GGGGGAATAAAACTGTTTTGAATATAGGCAGGAACGATTGTGAATAATCTCAGATTTATCTAGTACACCACAAGTCACTGAGCTCTAAAAAAATTCTAG,GGGGGAATAAAACTGTTTTGAATATAGGGGCAGGAACGATTGTGAATAATCTCAGATTTATCTAGTACACCACAAGTCACTGAGCTCTAAAAAAATTCT,10,30,14,27,27,35,27,37,27,28,28,35,30,37,29.28,7.168556963
hek293t,13658,1,2,GAAATAATAAAACTGTTTTGAATATAGGCAGGAACGATTGTGAATAATCTCAGATTTATCTAGTACACCACAAGTCACTGAGCAAAAAAATTCTAGTTG,GAAATAATAAAACTGTTTTGAATATAGGGGCAGGAACGATTGTGAATAATCTCAGATTTATCTAGTACACCACAAGTCACTGAGCAAAAAAATTCTAGT,10,30,14,27,27,38,27,40,27,28,28,38,30,40,29.28,8.430600118
hek293t,13660,1,13,GCATCAAGATCTTTAACTAACAAAGATTAAGGTTTACTAATATGTGGCTGCTAAATTTATTTTTAAAAAAATTCTAGTTGGTTTAACGCGTAACTAGAT,GCATCAAGATCTTTAACTAACAAAGATTAAGGTTTACTACTGAATGAACGAAATATGTGGCTGCTAAATTTATTTTTAAAAAAATTCTAGTTGGTTTAA,10,30,14,27,27,46,27,59,27,39,39,46,52,59,10.86,0.0
hek293t,13661,1,14,ATGGGCTGTTCACTAGGTCATTTTTGGACTGGGTCGACTCCAAACATGGTGGGATGGAGACCTCAAAAAAATTCTAGTTGGTTTAACGCGTAACTAGAT,ATGGGCTGTTCACTAGGTCATTTTTGGACTGGGTCGAAGCGAACAAGCGAACTCCAAACATGGTGGGATGGAGACCTCAAAAAAATTCTAGTTGGTTTA,10,30,14,27,27,45,27,59,27,38,38,45,52,59,3.67,0.083229297
hek293t,13662,1,5,CACACGGTTTTGTCTGAGGTTTTCGTTCTTGGGTTTTTCGTGCCTTTGATGAAGGAAGGGTTTCGCGGGGGGAAAAAAATTCTAGTTGGTTTAACGCGT,CACACGGTTTTGTCTGAGGTTTTCGTTCTTGGGTTAGTTATTTCGTGCCTTTGATGAAGGAAGGGTTTCGCGGGGGGAAAAAAATTCTAGTTGGTTTAA,10,30,14,27,27,46,27,51,27,36,36,46,41,51,1.06,1.629948613
hek293t,13662,1,5,GAGAGGGTTTTGTCTGAGGTTTTCGTTCTTGGGTTTTTCGTGCCTTTGATGAAGGAAGGGTTTCGCGAAAAAAATTCTAGTTGGTTTAACGCGTAACTA,GAGAGGGTTTTGTCTGAGGTTTTCGTTCTTGGGTTAGTTATTTCGTGCCTTTGATGAAGGAAGGGTTTCGCGAAAAAAATTCTAGTTGGTTTAACGCGT,10,30,14,27,27,51,27,56,27,36,36,51,41,56,1.06,0.569499165
hek293t,13664,1,11,ATGGGACAGACTTTCTTGGGAGCACACAAAGGCTGTCACCAGCCATTCGCTAAAACAAATGAACAAAAAAATTCTAGTTGGTTTAACGCGTAACTAGAT,ATGGGACAGACTTTCTTGGGAGCACACAAAGGCTGTCTAGGCATTGACACCAGCCATTCGCTAAAACAAATGAACAAAAAAATTCTAGTTGGTTTAACG,10,30,14,27,27,48,27,59,27,38,38,48,49,59,58.1,4.543083496
hek293t,13665,1,1,ATTATTGCCAAAAGCAGAATCAAGGTTGCTGGCAGTCCTGGCTGTCTCGCATGTTCAGCCTCTCTGCTGGCTGCAAAAAAATTCTAGTTGGTTTAACGC,ATTATTGCCAAAAGCAGAATCAAGGTTGCTGGCAGTCCTGAGCTGTCTCGCATGTTCAGCCTCTCTGCTGGCTGCAAAAAAATTCTAGTTGGTTTAACG,10,30,14,27,27,48,27,49,27,41,41,48,42,49,39.03,77.34794499
hek293t,13665,1,1,ATTTATGCCAAAAGCAGAATCAAGGTTGCTGGCAGTCCTGGCTGTCTCGCATGTTCAGCCTCTCTGAAAAAAATTCTAGTTGGTTTAACGCGTAACTAG,ATTTATGCCAAAAGCAGAATCAAGGTTGCTGGCAGTCCTGAGCTGTCTCGCATGTTCAGCCTCTCTGAAAAAAATTCTAGTTGGTTTAACGCGTAACTA,10,30,14,27,27,56,27,57,27,41,41,56,42,57,39.03,70.91657166
hek293t,13667,1,6,GAGGGTCTAAAATAGCACTCAAATTCCTCTGGCTCCAAAAGAGGATCAGCATCATCAAGACTGCTTTTACTAAAAAAAATTCTAGTTGGTTTAACGCGT,GAGGGTCTAAAATAGCACTCAAATTCCTCTGGCTCGAGCTCCAAAAGAGGATCAGCATCATCAAGACTGCTTTTACTAAAAAAAATTCTAGTTGGTTTA,10,30,14,27,27,45,27,51,27,35,35,45,41,51,22.82,2.614195367
hek293t,13667,1,6,TCCATTCTAAAATAGCACTCAAATTCCTCTGGCTCCAAAAGAGGATCAGCATCATCAAGACTGCTTTTACTATTTAAAAAAATTCTAGTTGGTTTAACG,TCCATTCTAAAATAGCACTCAAATTCCTCTGGCTCGAGCTCCAAAAGAGGATCAGCATCATCAAGACTGCTTTTACTATTTAAAAAAATTCTAGTTGGT,10,30,14,27,27,42,27,48,27,35,35,42,41,48,22.82,5.235101971
hek293t,13669,1,3,AACCATTTTTTATAGGATAATACCATTTTAGGTGCAAGCAGCAGCAGAAGAAACTTGAGGAAGCGGGTCACTGTTTTCAAAAAAATTCTAGTTGGTTTA,AACCATTTTTTATAGGATAATACCATTTTAGATCGTGCAAGCAGCAGCAGAAGAAACTTGAGGAAGCGGGTCACTGTTTTCAAAAAAATTCTAGTTGGT,10,30,14,27,27,42,27,45,27,32,32,42,35,45,1.06,9.316248991
hek293t,13669,1,3,CGCAGTTTTTTATAGGATAATACCATTTTAGGTGCAAGCAGCAGCAGAAGAAACTTGAGGAAGCGGGTCACTGAAAAAAATTCTAGTTGGTTTAACGCG,CGCAGTTTTTTATAGGATAATACCATTTTAGATCGTGCAAGCAGCAGCAGAAGAAACTTGAGGAAGCGGGTCACTGAAAAAAATTCTAGTTGGTTTAAC,10,30,14,27,27,47,27,50,27,32,32,47,35,50,1.06,7.761073335
hek293t,13671,1,12,GTGGCCACCACCGCACACGTGCTTGTCACAGGGACAGCGACCTCGGAAATAAAATGCCTTATATGCAAAAAAAATTCTAGTTGGTTTAACGCGTAACTA,GTGGCCACCACCGCACACGTGCTTGTCATAAGTGACGACTCAGGGACAGCGACCTCGGAAATAAAATGCCTTATATGCAAAAAAAATTCTAGTTGGTTT,10,30,14,27,27,44,27,56,27,29,29,44,41,56,38.69,55.32969335
hek293t,13673,1,12,ACGAGTGTGTGCCTCCTGTGTGACAGCTAAGGGTCCCTTACATCTATTCCCAAGGAAAAAATCTTGAAGTGTACAAAAAAAATTCTAGTTGGTTTAACG,ACGAGTGTGTGCCTCCTGTGTGACAGCTAAGGCTATCCAACTCGGTCCCTTACATCTATTCCCAAGGAAAAAATCTTGAAGTGTACAAAAAAAATTCTA,10,30,14,27,27,36,27,48,27,33,33,36,45,48,44.77,0.07733952
hek293t,13673,1,12,TCATCTGTGTGCCTCCTGTGTGACAGCTAAGGGTCCCTTACATCTATTCCCAAGGAAAAAATCTTGAAGTGAAAAAAATTCTAGTTGGTTTAACGCGTA,TCATCTGTGTGCCTCCTGTGTGACAGCTAAGGCTATCCAACTCGGTCCCTTACATCTATTCCCAAGGAAAAAATCTTGAAGTGAAAAAAATTCTAGTTG,10,30,14,27,27,40,27,52,27,33,33,40,45,52,44.77,2.196072232
hek293t,13675,1,13,CATGGAGTTAAATACCTGTTTAATTCTAAAGGCTCCACCCTTGTTACAAGATGCTGTCACTTCTTTACTGTTAAAAAAATTCTAGTTGGTTTAACGCGT,CATGGAGTTAAATACCTGTTTAATTCTTGTGGAAACAGTTAAAGGCTCCACCCTTGTTACAAGATGCTGTCACTTCTTTACTGTTAAAAAAATTCTAGT,10,30,14,27,27,38,27,51,27,28,28,38,41,51,2.83,6.234036248
hek293t,13675,1,13,TACGCAGTTAAATACCTGTTTAATTCTAAAGGCTCCACCCTTGTTACAAGATGCTGTCACTTCTTTACTGTTGGTCTGCAAAAAAATTCTAGTTGGTTT,TACGCAGTTAAATACCTGTTTAATTCTTGTGGAAACAGTTAAAGGCTCCACCCTTGTTACAAGATGCTGTCACTTCTTTACTGTTGGTCTGCAAAAAAA,10,30,14,27,27,31,27,44,27,28,28,31,41,44,2.83,0.0
hek293t,13677,1,5,GTAGACATTATAAGCTCTTCTGATACGTCTGGTTGTATTAATCTTGTTTGAACCATAGATTTGAGGCATTGCTAATCAAAAAAAATTCTAGTTGGTTTA,GTAGACATTATAAGCTCTTCTGATACGTCGAAAGTGGTTGTATTAATCTTGTTTGAACCATAGATTTGAGGCATTGCTAATCAAAAAAAATTCTAGTTG,10,30,14,27,27,40,27,45,27,30,30,40,35,45,38.07,50.4850669
hek293t,13677,1,5,ACATACATTATAAGCTCTTCTGATACGTCTGGTTGTATTAATCTTGTTTGAACCATAGATTTGAGGCATTGCTAATCATCTATGTAAAAAAATTCTAGT,ACATACATTATAAGCTCTTCTGATACGTCGAAAGTGGTTGTATTAATCTTGTTTGAACCATAGATTTGAGGCATTGCTAATCATCTATGTAAAAAAATT,10,30,14,27,27,33,27,38,27,30,30,33,35,38,38.07,0.34670629
hek293t,13679,1,12,CATCCTTACACAAAATGTGCAAATTTTGCAGGAAAAATAAGAACTTAAATCAGTCTTCATTGCACCAAAAAAATTCTAGTTGGTTTAACGCGTAACTAG,CATCCTTACACAAAATGTGCAAATTTTGCAGGAATTATAACGCAAGAAATAAGAACTTAAATCAGTCTTCATTGCACCAAAAAAATTCTAGTTGGTTTA,10,30,14,27,27,45,27,57,27,35,35,45,47,57,4.53,0.0
hek293t,16068,1,12,TGATGCTGAGTTGCCTGGTGGTATTTTACAGGCAGAGGTAATCTCACTCTGTCTTGAGCTGACCAAAAAAAATTCTAGTTGGTTTAACGCGTAACTAGA,TGATGCTGAGTTGCCTGGTGGTATTTTACAGAATTGAACTGAGGCAGAGGTAATCTCACTCTGTCTTGAGCTGACCAAAAAAAATTCTAGTTGGTTTAA,10,30,14,27,27,46,27,58,27,31,31,46,43,58,17.5,14.24257272
hek293t,16068,1,12,GGCGGCTGAGTTGCCTGGTGGTATTTTACAGGCAGAGGTAATCTCACTCTGTCTTGAGCTGACCAGGCCGAAAAAAATTCTAGTTGGTTTAACGCGTAA,GGCGGCTGAGTTGCCTGGTGGTATTTTACAGAATTGAACTGAGGCAGAGGTAATCTCACTCTGTCTTGAGCTGACCAGGCCGAAAAAAATTCTAGTTGG,10,30,14,27,27,41,27,53,27,31,31,41,43,53,17.5,5.961464548
hek293t,13682,1,10,TCACCAAGTCTAATGACCATGAAACAATTAGGAACCAATAGTAAATCTGTAGTTACCTTGTGTTTTAAAAAAATTCTAGTTGGTTTAACGCGTAACTAG,TCACCAAGTCTAATGACCATGAAACAATTAGGAACCAATCTTCTAAGTCAGTAAATCTGTAGTTACCTTGTGTTTTAAAAAAATTCTAGTTGGTTTAAC,10,30,14,27,27,47,27,57,27,40,40,47,50,57,16.43,0.075419348
hek293t,13683,1,1,AAAAGGGAGGGTTGGTGACGTGCAGAAAGAGGTGAACGTGCGCTCCCAGGCAGCGTGCAGCACTGGGTAAGGCTCAAAAAAATTCTAGTTGGTTTAACG,AAAAGGGAGGGTTGGTGACGTGCAGAAAGAGGTGAACGTAGCGCTCCCAGGCAGCGTGCAGCACTGGGTAAGGCTCAAAAAAATTCTAGTTGGTTTAAC,10,30,14,27,27,47,27,48,27,40,40,47,41,48,69.56,74.22435351
hek293t,13683,1,1,TGGCAGGAGGGTTGGTGACGTGCAGAAAGAGGTGAACGTGCGCTCCCAGGCAGCGTGCAGCACTGGGTAAGGAAAAAAATTCTAGTTGGTTTAACGCGT,TGGCAGGAGGGTTGGTGACGTGCAGAAAGAGGTGAACGTAGCGCTCCCAGGCAGCGTGCAGCACTGGGTAAGGAAAAAAATTCTAGTTGGTTTAACGCG,10,30,14,27,27,50,27,51,27,40,40,50,41,51,69.56,71.19952943
hek293t,13685,1,2,AAGGCTTTGAGGGATATAGGGGTAGTGTTAGGAAGAGCAAATCAGGTGACTATTAGTTTCACCTTGCTTTACTTTAGGGTGCTCAGCTAATAAAAAAAT,AAGGCTTTGAGGGATATAGGGGTAGTCAGTTAGGAAGAGCAAATCAGGTGACTATTAGTTTCACCTTGCTTTACTTTAGGGTGCTCAGCTAATAAAAAA,10,30,14,27,27,30,27,32,27,27,27,30,29,32,50.87,3.524285593
hek293t,13685,1,2,CAGGCTTTGAGGGATATAGGGGTAGTGTTAGGAAGAGCAAATCAGGTGACTATTAGTTTCACCTTGCTTTACTTTAGGGTGCTCAGCAAAAAAATTCTA,CAGGCTTTGAGGGATATAGGGGTAGTCAGTTAGGAAGAGCAAATCAGGTGACTATTAGTTTCACCTTGCTTTACTTTAGGGTGCTCAGCAAAAAAATTC,10,30,14,27,27,34,27,36,27,27,27,34,29,36,50.87,87.26007326
hek293t,13687,1,4,TCAGGAAGGCTGCGCGCTGTGCTGTGAGCAGGGAGGCTGCACTGCTCGTCCCTTGTGCCTCCGAGAGTATTTTGAGAGAGAGAAAAAAAATTCTAGTTG,TCAGGAAGGCTGCGCGCTGTGCTGTGAGTAGACAGGGAGGCTGCACTGCTCGTCCCTTGTGCCTCCGAGAGTATTTTGAGAGAGAGAAAAAAAATTCTA,10,30,14,27,27,36,27,40,27,29,29,36,33,40,30.2,85.03055118
hek293t,13687,1,4,AAGCAAAGGCTGCGCGCTGTGCTGTGAGCAGGGAGGCTGCACTGCTCGTCCCTTGTGCCTCCGAGAGTATTTTGAGAGAGAAAAAAATTCTAGTTGGTT,AAGCAAAGGCTGCGCGCTGTGCTGTGAGTAGACAGGGAGGCTGCACTGCTCGTCCCTTGTGCCTCCGAGAGTATTTTGAGAGAGAAAAAAATTCTAGTT,10,30,14,27,27,39,27,43,27,29,29,39,33,43,30.2,79.67058016
hek293t,13689,1,9,CATGGGCAGCAAAGCCTGTCTGGAAGCATAGGGTGGCTATATATAATGAGGACAAAAAGCAACCCCCCAAAAAAATTCTAGTTGGTTTAACGCGTAACT,CATGGGCAGCAAAGCCTGTCTGGAAGCATAGGGTGCCTGTAAACGCTATATATAATGAGGACAAAAAGCAACCCCCCAAAAAAATTCTAGTTGGTTTAA,10,30,14,27,27,46,27,55,27,36,36,46,45,55,48.58,0.812731123
hek293t,13690,1,13,AGTCCTTAGCAAATGTTGATTCTGTATTTTGGGAAGCTGACACCCATATACTACTTTTTCCCATTAAAAAAATTCTAGTTGGTTTAACGCGTAACTAGA,AGTCCTTAGCAAATGTTGATTCTGTATTTTGGGAAGCTTTTAAAACTCGTTGACACCCATATACTACTTTTTCCCATTAAAAAAATTCTAGTTGGTTTA,10,30,14,27,27,45,27,58,27,38,38,45,51,58,-0.11,0.209643606
hek293t,13691,1,8,GCGCTGCTACAATGAATTTAGCTGTATTTTGGTATATTTATTGATAAGTATGACTCATTTAAAGTGTAGCTTGCTTCATGTAAAAAAAATTCTAGTTGG,GCGCTGCTACAATGAATTTAGCTGTATTTTCCTGAAGTGGTATATTTATTGATAAGTATGACTCATTTAAAGTGTAGCTTGCTTCATGTAAAAAAAATT,10,30,14,27,27,33,27,41,27,30,30,33,38,41,5.34,0.0
hek293t,13691,1,8,ATCGGGCTACAATGAATTTAGCTGTATTTTGGTATATTTATTGATAAGTATGACTCATTTAAAGTGTAGCTTGCTTCAAAAAAAATTCTAGTTGGTTTA,ATCGGGCTACAATGAATTTAGCTGTATTTTCCTGAAGTGGTATATTTATTGATAAGTATGACTCATTTAAAGTGTAGCTTGCTTCAAAAAAAATTCTAG,10,30,14,27,27,37,27,45,27,30,30,37,38,45,5.34,1.226980352
hek293t,13693,1,9,TCTGCGAAGCGTACCCTTCTGCCCTTAGAAGGATGTCCAATAAGCTGAAGAGCTGAATGTTATGGACATTGTTAAAAAAATTCTAGTTGGTTTAACGCG,TCTGCGAAGCGTACCCTTCTGCCCTTAGAAACCTGGCTCGGATGTCCAATAAGCTGAAGAGCTGAATGTTATGGACATTGTTAAAAAAATTCTAGTTGG,10,30,14,27,27,41,27,50,27,31,31,41,40,50,31.49,16.21300174
hek293t,13693,1,9,CTCCTGAAGCGTACCCTTCTGCCCTTAGAAGGATGTCCAATAAGCTGAAGAGCTGAATGTTATGGACAAAAAAAATTCTAGTTGGTTTAACGCGTAACT,CTCCTGAAGCGTACCCTTCTGCCCTTAGAAACCTGGCTCGGATGTCCAATAAGCTGAAGAGCTGAATGTTATGGACAAAAAAAATTCTAGTTGGTTTAA,10,30,14,27,27,46,27,55,27,31,31,46,40,55,31.49,35.60758881
hek293t,13695,1,15,AGCAGCTGTATTATAGAAACATAGTAACCAGGAGATGTTTCACAGATTAAACCTGAACTTTCCATCTTTGAAAAAAATTCTAGTTGGTTTAACGCGTAA,AGCAGCTGTATTATAGAAACATAGTAACCAGTTACCATGTTTCGCGGAGATGTTTCACAGATTAAACCTGAACTTTCCATCTTTGAAAAAAATTCTAGT,10,30,14,27,27,38,27,53,27,31,31,38,46,53,66.69,0.388726919
hek293t,13696,1,11,TAACCAAAAACTATACATTTAGGTAAAGATGGGCTGAAGAGCTATCCCCTGTAATATCTTCCCCTAAATCATCCTCACAAAAAAATTCTAGTTGGTTTA,TAACCAAAAACTATACATTTAGGTAAAGATATAGGCGCCTGGGGCTGAAGAGCTATCCCCTGTAATATCTTCCCCTAAATCATCCTCACAAAAAAATTC,10,30,14,27,27,34,27,45,27,31,31,34,42,45,17.06,0.073421439
hek293t,13696,1,11,CTGGTAAAAACTATACATTTAGGTAAAGATGGGCTGAAGAGCTATCCCCTGTAATATCTTCCCCTAAAAAAAATTCTAGTTGGTTTAACGCGTAACTAG,CTGGTAAAAACTATACATTTAGGTAAAGATATAGGCGCCTGGGGCTGAAGAGCTATCCCCTGTAATATCTTCCCCTAAAAAAAATTCTAGTTGGTTTAA,10,30,14,27,27,46,27,57,27,31,31,46,42,57,17.06,1.898439339
hek293t,13698,1,7,TCGCCCTGACACCCGAAAGGCAAAGCTGCAGGCCAGTCCCTTTCCGAAGCGGCAGGTGCTGCCGCTCGTGCTGCCGGCAAAAAAATTCTAGTTGGTTTA,TCGCCCTGACACCCGAAAGGCAAAGCTGCACTCCCTCGGCCAGTCCCTTTCCGAAGCGGCAGGTGCTGCCGCTCGTGCTGCCGGCAAAAAAATTCTAGT,10,30,14,27,27,38,27,45,27,31,31,38,38,45,42.41,46.38340181
hek293t,13700,1,11,TTCTTTGAAGAAAATAAGGCCAGTGTAAGAGGGAAACACAACCCCCCCCCGTGTTTGAATGTATTTGGCAGCAAAAAAATTCTAGTTGGTTTAACGCGT,TTCTTTGAAGAAAATAAGGCCAGTGTAAGAGGGAAACCAGCCGACTCCACAACCCCCCCCCGTGTTTGAATGTATTTGGCAGCAAAAAAATTCTAGTTG,10,30,14,27,27,40,27,51,27,37,37,40,48,51,20.75,0.08841733
hek293t,13700,1,11,AGTTTTGAAGAAAATAAGGCCAGTGTAAGAGGGAAACACAACCCCCCCCCGTGTTTGAATGTATTTGGAAAAAAATTCTAGTTGGTTTAACGCGTAACT,AGTTTTGAAGAAAATAAGGCCAGTGTAAGAGGGAAACCAGCCGACTCCACAACCCCCCCCCGTGTTTGAATGTATTTGGAAAAAAATTCTAGTTGGTTT,10,30,14,27,27,44,27,55,27,37,37,44,48,55,20.75,0.0
hek293t,13702,1,4,ATTCAAAACTAAGGATTTTTATACCAAAATGGGGGGCAGGAAGTCTTTCACTGTGGTTCACAAGTGACAAATAAAAAAATTCTAGTTGGTTTAACGCGT,ATTCAAAACTAAGGATTTTTATACCAAAATGAGGCGGGGGCAGGAAGTCTTTCACTGTGGTTCACAAGTGACAAATAAAAAAATTCTAGTTGGTTTAAC,10,30,14,27,27,47,27,51,27,32,32,47,36,51,0.16,0.801691318
hek293t,13702,1,4,GTCCCAAACTAAGGATTTTTATACCAAAATGGGGGGCAGGAAGTCTTTCACTGTGGTTCACAAGTGACAAATACTTGTGGCTCCAAAAAAATTCTAGTT,GTCCCAAACTAAGGATTTTTATACCAAAATGAGGCGGGGGCAGGAAGTCTTTCACTGTGGTTCACAAGTGACAAATACTTGTGGCTCCAAAAAAATTCT,10,30,14,27,27,35,27,39,27,32,32,35,36,39,0.16,0.738047193
hek293t,20042,1,8,GACTCAGCCTGATGTGGTGCAGCTATAAAAGGCAGCACCAGCCAAAGCAGTCATCAGAGTTTTTCAAAAAAATTCTAGTTGGTTTAACGCGTAACTAGA,GACTCAGCCTGATGTGGTGCAGCTATAAAAGGCATGGATATAGCACCAGCCAAAGCAGTCATCAGAGTTTTTCAAAAAAATTCTAGTTGGTTTAACGCG,10,30,14,27,27,50,27,58,27,35,35,50,43,58,34.42,5.939516734
hek293t,20042,1,8,CGATAAGCCTGATGTGGTGCAGCTATAAAAGGCAGCACCAGCCAAAGCAGTCATCAGAGTTTTTCAAGGAAAAAAAATTCTAGTTGGTTTAACGCGTAA,CGATAAGCCTGATGTGGTGCAGCTATAAAAGGCATGGATATAGCACCAGCCAAAGCAGTCATCAGAGTTTTTCAAGGAAAAAAAATTCTAGTTGGTTTA,10,30,14,27,27,45,27,53,27,35,35,45,43,53,34.42,5.752475705
hek293t,13706,1,6,CATTAGAACTCCCAAGCTGATGTATGTAAAGGAGGAGAAAAGCCATTGGCCTAAATCTGCCTGGCAAGGCTAGATTTAAAAAAAATTCTAGTTGGTTTA,CATTAGAACTCCCAAGCTGATGTATGTATATACGAAGGAGGAGAAAAGCCATTGGCCTAAATCTGCCTGGCAAGGCTAGATTTAAAAAAAATTCTAGTT,10,30,14,27,27,39,27,45,27,29,29,39,35,45,43.53,46.10103066
hek293t,13706,1,6,CTATCGAACTCCCAAGCTGATGTATGTAAAGGAGGAGAAAAGCCATTGGCCTAAATCTGCCTGGCAAGGCTAGAAAAAAATTCTAGTTGGTTTAACGCG,CTATCGAACTCCCAAGCTGATGTATGTATATACGAAGGAGGAGAAAAGCCATTGGCCTAAATCTGCCTGGCAAGGCTAGAAAAAAATTCTAGTTGGTTT,10,30,14,27,27,44,27,50,27,29,29,44,35,50,43.53,47.85499632
hek293t,13708,1,4,CGTTAAAAATAGTGTGATGAGCATAAAAAAGGGATATTGACAGGGCAGATAGAATTTCTTCTTTGCTGACTTTTTATTATTCGTTTAGAAAAAAATTCT,CGTTAAAAATAGTGTGATGAGCATAAAGTGTAAAGGGATATTGACAGGGCAGATAGAATTTCTTCTTTGCTGACTTTTTATTATTCGTTTAGAAAAAAA,10,30,14,27,27,31,27,35,27,28,28,31,32,35,23.39,0.0
hek293t,13708,1,4,AGGAGAAAATAGTGTGATGAGCATAAAAAAGGGATATTGACAGGGCAGATAGAATTTCTTCTTTGCTGACTTTTTATTATTAAAAAAATTCTAGTTGGT,AGGAGAAAATAGTGTGATGAGCATAAAGTGTAAAGGGATATTGACAGGGCAGATAGAATTTCTTCTTTGCTGACTTTTTATTATTAAAAAAATTCTAGT,10,30,14,27,27,38,27,42,27,28,28,38,32,42,23.39,2.77006002
hek293t,13710,1,14,TTTGTACAGTGTCTGGCCTAACTGTTGGAAGGTCAGCTTTTAATTATTATTTTAAATAATCTTGGTTTGACCCCCAAAAAAATTCTAGTTGGTTTAACG,TTTGTACAGTGTCTGGCCTAACTGTTGGAATCATATTACCTTATGGTCAGCTTTTAATTATTATTTTAAATAATCTTGGTTTGACCCCCAAAAAAATTC,10,30,14,27,27,34,27,48,27,31,31,34,45,48,69.22,0.0
hek293t,13711,1,12,CAGGGTTGTTATAGAAGTGTTGCTACACTTGGGGTAATTTTGAGATAATTCACAAGCAAACTATATGAGAAAAAAATTCTAGTTGGTTTAACGCGTAAC,CAGGGTTGTTATAGAAGTGTTGCTACACTTGGGGAGACAGCCCATCTAATTTTGAGATAATTCACAAGCAAACTATATGAGAAAAAAATTCTAGTTGGT,10,30,14,27,27,42,27,54,27,35,35,42,47,54,27.62,0.363636364
hek293t,13711,1,12,CTTAATTGTTATAGAAGTGTTGCTACACTTGGGGTAATTTTGAGATAATTCACAAGCAAACTATATGAGTCATAAAAAAATTCTAGTTGGTTTAACGCG,CTTAATTGTTATAGAAGTGTTGCTACACTTGGGGAGACAGCCCATCTAATTTTGAGATAATTCACAAGCAAACTATATGAGTCATAAAAAAATTCTAGT,10,30,14,27,27,38,27,50,27,35,35,38,47,50,27.62,0.0
hek293t,13713,1,10,CTTGGCGTTACAAAAAAGTAATGAATGTGTGGCACTTTTTAATAATCTTTCTTTTATTCATAGCACTTAAAAAAATTCTAGTTGGTTTAACGCGTAACT,CTTGGCGTTACAAAAAAGTAATGAATGTGTGGCATTTCTAACAGCTTTTTAATAATCTTTCTTTTATTCATAGCACTTAAAAAAATTCTAGTTGGTTTA,10,30,14,27,27,45,27,55,27,35,35,45,45,55,54.36,0.0
hek293t,13713,1,10,ATTCCCGTTACAAAAAAGTAATGAATGTGTGGCACTTTTTAATAATCTTTCTTTTATTCATAGCACTTTTGAAAAAAATTCTAGTTGGTTTAACGCGTA,ATTCCCGTTACAAAAAAGTAATGAATGTGTGGCATTTCTAACAGCTTTTTAATAATCTTTCTTTTATTCATAGCACTTTTGAAAAAAATTCTAGTTGGT,10,30,14,27,27,42,27,52,27,35,35,42,45,52,54.36,0.043975374
hek293t,13715,1,11,GGCCGTCAGGACTGCCTCAAAGCATGCACTGGGAGGTACAGCAGTAATCAGGCTGGGAGTTAGAAAAAAAATTCTAGTTGGTTTAACGCGTAACTAGAT,GGCCGTCAGGACTGCCTCAAAGCATGCACTGGGAGGTAATAACTTTATACAGCAGTAATCAGGCTGGGAGTTAGAAAAAAAATTCTAGTTGGTTTAACG,10,30,14,27,27,48,27,59,27,38,38,48,49,59,53.16,0.556282497
hek293t,13721,1,10,GCTACCTGGCAAGCTGTGGGTGTCTCGCCTGGCTGGCACGGTCCCGCGGGGTTTCGCCGTTGCTGAGCAAGTGTGGGAAAAAAATTCTAGTTGGTTTAA,GCTACCTGGCAAGCTGTGGGTGTCTCGCCTGGAATCCTCCCCCTGGCACGGTCCCGCGGGGTTTCGCCGTTGCTGAGCAAGTGTGGGAAAAAAATTCTA,10,30,14,27,27,36,27,46,27,33,33,36,43,46,34.48,3.933574014
hek293t,13721,1,10,CTCAACTGGCAAGCTGTGGGTGTCTCGCCTGGCTGGCACGGTCCCGCGGGGTTTCGCCGTTGCTGAGCAAAAAAAAATTCTAGTTGGTTTAACGCGTAA,CTCAACTGGCAAGCTGTGGGTGTCTCGCCTGGAATCCTCCCCCTGGCACGGTCCCGCGGGGTTTCGCCGTTGCTGAGCAAAAAAAAATTCTAGTTGGTT,10,30,14,27,27,43,27,53,27,33,33,43,43,53,34.48,31.75008555
hek293t,13723,1,11,AATCTTGCTTTATTAGACTAAAAAGCTGGTGGATAGACTGACTGGTCTGATACTGGTGTAGATATCACAAAAAAATTCTAGTTGGTTTAACGCGTAACT,AATCTTGCTTTATTAGACTAAAAAGCTGGTGGATAGCTACTCGGTACACTGACTGGTCTGATACTGGTGTAGATATCACAAAAAAATTCTAGTTGGTTT,10,30,14,27,27,44,27,55,27,37,37,44,48,55,31.52,0.0
hek293t,13724,1,8,TTGAGTTATCCAAGTTTTCCCTCTGAACCAGGGCTGATTGCATACTTCAAACCAGTGTTTGCAAACACTCTGCTGCATTCTGAAAAAAAATTCTAGTTG,TTGAGTTATCCAAGTTTTCCCTCTGAACCATCTCACCAGGGCTGATTGCATACTTCAAACCAGTGTTTGCAAACACTCTGCTGCATTCTGAAAAAAAAT,10,30,14,27,27,32,27,40,27,29,29,32,37,40,23.78,0.138478435
hek293t,13724,1,8,AGAAGTTATCCAAGTTTTCCCTCTGAACCAGGGCTGATTGCATACTTCAAACCAGTGTTTGCAAACACTCTGCTGCAAAAAAATTCTAGTTGGTTTAAC,AGAAGTTATCCAAGTTTTCCCTCTGAACCATCTCACCAGGGCTGATTGCATACTTCAAACCAGTGTTTGCAAACACTCTGCTGCAAAAAAATTCTAGTT,10,30,14,27,27,39,27,47,27,29,29,39,37,47,23.78,26.88248159
hek293t,13726,1,14,AATCAAACATGTACTGTCTGTCAAATCAATGGGAATCCTTAAGTTCAGGATTCTTATAATGGGCATAAAAAAATTCTAGTTGGTTTAACGCGTAACTAG,AATCAAACATGTACTGTCTGTCAAATCAATGGGAAGTATTGAGACTCCGTCCTTAAGTTCAGGATTCTTATAATGGGCATAAAAAAATTCTAGTTGGTT,10,30,14,27,27,43,27,57,27,36,36,43,50,57,45.59,0.49533293
hek293t,3425,1,13,TTAGGCTAATTCTGCTGAAGGCAGAACAGAGGATGGGTATTTACAGGCTAATCTAAGGGATGCTATTACAAAAAAATTCTAGTTGGTTTAACGCGTAAC,TTAGGCTAATTCTGCTGAAGGCAGAACAGACCCTCATACCATTGGATGGGTATTTACAGGCTAATCTAAGGGATGCTATTACAAAAAAATTCTAGTTGG,10,30,14,27,27,41,27,54,27,31,31,41,44,54,71.59,17.01117089
hek293t,3425,1,13,AAGGACTAATTCTGCTGAAGGCAGAACAGAGGATGGGTATTTACAGGCTAATCTAAGGGATGCTAAAAAAATTCTAGTTGGTTTAACGCGTAACTAGAT,AAGGACTAATTCTGCTGAAGGCAGAACAGACCCTCATACCATTGGATGGGTATTTACAGGCTAATCTAAGGGATGCTAAAAAAATTCTAGTTGGTTTAA,10,30,14,27,27,46,27,59,27,31,31,46,44,59,71.59,25.07315716
hek293t,13729,1,3,TGCACGATGACACTTTGTAAAGTTCTAAGAGGTCTAGAGATTATATATGCAAAGCTATTAGTCATTTTAAATTTTCATTAGTAAAAAAATTCTAGTTGG,TGCACGATGACACTTTGTAAAGTTCTAAGAGGTCCGCTAGAGATTATATATGCAAAGCTATTAGTCATTTTAAATTTTCATTAGTAAAAAAATTCTAGT,10,30,14,27,27,38,27,41,27,35,35,38,38,41,62.59,0.0
hek293t,13731,1,14,TCTTGTCCTTGTTACCATCAAATCTGAAGAGGGCAAGCAGATTAGATTTTAGGTTAAGTATATATATAAAAAAAATTCTAGTTGGTTTAACGCGTAACT,TCTTGTCCTTGTTACCATCAAATCTGAAGAGGGTATACCGACTATATCAAGCAGATTAGATTTTAGGTTAAGTATATATATAAAAAAAATTCTAGTTGG,10,30,14,27,27,41,27,55,27,34,34,41,48,55,31.06,0.138706826
hek293t,13732,1,3,ATATACTTGTGTTACAAAGCTGGGACATTTGGAAATCAAATATCATCAAAGCTGCATTAGAAGCATACTCAGTAGAGATATAATAAAAAAATTCTAGTT,ATATACTTGTGTTACAAAGCTGGGACATGTGTTGGAAATCAAATATCATCAAAGCTGCATTAGAAGCATACTCAGTAGAGATATAATAAAAAAATTCTA,10,30,14,27,27,36,27,39,27,29,29,36,32,39,16.79,56.43962744
hek293t,13732,1,3,ACCTCCTTGTGTTACAAAGCTGGGACATTTGGAAATCAAATATCATCAAAGCTGCATTAGAAGCATACTCAGTAGAAAAAAAATTCTAGTTGGTTTAAC,ACCTCCTTGTGTTACAAAGCTGGGACATGTGTTGGAAATCAAATATCATCAAAGCTGCATTAGAAGCATACTCAGTAGAAAAAAAATTCTAGTTGGTTT,10,30,14,27,27,44,27,47,27,29,29,44,32,47,16.79,78.89438872
hek293t,13734,1,3,TCGGGATTAATCAAACTTCAAAGCATGCTAGGAATACCAAAATTTGCTAATACTTATTCTGTAAAAAAAAATTCTAGTTGGTTTAACGCGTAACTAGAT,TCGGGATTAATCAAACTTCAAAGCATGCTAGGAATACCAACCAAATTTGCTAATACTTATTCTGTAAAAAAAAATTCTAGTTGGTTTAACGCGTAACTA,10,30,14,27,27,56,27,59,27,41,41,56,44,59,27.85,15.27871197
hek293t,13734,1,3,TGGGTATTAATCAAACTTCAAAGCATGCTAGGAATACCAAAATTTGCTAATACTTATTCTGTAACTAACATTAAAAAAATTCTAGTTGGTTTAACGCGT,TGGGTATTAATCAAACTTCAAAGCATGCTAGGAATACCAACCAAATTTGCTAATACTTATTCTGTAACTAACATTAAAAAAATTCTAGTTGGTTTAACG,10,30,14,27,27,48,27,51,27,41,41,48,44,51,27.85,32.95018303
hek293t,13736,1,9,TCCACGGCTGATAGGCGAAGGGTTCTCTGTGGCTGTCCTATCTGGCAACGGCCTGGTGCCTGGCCCTGCTTTCGAGGCCAAAAAAATTCTAGTTGGTTT,TCCACGGCTGATAGGCGAAGGGTTCTCTGTGTTAGTGTGGGCTGTCCTATCTGGCAACGGCCTGGTGCCTGGCCCTGCTTTCGAGGCCAAAAAAATTCT,10,30,14,27,27,35,27,44,27,32,32,35,41,44,75.93,8.330428709
hek293t,13736,1,9,ACCGCGGCTGATAGGCGAAGGGTTCTCTGTGGCTGTCCTATCTGGCAACGGCCTGGTGCCTGGCCCTGCTTTAAAAAAATTCTAGTTGGTTTAACGCGT,ACCGCGGCTGATAGGCGAAGGGTTCTCTGTGTTAGTGTGGGCTGTCCTATCTGGCAACGGCCTGGTGCCTGGCCCTGCTTTAAAAAAATTCTAGTTGGT,10,30,14,27,27,42,27,51,27,32,32,42,41,51,75.93,31.52775867
hek293t,13738,1,8,AGCAAGTATGTTGTTTACAACCTCAGAGAAGGGCAGTTAATAGGAGGTTTGGTAGGCATCCAGCAGGGTCATAAAAAAATTCTAGTTGGTTTAACGCGT,AGCAAGTATGTTGTTTACAACCTCAGACTAAGCATGAAGGGCAGTTAATAGGAGGTTTGGTAGGCATCCAGCAGGGTCATAAAAAAATTCTAGTTGGTT,10,30,14,27,27,43,27,51,27,28,28,43,36,51,57.53,42.99860315
hek293t,13738,1,8,GTTACGTATGTTGTTTACAACCTCAGAGAAGGGCAGTTAATAGGAGGTTTGGTAGGCATCCAGCAGGGTCATTAGCTGGAAAAAAAATTCTAGTTGGTT,GTTACGTATGTTGTTTACAACCTCAGACTAAGCATGAAGGGCAGTTAATAGGAGGTTTGGTAGGCATCCAGCAGGGTCATTAGCTGGAAAAAAAATTCT,10,30,14,27,27,35,27,43,27,28,28,35,36,43,57.53,30.63794912
hek293t,13740,1,14,GATAGGTTACGAGGAAGGCAGCTGTGACGTGGGCTCGTTGTAATGACAGACTGATTCTCTAAAGAGAAAAAAAATTCTAGTTGGTTTAACGCGTAACTA,GATAGGTTACGAGGAAGGCAGCTGTGGGTGCTTCTTCACAACGTGGGCTCGTTGTAATGACAGACTGATTCTCTAAAGAGAAAAAAAATTCTAGTTGGT,10,30,14,27,27,42,27,56,27,27,27,42,41,56,53.19,32.21489641
hek293t,3209,1,11,CGTCAAAGCATGGAGCTGTTCAACTGACATGGAAGGGACTTTTTGTGCTGGAACCACAGTTAGGTGTCGATGGAAAAAAATTCTAGTTGGTTTAACGCG,CGTCAAAGCATGGAGCTGTTCAACTGACATGGAAGCGACTCCGAACGGACTTTTTGTGCTGGAACCACAGTTAGGTGTCGATGGAAAAAAATTCTAGTT,10,30,14,27,27,39,27,50,27,36,36,39,47,50,57.23,0.110011001
hek293t,3784,1,7,TCAACAGGTATATTGTGTAAAAATGAGTGAGGAGACTGTTTATTGGACACCTGCAAGTATACAAATAACAGCAGAAAAAAATTCTAGTTGGTTTAACGC,TCAACAGGTATATTGTGTAAAAATGAGTGAGGAGACTGTCGAGAGTTTATTGGACACCTGCAAGTATACAAATAACAGCAGAAAAAAATTCTAGTTGGT,10,30,14,27,27,42,27,49,27,39,39,42,46,49,51.97,0.0
hek293t,3784,1,7,AATGCAGGTATATTGTGTAAAAATGAGTGAGGAGACTGTTTATTGGACACCTGCAAGTATACAAATAACAAAAAAAATTCTAGTTGGTTTAACGCGTAA,AATGCAGGTATATTGTGTAAAAATGAGTGAGGAGACTGTCGAGAGTTTATTGGACACCTGCAAGTATACAAATAACAAAAAAAATTCTAGTTGGTTTAA,10,30,14,27,27,46,27,53,27,39,39,46,46,53,51.97,0.0
hek293t,13746,1,10,TCTCCTACTTACTTTAATTCATTGTCATAAGGTTGCACTGGGCAAACTTTTCTTGCTCCTTTTCTGACCCAAAAAAATTCTAGTTGGTTTAACGCGTAA,TCTCCTACTTACTTTAATTCATTGTCATGTGTGACCGTAAGGTTGCACTGGGCAAACTTTTCTTGCTCCTTTTCTGACCCAAAAAAATTCTAGTTGGTT,10,30,14,27,27,43,27,53,27,28,28,43,38,53,3.65,12.11019623
hek293t,13746,1,10,TTGTTTACTTACTTTAATTCATTGTCATAAGGTTGCACTGGGCAAACTTTTCTTGCTCCTTTTCTGACCCTAATAAACAAAAAAATTCTAGTTGGTTTA,TTGTTTACTTACTTTAATTCATTGTCATGTGTGACCGTAAGGTTGCACTGGGCAAACTTTTCTTGCTCCTTTTCTGACCCTAATAAACAAAAAAATTCT,10,30,14,27,27,35,27,45,27,28,28,35,38,45,3.65,8.79080512
hek293t,13748,1,9,CAGGACTGAATTATTTACCTTTTTCCAAGAGGTTCCCTTTCATTTTTGTAATAATCCCACCTGAAATAATTAGAAAACAGCAAAAAAAATTCTAGTTGG,CAGGACTGAATTATTTACCTTTTTCCAACTGGGACAAGAGGTTCCCTTTCATTTTTGTAATAATCCCACCTGAAATAATTAGAAAACAGCAAAAAAAAT,10,30,14,27,27,32,27,41,27,29,29,32,38,41,5.71,0.0
hek293t,13748,1,9,CGCATCTGAATTATTTACCTTTTTCCAAGAGGTTCCCTTTCATTTTTGTAATAATCCCACCTGAAATAATAAAAAAATTCTAGTTGGTTTAACGCGTAA,CGCATCTGAATTATTTACCTTTTTCCAACTGGGACAAGAGGTTCCCTTTCATTTTTGTAATAATCCCACCTGAAATAATAAAAAAATTCTAGTTGGTTT,10,30,14,27,27,44,27,53,27,29,29,44,38,53,5.71,2.308806894
hek293t,13750,1,12,GTAGCGCTAGGTAGTCTGGAATGATCAGAAGGACATTTATCTGTAATAACCAACTTTCTAAGTATAGTAGCAAAAAAAATTCTAGTTGGTTTAACGCGT,GTAGCGCTAGGTAGTCTGGAATGATCAGGGGACGCGGTGCAAGGACATTTATCTGTAATAACCAACTTTCTAAGTATAGTAGCAAAAAAAATTCTAGTT,10,30,14,27,27,39,27,51,27,29,29,39,41,51,47.44,4.05425928
hek293t,13750,1,12,GGTGTGCTAGGTAGTCTGGAATGATCAGAAGGACATTTATCTGTAATAACCAACTTTCTAAGTATAGTAGCATCCATTCAAAAAAATTCTAGTTGGTTT,GGTGTGCTAGGTAGTCTGGAATGATCAGGGGACGCGGTGCAAGGACATTTATCTGTAATAACCAACTTTCTAAGTATAGTAGCATCCATTCAAAAAAAT,10,30,14,27,27,32,27,44,27,29,29,32,41,44,47.44,0.698513667
hek293t,13752,1,12,AAGCTTAGCACCTATGGAATAAACAGCCAAGGCAAATGCAACCAGAATATTTGTCCCTAATGCACAAATCAAAAAAATTCTAGTTGGTTTAACGCGTAA,AAGCTTAGCACCTATGGAATAAACAGCCAAGGCTCGGCGTCAGCCAAATGCAACCAGAATATTTGTCCCTAATGCACAAATCAAAAAAATTCTAGTTGG,10,30,14,27,27,41,27,53,27,34,34,41,46,53,59.94,4.092474702
hek293t,13753,1,8,GCCCTAAGCCCCCTATTCCACCTTATACAAGGCAATCTTAAAATAGGATTACATTCCCTGAAACGTCTAAAAAAATTCTAGTTGGTTTAACGCGTAACT,GCCCTAAGCCCCCTATTCCACCTTATACAAGGCAATGTCGATGGCTTAAAATAGGATTACATTCCCTGAAACGTCTAAAAAAATTCTAGTTGGTTTAAC,10,30,14,27,27,47,27,55,27,37,37,47,45,55,49.18,0.3979991
hek293t,13754,1,15,GCTTGGCAAATCACTTCTAAAGAAGAATAAGGCTTGACCAAAGACTGAAGCAAATGTCTCCCATGACTCCATCTGAAAAAAATTCTAGTTGGTTTAACG,GCTTGGCAAATCACTTCTAAAGAAGAATATTTGACTTTCTAATCAGGCTTGACCAAAGACTGAAGCAAATGTCTCCCATGACTCCATCTGAAAAAAATT,10,30,14,27,27,33,27,48,27,30,30,33,45,48,30.99,0.0
hek293t,13757,1,2,TTTCCAGAGTTATCAGTGTCATGATAGTGAGGTCTCATCTTGCAAAGGAATCTGGGAGCCTGCCTTACATCTCAAAAAAATTCTAGTTGGTTTAACGCG,TTTCCAGAGTTATCAGTGTCATGATAGTGAGGGATCTCATCTTGCAAAGGAATCTGGGAGCCTGCCTTACATCTCAAAAAAATTCTAGTTGGTTTAACG,10,30,14,27,27,48,27,50,27,33,33,48,35,50,65.09,86.80816711
hek293t,13757,1,2,CCGTAAGAGTTATCAGTGTCATGATAGTGAGGTCTCATCTTGCAAAGGAATCTGGGAGCCTGCCTTACATCTCTTTGGAGCATACAAAAAAATTCTAGT,CCGTAAGAGTTATCAGTGTCATGATAGTGAGGGATCTCATCTTGCAAAGGAATCTGGGAGCCTGCCTTACATCTCTTTGGAGCATACAAAAAAATTCTA,10,30,14,27,27,36,27,38,27,33,33,36,35,38,65.09,2.613521426
hek293t,13759,1,1,TCCGTGGGTTGCACAACATATTTCTAACAAGGTAAAGCTGTATGTTTTCTCACTCACGTAAAAGGTGATGGACTGTGGCCTTTAAAAAAATTCTAGTTG,TCCGTGGGTTGCACAACATATTTCTAACAAAGGTAAAGCTGTATGTTTTCTCACTCACGTAAAAGGTGATGGACTGTGGCCTTTAAAAAAATTCTAGTT,10,30,14,27,27,39,27,40,27,29,29,39,30,40,30.1,0.744446026
hek293t,13759,1,1,AGGTAGGGTTGCACAACATATTTCTAACAAGGTAAAGCTGTATGTTTTCTCACTCACGTAAAAGGTGATGGACTGTGGCCTTTGGAAAAAAAATTCTAG,AGGTAGGGTTGCACAACATATTTCTAACAAAGGTAAAGCTGTATGTTTTCTCACTCACGTAAAAGGTGATGGACTGTGGCCTTTGGAAAAAAAATTCTA,10,30,14,27,27,36,27,37,27,29,29,36,30,37,30.1,3.328658862
hek293t,13761,1,15,CAGGACCCCCACAGGCAAACACACTTTAATGGCAGCCAGCAGATTTTAGAACTTGGTTCCCCATAAAAAAATTCTAGTTGGTTTAACGCGTAACTAGAT,CAGGACCCCCACAGGCAAACACACTTTAATGGCAGCCAGCACCCGCCCGTATTTAAGATTTTAGAACTTGGTTCCCCATAAAAAAATTCTAGTTGGTTT,10,30,14,27,27,44,27,59,27,41,41,44,56,59,11.69,0.0
hek293t,13766,1,2,ATACTATCAGTTGGTCAAACATCTAGATATGGAGTTGAAACCCACGTGCCTTGTTTCACAAGTATAAAAGTCCCAGGGTGAAAAAAATTCTAGTTGGTT,ATACTATCAGTTGGTCAAACATCTAGATATGGGGAGTTGAAACCCACGTGCCTTGTTTCACAAGTATAAAAGTCCCAGGGTGAAAAAAATTCTAGTTGG,10,30,14,27,27,41,27,43,27,31,31,41,33,43,37.87,79.16053594
hek293t,13766,1,2,GATCTATCAGTTGGTCAAACATCTAGATATGGAGTTGAAACCCACGTGCCTTGTTTCACAAGTATAAAAGTCCCAAAAAAAATTCTAGTTGGTTTAACG,GATCTATCAGTTGGTCAAACATCTAGATATGGGGAGTTGAAACCCACGTGCCTTGTTTCACAAGTATAAAAGTCCCAAAAAAAATTCTAGTTGGTTTAA,10,30,14,27,27,46,27,48,27,31,31,46,33,48,37.87,82.48917755
hek293t,13768,1,11,ACTGTACATGGCAGCCCCAACGTAGTACATGGTGTAGGAGCTTATATAAAATGTTCTTACAAGGTTGAGAACTTTAAAAAAAAATTCTAGTTGGTTTAA,ACTGTACATGGCAGCCCCAACGTAGTAGTTGCACGGGGCATGGTGTAGGAGCTTATATAAAATGTTCTTACAAGGTTGAGAACTTTAAAAAAAAATTCT,10,30,14,27,27,35,27,46,27,28,28,35,39,46,70.97,0.710198498
hek293t,13768,1,11,TCCGAACATGGCAGCCCCAACGTAGTACATGGTGTAGGAGCTTATATAAAATGTTCTTACAAGGTTGAGAAAAAAATTCTAGTTGGTTTAACGCGTAAC,TCCGAACATGGCAGCCCCAACGTAGTAGTTGCACGGGGCATGGTGTAGGAGCTTATATAAAATGTTCTTACAAGGTTGAGAAAAAAATTCTAGTTGGTT,10,30,14,27,27,43,27,54,27,28,28,43,39,54,70.97,6.221726221
hek293t,13770,1,3,AGGGGCCGGAGGCCTTTGAGGAAGGAAGCCGGCATTGCTGGGGCCGTTGCACACACAAGCGATAGCGCCTGGGGGCAAAAAAATTCTAGTTGGTTTAAC,AGGGGCCGGAGGCCTTTGAGGAAGGAAGCCGGCATTGCTGTCAGGGCCGTTGCACACACAAGCGATAGCGCCTGGGGGCAAAAAAATTCTAGTTGGTTT,10,30,14,27,27,44,27,47,27,41,41,44,44,47,41.55,9.787700856
hek293t,13770,1,3,CACGTCCGGAGGCCTTTGAGGAAGGAAGCCGGCATTGCTGGGGCCGTTGCACACACAAGCGATAGCGCCAAAAAAATTCTAGTTGGTTTAACGCGTAAC,CACGTCCGGAGGCCTTTGAGGAAGGAAGCCGGCATTGCTGTCAGGGCCGTTGCACACACAAGCGATAGCGCCAAAAAAATTCTAGTTGGTTTAACGCGT,10,30,14,27,27,51,27,54,27,41,41,51,44,54,41.55,76.36736285
hek293t,13772,1,10,CAACTATTACACTGCCTACGAAGGTTACAAGGGTCTCATTTGTCCATAGCCAAAACTGGGTTTTGCAGAAGTTCCAAAAAAAATTCTAGTTGGTTTAAC,CAACTATTACACTGCCTACGAAGGTTACATGTATAGTCGAGGGTCTCATTTGTCCATAGCCAAAACTGGGTTTTGCAGAAGTTCCAAAAAAAATTCTAG,10,30,14,27,27,37,27,47,27,30,30,37,40,47,31.33,4.309895045
hek293t,13772,1,10,ACATTATTACACTGCCTACGAAGGTTACAAGGGTCTCATTTGTCCATAGCCAAAACTGGGTTTTGCAGAAAAAAATTCTAGTTGGTTTAACGCGTAACT,ACATTATTACACTGCCTACGAAGGTTACATGTATAGTCGAGGGTCTCATTTGTCCATAGCCAAAACTGGGTTTTGCAGAAAAAAATTCTAGTTGGTTTA,10,30,14,27,27,45,27,55,27,30,30,45,40,55,31.33,13.40139199
hek293t,13775,1,13,CTTAAGTATCCCATGCACCAGAAGGTATCCGGAGGCTCTTCGCCCCCGCAGGTCTCCATCCCGCTAGCTGCAGAAAAAAATTCTAGTTGGTTTAACGCG,CTTAAGTATCCCATGCACCAGAAGGTTATACAGGTGCTAATCCGGAGGCTCTTCGCCCCCGCAGGTCTCCATCCCGCTAGCTGCAGAAAAAAATTCTAG,10,30,14,27,27,37,27,50,27,27,27,37,40,50,30.11,19.73093343
hek293t,3303,1,4,CAGAGCTCGTGCCTAGTAACACTGTTGCTAGGGGGATAGTATTTCTGCAGGATCTCCTTCAGCCGACGAAAAAAATTCTAGTTGGTTTAACGCGTAACT,CAGAGCTCGTGCCTAGTAACACTGTTGCTAGGGGGCCATATAGTATTTCTGCAGGATCTCCTTCAGCCGACGAAAAAAATTCTAGTTGGTTTAACGCGT,10,30,14,27,27,51,27,55,27,36,36,51,40,55,54.03,29.47244764
hek293t,3303,1,4,TGACTCTCGTGCCTAGTAACACTGTTGCTAGGGGGATAGTATTTCTGCAGGATCTCCTTCAGCCGACGTTTCATCTAAAAAAATTCTAGTTGGTTTAAC,TGACTCTCGTGCCTAGTAACACTGTTGCTAGGGGGCCATATAGTATTTCTGCAGGATCTCCTTCAGCCGACGTTTCATCTAAAAAAATTCTAGTTGGTT,10,30,14,27,27,43,27,47,27,36,36,43,40,47,54.03,35.49429751
hek293t,13779,1,7,CGCCTATTGCAGTCAGATGTCTTTGTATGAGGGCAATACTGAAGTAGCTAGGAAAGAAGGGGTCAGGATGTACCAAAAAAAATTCTAGTTGGTTTAACG,CGCCTATTGCAGTCAGATGTCTTTGTATGAGGGCCCCAGTCAATACTGAAGTAGCTAGGAAAGAAGGGGTCAGGATGTACCAAAAAAAATTCTAGTTGG,10,30,14,27,27,41,27,48,27,34,34,41,41,48,31.73,13.6469188
hek293t,13779,1,7,AACTCATTGCAGTCAGATGTCTTTGTATGAGGGCAATACTGAAGTAGCTAGGAAAGAAGGGGTCAGGATGTAAAAAAAATTCTAGTTGGTTTAACGCGT,AACTCATTGCAGTCAGATGTCTTTGTATGAGGGCCCCAGTCAATACTGAAGTAGCTAGGAAAGAAGGGGTCAGGATGTAAAAAAAATTCTAGTTGGTTT,10,30,14,27,27,44,27,51,27,34,34,44,41,51,31.73,44.3686866
hek293t,13781,1,10,CAAATAAAAATCAGAAGTCATAATGGAAGAGGTGAATGAAATCGAGAAGAAAAAGGTTGGTATCTGGGGGCGTGCGCTAAAAAAATTCTAGTTGGTTTA,CAAATAAAAATCAGAAGTCATAATGGAGAATCATCCGAGAGGTGAATGAAATCGAGAAGAAAAAGGTTGGTATCTGGGGGCGTGCGCTAAAAAAATTCT,10,30,14,27,27,35,27,45,27,28,28,35,38,45,38.86,1.531440969
hek293t,13781,1,10,GGGCAAAAAATCAGAAGTCATAATGGAAGAGGTGAATGAAATCGAGAAGAAAAAGGTTGGTATCTGGGGGAAAAAAATTCTAGTTGGTTTAACGCGTAA,GGGCAAAAAATCAGAAGTCATAATGGAGAATCATCCGAGAGGTGAATGAAATCGAGAAGAAAAAGGTTGGTATCTGGGGGAAAAAAATTCTAGTTGGTT,10,30,14,27,27,43,27,53,27,28,28,43,38,53,38.86,4.811044565
hek293t,17603,1,6,CATAAACTGCAGTATATCCTTAAAGTTTAAGGGAGGAAGTTCTGCCTTCTAGATTTTTGGTTCCTCTTTTCCCAAAAAAATTCTAGTTGGTTTAACGCG,CATAAACTGCAGTATATCCTTAAAGTTTTATAGAAAGGGAGGAAGTTCTGCCTTCTAGATTTTTGGTTCCTCTTTTCCCAAAAAAATTCTAGTTGGTTT,10,30,14,27,27,44,27,50,27,29,29,44,35,50,3.56,13.5827508
hek293t,13785,1,6,TGCACTCCACTGTCTTCAGTTGCTGGATAAGGACATGCCCTGTTCTCCTTCTCAGGGGAGTTCTGAAAAAAATTCTAGTTGGTTTAACGCGTAACTAGA,TGCACTCCACTGTCTTCAGTTGCTGGATAAGGACATCCTCCAGCCCTGTTCTCCTTCTCAGGGGAGTTCTGAAAAAAATTCTAGTTGGTTTAACGCGTA,10,30,14,27,27,52,27,58,27,37,37,52,43,58,24.38,2.889029044
hek293t,13785,1,6,TCTTTTCCACTGTCTTCAGTTGCTGGATAAGGACATGCCCTGTTCTCCTTCTCAGGGGAGTTCTGCTTTCAAAAAAATTCTAGTTGGTTTAACGCGTAA,TCTTTTCCACTGTCTTCAGTTGCTGGATAAGGACATCCTCCAGCCCTGTTCTCCTTCTCAGGGGAGTTCTGCTTTCAAAAAAATTCTAGTTGGTTTAAC,10,30,14,27,27,47,27,53,27,37,37,47,43,53,24.38,7.644555979
hek293t,13787,1,9,TCGGCACTTCGACTTTTATAGTTTTTCCATGGCAAAAAGAAATGGCTTCAGATGGCTGCTCTCAAAAAAAATTCTAGTTGGTTTAACGCGTAACTAGAT,TCGGCACTTCGACTTTTATAGTTTTTCCATGGCAATTTCGTTCAAAAGAAATGGCTTCAGATGGCTGCTCTCAAAAAAAATTCTAGTTGGTTTAACGCG,10,30,14,27,27,50,27,59,27,35,35,50,44,59,7.09,0.0
hek293t,15493,1,10,TCCTCTGAAATGCATGTTGGTTGGTGGTTTGGCCTGTTAACTAATTATCATTCAAAGCTGAAACATTCTCCAGCAAAAAAATTCTAGTTGGTTTAACGC,TCCTCTGAAATGCATGTTGGTTGGTGGTTTGGCCTGTGCTTTCATGTTAACTAATTATCATTCAAAGCTGAAACATTCTCCAGCAAAAAAATTCTAGTT,10,30,14,27,27,39,27,49,27,36,36,39,46,49,16.21,0.0
hek293t,13790,1,10,TACATGAAAAGGGAAAGCATCTAATTAATTGGATTGGTTTTGGTGAAAATCAGTTGAGAGCTAATGCCCCCCCTGTGTAAAAAAATTCTAGTTGGTTTA,TACATGAAAAGGGAAAGCATCTAATTAATTGGCAATATCACGATTGGTTTTGGTGAAAATCAGTTGAGAGCTAATGCCCCCCCTGTGTAAAAAAATTCT,10,30,14,27,27,35,27,45,27,32,32,35,42,45,6.64,0.0
hek293t,13790,1,10,TACGGGAAAAGGGAAAGCATCTAATTAATTGGATTGGTTTTGGTGAAAATCAGTTGAGAGCTAATGAAAAAAATTCTAGTTGGTTTAACGCGTAACTAG,TACGGGAAAAGGGAAAGCATCTAATTAATTGGCAATATCACGATTGGTTTTGGTGAAAATCAGTTGAGAGCTAATGAAAAAAATTCTAGTTGGTTTAAC,10,30,14,27,27,47,27,57,27,32,32,47,42,57,6.64,4.820689604
hek293t,13792,1,13,ATACTTGGTTTCTTTCTGGAATGTGCTGGTGGTTCTGATCTGCAAAGCTGTGATGCTGAGCTCCTGTCTGTCTTCCAAAAAAAATTCTAGTTGGTTTAA,ATACTTGGTTTCTTTCTGGAATGTGCTGGGTACTGACTTCTATGGTTCTGATCTGCAAAGCTGTGATGCTGAGCTCCTGTCTGTCTTCCAAAAAAAATT,10,30,14,27,27,33,27,46,27,30,30,33,43,46,24.94,0.0
hek293t,13792,1,13,ACTTATGGTTTCTTTCTGGAATGTGCTGGTGGTTCTGATCTGCAAAGCTGTGATGCTGAGCTCCTAAAAAAATTCTAGTTGGTTTAACGCGTAACTAGA,ACTTATGGTTTCTTTCTGGAATGTGCTGGGTACTGACTTCTATGGTTCTGATCTGCAAAGCTGTGATGCTGAGCTCCTAAAAAAATTCTAGTTGGTTTA,10,30,14,27,27,45,27,58,27,30,30,45,43,58,24.94,4.63030303
hek293t,13794,1,7,AGAGCTGCATGGTGGTTCAGCTGGGTGTCTGGAGGCAGGCAGGAGTGCTCATTTACCCACGCAGCTTAAAAAAATTCTAGTTGGTTTAACGCGTAACTA,AGAGCTGCATGGTGGTTCAGCTGGGTGTCTGGAGAATACAGGCAGGCAGGAGTGCTCATTTACCCACGCAGCTTAAAAAAATTCTAGTTGGTTTAACGC,10,30,14,27,27,49,27,56,27,34,34,49,41,56,39.5,22.05049544
hek293t,13794,1,7,GGCCATGCATGGTGGTTCAGCTGGGTGTCTGGAGGCAGGCAGGAGTGCTCATTTACCCACGCAGCTTTGGGCGTGTTCAAAAAAAATTCTAGTTGGTTT,GGCCATGCATGGTGGTTCAGCTGGGTGTCTGGAGAATACAGGCAGGCAGGAGTGCTCATTTACCCACGCAGCTTTGGGCGTGTTCAAAAAAAATTCTAG,10,30,14,27,27,37,27,44,27,34,34,37,41,44,39.5,7.796621807
hek293t,13796,1,5,ATAAGGGAATAATAGAAGGCTGCAATAATTGGTGTGTACATCCCTACAGAAATTTGTGGTGATGCAAAATCTTTTGGGAAAAAAAATTCTAGTTGGTTT,ATAAGGGAATAATAGAAGGCTGCAATAAGAATATTGGTGTGTACATCCCTACAGAAATTTGTGGTGATGCAAAATCTTTTGGGAAAAAAAATTCTAGTT,10,30,14,27,27,39,27,44,27,29,29,39,34,44,12.94,4.634329259
hek293t,13796,1,5,AAAACGGAATAATAGAAGGCTGCAATAATTGGTGTGTACATCCCTACAGAAATTTGTGGTGATGCAAAATCTTTTGGGAGAAGAGTAAAAAAATTCTAG,AAAACGGAATAATAGAAGGCTGCAATAAGAATATTGGTGTGTACATCCCTACAGAAATTTGTGGTGATGCAAAATCTTTTGGGAGAAGAGTAAAAAAAT,10,30,14,27,27,32,27,37,27,29,29,32,34,37,12.94,0.0
hek293t,13798,1,13,CCCGCAAATATCTAAGCTTCTGCAACTTGTGGTATGAAGTCGGATTGCATCTGTCTGCAGTAAATTTAAGTATGAAAAAAATTCTAGTTGGTTTAACGC,CCCGCAAATATCTAAGCTTCTGCAACTTGTGGGATATACTGAGTTTATGAAGTCGGATTGCATCTGTCTGCAGTAAATTTAAGTATGAAAAAAATTCTA,10,30,14,27,27,36,27,49,27,33,33,36,46,49,34.61,0.719089714
hek293t,13800,1,1,TGGCAAATGGGTTGACTTGTAACTCAGACAGGAAAGAGCATGGGCCTGCATCCATTCAGAACTAATCCTGTCTAGCCTTTTTGTAAAAAAATTCTAGTT,TGGCAAATGGGTTGACTTGTAACTCAGACAAGGAAAGAGCATGGGCCTGCATCCATTCAGAACTAATCCTGTCTAGCCTTTTTGTAAAAAAATTCTAGT,10,30,14,27,27,38,27,39,27,31,31,38,32,39,30.48,39.4999455
hek293t,13801,1,13,GTATCCCACTAGAAGCAGCAGCACAGTGTTGGTTCTAGAACTACTTTCTGCTCTAATGGGAATCTAAAAATAAAAAAAATTCTAGTTGGTTTAACGCGT,GTATCCCACTAGAAGCAGCAGCACAGTGTTGGTTTTTTATTTTATAGCTAGAACTACTTTCTGCTCTAATGGGAATCTAAAAATAAAAAAAATTCTAGT,10,30,14,27,27,38,27,51,27,35,35,38,48,51,66.2,0.0
hek293t,13802,1,7,GTAAGTGCTCAGATAACCTGCACGAAATCAGGGGCAGAGTGTGGGTGAGTCAGAAACAAAGGTGATTTTGGAAAAAAATTCTAGTTGGTTTAACGCGTA,GTAAGTGCTCAGATAACCTGCACGAAATCAGGGGCAGTGCCGGGAGTGTGGGTGAGTCAGAAACAAAGGTGATTTTGGAAAAAAATTCTAGTTGGTTTA,10,30,14,27,27,45,27,52,27,38,38,45,45,52,19.12,25.31392519
hek293t,13802,1,7,ACGTCTGCTCAGATAACCTGCACGAAATCAGGGGCAGAGTGTGGGTGAGTCAGAAACAAAGGTGATTTAAAAAAATTCTAGTTGGTTTAACGCGTAACT,ACGTCTGCTCAGATAACCTGCACGAAATCAGGGGCAGTGCCGGGAGTGTGGGTGAGTCAGAAACAAAGGTGATTTAAAAAAATTCTAGTTGGTTTAACG,10,30,14,27,27,48,27,55,27,38,38,48,45,55,19.12,9.008430586
hek293t,3804,1,5,CACTGTTCTATTACTTTAAGATATGTGGGAGGAATTTCAAGTTCTTTCTACAATTCTAAATGCCCTTGAAATAAAAATCAAAAAAAAATTCTAGTTGGT,CACTGTTCTATTACTTTAAGATATGTACTACGGGAGGAATTTCAAGTTCTTTCTACAATTCTAAATGCCCTTGAAATAAAAATCAAAAAAAAATTCTAG,10,30,14,27,27,37,27,42,27,27,27,37,32,42,53.31,15.61120958
hek293t,3804,1,5,GAGAATTCTATTACTTTAAGATATGTGGGAGGAATTTCAAGTTCTTTCTACAATTCTAAATGCCCTTGAAATAAAAATCAAAATAAAAAAATTCTAGTT,GAGAATTCTATTACTTTAAGATATGTACTACGGGAGGAATTTCAAGTTCTTTCTACAATTCTAAATGCCCTTGAAATAAAAATCAAAATAAAAAAATTC,10,30,14,27,27,34,27,39,27,27,27,34,32,39,53.31,9.372577634
hek293t,13806,1,3,TCATCTCAGCTGAAGTATCCTAATGTTAACGGCTGATAAATTAAGCAGCCTTAGAATTCTCATTAAGTATGTCAAGCTGAATTTAAAAAAATTCTAGTT,TCATCTCAGCTGAAGTATCCTAATGTTAACGGCCTCTGATAAATTAAGCAGCCTTAGAATTCTCATTAAGTATGTCAAGCTGAATTTAAAAAAATTCTA,10,30,14,27,27,36,27,39,27,33,33,36,36,39,17.57,0.0
hek293t,13806,1,3,GGCGTTCAGCTGAAGTATCCTAATGTTAACGGCTGATAAATTAAGCAGCCTTAGAATTCTCATTAAGTATGTAAAAAAATTCTAGTTGGTTTAACGCGT,GGCGTTCAGCTGAAGTATCCTAATGTTAACGGCCTCTGATAAATTAAGCAGCCTTAGAATTCTCATTAAGTATGTAAAAAAATTCTAGTTGGTTTAACG,10,30,14,27,27,48,27,51,27,33,33,48,36,51,17.57,15.01823982
hek293t,13808,1,8,TCGGTTTTCTGGCAGGGTTCTTTGCTGGTTGGTTTGCCCCCCCAATATAAGACCGTCACAGCAAAGCAAATGAAAAAAAATTCTAGTTGGTTTAACGCG,TCGGTTTTCTGGCAGGGTTCTTTGCTGGTTGGTTGAGACTTGTGCCCCCCCAATATAAGACCGTCACAGCAAAGCAAATGAAAAAAAATTCTAGTTGGT,10,30,14,27,27,42,27,50,27,35,35,42,43,50,45.57,15.96959564
hek293t,13808,1,8,CTTAGTTTCTGGCAGGGTTCTTTGCTGGTTGGTTTGCCCCCCCAATATAAGACCGTCACAGCAAAAAAAAAATTCTAGTTGGTTTAACGCGTAACTAGA,CTTAGTTTCTGGCAGGGTTCTTTGCTGGTTGGTTGAGACTTGTGCCCCCCCAATATAAGACCGTCACAGCAAAAAAAAAATTCTAGTTGGTTTAACGCG,10,30,14,27,27,50,27,58,27,35,35,50,43,58,45.57,1.197297365
hek293t,13810,1,9,TCTCCCAGCATGCAGATCTTCCTGGCCTCTGGAAGTGTAGCTGACCTCCTACGGCACAAACAGCTCAAAATATCAAAAAAATTCTAGTTGGTTTAACGC,TCTCCCAGCATGCAGATCTTCCTGGCCTCTGGAAGTTAATAGAGCGTAGCTGACCTCCTACGGCACAAACAGCTCAAAATATCAAAAAAATTCTAGTTG,10,30,14,27,27,40,27,49,27,37,37,40,46,49,55.21,0.429058699
hek293t,13810,1,9,GGACACAGCATGCAGATCTTCCTGGCCTCTGGAAGTGTAGCTGACCTCCTACGGCACAAACAGCTCAAAAAAAAAAATTCTAGTTGGTTTAACGCGTAA,GGACACAGCATGCAGATCTTCCTGGCCTCTGGAAGTTAATAGAGCGTAGCTGACCTCCTACGGCACAAACAGCTCAAAAAAAAAAATTCTAGTTGGTTT,10,30,14,27,27,44,27,53,27,37,37,44,46,53,55.21,7.281527084
hek293t,13812,1,2,TACTCTTACTACGGACCCCCTTTTTCATGTGGGTAGAGATTCAGACTGCCTCATGAGGATGCAGAGGAAAAAAATTCTAGTTGGTTTAACGCGTAACTA,TACTCTTACTACGGACCCCCTTTTTCATGTGGGTAGAGAAATTCAGACTGCCTCATGAGGATGCAGAGGAAAAAAATTCTAGTTGGTTTAACGCGTAAC,10,30,14,27,27,54,27,56,27,39,39,54,41,56,16.22,29.66156565
hek293t,13812,1,2,AATGCTTACTACGGACCCCCTTTTTCATGTGGGTAGAGATTCAGACTGCCTCATGAGGATGCAGAGGCAGTGAAAAAAATTCTAGTTGGTTTAACGCGT,AATGCTTACTACGGACCCCCTTTTTCATGTGGGTAGAGAAATTCAGACTGCCTCATGAGGATGCAGAGGCAGTGAAAAAAATTCTAGTTGGTTTAACGC,10,30,14,27,27,49,27,51,27,39,39,49,41,51,16.22,15.89773352
hek293t,13814,1,14,CGTTAATGGAGATGAACAGTCAGGTCTCCAGGAGTCTGGGTTTGTTTTGCTTTGCTTTGCTTTTAAAAAAATTCTAGTTGGTTTAACGCGTAACTAGAT,CGTTAATGGAGATGAACAGTCAGGTCTCCAGGAGTCTCCAATATTCCCGATGGGTTTGTTTTGCTTTGCTTTGCTTTTAAAAAAATTCTAGTTGGTTTA,10,30,14,27,27,45,27,59,27,38,38,45,52,59,38.24,1.615833874
hek293t,23521,1,4,GTGGCATACATAATAGCAGCTGATTACTTTGGAAATTTCATCAGTCTTTTGCATGCTGGGCTCAGCTACAAATCTGAGATTAAAAAAATTCTAGTTGGT,GTGGCATACATAATAGCAGCTGATTACTTTGGAACGCCATTTCATCAGTCTTTTGCATGCTGGGCTCAGCTACAAATCTGAGATTAAAAAAATTCTAGT,10,30,14,27,27,38,27,42,27,35,35,38,39,42,30.52,0.856628245
hek293t,23521,1,4,GCAAAATACATAATAGCAGCTGATTACTTTGGAAATTTCATCAGTCTTTTGCATGCTGGGCTCAGCTACAAAAAAATTCTAGTTGGTTTAACGCGTAAC,GCAAAATACATAATAGCAGCTGATTACTTTGGAACGCCATTTCATCAGTCTTTTGCATGCTGGGCTCAGCTACAAAAAAATTCTAGTTGGTTTAACGCG,10,30,14,27,27,50,27,54,27,35,35,50,39,54,30.52,29.35359132
hek293t,13817,1,7,AATGACATATCTTAATATAGCAGACTACTTGGCAAAACTAGATGGTGAGTCCTAGGGAAGGAGGAGAGCTGGGTTTAAAAAAATTCTAGTTGGTTTAAC,AATGACATATCTTAATATAGCAGACTACTTGGATAGTCGCAAAACTAGATGGTGAGTCCTAGGGAAGGAGGAGAGCTGGGTTTAAAAAAATTCTAGTTG,10,30,14,27,27,40,27,47,27,33,33,40,40,47,24.71,5.168138813
hek293t,13817,1,7,GCCGTCATATCTTAATATAGCAGACTACTTGGCAAAACTAGATGGTGAGTCCTAGGGAAGGAGGAGAGCTGGGTTTACTTAAAAAAATTCTAGTTGGTT,GCCGTCATATCTTAATATAGCAGACTACTTGGATAGTCGCAAAACTAGATGGTGAGTCCTAGGGAAGGAGGAGAGCTGGGTTTACTTAAAAAAATTCTA,10,30,14,27,27,36,27,43,27,33,33,36,40,43,24.71,0.0
hek293t,13820,1,8,ACAGGCCACAAAGACAAAAAACATCTGAGAGGTGTCATTTTATACTTGATTTTGAATCATCCATTGTCTCAGAGAGTCAAACAAAAAAATTCTAGTTGG,ACAGGCCACAAAGACAAAAAACATCTGAGGGGATCGCAGGTGTCATTTTATACTTGATTTTGAATCATCCATTGTCTCAGAGAGTCAAACAAAAAAATT,10,30,14,27,27,33,27,41,27,30,30,33,38,41,73.14,0.0
hek293t,13820,1,8,CGACGCCACAAAGACAAAAAACATCTGAGAGGTGTCATTTTATACTTGATTTTGAATCATCCATTGTCTCAAAAAAATTCTAGTTGGTTTAACGCGTAA,CGACGCCACAAAGACAAAAAACATCTGAGGGGATCGCAGGTGTCATTTTATACTTGATTTTGAATCATCCATTGTCTCAAAAAAATTCTAGTTGGTTTA,10,30,14,27,27,45,27,53,27,30,30,45,38,53,73.14,0.284900285
hek293t,13822,1,3,TACCCGTTAAGTGATTGCAAAATTTCAGTTGGATTTAAAATTTGACATGTAAGACTTAGCTCCCAAAAAAAAAATTCTAGTTGGTTTAACGCGTAACTA,TACCCGTTAAGTGATTGCAAAATTTCAGTTGGATTTATTAAAATTTGACATGTAAGACTTAGCTCCCAAAAAAAAAATTCTAGTTGGTTTAACGCGTAA,10,30,14,27,27,53,27,56,27,38,38,53,41,56,11.37,0.451574569
hek293t,13822,1,3,CGGGTGTTAAGTGATTGCAAAATTTCAGTTGGATTTAAAATTTGACATGTAAGACTTAGCTCCCAAAAGGAGAAAAAAATTCTAGTTGGTTTAACGCGT,CGGGTGTTAAGTGATTGCAAAATTTCAGTTGGATTTATTAAAATTTGACATGTAAGACTTAGCTCCCAAAAGGAGAAAAAAATTCTAGTTGGTTTAACG,10,30,14,27,27,48,27,51,27,38,38,48,41,51,11.37,1.732724613
hek293t,13824,1,1,CTTGCACAGTGAGATGCTTGGAGAATGTGAGGAGGGGCAATTATTACTGAAATACCCCCCCCGGTATTCAGAACATGAAAAAAAATTCTAGTTGGTTTA,CTTGCACAGTGAGATGCTTGGAGAATGTGAGGACGGGGCAATTATTACTGAAATACCCCCCCCGGTATTCAGAACATGAAAAAAAATTCTAGTTGGTTT,10,30,14,27,27,44,27,45,27,34,34,44,35,45,72.4,82.78200685
hek293t,13824,1,1,GGAGCACAGTGAGATGCTTGGAGAATGTGAGGAGGGGCAATTATTACTGAAATACCCCCCCCGGTATTCAGAAAAAAAAATTCTAGTTGGTTTAACGCG,GGAGCACAGTGAGATGCTTGGAGAATGTGAGGACGGGGCAATTATTACTGAAATACCCCCCCCGGTATTCAGAAAAAAAAATTCTAGTTGGTTTAACGC,10,30,14,27,27,49,27,50,27,34,34,49,35,50,72.4,66.04802262
hek293t,13828,1,4,GATTGTCTTATCACAGACCTGCTGTGCTGGGGAATTCATTCTCCCTTTCCCAAGCAAACATGCTAGTGAAAAAAAAATTCTAGTTGGTTTAACGCGTAA,GATTGTCTTATCACAGACCTGCTGTGCTGGGGAGACAATTCATTCTCCCTTTCCCAAGCAAACATGCTAGTGAAAAAAAAATTCTAGTTGGTTTAACGC,10,30,14,27,27,49,27,53,27,34,34,49,38,53,60.53,83.77399039
hek293t,13828,1,4,TGATCTCTTATCACAGACCTGCTGTGCTGGGGAATTCATTCTCCCTTTCCCAAGCAAACATGCTAGTGAATTACCAAAAAAATTCTAGTTGGTTTAACG,TGATCTCTTATCACAGACCTGCTGTGCTGGGGAGACAATTCATTCTCCCTTTCCCAAGCAAACATGCTAGTGAATTACCAAAAAAATTCTAGTTGGTTT,10,30,14,27,27,44,27,48,27,34,34,44,38,48,60.53,80.8184574
hek293t,13830,1,3,AAAAGCATTCTTTCATGTAAACTACTAATTGGAACATAATGGATACTAAAGTTCTTGCTTAACAAATCGTAATAAAAAAATTCTAGTTGGTTTAACGCG,AAAAGCATTCTTTCATGTAAACTACTAATTGCAAGAACATAATGGATACTAAAGTTCTTGCTTAACAAATCGTAATAAAAAAATTCTAGTTGGTTTAAC,10,30,14,27,27,47,27,50,27,32,32,47,35,50,8.35,2.443782994
hek293t,13832,1,13,CTTTTTCAAAAGAGCTCAACATGCCATCCCGGAACATGGGAGGGTAAACTGGTATCTGCCCTCCTTTGAAAAAAATTCTAGTTGGTTTAACGCGTAACT,CTTTTTCAAAAGAGCTCAACATGCCATCCCGTTGTTTCGTAGGCGAACATGGGAGGGTAAACTGGTATCTGCCCTCCTTTGAAAAAAATTCTAGTTGGT,10,30,14,27,27,42,27,55,27,32,32,42,45,55,46.73,24.17215946
hek293t,560,1,11,CTCGACTGAGCTCTAGCAGCTTCGTTCACCGGGGTTTACACGTATTTCTTATAGATGTGTCCGTCAAAAAAATTCTAGTTGGTTTAACGCGTAACTAGA,CTCGACTGAGCTCTAGCAGCTTCGTTCACCGGGGTTTCTTGCCGCCATACACGTATTTCTTATAGATGTGTCCGTCAAAAAAATTCTAGTTGGTTTAAC,10,30,14,27,27,47,27,58,27,37,37,47,48,58,30.21,5.571686153
hek293t,13837,1,12,CGACCATGGAGAAAAATGGCAAAGTGAACAGGGTATTTGCTGTTTCTATTTTCCATGAATGTTAGAAAAAAATTCTAGTTGGTTTAACGCGTAACTAGA,CGACCATGGAGAAAAATGGCAAAGTGAACAAAGACATCCCGTGGGTATTTGCTGTTTCTATTTTCCATGAATGTTAGAAAAAAATTCTAGTTGGTTTAA,10,30,14,27,27,46,27,58,27,31,31,46,43,58,14.75,6.972722522
hek293t,13837,1,12,AGTTCATGGAGAAAAATGGCAAAGTGAACAGGGTATTTGCTGTTTCTATTTTCCATGAATGTTAGGTTCAAAAAAAATTCTAGTTGGTTTAACGCGTAA,AGTTCATGGAGAAAAATGGCAAAGTGAACAAAGACATCCCGTGGGTATTTGCTGTTTCTATTTTCCATGAATGTTAGGTTCAAAAAAAATTCTAGTTGG,10,30,14,27,27,41,27,53,27,31,31,41,43,53,14.75,7.168242468
hek293t,13839,1,9,TGATGAATATTTATGATTTTATTGCCTTCCGGCTTCTGAACTTGTGGTTATATGCACTGGGAGTGACACATTCTCTGAAAAAAATTCTAGTTGGTTTAA,TGATGAATATTTATGATTTTATTGCCTTCACACTATCTCGGCTTCTGAACTTGTGGTTATATGCACTGGGAGTGACACATTCTCTGAAAAAAATTCTAG,10,30,14,27,27,37,27,46,27,30,30,37,39,46,2.35,1.135662221
hek293t,13841,1,6,AGCGCTTCAGTGTAATGCAAATATGTAACAGGATTTTCAGGGTGGAACTAGACGTATCCAGCAAAAAAAAATTCTAGTTGGTTTAACGCGTAACTAGAT,AGCGCTTCAGTGTAATGCAAATATGTAACAGGATTTTACTGTGCAGGGTGGAACTAGACGTATCCAGCAAAAAAAAATTCTAGTTGGTTTAACGCGTAA,10,30,14,27,27,53,27,59,27,38,38,53,44,59,37.71,2.877603307
hek293t,13841,1,6,CCTTTTTCAGTGTAATGCAAATATGTAACAGGATTTTCAGGGTGGAACTAGACGTATCCAGCAAGCTCAGACTGTTAAAAAAATTCTAGTTGGTTTAAC,CCTTTTTCAGTGTAATGCAAATATGTAACAGGATTTTACTGTGCAGGGTGGAACTAGACGTATCCAGCAAGCTCAGACTGTTAAAAAAATTCTAGTTGG,10,30,14,27,27,41,27,47,27,38,38,41,44,47,37.71,0.0
hek293t,13843,1,7,GAACACAAGAGTTTCCCGAGGTTATTAATTGGAAACACAGAAAAATCCACAAGAGATCATTTGGGGAATTTACATCAAAAAAATTCTAGTTGGTTTAAC,GAACACAAGAGTTTCCCGAGGTTATTAATTGGCGAGCTAAAACACAGAAAAATCCACAAGAGATCATTTGGGGAATTTACATCAAAAAAATTCTAGTTG,10,30,14,27,27,40,27,47,27,33,33,40,40,47,12.35,2.102031804
hek293t,13843,1,7,TCGTACAAGAGTTTCCCGAGGTTATTAATTGGAAACACAGAAAAATCCACAAGAGATCATTTGGGGAATTTACATCAGTGAAAAAAATTCTAGTTGGTT,TCGTACAAGAGTTTCCCGAGGTTATTAATTGGCGAGCTAAAACACAGAAAAATCCACAAGAGATCATTTGGGGAATTTACATCAGTGAAAAAAATTCTA,10,30,14,27,27,36,27,43,27,33,33,36,40,43,12.35,2.376860616
hek293t,13846,1,7,TTCTGGGATAAAGAGACACTTGCAGGCTAAGGGCACCAGAGCTGTTTGATCAAAGGGGGTGAGGTTGGCAAAAAAATTCTAGTTGGTTTAACGCGTAAC,TTCTGGGATAAAGAGACACTTGCAGGCTAAGGGCACCAGTTTTGTAAGCTGTTTGATCAAAGGGGGTGAGGTTGGCAAAAAAATTCTAGTTGGTTTAAC,10,30,14,27,27,47,27,54,27,40,40,47,47,54,44.65,5.437322109
hek293t,13846,1,7,GGCAAGGATAAAGAGACACTTGCAGGCTAAGGGCACCAGAGCTGTTTGATCAAAGGGGGTGAGGTTAAAAAAATTCTAGTTGGTTTAACGCGTAACTAG,GGCAAGGATAAAGAGACACTTGCAGGCTAAGGGCACCAGTTTTGTAAGCTGTTTGATCAAAGGGGGTGAGGTTAAAAAAATTCTAGTTGGTTTAACGCG,10,30,14,27,27,50,27,57,27,40,40,50,47,57,44.65,6.172322111
hek293t,13848,1,14,TGACTTAGTCTAACTTGAAGGTTATGTTTAGGTGATCCTGTTTGATACCTAAGGCTTGCTACTGTGTCAAGAAAAAAATTCTAGTTGGTTTAACGCGTA,TGACTTAGTCTAACTTGAAGGTTATGTTTCCTCGAGCAACGTTAGGTGATCCTGTTTGATACCTAAGGCTTGCTACTGTGTCAAGAAAAAAATTCTAGT,10,30,14,27,27,38,27,52,27,28,28,38,42,52,23.14,6.586697046
hek293t,13848,1,14,AGGGTTAGTCTAACTTGAAGGTTATGTTTAGGTGATCCTGTTTGATACCTAAGGCTTGCTACTGTGAAAAAAATTCTAGTTGGTTTAACGCGTAACTAG,AGGGTTAGTCTAACTTGAAGGTTATGTTTCCTCGAGCAACGTTAGGTGATCCTGTTTGATACCTAAGGCTTGCTACTGTGAAAAAAATTCTAGTTGGTT,10,30,14,27,27,43,27,57,27,28,28,43,42,57,23.14,17.3035832
hek293t,13850,1,10,CGCGATCATTCGCAGGCTTGAAATGAAAATGGCAGGTGAGGATAGAGTCGCTCTGTATTATTCCTGCCCGAAAAAAATTCTAGTTGGTTTAACGCGTAA,CGCGATCATTCGCAGGCTTGAAATGAATTACTTTCAAAATGGCAGGTGAGGATAGAGTCGCTCTGTATTATTCCTGCCCGAAAAAAATTCTAGTTGGTT,10,30,14,27,27,43,27,53,27,28,28,43,38,53,22.62,0.32182915
hek293t,13852,1,10,GGTTCATTCTGAAGCGGAAAGATGTTTTGGGGTTCTTTTTATTGACTCTTTTCCTGGATGTTGAAACTTAAAAAAATTCTAGTTGGTTTAACGCGTAAC,GGTTCATTCTGAAGCGGAAAGATGTTTTGGGGTCTCTGAGCTGTCTTTTTATTGACTCTTTTCCTGGATGTTGAAACTTAAAAAAATTCTAGTTGGTTT,10,30,14,27,27,44,27,54,27,34,34,44,44,54,31.43,0.819909086
hek293t,13852,1,10,GCTGAATTCTGAAGCGGAAAGATGTTTTGGGGTTCTTTTTATTGACTCTTTTCCTGGATGTTGAAACTTTCAGCTCAAAAAAATTCTAGTTGGTTTAAC,GCTGAATTCTGAAGCGGAAAGATGTTTTGGGGTCTCTGAGCTGTCTTTTTATTGACTCTTTTCCTGGATGTTGAAACTTTCAGCTCAAAAAAATTCTAG,10,30,14,27,27,37,27,47,27,34,34,37,44,47,31.43,0.0
hek293t,13854,1,9,AGTACCTTTAAGTGCCTGGGGAAGGTGGGAGGGCAGGGATGAATTACCTATAAATCTTAATGATTAGGATTTCAGAAAAAAATTCTAGTTGGTTTAACG,AGTACCTTTAAGTGCCTGGGGAAGGTGGGAGGGCAATAAGGAGGGGGATGAATTACCTATAAATCTTAATGATTAGGATTTCAGAAAAAAATTCTAGTT,10,30,14,27,27,39,27,48,27,36,36,39,45,48,32.97,0.0
hek293t,13854,1,9,GAGTGCTTTAAGTGCCTGGGGAAGGTGGGAGGGCAGGGATGAATTACCTATAAATCTTAATGATTAGGAAAAAAATTCTAGTTGGTTTAACGCGTAACT,GAGTGCTTTAAGTGCCTGGGGAAGGTGGGAGGGCAATAAGGAGGGGGATGAATTACCTATAAATCTTAATGATTAGGAAAAAAATTCTAGTTGGTTTAA,10,30,14,27,27,46,27,55,27,36,36,46,45,55,32.97,2.793076207
hek293t,13856,1,4,GGCCGAACTTCCCACAAACACGAGTTTCCAGGGCACAACTGAAAGGGGCTCAAAGGGGTGCCGCCAACTTAAAACGAAAAAAAATTCTAGTTGGTTTAA,GGCCGAACTTCCCACAAACACGAGTTTCCAGGCCCGGCACAACTGAAAGGGGCTCAAAGGGGTGCCGCCAACTTAAAACGAAAAAAAATTCTAGTTGGT,10,30,14,27,27,42,27,46,27,32,32,42,36,46,17.93,22.58865585
hek293t,13858,1,14,GGGGTCAGCTCAGGTAATTTTCACTTTTGGGGGCTTTAAATATTCCATCCTTCAGATTACAGCCATTCTTTTAAAAAAATTCTAGTTGGTTTAACGCGT,GGGGTCAGCTCAGGTAATTTTCACTTTTGATCGTCGCTAAGTTGGGGCTTTAAATATTCCATCCTTCAGATTACAGCCATTCTTTTAAAAAAATTCTAG,10,30,14,27,27,37,27,51,27,30,30,37,44,51,3.5,0.14587892
hek293t,13858,1,14,CCGACCAGCTCAGGTAATTTTCACTTTTGGGGGCTTTAAATATTCCATCCTTCAGATTACAGCCAAAAAAATTCTAGTTGGTTTAACGCGTAACTAGAT,CCGACCAGCTCAGGTAATTTTCACTTTTGATCGTCGCTAAGTTGGGGCTTTAAATATTCCATCCTTCAGATTACAGCCAAAAAAATTCTAGTTGGTTTA,10,30,14,27,27,45,27,59,27,30,30,45,44,59,3.5,0.0
hek293t,13860,1,8,TTAGCCAGTGCTGAAAGCAGTATTTTGAAAGGTAATGTTACTGATATCCCACTAGGCTTGCAAATCTAAAAAAAATTCTAGTTGGTTTAACGCGTAACT,TTAGCCAGTGCTGAAAGCAGTATTTTGAAAGAATCTAAGGTAATGTTACTGATATCCCACTAGGCTTGCAAATCTAAAAAAAATTCTAGTTGGTTTAAC,10,30,14,27,27,47,27,55,27,32,32,47,40,55,31.99,3.031838825
hek293t,13860,1,8,CGGTCCAGTGCTGAAAGCAGTATTTTGAAAGGTAATGTTACTGATATCCCACTAGGCTTGCAAATCTAAGATTTTTAAAAAAATTCTAGTTGGTTTAAC,CGGTCCAGTGCTGAAAGCAGTATTTTGAAAGAATCTAAGGTAATGTTACTGATATCCCACTAGGCTTGCAAATCTAAGATTTTTAAAAAAATTCTAGTT,10,30,14,27,27,39,27,47,27,32,32,39,40,47,31.99,1.951413988
hek293t,13864,1,14,GCGACAAGTGAATAGCTGCCCTGCAGTTTTGGCTGGCTAGACACTCCAGAGTCTGCCACCCACATAAAAAAATTCTAGTTGGTTTAACGCGTAACTAGA,GCGACAAGTGAATAGCTGCCCTGCAGTTTTGGCTGGGACGGAAGTTCAACCTAGACACTCCAGAGTCTGCCACCCACATAAAAAAATTCTAGTTGGTTT,10,30,14,27,27,44,27,58,27,37,37,44,51,58,29.98,0.334448161
hek293t,13865,1,5,ACTGGAGCCAGAATTTACATGACGGTACAAGGCCCCCCCTTCCCAGATCTCTGCTAACGGGACAAACAGTGTGAGTGTGACAGAAAAAAATTCTAGTTG,ACTGGAGCCAGAATTTACATGACGGTAACGTTCAAGGCCCCCCCTTCCCAGATCTCTGCTAACGGGACAAACAGTGTGAGTGTGACAGAAAAAAATTCT,10,30,14,27,27,35,27,40,27,28,28,35,33,40,30.64,81.76052535
hek293t,13865,1,5,ATCTGAGCCAGAATTTACATGACGGTACAAGGCCCCCCCTTCCCAGATCTCTGCTAACGGGACAAACAGTGTGAGTGTGACAGGTCAAAAAAAATTCTA,ATCTGAGCCAGAATTTACATGACGGTAACGTTCAAGGCCCCCCCTTCCCAGATCTCTGCTAACGGGACAAACAGTGTGAGTGTGACAGGTCAAAAAAAA,10,30,14,27,27,31,27,36,27,28,28,31,33,36,30.64,0.445524504
hek293t,13868,1,12,AAACCGGTTAAGCATTTCCTACGGTGTATAGGAAGAACTTACTTAGTGTTTCTTCAAGCCATTTCCAAAAAAATTCTAGTTGGTTTAACGCGTAACTAG,AAACCGGTTAAGCATTTCCTACGGTGTATAGGAAGAACGCTGAAACTGACTTACTTAGTGTTTCTTCAAGCCATTTCCAAAAAAATTCTAGTTGGTTTA,10,30,14,27,27,45,27,57,27,38,38,45,50,57,25.76,0.30751291
hek293t,13868,1,12,ATTTCGGTTAAGCATTTCCTACGGTGTATAGGAAGAACTTACTTAGTGTTTCTTCAAGCCATTTCCATGCAAAAAAATTCTAGTTGGTTTAACGCGTAA,ATTTCGGTTAAGCATTTCCTACGGTGTATAGGAAGAACGCTGAAACTGACTTACTTAGTGTTTCTTCAAGCCATTTCCATGCAAAAAAATTCTAGTTGG,10,30,14,27,27,41,27,53,27,38,38,41,50,53,25.76,0.0
hek293t,13870,1,6,TCGACAGTTTTAGCATCTGCGTTTCTGAGGGGGGCAGCAGTTGGAGTAAGTATGGTGAAGATGATAAAAAAATTCTAGTTGGTTTAACGCGTAACTAGA,TCGACAGTTTTAGCATCTGCGTTTCTGAGGGGGGCACTCGTGGCAGTTGGAGTAAGTATGGTGAAGATGATAAAAAAATTCTAGTTGGTTTAACGCGTA,10,30,14,27,27,52,27,58,27,37,37,52,43,58,60.94,50.51606316
hek293t,13870,1,6,CATTAAGTTTTAGCATCTGCGTTTCTGAGGGGGGCAGCAGTTGGAGTAAGTATGGTGAAGATGATGCTGAAAAAAAATTCTAGTTGGTTTAACGCGTAA,CATTAAGTTTTAGCATCTGCGTTTCTGAGGGGGGCACTCGTGGCAGTTGGAGTAAGTATGGTGAAGATGATGCTGAAAAAAAATTCTAGTTGGTTTAAC,10,30,14,27,27,47,27,53,27,37,37,47,43,53,60.94,55.44739376
hek293t,13872,1,7,GGCCACCTAGTTTGAGAAGTCTAAACACTTGGAAATATTTTACTGTATGGGTTATTGGCTTGCTAAACAACAAAAAAAATTCTAGTTGGTTTAACGCGT,GGCCACCTAGTTTGAGAAGTCTAAACACTTGGAGTCGTCCAATATTTTACTGTATGGGTTATTGGCTTGCTAAACAACAAAAAAAATTCTAGTTGGTTT,10,30,14,27,27,44,27,51,27,34,34,44,41,51,34.02,17.21519022
hek293t,13872,1,7,CTTTGCCTAGTTTGAGAAGTCTAAACACTTGGAAATATTTTACTGTATGGGTTATTGGCTTGCTAAACAACAGTTAAAAAAATTCTAGTTGGTTTAACG,CTTTGCCTAGTTTGAGAAGTCTAAACACTTGGAGTCGTCCAATATTTTACTGTATGGGTTATTGGCTTGCTAAACAACAGTTAAAAAAATTCTAGTTGG,10,30,14,27,27,41,27,48,27,34,34,41,41,48,34.02,0.352112676
hek293t,13874,1,1,ACGCGTATGCCTAAAATTTAGGCATATAAAGGCACTGGGAGCTCAGGAGATGAAAGTGTGCAGTGCATTTGAAAAGCAGCTTACAAAAAAATTCTAGTT,ACGCGTATGCCTAAAATTTAGGCATATAAAGGCAGCTGGGAGCTCAGGAGATGAAAGTGTGCAGTGCATTTGAAAAGCAGCTTACAAAAAAATTCTAGT,10,30,14,27,27,38,27,39,27,35,35,38,36,39,7.09,1.108486391
hek293t,13874,1,1,TATATTATGCCTAAAATTTAGGCATATAAAGGCACTGGGAGCTCAGGAGATGAAAGTGTGCAGTGCATTTGAAAAGCAGCAAAAAAATTCTAGTTGGTT,TATATTATGCCTAAAATTTAGGCATATAAAGGCAGCTGGGAGCTCAGGAGATGAAAGTGTGCAGTGCATTTGAAAAGCAGCAAAAAAATTCTAGTTGGT,10,30,14,27,27,42,27,43,27,35,35,42,36,43,7.09,2.459405489
hek293t,17780,1,7,CGCTATAAAGCAGAGATTGTTCACGACTCTGGGAAGAGGGGTGTATTTTTAAGCAGTGTTGCTCTGAGCGCTAAAAAAATTCTAGTTGGTTTAACGCGT,CGCTATAAAGCAGAGATTGTTCACGACTCACATGACTGGGAAGAGGGGTGTATTTTTAAGCAGTGTTGCTCTGAGCGCTAAAAAAATTCTAGTTGGTTT,10,30,14,27,27,44,27,51,27,29,29,44,36,51,41.66,19.14763484
hek293t,17780,1,7,ACAGTTAAAGCAGAGATTGTTCACGACTCTGGGAAGAGGGGTGTATTTTTAAGCAGTGTTGCTCTGAGCGCTAGTCAAAAAAAATTCTAGTTGGTTTAA,ACAGTTAAAGCAGAGATTGTTCACGACTCACATGACTGGGAAGAGGGGTGTATTTTTAAGCAGTGTTGCTCTGAGCGCTAGTCAAAAAAAATTCTAGTT,10,30,14,27,27,39,27,46,27,29,29,39,36,46,41.66,51.24059002
hek293t,13881,1,3,GCTGTATACCCTTTTAATTTGACAGTTGCTGGAGAAACAGCTGACATATACACATGAAATACCAGTTTGTGTTGTCTAAAAAAATTCTAGTTGGTTTAA,GCTGTATACCCTTTTAATTTGACAGTTGCTGGAGAGTAAACAGCTGACATATACACATGAAATACCAGTTTGTGTTGTCTAAAAAAATTCTAGTTGGTT,10,30,14,27,27,43,27,46,27,36,36,43,39,46,1.34,1.818626519
hek293t,13881,1,3,CGTAAATACCCTTTTAATTTGACAGTTGCTGGAGAAACAGCTGACATATACACATGAAATACCAGTTTGTGTTGTCTCTTCAAAAAAATTCTAGTTGGT,CGTAAATACCCTTTTAATTTGACAGTTGCTGGAGAGTAAACAGCTGACATATACACATGAAATACCAGTTTGTGTTGTCTCTTCAAAAAAATTCTAGTT,10,30,14,27,27,39,27,42,27,36,36,39,39,42,1.34,0.0
hek293t,13883,1,5,TTCGGCAGGGAAGTAACCACAGGAGCACTCGGAACAGTCACAGTCCTTGTCCCATCAGTTCGGACAGTTAAAAAAATTCTAGTTGGTTTAACGCGTAAC,TTCGGCAGGGAAGTAACCACAGGAGCACTCGGAACAGTAGCACCACAGTCCTTGTCCCATCAGTTCGGACAGTTAAAAAAATTCTAGTTGGTTTAACGC,10,30,14,27,27,49,27,54,27,39,39,49,44,54,63.58,59.88492681
hek293t,13883,1,5,ATTTGCAGGGAAGTAACCACAGGAGCACTCGGAACAGTCACAGTCCTTGTCCCATCAGTTCGGACAGTTCAGAAAAAAATTCTAGTTGGTTTAACGCGT,ATTTGCAGGGAAGTAACCACAGGAGCACTCGGAACAGTAGCACCACAGTCCTTGTCCCATCAGTTCGGACAGTTCAGAAAAAAATTCTAGTTGGTTTAA,10,30,14,27,27,46,27,51,27,39,39,46,44,51,63.58,20.95702866
hek293t,13888,1,5,CTACCCAAGTACTTACAGCAAAGATTAAATGGGTGACCAAGAAAGAAAAACATTTGTGGTCTGACTTTTGAGGGGTAAAAAAATTCTAGTTGGTTTAAC,CTACCCAAGTACTTACAGCAAAGATTAAATGGGTAAACAGACCAAGAAAGAAAAACATTTGTGGTCTGACTTTTGAGGGGTAAAAAAATTCTAGTTGGT,10,30,14,27,27,42,27,47,27,35,35,42,40,47,5.72,1.252578672
hek293t,13888,1,5,TCTCCCAAGTACTTACAGCAAAGATTAAATGGGTGACCAAGAAAGAAAAACATTTGTGGTCTGACTTTAAAAAAATTCTAGTTGGTTTAACGCGTAACT,TCTCCCAAGTACTTACAGCAAAGATTAAATGGGTAAACAGACCAAGAAAGAAAAACATTTGTGGTCTGACTTTAAAAAAATTCTAGTTGGTTTAACGCG,10,30,14,27,27,50,27,55,27,35,35,50,40,55,5.72,0.885439734
hek293t,13890,1,7,CAAAATGAAAATGGCACCCCAGGTGCTCCTGGACCTCCTGGTGAGGAAGGCAAAAGAGGTGCAAATGGTGAAAAAAATTCTAGTTGGTTTAACGCGTAA,CAAAATGAAAATGGCACCCCAGGTGCTCCTGGACCGAGTGGTTCCTGGTGAGGAAGGCAAAAGAGGTGCAAATGGTGAAAAAAATTCTAGTTGGTTTAA,10,30,14,27,27,46,27,53,27,36,36,46,43,53,37.92,16.65259459
hek293t,13890,1,7,TTTCATGAAAATGGCACCCCAGGTGCTCCTGGACCTCCTGGTGAGGAAGGCAAAAGAGGTGCAAATGGTGAACAAAAAAATTCTAGTTGGTTTAACGCG,TTTCATGAAAATGGCACCCCAGGTGCTCCTGGACCGAGTGGTTCCTGGTGAGGAAGGCAAAAGAGGTGCAAATGGTGAACAAAAAAATTCTAGTTGGTT,10,30,14,27,27,43,27,50,27,36,36,43,43,50,37.92,0.65711568
hek293t,13892,1,3,ACACGAACTTTTTATGGTGCTCTTAAAACAGGCTAATGCAAAGTTAATAACACAAAAATAAGCCTGTATGTGGGGCAGAGAAAGCCATCAAAAAAATTC,ACACGAACTTTTTATGGTGCTCTTAAAAAGACAGGCTAATGCAAAGTTAATAACACAAAAATAAGCCTGTATGTGGGGCAGAGAAAGCCATCAAAAAAA,10,30,14,27,27,31,27,34,27,28,28,31,31,34,11.76,0.0
hek293t,13892,1,3,ATGTCAACTTTTTATGGTGCTCTTAAAACAGGCTAATGCAAAGTTAATAACACAAAAATAAGCCTGTATGTGGGGCAGAGAAAGCAAAAAAATTCTAGT,ATGTCAACTTTTTATGGTGCTCTTAAAAAGACAGGCTAATGCAAAGTTAATAACACAAAAATAAGCCTGTATGTGGGGCAGAGAAAGCAAAAAAATTCT,10,30,14,27,27,35,27,38,27,28,28,35,31,38,11.76,1.773064323
hek293t,13894,1,13,AGTGCTATCCATGGCTAAGGACTGCACAGGGGAGAATTCTCATAGCAGGCTATCATTTGCTTTGGCAAACTTTCTAAAAAAATTCTAGTTGGTTTAACG,AGTGCTATCCATGGCTAAGGACTGCACAGGGCTATATAAGCTCAGAGAATTCTCATAGCAGGCTATCATTTGCTTTGGCAAACTTTCTAAAAAAATTCT,10,30,14,27,27,35,27,48,27,32,32,35,45,48,76.94,1.641083143
hek293t,13894,1,13,CGGATTATCCATGGCTAAGGACTGCACAGGGGAGAATTCTCATAGCAGGCTATCATTTGCTTTGGCAAAAAAAAATTCTAGTTGGTTTAACGCGTAACT,CGGATTATCCATGGCTAAGGACTGCACAGGGCTATATAAGCTCAGAGAATTCTCATAGCAGGCTATCATTTGCTTTGGCAAAAAAAAATTCTAGTTGGT,10,30,14,27,27,42,27,55,27,32,32,42,45,55,76.94,46.90642323
hek293t,13896,1,9,TTTGTCTAATCCATAAATGTATTGGCTTAAGGAACAGTCCTACTACACGGTATAATTTTAGAAATTCAAAAAAATTCTAGTTGGTTTAACGCGTAACTA,TTTGTCTAATCCATAAATGTATTGGCTTAAGGAACAATGTGCTACGTCCTACTACACGGTATAATTTTAGAAATTCAAAAAAATTCTAGTTGGTTTAAC,10,30,14,27,27,47,27,56,27,37,37,47,46,56,9.79,5.748134657
hek293t,13898,1,2,CTCACTATATAAAAACATACACCAATGTGCGGAAATGGACTCAAAGTTTAGCAAATGGAACATTAAAACCGTGGTATAAAAAAATTCTAGTTGGTTTAA,CTCACTATATAAAAACATACACCAATGTGCGGAAATGGACCGTCAAAGTTTAGCAAATGGAACATTAAAACCGTGGTATAAAAAAATTCTAGTTGGTTT,10,30,14,27,27,44,27,46,27,41,41,44,43,46,66.29,0.0
hek293t,13898,1,2,CATCCTATATAAAAACATACACCAATGTGCGGAAATGGACTCAAAGTTTAGCAAATGGAACATTAAAAAAAATTCTAGTTGGTTTAACGCGTAACTAGA,CATCCTATATAAAAACATACACCAATGTGCGGAAATGGACCGTCAAAGTTTAGCAAATGGAACATTAAAAAAAATTCTAGTTGGTTTAACGCGTAACTA,10,30,14,27,27,56,27,58,27,41,41,56,43,58,66.29,1.765036592
hek293t,13900,1,1,AAGTATGCCTTCACCAGGAAAAGACGACGGGGAAAGGCCAAACACAGCATGTATCCACAATCTTTATGGAGTGTGAACGACGAAAAAAATTCTAGTTGG,AAGTATGCCTTCACCAGGAAAAGACGACGAGGGAAAGGCCAAACACAGCATGTATCCACAATCTTTATGGAGTGTGAACGACGAAAAAAATTCTAGTTG,10,30,14,27,27,40,27,41,27,30,30,40,31,41,61.05,14.08022342
hek293t,13900,1,1,CGTCGTGCCTTCACCAGGAAAAGACGACGGGGAAAGGCCAAACACAGCATGTATCCACAATCTTTATGGAGTGTGAACGACGTGCTGCTAAAAAAATTC,CGTCGTGCCTTCACCAGGAAAAGACGACGAGGGAAAGGCCAAACACAGCATGTATCCACAATCTTTATGGAGTGTGAACGACGTGCTGCTAAAAAAATT,10,30,14,27,27,33,27,34,27,30,30,33,31,34,61.05,0.569105691
hek293t,13902,1,12,GCATGTAGGCAGGAAATCAATACTCTTCAAGGCCTCTCAGTGTTGGTAATGGTCAATGTTGGTAAAAAAAATTCTAGTTGGTTTAACGCGTAACTAGAT,GCATGTAGGCAGGAAATCAATACTCTTCAAGCCTAGGAGCCATGCCTCTCAGTGTTGGTAATGGTCAATGTTGGTAAAAAAAATTCTAGTTGGTTTAAC,10,30,14,27,27,47,27,59,27,32,32,47,44,59,23.47,1.23094997
hek293t,13902,1,12,TCGGCTAGGCAGGAAATCAATACTCTTCAAGGCCTCTCAGTGTTGGTAATGGTCAATGTTGGTAGTCATCGGAAAAAAATTCTAGTTGGTTTAACGCGT,TCGGCTAGGCAGGAAATCAATACTCTTCAAGCCTAGGAGCCATGCCTCTCAGTGTTGGTAATGGTCAATGTTGGTAGTCATCGGAAAAAAATTCTAGTT,10,30,14,27,27,39,27,51,27,32,32,39,44,51,23.47,0.065104167
hek293t,13904,1,11,GGACAAATGTTGCTCTGTGCAGTGGAAAGAGGGAGACTTTCAAGACAAAACAAACTTTCAGTCTCTAAATAATGAGAAAAAAATTCTAGTTGGTTTAAC,GGACAAATGTTGCTCTGTGCAGTGGAAAGAGGCTAAGTAGGTCGAGACTTTCAAGACAAAACAAACTTTCAGTCTCTAAATAATGAGAAAAAAATTCTA,10,30,14,27,27,36,27,47,27,33,33,36,44,47,54.41,0.0
hek293t,13904,1,11,AGAACAATGTTGCTCTGTGCAGTGGAAAGAGGGAGACTTTCAAGACAAAACAAACTTTCAGTCTCTAAAAAAAAAATTCTAGTTGGTTTAACGCGTAAC,AGAACAATGTTGCTCTGTGCAGTGGAAAGAGGCTAAGTAGGTCGAGACTTTCAAGACAAAACAAACTTTCAGTCTCTAAAAAAAAAATTCTAGTTGGTT,10,30,14,27,27,43,27,54,27,33,33,43,44,54,54.41,12.60311641
hek293t,13906,1,14,TCCAGTTGTGCCAAGGTGAACTGAGTTTTTGGAACTGCATTTTTATGTGTAAGAAGGAAAGTCTACTTTCTCTGCAAAAAAATTCTAGTTGGTTTAACG,TCCAGTTGTGCCAAGGTGAACTGAGTTTTTATAGGACTTCAGAGGGAACTGCATTTTTATGTGTAAGAAGGAAAGTCTACTTTCTCTGCAAAAAAATTC,10,30,14,27,27,34,27,48,27,31,31,34,45,48,8.26,0.0
hek293t,13906,1,14,CTGGATTGTGCCAAGGTGAACTGAGTTTTTGGAACTGCATTTTTATGTGTAAGAAGGAAAGTCTACTTTCTAAAAAAATTCTAGTTGGTTTAACGCGTA,CTGGATTGTGCCAAGGTGAACTGAGTTTTTATAGGACTTCAGAGGGAACTGCATTTTTATGTGTAAGAAGGAAAGTCTACTTTCTAAAAAAATTCTAGT,10,30,14,27,27,38,27,52,27,31,31,38,45,52,8.26,0.0
hek293t,13908,1,5,CATGTATTATTTTACAGCAAAGGGTGCCACGGACCAAATAGGCCTCTTAGAGTTAGGCTGTCCCTCTGCTTACATTCAAAAAAATTCTAGTTGGTTTAA,CATGTATTATTTTACAGCAAAGGGTGCCACGGACCAAAAGACATAGGCCTCTTAGAGTTAGGCTGTCCCTCTGCTTACATTCAAAAAAATTCTAGTTGG,10,30,14,27,27,41,27,46,27,38,38,41,43,46,32.6,0.0
hek293t,13908,1,5,CTCGGATTATTTTACAGCAAAGGGTGCCACGGACCAAATAGGCCTCTTAGAGTTAGGCTGTCCCTAAAAAAATTCTAGTTGGTTTAACGCGTAACTAGA,CTCGGATTATTTTACAGCAAAGGGTGCCACGGACCAAAAGACATAGGCCTCTTAGAGTTAGGCTGTCCCTAAAAAAATTCTAGTTGGTTTAACGCGTAA,10,30,14,27,27,53,27,58,27,38,38,53,43,58,32.6,0.583333333
hek293t,13910,1,10,GGTAAGCAATCTATCATCCCATTTCCATCAGGAGGCTGGGATACCAGGATTTTAAAGTATTGCTTATAAAAAAATTCTAGTTGGTTTAACGCGTAACTA,GGTAAGCAATCTATCATCCCATTTCCATCAGGAGGTAAAAAGCTTCTGGGATACCAGGATTTTAAAGTATTGCTTATAAAAAAATTCTAGTTGGTTTAA,10,30,14,27,27,46,27,56,27,36,36,46,46,56,26.43,5.385228654
hek293t,13911,1,3,AGCTTGGGAACTGTGTTGTTTTAACTCATAGGGAAAGAATTTGGAGCAATCAAGTATGAAAAGGTGGATTACTGAGGAAAAAAAAAATTCTAGTTGGTT,AGCTTGGGAACTGTGTTGTTTTAACTCATTTGAGGGAAAGAATTTGGAGCAATCAAGTATGAAAAGGTGGATTACTGAGGAAAAAAAAAATTCTAGTTG,10,30,14,27,27,40,27,43,27,30,30,40,33,43,14.71,46.61201794
hek293t,13911,1,3,TGGGTGGGAACTGTGTTGTTTTAACTCATAGGGAAAGAATTTGGAGCAATCAAGTATGAAAAGGTGGATTACTGAGGAAATTGTAGTAAAAAAATTCTA,TGGGTGGGAACTGTGTTGTTTTAACTCATTTGAGGGAAAGAATTTGGAGCAATCAAGTATGAAAAGGTGGATTACTGAGGAAATTGTAGTAAAAAAATT,10,30,14,27,27,33,27,36,27,30,30,33,33,36,14.71,0.878481788
hek293t,13914,1,7,TCGGTCAATCTGGTAGGAATATTTCTACCTGGTAGGAAAACACCCTGTAACAACCTCAGACCCACTACACACAGTGAGAAAAAAATTCTAGTTGGTTTA,TCGGTCAATCTGGTAGGAATATTTCTACATGTTCCCTGGTAGGAAAACACCCTGTAACAACCTCAGACCCACTACACACAGTGAGAAAAAAATTCTAGT,10,30,14,27,27,38,27,45,27,28,28,38,35,45,41.39,42.4421782
hek293t,13914,1,7,GGTTGCAATCTGGTAGGAATATTTCTACCTGGTAGGAAAACACCCTGTAACAACCTCAGACCCACTACACACAGTGAGACCAAAAAAATTCTAGTTGGT,GGTTGCAATCTGGTAGGAATATTTCTACATGTTCCCTGGTAGGAAAACACCCTGTAACAACCTCAGACCCACTACACACAGTGAGACCAAAAAAATTCT,10,30,14,27,27,35,27,42,27,28,28,35,35,42,41.39,22.13100277
hek293t,13916,1,9,GCCCACACTTACTCCTCTTGCCATTGGTTTGGCGCTGCCAGATGTTCCTCTCACCCACGTCGCTCCAGCGGGTGCAAAAAAATTCTAGTTGGTTTAACG,GCCCACACTTACTCCTCTTGCCATTGGTTTGGCGCAGTCCCCGCTGCCAGATGTTCCTCTCACCCACGTCGCTCCAGCGGGTGCAAAAAAATTCTAGTT,10,30,14,27,27,39,27,48,27,36,36,39,45,48,47.68,0.0
hek293t,13917,1,13,CCCCTTCATACATGTTTCAGTGCACTTCAAGGCAGATAGCTATCGTTGTCAAGTTCTGAATATGTAGCTAAAAAAAAATTCTAGTTGGTTTAACGCGTA,CCCCTTCATACATGTTTCAGTGCACTTCCTCGATGGTTCCAAAGGCAGATAGCTATCGTTGTCAAGTTCTGAATATGTAGCTAAAAAAAAATTCTAGTT,10,30,14,27,27,39,27,52,27,29,29,39,42,52,31.13,52.77022067
hek293t,13917,1,13,TTTTGTCATACATGTTTCAGTGCACTTCAAGGCAGATAGCTATCGTTGTCAAGTTCTGAATATGTAGCTAATGCAAAAAAATTCTAGTTGGTTTAACGC,TTTTGTCATACATGTTTCAGTGCACTTCCTCGATGGTTCCAAAGGCAGATAGCTATCGTTGTCAAGTTCTGAATATGTAGCTAATGCAAAAAAATTCTA,10,30,14,27,27,36,27,49,27,29,29,36,42,49,31.13,3.347168758
hek293t,13919,1,11,GAATGCTGCTTGGAAAATCTGGGGCCATTTGGAAATCATCTCCAGGAGGTTTATTTTATTTCTCAGAAAAAAATTCTAGTTGGTTTAACGCGTAACTAG,GAATGCTGCTTGGAAAATCTGGGGCCATTTCTCACAGCGTAGGAAATCATCTCCAGGAGGTTTATTTTATTTCTCAGAAAAAAATTCTAGTTGGTTTAA,10,30,14,27,27,46,27,57,27,31,31,46,42,57,11.62,5.625876733
hek293t,13921,1,13,GTGGCTGCTTGTCCCTAACGACAGGGGTTAGGGAGCACAGGGACATACTCCCATCTCCAGCCAAACGCTAAAAAAATTCTAGTTGGTTTAACGCGTAAC,GTGGCTGCTTGTCCCTAACGACAGGGGTTAGGGCTCCCGAAATAATAGCACAGGGACATACTCCCATCTCCAGCCAAACGCTAAAAAAATTCTAGTTGG,10,30,14,27,27,41,27,54,27,34,34,41,47,54,44.51,1.121037846
hek293t,13925,1,13,CTGGTCCTCACTCTGCACAGTACTTCCTGAGGCTTATTACTGGAATTAACAAACAATTTTAAAACCAGGATAAAAAAATTCTAGTTGGTTTAACGCGTA,CTGGTCCTCACTCTGCACAGTACTTCCTCTTAGACCACGGGGAGGCTTATTACTGGAATTAACAAACAATTTTAAAACCAGGATAAAAAAATTCTAGTT,10,30,14,27,27,39,27,52,27,29,29,39,42,52,58.57,10.8952467
hek293t,13925,1,13,GAGCCCCTCACTCTGCACAGTACTTCCTGAGGCTTATTACTGGAATTAACAAACAATTTTAAAACCAGGATTTAAAAAAAATTCTAGTTGGTTTAACGC,GAGCCCCTCACTCTGCACAGTACTTCCTCTTAGACCACGGGGAGGCTTATTACTGGAATTAACAAACAATTTTAAAACCAGGATTTAAAAAAAATTCTA,10,30,14,27,27,36,27,49,27,29,29,36,42,49,58.57,0.567375887
hek293t,13927,1,11,AATTGGGTTTTAAGCTTGTGATTAATTGCTGGAGAAATGCTATGCCAAGATTAGTTTTCTGTTTTGTGTGGATTTTCAAAAAAATTCTAGTTGGTTTAA,AATTGGGTTTTAAGCTTGTGATTAATTGCTGCATGCTGTTGTGAGAAATGCTATGCCAAGATTAGTTTTCTGTTTTGTGTGGATTTTCAAAAAAATTCT,10,30,14,27,27,35,27,46,27,32,32,35,43,46,11.47,0.0
hek293t,13927,1,11,CAATGGGTTTTAAGCTTGTGATTAATTGCTGGAGAAATGCTATGCCAAGATTAGTTTTCTGTTTTGTGTGGATAAAAAAATTCTAGTTGGTTTAACGCG,CAATGGGTTTTAAGCTTGTGATTAATTGCTGCATGCTGTTGTGAGAAATGCTATGCCAAGATTAGTTTTCTGTTTTGTGTGGATAAAAAAATTCTAGTT,10,30,14,27,27,39,27,50,27,32,32,39,43,50,11.47,1.767435643
hek293t,13929,1,5,TTTGTAGTCTGAATATCACTGATGAGCGCAGGGAGAGTCTATGTAACTCCTCTTCAGTCTTTGCAAACATTGCTGGGCAAAAAAATTCTAGTTGGTTTA,TTTGTAGTCTGAATATCACTGATGAGCGCAGGGAGAACCGAGTCTATGTAACTCCTCTTCAGTCTTTGCAAACATTGCTGGGCAAAAAAATTCTAGTTG,10,30,14,27,27,40,27,45,27,37,37,40,42,45,38.37,0.212314225
hek293t,13929,1,5,CGTTAAGTCTGAATATCACTGATGAGCGCAGGGAGAGTCTATGTAACTCCTCTTCAGTCTTTGCAAACATTGCTAAAAAAATTCTAGTTGGTTTAACGC,CGTTAAGTCTGAATATCACTGATGAGCGCAGGGAGAACCGAGTCTATGTAACTCCTCTTCAGTCTTTGCAAACATTGCTAAAAAAATTCTAGTTGGTTT,10,30,14,27,27,44,27,49,27,37,37,44,42,49,38.37,46.83049135
hek293t,13931,1,12,CTCCTTACAGGATATTTCAGAAGAGATCAAGGTTTTAGTTTGCTCTCCTTTGTGTAATGTATGTGTGCAAAAAAATTCTAGTTGGTTTAACGCGTAACT,CTCCTTACAGGATATTTCAGAAGAGATCAAGGATGCCCATATCATTTTAGTTTGCTCTCCTTTGTGTAATGTATGTGTGCAAAAAAATTCTAGTTGGTT,10,30,14,27,27,43,27,55,27,33,33,43,45,55,47.39,2.177703484
hek293t,13933,1,7,GGAAAGACTCAAGCCTCACAAATAAGCACTGGGACATGAGAGGAATCAATAACAGTCTTACAGTTTTTACATGCAATTTAAAAAAATTCTAGTTGGTTT,GGAAAGACTCAAGCCTCACAAATAAGCACTGGGCTGGATAACATGAGAGGAATCAATAACAGTCTTACAGTTTTTACATGCAATTTAAAAAAATTCTAG,10,30,14,27,27,37,27,44,27,34,34,37,41,44,48.91,0.0
hek293t,13933,1,7,TTTATGACTCAAGCCTCACAAATAAGCACTGGGACATGAGAGGAATCAATAACAGTCTTACAGTTTTTACATAAAAAAATTCTAGTTGGTTTAACGCGT,TTTATGACTCAAGCCTCACAAATAAGCACTGGGCTGGATAACATGAGAGGAATCAATAACAGTCTTACAGTTTTTACATAAAAAAATTCTAGTTGGTTT,10,30,14,27,27,44,27,51,27,34,34,44,41,51,48.91,3.8482606
hek293t,13935,1,1,CATAGGCTGACAGAACATGTTCCAGGAAAAGGGGGCCCTCCTTGATATAGTTGCTGTTATTGGTATGTCTCGATGTATTATTAAAAAAATTCTAGTTGG,CATAGGCTGACAGAACATGTTCCAGGAAAAGGGGGGCCCTCCTTGATATAGTTGCTGTTATTGGTATGTCTCGATGTATTATTAAAAAAATTCTAGTTG,10,30,14,27,27,40,27,41,27,33,33,40,34,41,32.26,16.25756134
hek293t,13935,1,1,CTCAGGCTGACAGAACATGTTCCAGGAAAAGGGGGCCCTCCTTGATATAGTTGCTGTTATTGGTATGTCTCGATAAAAAAATTCTAGTTGGTTTAACGC,CTCAGGCTGACAGAACATGTTCCAGGAAAAGGGGGGCCCTCCTTGATATAGTTGCTGTTATTGGTATGTCTCGATAAAAAAATTCTAGTTGGTTTAACG,10,30,14,27,27,48,27,49,27,33,33,48,34,49,32.26,46.05533164
hek293t,13937,1,10,TACGGCCGCACACTGATCAGAGCAGTTAGGGGGTCAGTTACAGCCTGTGTGCCTTTAGACCTCTGCCTAGCAAAAAAAAATTCTAGTTGGTTTAACGCG,TACGGCCGCACACTGATCAGAGCAGTTAGGGGGTGTGAGCTAGTCAGTTACAGCCTGTGTGCCTTTAGACCTCTGCCTAGCAAAAAAAAATTCTAGTTG,10,30,14,27,27,40,27,50,27,33,33,40,43,50,53.44,7.438342918
hek293t,13937,1,10,TTTACCCGCACACTGATCAGAGCAGTTAGGGGGTCAGTTACAGCCTGTGTGCCTTTAGACCTCTGCCTAGAAAAAAATTCTAGTTGGTTTAACGCGTAA,TTTACCCGCACACTGATCAGAGCAGTTAGGGGGTGTGAGCTAGTCAGTTACAGCCTGTGTGCCTTTAGACCTCTGCCTAGAAAAAAATTCTAGTTGGTT,10,30,14,27,27,43,27,53,27,33,33,43,43,53,53.44,51.84331438
hek293t,13939,1,8,GAGTAACTCTGCGAAGGAGAGTGACTTGTAGGCATCATGGCAAAAGTGCCTTAAAAGACAGTAAGATGAAAAAAAATTCTAGTTGGTTTAACGCGTAAC,GAGTAACTCTGCGAAGGAGAGTGACTTGTACCCTACACGGCATCATGGCAAAAGTGCCTTAAAAGACAGTAAGATGAAAAAAAATTCTAGTTGGTTTAA,10,30,14,27,27,46,27,54,27,31,31,46,39,54,40.37,6.656771695
hek293t,13939,1,8,GGCTGACTCTGCGAAGGAGAGTGACTTGTAGGCATCATGGCAAAAGTGCCTTAAAAGACAGTAAGATGAGAGCTCTGAAAAAAATTCTAGTTGGTTTAA,GGCTGACTCTGCGAAGGAGAGTGACTTGTACCCTACACGGCATCATGGCAAAAGTGCCTTAAAAGACAGTAAGATGAGAGCTCTGAAAAAAATTCTAGT,10,30,14,27,27,38,27,46,27,31,31,38,39,46,40.37,14.30858128
hek293t,13941,1,4,CTAATGTCATCCCTCAAGAGATGAAACCAAGGGAAGTCTCTCCCACATTTCAATCAGCTCCAGAGAAAAAAATTCTAGTTGGTTTAACGCGTAACTAGA,CTAATGTCATCCCTCAAGAGATGAAACCAAGGGAAGTCCATATCTCCCACATTTCAATCAGCTCCAGAGAAAAAAATTCTAGTTGGTTTAACGCGTAAC,10,30,14,27,27,54,27,58,27,39,39,54,43,58,74.65,48.52302014
hek293t,13941,1,4,GTCAAGTCATCCCTCAAGAGATGAAACCAAGGGAAGTCTCTCCCACATTTCAATCAGCTCCAGAGGCCTCAATAAAAAAATTCTAGTTGGTTTAACGCG,GTCAAGTCATCCCTCAAGAGATGAAACCAAGGGAAGTCCATATCTCCCACATTTCAATCAGCTCCAGAGGCCTCAATAAAAAAATTCTAGTTGGTTTAA,10,30,14,27,27,46,27,50,27,39,39,46,43,50,74.65,48.09477631
hek293t,13943,1,14,CTTTAAACAAACTTCACATCTGTGATCCTTGGGCCATCTTTATAACAGTATTACTAATGGTGAGGGCTCAAAAAAAAAATTCTAGTTGGTTTAACGCGT,CTTTAAACAAACTTCACATCTGTGATCCTTGGGTAATACTTGGCTGGCCATCTTTATAACAGTATTACTAATGGTGAGGGCTCAAAAAAAAAATTCTAG,10,30,14,27,27,37,27,51,27,34,34,37,48,51,38.05,0.268276325
hek293t,13943,1,14,TGAATAACAAACTTCACATCTGTGATCCTTGGGCCATCTTTATAACAGTATTACTAATGGTGAGGAAAAAAATTCTAGTTGGTTTAACGCGTAACTAGA,TGAATAACAAACTTCACATCTGTGATCCTTGGGTAATACTTGGCTGGCCATCTTTATAACAGTATTACTAATGGTGAGGAAAAAAATTCTAGTTGGTTT,10,30,14,27,27,44,27,58,27,34,34,44,48,58,38.05,13.41715565
hek293t,13945,1,11,TTGATCTTCAGCTGCATTTCACTGAGTACAGGAAACAGTTTTTGTAGTGTACCAGTGAAATAATTATCCAAAAAAATTCTAGTTGGTTTAACGCGTAAC,TTGATCTTCAGCTGCATTTCACTGAGTTACCGATAACCACAGGAAACAGTTTTTGTAGTGTACCAGTGAAATAATTATCCAAAAAAATTCTAGTTGGTT,10,30,14,27,27,43,27,54,27,28,28,43,39,54,28.32,35.51016159
hek293t,13947,1,3,CCTTAAGAAGGAGCAAGTTTTGAAGAAACTGGAAGAAGCCATGCAACAAGCAGAAGCTGTGTCCTTCAGGCCTTACATCTAAAAAAATTCTAGTTGGTT,CCTTAAGAAGGAGCAAGTTTTGAAGAAACTGGAAGATGTAGCCATGCAACAAGCAGAAGCTGTGTCCTTCAGGCCTTACATCTAAAAAAATTCTAGTTG,10,30,14,27,27,40,27,43,27,37,37,40,40,43,23.94,0.553899159
hek293t,13947,1,3,CATTTAGAAGGAGCAAGTTTTGAAGAAACTGGAAGAAGCCATGCAACAAGCAGAAGCTGTGTCCTTCAAAAAAAATTCTAGTTGGTTTAACGCGTAACT,CATTTAGAAGGAGCAAGTTTTGAAGAAACTGGAAGATGTAGCCATGCAACAAGCAGAAGCTGTGTCCTTCAAAAAAAATTCTAGTTGGTTTAACGCGTA,10,30,14,27,27,52,27,55,27,37,37,52,40,55,23.94,61.2890561
hek293t,13949,1,14,CCCCAACATAAAATAGGAGTCTGAATCTTTGGCTGAGATTCTGACCTTCACAGAGCTTAAGTTATTCCTGATAAAAAAATTCTAGTTGGTTTAACGCGT,CCCCAACATAAAATAGGAGTCTGAATCTTTGGCACCCGTGGAGGATTTGAGATTCTGACCTTCACAGAGCTTAAGTTATTCCTGATAAAAAAATTCTAG,10,30,14,27,27,37,27,51,27,34,34,37,48,51,17.81,1.045557683
hek293t,13950,1,11,TTGGTTAATTAGTAAGATGTCAGCATTCCAGGTAGGAATTCCACTTGGGGAGCAGGAAGATGGAAGACAACTTAGAATTAAAAAAATTCTAGTTGGTTT,TTGGTTAATTAGTAAGATGTCAGCATTCCCTGATTAAATGAGGTAGGAATTCCACTTGGGGAGCAGGAAGATGGAAGACAACTTAGAATTAAAAAAATT,10,30,14,27,27,33,27,44,27,30,30,33,41,44,21.99,0.0
hek293t,13950,1,11,CACAATAATTAGTAAGATGTCAGCATTCCAGGTAGGAATTCCACTTGGGGAGCAGGAAGATGGAAGACAACTTAGAAAAAAATTCTAGTTGGTTTAACG,CACAATAATTAGTAAGATGTCAGCATTCCCTGATTAAATGAGGTAGGAATTCCACTTGGGGAGCAGGAAGATGGAAGACAACTTAGAAAAAAATTCTAG,10,30,14,27,27,37,27,48,27,30,30,37,41,48,21.99,0.089013351
hek293t,13953,1,13,CACAGGACAAAAAGGGTGATGGGCTGCTTTGGAAAAAGCCACATTGGCAGCGTCACCTATATAACTATGTGCAATGTAAAAAAATTCTAGTTGGTTTAA,CACAGGACAAAAAGGGTGATGGGCTGCTTGTCTTGGACCCAATGGAAAAAGCCACATTGGCAGCGTCACCTATATAACTATGTGCAATGTAAAAAAATT,10,30,14,27,27,33,27,46,27,30,30,33,43,46,42.2,0.0
hek293t,13953,1,13,ATCTCGACAAAAAGGGTGATGGGCTGCTTTGGAAAAAGCCACATTGGCAGCGTCACCTATATAACTATGTGCAAAAAAAATTCTAGTTGGTTTAACGCG,ATCTCGACAAAAAGGGTGATGGGCTGCTTGTCTTGGACCCAATGGAAAAAGCCACATTGGCAGCGTCACCTATATAACTATGTGCAAAAAAAATTCTAG,10,30,14,27,27,37,27,50,27,30,30,37,43,50,42.2,0.591597313
hek293t,13955,1,8,ATAACAGTAGCTAAATTTGTTGAAGCCTTAGGCCGCACATAGATAAAATAAAGAACTTTTACCTAGTTCAGTAAGAAAAAAAATTCTAGTTGGTTTAAC,ATAACAGTAGCTAAATTTGTTGAAGCCTGAGTAGCCTAGGCCGCACATAGATAAAATAAAGAACTTTTACCTAGTTCAGTAAGAAAAAAAATTCTAGTT,10,30,14,27,27,39,27,47,27,29,29,39,37,47,13.81,13.77887395
hek293t,13955,1,8,AACACAGTAGCTAAATTTGTTGAAGCCTTAGGCCGCACATAGATAAAATAAAGAACTTTTACCTAGTTCAGTAAGAAAAAAAAAAATTCTAGTTGGTTT,AACACAGTAGCTAAATTTGTTGAAGCCTGAGTAGCCTAGGCCGCACATAGATAAAATAAAGAACTTTTACCTAGTTCAGTAAGAAAAAAAAAAATTCTA,10,30,14,27,27,36,27,44,27,29,29,36,37,44,13.81,0.0
hek293t,13957,1,12,ATAGGTTCTATTTTGCAAATATTTTGTAATGGTGGCTACAATACTCTTAGTTACAAACTTTGACGAAAAGCTAAAAAAATTCTAGTTGGTTTAACGCGT,ATAGGTTCTATTTTGCAAATATTTTGTAATGGTGGTCACGGTCTTGGCTACAATACTCTTAGTTACAAACTTTGACGAAAAGCTAAAAAAATTCTAGTT,10,30,14,27,27,39,27,51,27,36,36,39,48,51,2.58,0.0
hek293t,13958,1,8,GTCAAAACCAATCTTAATGGATTTTGCTTAGGAATAAGTTCAAATGAAACCTCACCTTCAGACAAGCCTCAAAAAAAATTCTAGTTGGTTTAACGCGTA,GTCAAAACCAATCTTAATGGATTTTGCTGCTGTTCATAGGAATAAGTTCAAATGAAACCTCACCTTCAGACAAGCCTCAAAAAAAATTCTAGTTGGTTT,10,30,14,27,27,44,27,52,27,29,29,44,37,52,16.42,2.869595786
hek293t,13958,1,8,AGAGAAACCAATCTTAATGGATTTTGCTTAGGAATAAGTTCAAATGAAACCTCACCTTCAGACAAGCCTCAAGTTTAAAAAAATTCTAGTTGGTTTAAC,AGAGAAACCAATCTTAATGGATTTTGCTGCTGTTCATAGGAATAAGTTCAAATGAAACCTCACCTTCAGACAAGCCTCAAGTTTAAAAAAATTCTAGTT,10,30,14,27,27,39,27,47,27,29,29,39,37,47,16.42,2.950835063
hek293t,13960,1,13,ACATTGAAAGACTTCTTGTTCTCAGAAGATGGACAGCTAGGCCAGGGGACAAAGGATAATGCAAAAACAAAAAAATTCTAGTTGGTTTAACGCGTAACT,ACATTGAAAGACTTCTTGTTCTCAGAAGATGGACTTGTCATGAACTAAGCTAGGCCAGGGGACAAAGGATAATGCAAAAACAAAAAAATTCTAGTTGGT,10,30,14,27,27,42,27,55,27,35,35,42,48,55,31.85,2.632845912
hek293t,13960,1,13,CCCGAGAAAGACTTCTTGTTCTCAGAAGATGGACAGCTAGGCCAGGGGACAAAGGATAATGCAAAAACCAATAAAAAAATTCTAGTTGGTTTAACGCGT,CCCGAGAAAGACTTCTTGTTCTCAGAAGATGGACTTGTCATGAACTAAGCTAGGCCAGGGGACAAAGGATAATGCAAAAACCAATAAAAAAATTCTAGT,10,30,14,27,27,38,27,51,27,35,35,38,48,51,31.85,0.0
hek293t,23069,1,13,CAAGCCTCGGTACCACAGCCTCCCAGAAGTGGGGAAAGATTTTGTCTTCCTAAACGCCACCCAGAGAAGAAAAAAATTCTAGTTGGTTTAACGCGTAAC,CAAGCCTCGGTACCACAGCCTCCCAGAAGTGGGACCAAGGCTACCTGAAAGATTTTGTCTTCCTAAACGCCACCCAGAGAAGAAAAAAATTCTAGTTGG,10,30,14,27,27,41,27,54,27,34,34,41,47,54,50.52,2.315887616
hek293t,23069,1,13,TTGCACTCGGTACCACAGCCTCCCAGAAGTGGGGAAAGATTTTGTCTTCCTAAACGCCACCCAGAGAAGCTGCAAAAAAATTCTAGTTGGTTTAACGCG,TTGCACTCGGTACCACAGCCTCCCAGAAGTGGGACCAAGGCTACCTGAAAGATTTTGTCTTCCTAAACGCCACCCAGAGAAGCTGCAAAAAAATTCTAG,10,30,14,27,27,37,27,50,27,34,34,37,47,50,50.52,4.522327596
hek293t,13964,1,1,GAATTTGGATATGAGTGGCATAACTTTGATGGCATAACTCAGAGGCCCACATATTCTAGGTGTGTAAAAACTGGGCAATAAAAAAATTCTAGTTGGTTT,GAATTTGGATATGAGTGGCATAACTTTGATGGCCATAACTCAGAGGCCCACATATTCTAGGTGTGTAAAAACTGGGCAATAAAAAAATTCTAGTTGGTT,10,30,14,27,27,43,27,44,27,33,33,43,34,44,44.59,55.45064888
hek293t,13964,1,1,AGGGCTGGATATGAGTGGCATAACTTTGATGGCATAACTCAGAGGCCCACATATTCTAGGTGTGTAAAAACTGGGCAATTGTAAAAAAATTCTAGTTGG,AGGGCTGGATATGAGTGGCATAACTTTGATGGCCATAACTCAGAGGCCCACATATTCTAGGTGTGTAAAAACTGGGCAATTGTAAAAAAATTCTAGTTG,10,30,14,27,27,40,27,41,27,33,33,40,34,41,44.59,72.8833854
hek293t,13966,1,15,CACCTTGGAGGCTTGTTTCATATAAAAATTGGTGTTTGTAAATCTGGATGAAAGAACCATTAAGGTGTTGTTAAAAAAATTCTAGTTGGTTTAACGCGT,CACCTTGGAGGCTTGTTTCATATAAAAATTGGCTGGCGTTGAAGGTGTGTTTGTAAATCTGGATGAAAGAACCATTAAGGTGTTGTTAAAAAAATTCTA,10,30,14,27,27,36,27,51,27,33,33,36,48,51,12.63,0.0
hek293t,13966,1,15,AACTGTGGAGGCTTGTTTCATATAAAAATTGGTGTTTGTAAATCTGGATGAAAGAACCATTAAGGAAAAAAATTCTAGTTGGTTTAACGCGTAACTAGA,AACTGTGGAGGCTTGTTTCATATAAAAATTGGCTGGCGTTGAAGGTGTGTTTGTAAATCTGGATGAAAGAACCATTAAGGAAAAAAATTCTAGTTGGTT,10,30,14,27,27,43,27,58,27,33,33,43,48,58,12.63,0.0
hek293t,13968,1,7,TTGTATAAAAGATTCCGCAGGGCCACAAGGGGGCATCCTTTAAACACACACACAGTAGAGTGGCACTGACCGTTCCGGACCGAAAAAAATTCTAGTTGG,TTGTATAAAAGATTCCGCAGGGCCACATGAAAGAAGGGGGCATCCTTTAAACACACACACAGTAGAGTGGCACTGACCGTTCCGGACCGAAAAAAATTC,10,30,14,27,27,34,27,41,27,27,27,34,34,41,49.61,24.61436711
hek293t,13968,1,7,TCCAGTAAAAGATTCCGCAGGGCCACAAGGGGGCATCCTTTAAACACACACACAGTAGAGTGGCACTGACCGTTCCGGAAAAAAAATTCTAGTTGGTTT,TCCAGTAAAAGATTCCGCAGGGCCACATGAAAGAAGGGGGCATCCTTTAAACACACACACAGTAGAGTGGCACTGACCGTTCCGGAAAAAAAATTCTAG,10,30,14,27,27,37,27,44,27,27,27,37,34,44,49.61,55.06354543
hek293t,13970,1,9,ATACTTTAGAATTAACTGCTGTCTTTCTTCGGCTCAGCACCTTCATAGCACTGTTGCTGTCTTGTTAGCAGCTTAAAAAAATTCTAGTTGGTTTAACGC,ATACTTTAGAATTAACTGCTGTCTTTCTTCGGCTCACGCTAGAAAGCACCTTCATAGCACTGTTGCTGTCTTGTTAGCAGCTTAAAAAAATTCTAGTTG,10,30,14,27,27,40,27,49,27,37,37,40,46,49,10.08,0.27100271
hek293t,13970,1,9,TGAATTTAGAATTAACTGCTGTCTTTCTTCGGCTCAGCACCTTCATAGCACTGTTGCTGTCTTGTTAAAAAAAATTCTAGTTGGTTTAACGCGTAACTA,TGAATTTAGAATTAACTGCTGTCTTTCTTCGGCTCACGCTAGAAAGCACCTTCATAGCACTGTTGCTGTCTTGTTAAAAAAAATTCTAGTTGGTTTAAC,10,30,14,27,27,47,27,56,27,37,37,47,46,56,10.08,33.35880881
hek293t,13972,1,3,CCTGAGATGTCTCTGCATAGTTTATATGATGGTGATTTGCCGTAGGTTCATCAATAAGATGCTTCAAAGCCTGCAAGAAAAAAATTCTAGTTGGTTTAA,CCTGAGATGTCTCTGCATAGTTTATATGATGGCACTGATTTGCCGTAGGTTCATCAATAAGATGCTTCAAAGCCTGCAAGAAAAAAATTCTAGTTGGTT,10,30,14,27,27,43,27,46,27,33,33,43,36,46,46.59,72.80033362
hek293t,13972,1,3,AGTAAGATGTCTCTGCATAGTTTATATGATGGTGATTTGCCGTAGGTTCATCAATAAGATGCTTCAAAGCCTGCAAGACTAAAAAAATTCTAGTTGGTT,AGTAAGATGTCTCTGCATAGTTTATATGATGGCACTGATTTGCCGTAGGTTCATCAATAAGATGCTTCAAAGCCTGCAAGACTAAAAAAATTCTAGTTG,10,30,14,27,27,40,27,43,27,33,33,40,36,43,46.59,46.15847908
hek293t,13974,1,8,ATCCTACCACTGATTTTTGTGTCTGCCTAAGGGCAGACAGAAAGAACAAAAGAACGAGATTTACGGAGTATTCACTAGAAAAAAATTCTAGTTGGTTTA,ATCCTACCACTGATTTTTGTGTCTGCCTCGGAACCTAAGGGCAGACAGAAAGAACAAAAGAACGAGATTTACGGAGTATTCACTAGAAAAAAATTCTAG,10,30,14,27,27,37,27,45,27,27,27,37,35,45,4.68,0.1769495
hek293t,13974,1,8,CCCTCACCACTGATTTTTGTGTCTGCCTAAGGGCAGACAGAAAGAACAAAAGAACGAGATTTACGGAGTATTCACTAGGAAAAAAAAATTCTAGTTGGT,CCCTCACCACTGATTTTTGTGTCTGCCTCGGAACCTAAGGGCAGACAGAAAGAACAAAAGAACGAGATTTACGGAGTATTCACTAGGAAAAAAAAATTC,10,30,14,27,27,34,27,42,27,27,27,34,35,42,4.68,0.0
hek293t,13976,1,7,GGCTTGAAAATGTAGGGCAAACCAGCTCCTGGGATTTCTCTGAATAGCAGTTATTTTGTGCATATGAAGTAAAAAAAATTCTAGTTGGTTTAACGCGTA,GGCTTGAAAATGTAGGGCAAACCAGCTCCTACAGCTTGGGATTTCTCTGAATAGCAGTTATTTTGTGCATATGAAGTAAAAAAAATTCTAGTTGGTTTA,10,30,14,27,27,45,27,52,27,30,30,45,37,52,53.06,44.32766934
hek293t,13978,1,4,ATCGAAAGGGGATGTCATTATGCATCAGATGGGTGACACTGATCCAACACACAATGTAACTGAAATCATAAAAAAAATTCTAGTTGGTTTAACGCGTAA,ATCGAAAGGGGATGTCATTATGCATCAGATGGGTGGATGACACTGATCCAACACACAATGTAACTGAAATCATAAAAAAAATTCTAGTTGGTTTAACGC,10,30,14,27,27,49,27,53,27,34,34,49,38,53,32.15,84.40577408
hek293t,13978,1,4,TCGTGAAGGGGATGTCATTATGCATCAGATGGGTGACACTGATCCAACACACAATGTAACTGAAATCATACAAACAAAAAAATTCTAGTTGGTTTAACG,TCGTGAAGGGGATGTCATTATGCATCAGATGGGTGGATGACACTGATCCAACACACAATGTAACTGAAATCATACAAACAAAAAAATTCTAGTTGGTTT,10,30,14,27,27,44,27,48,27,34,34,44,38,48,32.15,81.92538339
hek293t,13982,1,5,AACGACTAAGCAGGACTGGACTATGTGTTTGGACAGAGATTTGCAAAGAAGGATGCTTCCGGAAGTACTGGGGTTTTGACAAAAAAAATTCTAGTTGGT,AACGACTAAGCAGGACTGGACTATGTGTTTGGACAAGCCAGAGATTTGCAAAGAAGGATGCTTCCGGAAGTACTGGGGTTTTGACAAAAAAAATTCTAG,10,30,14,27,27,37,27,42,27,34,34,37,39,42,57.51,0.493833167
hek293t,13982,1,5,GCAGACTAAGCAGGACTGGACTATGTGTTTGGACAGAGATTTGCAAAGAAGGATGCTTCCGGAAGTACTAAAAAAATTCTAGTTGGTTTAACGCGTAAC,GCAGACTAAGCAGGACTGGACTATGTGTTTGGACAAGCCAGAGATTTGCAAAGAAGGATGCTTCCGGAAGTACTAAAAAAATTCTAGTTGGTTTAACGC,10,30,14,27,27,49,27,54,27,34,34,49,39,54,57.51,34.41915591
hek293t,13984,1,9,TACTGAATGAATTTTGGAGAAATGGTATAAGGAGGTGATGTGTAACTCAGGGACTTTAAATTGCCAAAAAAATTCTAGTTGGTTTAACGCGTAACTAGA,TACTGAATGAATTTTGGAGAAATGGTATAAGGAGGTGACAACGCCTTTGTGTAACTCAGGGACTTTAAATTGCCAAAAAAATTCTAGTTGGTTTAACGC,10,30,14,27,27,49,27,58,27,39,39,49,48,58,22.33,1.097309132
hek293t,13985,1,9,CATCTTAGTGAAGTTGGGAGTTTATGGAAAGGCACCTGAAAATGTCAGGAAATCATCTAGGAAATGTTAGAAAAAAATTCTAGTTGGTTTAACGCGTAA,CATCTTAGTGAAGTTGGGAGTTTATGGAAAGGCACCTGCGGGGAGTGAAAATGTCAGGAAATCATCTAGGAAATGTTAGAAAAAAATTCTAGTTGGTTT,10,30,14,27,27,44,27,53,27,37,37,44,46,53,52.59,0.91031164
hek293t,13987,1,10,TATCCTTTTCTTTTCAAACTGTAGAAATATGGAATGTTCTTACCTGGTGGTTGACTATTTGGGACATGGCTCAGCCATGAAAAAAATTCTAGTTGGTTT,TATCCTTTTCTTTTCAAACTGTAGAAATATAACATCGATAGGAATGTTCTTACCTGGTGGTTGACTATTTGGGACATGGCTCAGCCATGAAAAAAATTC,10,30,14,27,27,34,27,44,27,31,31,34,41,44,8.76,0.0
hek293t,13987,1,10,GGAGCTTTTCTTTTCAAACTGTAGAAATATGGAATGTTCTTACCTGGTGGTTGACTATTTGGGACATGGCTCAAAAAAATTCTAGTTGGTTTAACGCGT,GGAGCTTTTCTTTTCAAACTGTAGAAATATAACATCGATAGGAATGTTCTTACCTGGTGGTTGACTATTTGGGACATGGCTCAAAAAAATTCTAGTTGG,10,30,14,27,27,41,27,51,27,31,31,41,41,51,8.76,1.098762394
hek293t,13989,1,1,TGCGTTTGTGGCAAAACTGCTACTCCTACAGGTTTAGGGGTCTTGCTGCTTGTAATTGCCCTTGCAATGACAGAATTAAAAAAAATTCTAGTTGGTTTA,TGCGTTTGTGGCAAAACTGCTACTCCTACAGGTTTAGGGGTTCTTGCTGCTTGTAATTGCCCTTGCAATGACAGAATTAAAAAAAATTCTAGTTGGTTT,10,30,14,27,27,44,27,45,27,41,41,44,42,45,18.82,6.535008335
hek293t,13989,1,1,TTACATTGTGGCAAAACTGCTACTCCTACAGGTTTAGGGGTCTTGCTGCTTGTAATTGCCCTTGCAATGACAAAAAAATTCTAGTTGGTTTAACGCGTA,TTACATTGTGGCAAAACTGCTACTCCTACAGGTTTAGGGGTTCTTGCTGCTTGTAATTGCCCTTGCAATGACAAAAAAATTCTAGTTGGTTTAACGCGT,10,30,14,27,27,51,27,52,27,41,41,51,42,52,18.82,65.88848631
hek293t,20305,1,3,TTGGCCCACAATATGACGTACTCTGTGTGTGGGGACCCCCCCTAATAAAGTAGAATGATTTCCTCATCAAAGAATAAAAAAAAAATTCTAGTTGGTTTA,TTGGCCCACAATATGACGTACTCTGTGTGTGGGGACCCGAGCCCCTAATAAAGTAGAATGATTTCCTCATCAAAGAATAAAAAAAAAATTCTAGTTGGT,10,30,14,27,27,42,27,45,27,39,39,42,42,45,55.99,0.771604938
hek293t,20305,1,3,GAAGGCCACAATATGACGTACTCTGTGTGTGGGGACCCCCCCTAATAAAGTAGAATGATTTCCTCATCAAAGAAAAAAAAATTCTAGTTGGTTTAACGC,GAAGGCCACAATATGACGTACTCTGTGTGTGGGGACCCGAGCCCCTAATAAAGTAGAATGATTTCCTCATCAAAGAAAAAAAAATTCTAGTTGGTTTAA,10,30,14,27,27,46,27,49,27,39,39,46,42,49,55.99,39.53952498
hek293t,17712,1,13,AACGGGAACAGCATTGCATGTGGCAGCTGCGGAAGGTACTGTCTTCTCCTGTATAACTTGCTATAAAAAAATTCTAGTTGGTTTAACGCGTAACTAGAT,AACGGGAACAGCATTGCATGTGGCAGCTGCCCATCATACGAGTGGAAGGTACTGTCTTCTCCTGTATAACTTGCTATAAAAAAATTCTAGTTGGTTTAA,10,30,14,27,27,46,27,59,27,31,31,46,44,59,62.96,75.69590196
hek293t,17712,1,13,TCGGCGAACAGCATTGCATGTGGCAGCTGCGGAAGGTACTGTCTTCTCCTGTATAACTTGCTATCTGTTAATGGGAAAAAAAATTCTAGTTGGTTTAAC,TCGGCGAACAGCATTGCATGTGGCAGCTGCCCATCATACGAGTGGAAGGTACTGTCTTCTCCTGTATAACTTGCTATCTGTTAATGGGAAAAAAAATTC,10,30,14,27,27,34,27,47,27,31,31,34,44,47,62.96,0.334448161
hek293t,13995,1,4,ACCGCATAAATAGCAACAGTTCTGTTTTCAGGGGCACTCTAAAAATATGTTGTATTTGAAAACATTGATTTTTAACGTAATGTCTCCAAAAAAATTCTA,ACCGCATAAATAGCAACAGTTCTGTTTTGATGCAGGGGCACTCTAAAAATATGTTGTATTTGAAAACATTGATTTTTAACGTAATGTCTCCAAAAAAAT,10,30,14,27,27,32,27,36,27,29,29,32,33,36,9.11,0.746965453
hek293t,13995,1,4,CGCAGATAAATAGCAACAGTTCTGTTTTCAGGGGCACTCTAAAAATATGTTGTATTTGAAAACATTGATTTTTAACGTAAAAAAAAATTCTAGTTGGTT,CGCAGATAAATAGCAACAGTTCTGTTTTGATGCAGGGGCACTCTAAAAATATGTTGTATTTGAAAACATTGATTTTTAACGTAAAAAAAAATTCTAGTT,10,30,14,27,27,39,27,43,27,29,29,39,33,43,9.11,34.47476134
hek293t,13998,1,13,CATATAACTTAAGAAACAGAACCTTTTCTTGGCCTGATAACTAGTAACTTCAGTATGTCTGGCCTGGCTTTCTAAAAAAATTCTAGTTGGTTTAACGCG,CATATAACTTAAGAAACAGAACCTTTTCTTTGCCCTTCCAAGTGGCCTGATAACTAGTAACTTCAGTATGTCTGGCCTGGCTTTCTAAAAAAATTCTAG,10,30,14,27,27,37,27,50,27,30,30,37,43,50,16.04,9.155922862
hek293t,13998,1,13,GCGGCAACTTAAGAAACAGAACCTTTTCTTGGCCTGATAACTAGTAACTTCAGTATGTCTGGCCTGGCTTAAAAAAATTCTAGTTGGTTTAACGCGTAA,GCGGCAACTTAAGAAACAGAACCTTTTCTTTGCCCTTCCAAGTGGCCTGATAACTAGTAACTTCAGTATGTCTGGCCTGGCTTAAAAAAATTCTAGTTG,10,30,14,27,27,40,27,53,27,30,30,40,43,53,16.04,5.488811681
hek293t,17505,1,7,TTACGTACCCCAGGGAAGGTGGCAGGAGGAGGAAAACAGATGTGTCAAGCACCCGAGAAACTTCTAAAAAAATTCTAGTTGGTTTAACGCGTAACTAGA,TTACGTACCCCAGGGAAGGTGGCAGGAGGAGGAAACCTGACTACAGATGTGTCAAGCACCCGAGAAACTTCTAAAAAAATTCTAGTTGGTTTAACGCGT,10,30,14,27,27,51,27,58,27,36,36,51,43,58,48.19,1.965821087
hek293t,17505,1,7,TGAAGTACCCCAGGGAAGGTGGCAGGAGGAGGAAAACAGATGTGTCAAGCACCCGAGAAACTTCTCTCATCTGGGTTAAAAAAATTCTAGTTGGTTTAA,TGAAGTACCCCAGGGAAGGTGGCAGGAGGAGGAAACCTGACTACAGATGTGTCAAGCACCCGAGAAACTTCTCTCATCTGGGTTAAAAAAATTCTAGTT,10,30,14,27,27,39,27,46,27,36,36,39,43,46,48.19,0.0
hek293t,14002,1,9,TCTTCTGGACTTTATTTCCTTATAAACATTGGGAGTGTACAGAAGGACTGACTGACCCAAGGCCTTGCAGGATCAAGCTTTAAAAAAATTCTAGTTGGT,TCTTCTGGACTTTATTTCCTTATAAACATTCGGCCTTATGGGAGTGTACAGAAGGACTGACTGACCCAAGGCCTTGCAGGATCAAGCTTTAAAAAAATT,10,30,14,27,27,33,27,42,27,30,30,33,39,42,8.86,0.0
hek293t,14002,1,9,CTTGATGGACTTTATTTCCTTATAAACATTGGGAGTGTACAGAAGGACTGACTGACCCAAGGCCTTGCAGGATCAAAAAAATTCTAGTTGGTTTAACGC,CTTGATGGACTTTATTTCCTTATAAACATTCGGCCTTATGGGAGTGTACAGAAGGACTGACTGACCCAAGGCCTTGCAGGATCAAAAAAATTCTAGTTG,10,30,14,27,27,40,27,49,27,30,30,40,39,49,8.86,0.090009001
hek293t,14004,1,7,AGTCGAGCTGAAAAATGCAGTGCAGGGGAAGGGGAAGTATTACAGTGTAAATTAACTCAAGACTAGTTAAGGAGATATAAAAAAATTCTAGTTGGTTTA,AGTCGAGCTGAAAAATGCAGTGCAGGGGAAGGGGGCGAACCAAGTATTACAGTGTAAATTAACTCAAGACTAGTTAAGGAGATATAAAAAAATTCTAGT,10,30,14,27,27,38,27,45,27,35,35,38,42,45,38.35,0.0
hek293t,14004,1,7,TGTGAAGCTGAAAAATGCAGTGCAGGGGAAGGGGAAGTATTACAGTGTAAATTAACTCAAGACTAGAAAAAAATTCTAGTTGGTTTAACGCGTAACTAG,TGTGAAGCTGAAAAATGCAGTGCAGGGGAAGGGGGCGAACCAAGTATTACAGTGTAAATTAACTCAAGACTAGAAAAAAATTCTAGTTGGTTTAACGCG,10,30,14,27,27,50,27,57,27,35,35,50,42,57,38.35,1.879391886
hek293t,14006,1,4,GATGGTTAAGCATACACCACTGTAACTATAGGTATCAATGCACAGCCATAGTAGACTTCATTGAGATTTTGAAAAAAATTCTAGTTGGTTTAACGCGTA,GATGGTTAAGCATACACCACTGTAACTATAGGTATCATGACATGCACAGCCATAGTAGACTTCATTGAGATTTTGAAAAAAATTCTAGTTGGTTTAACG,10,30,14,27,27,48,27,52,27,38,38,48,42,52,44.04,78.45025795
hek293t,14006,1,4,GGTTATTAAGCATACACCACTGTAACTATAGGTATCAATGCACAGCCATAGTAGACTTCATTGAGATTTTGATCTGCCAAAAAAATTCTAGTTGGTTTA,GGTTATTAAGCATACACCACTGTAACTATAGGTATCATGACATGCACAGCCATAGTAGACTTCATTGAGATTTTGATCTGCCAAAAAAATTCTAGTTGG,10,30,14,27,27,41,27,45,27,38,38,41,42,45,44.04,0.896860987
hek293t,14008,1,1,GCGTTGCAAAGGCTTTACGCCCCTTGCTGTGGACGAAGCAGGCTTTGCCCCCTACGGCCAGAGAGAGCAAGCAAAAAAATTCTAGTTGGTTTAACGCGT,GCGTTGCAAAGGCTTTACGCCCCTTGCTGTGGACGAAGCGAGGCTTTGCCCCCTACGGCCAGAGAGAGCAAGCAAAAAAATTCTAGTTGGTTTAACGCG,10,30,14,27,27,50,27,51,27,40,40,50,41,51,39.88,67.91640216
hek293t,14008,1,1,TAGCTGCAAAGGCTTTACGCCCCTTGCTGTGGACGAAGCAGGCTTTGCCCCCTACGGCCAGAGAGAGCAAGCCAGCCTGAAAAAAATTCTAGTTGGTTT,TAGCTGCAAAGGCTTTACGCCCCTTGCTGTGGACGAAGCGAGGCTTTGCCCCCTACGGCCAGAGAGAGCAAGCCAGCCTGAAAAAAATTCTAGTTGGTT,10,30,14,27,27,43,27,44,27,40,40,43,41,44,39.88,0.833788259
hek293t,14010,1,8,AACGCGCAAAAACACTGTTGCCAAGGTTCAGGTTAACAGGTCTATCTCTGTCGATATTAATCTAGATACTTACAGAATATAAAAAAATTCTAGTTGGTT,AACGCGCAAAAACACTGTTGCCAAGGTTCAGAACCACTAGTTAACAGGTCTATCTCTGTCGATATTAATCTAGATACTTACAGAATATAAAAAAATTCT,10,30,14,27,27,35,27,43,27,32,32,35,40,43,35.73,2.113853769
hek293t,14010,1,8,TCCCCGCAAAAACACTGTTGCCAAGGTTCAGGTTAACAGGTCTATCTCTGTCGATATTAATCTAGATACTTACAAAAAAATTCTAGTTGGTTTAACGCG,TCCCCGCAAAAACACTGTTGCCAAGGTTCAGAACCACTAGTTAACAGGTCTATCTCTGTCGATATTAATCTAGATACTTACAAAAAAATTCTAGTTGGT,10,30,14,27,27,42,27,50,27,32,32,42,40,50,35.73,44.36594732
hek293t,14012,1,7,GAGCCGTTGACAGTCAAGAGGGCAAAGAAAGGGGAAACTAAAAACATTCTTGCTCTCCGTGGGCCAGTGGTGTAAAAAAATTCTAGTTGGTTTAACGCG,GAGCCGTTGACAGTCAAGAGGGCAAAGAAAGGGGAAACTGTTTGAAAAAAACATTCTTGCTCTCCGTGGGCCAGTGGTGTAAAAAAATTCTAGTTGGTT,10,30,14,27,27,43,27,50,27,40,40,43,47,50,54.49,0.520833333
hek293t,14012,1,7,AGTCAGTTGACAGTCAAGAGGGCAAAGAAAGGGGAAACTAAAAACATTCTTGCTCTCCGTGGGCCAAAAAAAATTCTAGTTGGTTTAACGCGTAACTAG,AGTCAGTTGACAGTCAAGAGGGCAAAGAAAGGGGAAACTGTTTGAAAAAAACATTCTTGCTCTCCGTGGGCCAAAAAAAATTCTAGTTGGTTTAACGCG,10,30,14,27,27,50,27,57,27,40,40,50,47,57,54.49,0.12300123
hek293t,3243,1,15,ATAGGTTGCTGCTTCATCTGCAGCAGGGATGGGGGTGGCACTTTGGCTTAGCTTGGCCTGGCCCTGACTTAAAAAAATTCTAGTTGGTTTAACGCGTAA,ATAGGTTGCTGCTTCATCTGCAGCAGGGATGGGGCTATTGGTACACCGTGTGGCACTTTGGCTTAGCTTGGCCTGGCCCTGACTTAAAAAAATTCTAGT,10,30,14,27,27,38,27,53,27,35,35,38,50,53,25.65,0.0
hek293t,3243,1,15,GTCACTTGCTGCTTCATCTGCAGCAGGGATGGGGGTGGCACTTTGGCTTAGCTTGGCCTGGCCCTGAAAAAAATTCTAGTTGGTTTAACGCGTAACTAG,GTCACTTGCTGCTTCATCTGCAGCAGGGATGGGGCTATTGGTACACCGTGTGGCACTTTGGCTTAGCTTGGCCTGGCCCTGAAAAAAATTCTAGTTGGT,10,30,14,27,27,42,27,57,27,35,35,42,50,57,25.65,0.068728522
hek293t,14018,1,10,AAACCCTTCTCACCTTTGCAGCAGGCGCACGGCTGGCAGGCCATGAGCCCTCTTGGGCCCACCTGTAAATGTGGACAAAAAAATTCTAGTTGGTTTAAC,AAACCCTTCTCACCTTTGCAGCAGGCCCGCGACAGTGCACGGCTGGCAGGCCATGAGCCCTCTTGGGCCCACCTGTAAATGTGGACAAAAAAATTCTAG,10,30,14,27,27,37,27,47,27,27,27,37,37,47,55.52,37.23428603
hek293t,14020,1,3,CCGTCATATTTTGCTTCACTTTCTTATTTTGGTTCATTAACATCATGCATTTTCTCTCAGGTAGGAATGTCAATAAAAAAATTCTAGTTGGTTTAACGC,CCGTCATATTTTGCTTCACTTTCTTATTTTGGTTCGGAATTAACATCATGCATTTTCTCTCAGGTAGGAATGTCAATAAAAAAATTCTAGTTGGTTTAA,10,30,14,27,27,46,27,49,27,36,36,46,39,49,-1.62,7.242771818
hek293t,14020,1,3,CCATTATATTTTGCTTCACTTTCTTATTTTGGTTCATTAACATCATGCATTTTCTCTCAGGTAGGAATGAAAAAAATTCTAGTTGGTTTAACGCGTAAC,CCATTATATTTTGCTTCACTTTCTTATTTTGGTTCGGAATTAACATCATGCATTTTCTCTCAGGTAGGAATGAAAAAAATTCTAGTTGGTTTAACGCGT,10,30,14,27,27,51,27,54,27,36,36,51,39,54,-1.62,10.43205575
hek293t,14022,1,10,GGGATTGCTGTGGCAGAGATGCCTTCTCCTGGGCAGCCCTTCCTCGGGGGGTTTCTGCAGGGAGGGACGCTGTGAAAAAAATTCTAGTTGGTTTAACGC,GGGATTGCTGTGGCAGAGATGCCTTCTCCTGTGACCTACGCGGCAGCCCTTCCTCGGGGGGTTTCTGCAGGGAGGGACGCTGTGAAAAAAATTCTAGTT,10,30,14,27,27,39,27,49,27,32,32,39,42,49,50.68,26.44812254
hek293t,14022,1,10,AGTAATGCTGTGGCAGAGATGCCTTCTCCTGGGCAGCCCTTCCTCGGGGGGTTTCTGCAGGGAGGGACGCTGTGGCAAAAAAAAATTCTAGTTGGTTTA,AGTAATGCTGTGGCAGAGATGCCTTCTCCTGTGACCTACGCGGCAGCCCTTCCTCGGGGGGTTTCTGCAGGGAGGGACGCTGTGGCAAAAAAAAATTCT,10,30,14,27,27,35,27,45,27,32,32,35,42,45,50.68,2.178728507
hek293t,14024,1,10,ACATTGCAGGAGGAGAAAGAAACAACTGAAGGGATGAGAATCGAGATACTTTATCATCCCCTGTATTGTTGCAAAAAAATTCTAGTTGGTTTAACGCGT,ACATTGCAGGAGGAGAAAGAAACAACTGAAGGGATCGCATATAATGAGAATCGAGATACTTTATCATCCCCTGTATTGTTGCAAAAAAATTCTAGTTGG,10,30,14,27,27,41,27,51,27,34,34,41,44,51,54.87,0.0
hek293t,14024,1,10,TATACGCAGGAGGAGAAAGAAACAACTGAAGGGATGAGAATCGAGATACTTTATCATCCCCTGTATTGTAAAAAAATTCTAGTTGGTTTAACGCGTAAC,TATACGCAGGAGGAGAAAGAAACAACTGAAGGGATCGCATATAATGAGAATCGAGATACTTTATCATCCCCTGTATTGTAAAAAAATTCTAGTTGGTTT,10,30,14,27,27,44,27,54,27,34,34,44,44,54,54.87,0.647083905
hek293t,14026,1,11,TTACTAACCTATGAGACTTGGTCACTGACAGGCATGTTATCCACTGCTCTGTGGATACAGGAAAAAAAAAATTCTAGTTGGTTTAACGCGTAACTAGAT,TTACTAACCTATGAGACTTGGTCACTGACAGGAACAATTTTGTCATGTTATCCACTGCTCTGTGGATACAGGAAAAAAAAAATTCTAGTTGGTTTAACG,10,30,14,27,27,48,27,59,27,33,33,48,44,59,61.67,3.849619858
hek293t,14026,1,11,GAGCGAACCTATGAGACTTGGTCACTGACAGGCATGTTATCCACTGCTCTGTGGATACAGGAAATTCTGATCTTTAAAAAAAATTCTAGTTGGTTTAAC,GAGCGAACCTATGAGACTTGGTCACTGACAGGAACAATTTTGTCATGTTATCCACTGCTCTGTGGATACAGGAAATTCTGATCTTTAAAAAAAATTCTA,10,30,14,27,27,36,27,47,27,33,33,36,44,47,61.67,0.796457023
hek293t,14030,1,12,CATTGGTTTCCCTGGATGTAAATAAACAATGGACAATGGGACATTTATTTAATTATTTGTGTTCAAAAAAATTCTAGTTGGTTTAACGCGTAACTAGAT,CATTGGTTTCCCTGGATGTAAATAAACAATGGACAATCCGTTTGTGATTGGGACATTTATTTAATTATTTGTGTTCAAAAAAATTCTAGTTGGTTTAAC,10,30,14,27,27,47,27,59,27,37,37,47,49,59,58.61,0.0
hek293t,14031,1,8,AAAGCATTACTATATTGAGACTCATTCCAAGGCAAAAAGACCAGGAAAGACCAGAAAAGACGGCATGAGACAAAAAAAATTCTAGTTGGTTTAACGCGT,AAAGCATTACTATATTGAGACTCATTCCAAGGCAAAAAGTTATAACAACCAGGAAAGACCAGAAAAGACGGCATGAGACAAAAAAAATTCTAGTTGGTT,10,30,14,27,27,43,27,51,27,40,40,43,48,51,53.37,0.0
hek293t,14034,1,5,TTTAAGATTTTGTGAAGTTACTGTGACCATGGGAGATAGCATGTGCATGTTGGGTGGGGGAGTTACTGGAGTAGAGAATAAAAAAATTCTAGTTGGTTT,TTTAAGATTTTGTGAAGTTACTGTGACCATGCCAAAGGAGATAGCATGTGCATGTTGGGTGGGGGAGTTACTGGAGTAGAGAATAAAAAAATTCTAGTT,10,30,14,27,27,39,27,44,27,32,32,39,37,44,40.67,17.19391083
hek293t,14034,1,5,TGCAGGATTTTGTGAAGTTACTGTGACCATGGGAGATAGCATGTGCATGTTGGGTGGGGGAGTTACTGGAGAAAAAAATTCTAGTTGGTTTAACGCGTA,TGCAGGATTTTGTGAAGTTACTGTGACCATGCCAAAGGAGATAGCATGTGCATGTTGGGTGGGGGAGTTACTGGAGAAAAAAATTCTAGTTGGTTTAAC,10,30,14,27,27,47,27,52,27,32,32,47,37,52,40.67,27.49485654
hek293t,14036,1,7,TTTAAGGTGATTTGCAGTTATCAAGCTAACGGCATTCTTAAGTGGATCTAGCCTGTGTAGAGATGATCACTTAAGGCAGCAAAAAAAAAAAATTCTAGT,TTTAAGGTGATTTGCAGTTATCAAGCTATACCTGAACGGCATTCTTAAGTGGATCTAGCCTGTGTAGAGATGATCACTTAAGGCAGCAAAAAAAAAAAA,10,30,14,27,27,31,27,38,27,28,28,31,35,38,23.37,0.569147686
hek293t,14036,1,7,CTTTTGGTGATTTGCAGTTATCAAGCTAACGGCATTCTTAAGTGGATCTAGCCTGTGTAGAGATGATCACTTAAAAAAAATTCTAGTTGGTTTAACGCG,CTTTTGGTGATTTGCAGTTATCAAGCTATACCTGAACGGCATTCTTAAGTGGATCTAGCCTGTGTAGAGATGATCACTTAAAAAAAATTCTAGTTGGTT,10,30,14,27,27,43,27,50,27,28,28,43,35,50,23.37,39.48785913
hek293t,10566,1,2,CGGGATTAGCGCTGGCAAGTGGGAGTCATAGGATGGAGGAATAACACGGAGCAGTGGAGGCTCAGTGTCAGCTGTGCTGAAAAAAATTCTAGTTGGTTT,CGGGATTAGCGCTGGCAAGTGGGAGTAACATAGGATGGAGGAATAACACGGAGCAGTGGAGGCTCAGTGTCAGCTGTGCTGAAAAAAATTCTAGTTGGT,10,30,14,27,27,42,27,44,27,27,27,42,29,44,23.0,46.66701565
hek293t,10566,1,2,TAATATTAGCGCTGGCAAGTGGGAGTCATAGGATGGAGGAATAACACGGAGCAGTGGAGGCTCAGTGTCAGCTGTGCTGCAGGAAGCAAAAAAATTCTA,TAATATTAGCGCTGGCAAGTGGGAGTAACATAGGATGGAGGAATAACACGGAGCAGTGGAGGCTCAGTGTCAGCTGTGCTGCAGGAAGCAAAAAAATTC,10,30,14,27,27,34,27,36,27,27,27,34,29,36,23.0,14.13199572
hek293t,14040,1,1,AAAGCGTGGTTGCTTGGGTCCTTTCATTTTGGATGAGGCATATGCTGCTTGTAAGAGTCATTGTTTTATGCAGTCTGAAAAAAATTCTAGTTGGTTTAA,AAAGCGTGGTTGCTTGGGTCCTTTCATTTTGGATGAGAGCATATGCTGCTTGTAAGAGTCATTGTTTTATGCAGTCTGAAAAAAATTCTAGTTGGTTTA,10,30,14,27,27,45,27,46,27,38,38,45,39,46,4.33,71.33730714
hek293t,14042,1,5,TCGCATGTAGAACAGACTGATAGATTTTCAGGCTGGAACAAGCAGTGTGATGGTTCTGGCTAGTCCAGTGACTGTTGTGGTAAAAAAATTCTAGTTGGT,TCGCATGTAGAACAGACTGATAGATTTTCAGGCTACCATGGAACAAGCAGTGTGATGGTTCTGGCTAGTCCAGTGACTGTTGTGGTAAAAAAATTCTAG,10,30,14,27,27,37,27,42,27,34,34,37,39,42,10.14,0.311111111
hek293t,14042,1,5,GACACTGTAGAACAGACTGATAGATTTTCAGGCTGGAACAAGCAGTGTGATGGTTCTGGCTAGTCCAGTAAAAAAATTCTAGTTGGTTTAACGCGTAAC,GACACTGTAGAACAGACTGATAGATTTTCAGGCTACCATGGAACAAGCAGTGTGATGGTTCTGGCTAGTCCAGTAAAAAAATTCTAGTTGGTTTAACGC,10,30,14,27,27,49,27,54,27,34,34,49,39,54,10.14,70.17033487
hek293t,14044,1,15,GGGTGACGTGTTTCTTCAGGGCTGGTCTCAGGTGGTGCTCAGCGCCCTCAGCCGCGGTTTCCTGTGAAAAAAAATTCTAGTTGGTTTAACGCGTAACTA,GGGTGACGTGTTTCTTCAGGGCTGGTCTCAGGTATCGTCGGACAATAAGGTGCTCAGCGCCCTCAGCCGCGGTTTCCTGTGAAAAAAAATTCTAGTTGG,10,30,14,27,27,41,27,56,27,34,34,41,49,56,24.52,0.264132394
hek293t,14044,1,15,CTCTTACGTGTTTCTTCAGGGCTGGTCTCAGGTGGTGCTCAGCGCCCTCAGCCGCGGTTTCCTGAAAAAAATTCTAGTTGGTTTAACGCGTAACTAGAT,CTCTTACGTGTTTCTTCAGGGCTGGTCTCAGGTATCGTCGGACAATAAGGTGCTCAGCGCCCTCAGCCGCGGTTTCCTGAAAAAAATTCTAGTTGGTTT,10,30,14,27,27,44,27,59,27,34,34,44,49,59,24.52,2.310252817
hek293t,14049,1,11,CCGAATCCTGTGGTATTACTGTATTCCTGAGGGAATACAGGAAATAAAGCAGTTAGCGTTGGAGGATAAAAAAAAAATTCTAGTTGGTTTAACGCGTAA,CCGAATCCTGTGGTATTACTGTATTCCTGAGGGAAACCCTGGGCAATACAGGAAATAAAGCAGTTAGCGTTGGAGGATAAAAAAAAAATTCTAGTTGGT,10,30,14,27,27,42,27,53,27,35,35,42,46,53,56.85,0.21536355
hek293t,14049,1,11,AGAATTCCTGTGGTATTACTGTATTCCTGAGGGAATACAGGAAATAAAGCAGTTAGCGTTGGAGGATAAAAAAATTCTAGTTGGTTTAACGCGTAACTA,AGAATTCCTGTGGTATTACTGTATTCCTGAGGGAAACCCTGGGCAATACAGGAAATAAAGCAGTTAGCGTTGGAGGATAAAAAAATTCTAGTTGGTTTA,10,30,14,27,27,45,27,56,27,35,35,45,46,56,56.85,0.820683035
hek293t,5962,1,12,GTACGTAAAGGGGTCTTTCTCAGGGTGTGGGGGGTAGGAGTTGGGTTTTTCTTTTGTTTTCCGAAAAAAAATTCTAGTTGGTTTAACGCGTAACTAGAT,GTACGTAAAGGGGTCTTTCTCAGGGTGTGGGGGGTAACGAGCTCCAGAGGAGTTGGGTTTTTCTTTTGTTTTCCGAAAAAAAATTCTAGTTGGTTTAAC,10,30,14,27,27,47,27,59,27,37,37,47,49,59,41.04,25.53194148
hek293t,14053,1,14,CCTATTTCTCTGCTCTGGCCTCTCCTTCCTGGAATTGTTTCTCGCAGGGCTGGCGCTCAGGGCTGTAAAAAAATTCTAGTTGGTTTAACGCGTAACTAG,CCTATTTCTCTGCTCTGGCCTCTCCTTCCTGGAATTCGGTGCAATCGAATGTTTCTCGCAGGGCTGGCGCTCAGGGCTGTAAAAAAATTCTAGTTGGTT,10,30,14,27,27,43,27,57,27,36,36,43,50,57,20.55,1.132537344
hek293t,14054,1,9,GCTAGTTTCTTCTTTTCCTCCTTAATGTGTGGCCTCTTTAGACAGTAGGTATTTGCTTAAGTTAACATTGTCTGAAAAAAATTCTAGTTGGTTTAACGC,GCTAGTTTCTTCTTTTCCTCCTTAATGTGTGGAGGCGCGCCCCTCTTTAGACAGTAGGTATTTGCTTAAGTTAACATTGTCTGAAAAAAATTCTAGTTG,10,30,14,27,27,40,27,49,27,33,33,40,42,49,49.47,4.294404976
hek293t,14054,1,9,ACTATTTTCTTCTTTTCCTCCTTAATGTGTGGCCTCTTTAGACAGTAGGTATTTGCTTAAGTTAACAAAAAAATTCTAGTTGGTTTAACGCGTAACTAG,ACTATTTTCTTCTTTTCCTCCTTAATGTGTGGAGGCGCGCCCCTCTTTAGACAGTAGGTATTTGCTTAAGTTAACAAAAAAATTCTAGTTGGTTTAACG,10,30,14,27,27,48,27,57,27,33,33,48,42,57,49.47,20.74432633
hek293t,14056,1,4,ATACGCATCCTTTGAATTCCCAAATACTGAGGGGTCACTACTCTGGGGCAGAGATCACAGAAATTGTCAAATAGGATAAAAAAATTCTAGTTGGTTTAA,ATACGCATCCTTTGAATTCCCAAATACTGAGTATGGGGTCACTACTCTGGGGCAGAGATCACAGAAATTGTCAAATAGGATAAAAAAATTCTAGTTGGT,10,30,14,27,27,42,27,46,27,32,32,42,36,46,34.43,14.46572444
hek293t,14058,1,3,GCTGTGAAGATGAGCTTGTGCAGAGTATGTGGGTACTGTATGGGCCACATAACTGCTTCAAGCTGATAGGTCTTTTAAAAAAAATTCTAGTTGGTTTAA,GCTGTGAAGATGAGCTTGTGCAGAGTATGTGGGTAACTCTGTATGGGCCACATAACTGCTTCAAGCTGATAGGTCTTTTAAAAAAAATTCTAGTTGGTT,10,30,14,27,27,43,27,46,27,36,36,43,39,46,43.02,85.82861176
hek293t,14060,1,6,CCAACCCCTAGAGCCTACAACAAAAGTTCAGGCTTTGGTGCAGTGCTCCAGCTACAGAGACCTTTTTCTGATTTAGTTTGGATCAAAAAAATTCTAGTT,CCAACCCCTAGAGCCTACAACAAAAGTTCGGAATAAGGCTTTGGTGCAGTGCTCCAGCTACAGAGACCTTTTTCTGATTTAGTTTGGATCAAAAAAATT,10,30,14,27,27,33,27,39,27,30,30,33,36,39,51.37,0.0
hek293t,14062,1,15,ATAGCGATGCAGAAGCCCTCCTTCTAACTTGGTACATATCAATCATAATAATACAAGGCCCCCTCAAAAAAAAAATTCTAGTTGGTTTAACGCGTAACT,ATAGCGATGCAGAAGCCCTCCTTCTAACTTGGCAATCGACTATGGTGTACATATCAATCATAATAATACAAGGCCCCCTCAAAAAAAAAATTCTAGTTG,10,30,14,27,27,40,27,55,27,33,33,40,48,55,24.09,0.0
hek293t,14066,1,2,AGACCCTGGCAGGACACAGCAGCGGTAGCAGGTTCACTGCTTTCTAGCCAGATCATTTACAGAAACCCTAGCCAAAAAAATTCTAGTTGGTTTAACGCG,AGACCCTGGCAGGACACAGCAGCGGTAGCAGGTTCACATTGCTTTCTAGCCAGATCATTTACAGAAACCCTAGCCAAAAAAATTCTAGTTGGTTTAACG,10,30,14,27,27,48,27,50,27,38,38,48,40,50,50.6,81.620634
hek293t,14066,1,2,GTGGGCTGGCAGGACACAGCAGCGGTAGCAGGTTCACTGCTTTCTAGCCAGATCATTTACAGAAACCCTAGCCGTTAGAGAAAAAAATTCTAGTTGGTT,GTGGGCTGGCAGGACACAGCAGCGGTAGCAGGTTCACATTGCTTTCTAGCCAGATCATTTACAGAAACCCTAGCCGTTAGAGAAAAAAATTCTAGTTGG,10,30,14,27,27,41,27,43,27,38,38,41,40,43,50.6,0.909090909
hek293t,14068,1,4,AAGTAGCTGTTATGGTAACTGGCAACCATAGGTGAGACTTAGATATTTACCTAATAAAATATATGAACAGGTTTCACCTGGAAAAAAATTCTAGTTGGT,AAGTAGCTGTTATGGTAACTGGCAACCATAGGTGTTGTAGACTTAGATATTTACCTAATAAAATATATGAACAGGTTTCACCTGGAAAAAAATTCTAGT,10,30,14,27,27,38,27,42,27,35,35,38,39,42,57.26,0.125
hek293t,14068,1,4,ACCAGGCTGTTATGGTAACTGGCAACCATAGGTGAGACTTAGATATTTACCTAATAAAATATATGAACAGGTTTAAAAAAATTCTAGTTGGTTTAACGC,ACCAGGCTGTTATGGTAACTGGCAACCATAGGTGTTGTAGACTTAGATATTTACCTAATAAAATATATGAACAGGTTTAAAAAAATTCTAGTTGGTTTA,10,30,14,27,27,45,27,49,27,35,35,45,39,49,57.26,86.74563142
hek293t,14070,1,7,ATCGGACAATAGACTAGGTCATTCATCTCTGGATCTTAAATGGCTGAATTACTCAAAATGAATGCAACTTTTACACTAGCTGAGAAAAAAAATTCTAGT,ATCGGACAATAGACTAGGTCATTCATCTACCTATTCTGGATCTTAAATGGCTGAATTACTCAAAATGAATGCAACTTTTACACTAGCTGAGAAAAAAAA,10,30,14,27,27,31,27,38,27,28,28,31,35,38,36.65,0.300681041
hek293t,14070,1,7,TTCGAACAATAGACTAGGTCATTCATCTCTGGATCTTAAATGGCTGAATTACTCAAAATGAATGCAACTTTTAAAAAAAATTCTAGTTGGTTTAACGCG,TTCGAACAATAGACTAGGTCATTCATCTACCTATTCTGGATCTTAAATGGCTGAATTACTCAAAATGAATGCAACTTTTAAAAAAAATTCTAGTTGGTT,10,30,14,27,27,43,27,50,27,28,28,43,35,50,36.65,27.52043619
hek293t,14072,1,3,TGTCTCTCTTAGCTTATCCATTAAAGCTAAGGCATTCTTGTGGGCATTATAAAACATAAGCAGTACTGAACTTTAAAAAAAAATTCTAGTTGGTTTAAC,TGTCTCTCTTAGCTTATCCATTAAAGCTAAGGCATTCGTCTTGTGGGCATTATAAAACATAAGCAGTACTGAACTTTAAAAAAAAATTCTAGTTGGTTT,10,30,14,27,27,44,27,47,27,37,37,44,40,47,57.94,15.61955676
hek293t,14072,1,3,AGCTTCTCTTAGCTTATCCATTAAAGCTAAGGCATTCTTGTGGGCATTATAAAACATAAGCAGTACTGAAAAAAATTCTAGTTGGTTTAACGCGTAACT,AGCTTCTCTTAGCTTATCCATTAAAGCTAAGGCATTCGTCTTGTGGGCATTATAAAACATAAGCAGTACTGAAAAAAATTCTAGTTGGTTTAACGCGTA,10,30,14,27,27,52,27,55,27,37,37,52,40,55,57.94,11.84641899
hek293t,20560,1,5,TAGTGCAACTATTTATTAATTTGCCTAAATGGTTAAAATTTTCAGTTATATCAGCCTTCTTCCCAAGCTGTTTTTCTAAAAAAATTCTAGTTGGTTTAA,TAGTGCAACTATTTATTAATTTGCCTAAATGGTCTCACTAAAATTTTCAGTTATATCAGCCTTCTTCCCAAGCTGTTTTTCTAAAAAAATTCTAGTTGG,10,30,14,27,27,41,27,46,27,34,34,41,39,46,-0.21,0.0
hek293t,14076,1,6,TACGCTTCAGGAGAGTGACATGTTGTATAAGGTTTAATGCAAATTTATCTGCATGGCTATGGCTGGAGAATACCTGAGAGAAAAAAATTCTAGTTGGTT,TACGCTTCAGGAGAGTGACATGTTGTATAGATTGTAGGTTTAATGCAAATTTATCTGCATGGCTATGGCTGGAGAATACCTGAGAGAAAAAAATTCTAG,10,30,14,27,27,37,27,43,27,30,30,37,36,43,39.7,5.987059268
hek293t,14078,1,3,TGATCAATTAATATTAGTGATAAAATAAGTGGTATTTTCCTATAAATACATTCAATAAGTATCACAGTAAGGCAGGAAAAAAATTCTAGTTGGTTTAAC,TGATCAATTAATATTAGTGATAAAATAACAAGTGGTATTTTCCTATAAATACATTCAATAAGTATCACAGTAAGGCAGGAAAAAAATTCTAGTTGGTTT,10,30,14,27,27,44,27,47,27,29,29,44,32,47,33.41,0.18018018
hek293t,14080,1,11,AGGGGCACATGACACACCAGAAATTTCAAAGGCTAAGAAAACCTGAATTTTGCGAGCATGGCAGGCAAAAAAATTCTAGTTGGTTTAACGCGTAACTAG,AGGGGCACATGACACACCAGAAATTTCAAAGGCTAAGAAATAGCTCAGGAAACCTGAATTTTGCGAGCATGGCAGGCAAAAAAATTCTAGTTGGTTTAA,10,30,14,27,27,46,27,57,27,39,39,46,50,57,45.67,0.0
hek293t,14081,1,3,ACAGTCAATGAAAATGAAAAGGGTAAAATTGGCAAAGCATACTATTCTTTTCTGATTACTTTGAAGCGTATAAGGACAAAAAAAATTCTAGTTGGTTTA,ACAGTCAATGAAAATGAAAAGGGTAAAATTGGCACAGAAGCATACTATTCTTTTCTGATTACTTTGAAGCGTATAAGGACAAAAAAAATTCTAGTTGGT,10,30,14,27,27,42,27,45,27,35,35,42,38,45,12.0,4.422296015
hek293t,14081,1,3,CCAGCCAATGAAAATGAAAAGGGTAAAATTGGCAAAGCATACTATTCTTTTCTGATTACTTTGAAGCGTATAAGGAAAAAAATTCTAGTTGGTTTAACG,CCAGCCAATGAAAATGAAAAGGGTAAAATTGGCACAGAAGCATACTATTCTTTTCTGATTACTTTGAAGCGTATAAGGAAAAAAATTCTAGTTGGTTTA,10,30,14,27,27,45,27,48,27,35,35,45,38,48,12.0,6.843184664
hek293t,14083,1,7,ATATCAGGCATAGCTAAATCCACACAGGCAGGGTGCTGTACCATTTTCAGCATGCTGGAAAATACCAGTTAATCAAGTCTGCATAAAAAAATTCTAGTT,ATATCAGGCATAGCTAAATCCACACAGGGCAGTTCCAGGGTGCTGTACCATTTTCAGCATGCTGGAAAATACCAGTTAATCAAGTCTGCATAAAAAAAT,10,30,14,27,27,32,27,39,27,29,29,32,36,39,60.77,0.059898173
hek293t,14083,1,7,ATTGGAGGCATAGCTAAATCCACACAGGCAGGGTGCTGTACCATTTTCAGCATGCTGGAAAATACCAGTTAATCAAGAAAAAAATTCTAGTTGGTTTAA,ATTGGAGGCATAGCTAAATCCACACAGGGCAGTTCCAGGGTGCTGTACCATTTTCAGCATGCTGGAAAATACCAGTTAATCAAGAAAAAAATTCTAGTT,10,30,14,27,27,39,27,46,27,29,29,39,36,46,60.77,10.80984656
hek293t,14085,1,12,GTTGCACAATACATTGTCCATGTAGGGTACGGTGTAGATAACCTCCTTCTGTCTATTTTCTAATTCATTACATAAGAAAGTAAAAAAATTCTAGTTGGT,GTTGCACAATACATTGTCCATGTAGGCGACTTTCCCTCGTACGGTGTAGATAACCTCCTTCTGTCTATTTTCTAATTCATTACATAAGAAAGTAAAAAA,10,30,14,27,27,30,27,42,27,27,27,30,39,42,59.93,0.0
hek293t,14087,1,1,CGTACCATGGTAGATTTCTGTTGATTCACAGGCTATGTGTTTTGCTTGTTTGTTTTATTTTAAATAGCTTAATTTTGTAATAAAAAAAAATTCTAGTTG,CGTACCATGGTAGATTTCTGTTGATTCACCAGGCTATGTGTTTTGCTTGTTTGTTTTATTTTAAATAGCTTAATTTTGTAATAAAAAAAAATTCTAGTT,10,30,14,27,27,39,27,40,27,29,29,39,30,40,25.12,61.02854858
hek293t,14087,1,1,GCAACCATGGTAGATTTCTGTTGATTCACAGGCTATGTGTTTTGCTTGTTTGTTTTATTTTAAATAGCTTAATTTTGTAATAAGAACTCAAAAAAAATT,GCAACCATGGTAGATTTCTGTTGATTCACCAGGCTATGTGTTTTGCTTGTTTGTTTTATTTTAAATAGCTTAATTTTGTAATAAGAACTCAAAAAAAAT,10,30,14,27,27,32,27,33,27,29,29,32,30,33,25.12,37.86044922
hek293t,1628,1,12,CCCGATAGTACAGGAGAGAAGGCAGCGGCAGGAAGGCACACCTTGGGAGAGGAACCACAAAAACTGGAAAAAAATTCTAGTTGGTTTAACGCGTAACTA,CCCGATAGTACAGGAGAGAAGGCAGCGGCAGGAAGGTGTTTCCGGATTCACACCTTGGGAGAGGAACCACAAAAACTGGAAAAAAATTCTAGTTGGTTT,10,30,14,27,27,44,27,56,27,37,37,44,49,56,58.84,0.862443883
hek293t,1628,1,12,CAAAGTAGTACAGGAGAGAAGGCAGCGGCAGGAAGGCACACCTTGGGAGAGGAACCACAAAAACAAAAAAATTCTAGTTGGTTTAACGCGTAACTAGAT,CAAAGTAGTACAGGAGAGAAGGCAGCGGCAGGAAGGTGTTTCCGGATTCACACCTTGGGAGAGGAACCACAAAAACAAAAAAATTCTAGTTGGTTTAAC,10,30,14,27,27,47,27,59,27,37,37,47,49,59,58.84,3.848914836
hek293t,14091,1,4,TCGGGAGATAAATATGTAAAAGGAAAAAGAGGAAGGCTAAGTATGTTTTGTACAGCAGAAAGATGCTGAGATAAAAAAATTCTAGTTGGTTTAACGCGT,TCGGGAGATAAATATGTAAAAGGAAAAAGAGTGAAGAAGGCTAAGTATGTTTTGTACAGCAGAAAGATGCTGAGATAAAAAAATTCTAGTTGGTTTAAC,10,30,14,27,27,47,27,51,27,32,32,47,36,51,62.07,0.0
hek293t,14091,1,4,TGCCTAGATAAATATGTAAAAGGAAAAAGAGGAAGGCTAAGTATGTTTTGTACAGCAGAAAGATGCTGAGATTTTGAAAATAGCAAAAAAATTCTAGTT,TGCCTAGATAAATATGTAAAAGGAAAAAGAGTGAAGAAGGCTAAGTATGTTTTGTACAGCAGAAAGATGCTGAGATTTTGAAAATAGCAAAAAAATTCT,10,30,14,27,27,35,27,39,27,32,32,35,36,39,62.07,0.0
hek293t,14093,1,2,GCCGCTGATCTACTGGTTAGATTAGCATCTGGTTTGCTTTGCAGTTACTTTTAAAATGCTTCTCCTGCTGCTTGGGCTGTGAAAAAAATTCTAGTTGGT,GCCGCTGATCTACTGGTTAGATTAGCATCTGGCTTTTGCTTTGCAGTTACTTTTAAAATGCTTCTCCTGCTGCTTGGGCTGTGAAAAAAATTCTAGTTG,10,30,14,27,27,40,27,42,27,33,33,40,35,42,49.63,81.34236984
hek293t,14095,1,3,GCAGTTATACACTTGGAAAGTAGTCCTTGTGGCTAACATCCAGGAGGAAACTATTTTAAGTGCAAACTAATGGAGAGTTTGCACCCATTAAAAAAATTC,GCAGTTATACACTTGGAAAGTAGTCCTTCCTGTGGCTAACATCCAGGAGGAAACTATTTTAAGTGCAAACTAATGGAGAGTTTGCACCCATTAAAAAAA,10,30,14,27,27,31,27,34,27,28,28,31,31,34,48.06,6.563636555
hek293t,14095,1,3,TATGTTATACACTTGGAAAGTAGTCCTTGTGGCTAACATCCAGGAGGAAACTATTTTAAGTGCAAACTAATGGAGAGTTTGCACCAAAAAAATTCTAGT,TATGTTATACACTTGGAAAGTAGTCCTTCCTGTGGCTAACATCCAGGAGGAAACTATTTTAAGTGCAAACTAATGGAGAGTTTGCACCAAAAAAATTCT,10,30,14,27,27,35,27,38,27,28,28,35,31,38,48.06,70.99490651
hek293t,14097,1,4,ATAGTTCCAGCCACCCCCAGACTCCCCTGAGGAGTTTGGAAAGCAAGGGGGCCCATTCTAAACCCCATGACTCAACAGGAGAAAAAAATTCTAGTTGGT,ATAGTTCCAGCCACCCCCAGACTCCCCTGACTTGGGAGTTTGGAAAGCAAGGGGGCCCATTCTAAACCCCATGACTCAACAGGAGAAAAAAATTCTAGT,10,30,14,27,27,38,27,42,27,31,31,38,35,42,65.7,69.16617411
hek293t,14103,1,13,GGGTGAGGTACTGCCAAACTACTATGTAATGGATACACTTACTTCCCCCCCGGGTTTCCCTGTCTTAAAAAAATTCTAGTTGGTTTAACGCGTAACTAG,GGGTGAGGTACTGCCAAACTACTATGTACACAGCGGCCACGATGGATACACTTACTTCCCCCCCGGGTTTCCCTGTCTTAAAAAAATTCTAGTTGGTTT,10,30,14,27,27,44,27,57,27,29,29,44,42,57,51.18,45.33266519
hek293t,23462,1,15,GATGAAGCCTATCTGGAGTCATGGCAGGCTGGTGGTCCCTGCATGGTCCCTGCTGATCGAAGCTGCTGCAAAAAAAATTCTAGTTGGTTTAACGCGTAA,GATGAAGCCTATCTGGAGTCATGGCAGCACGCCAGGAATTTCGCTGGTGGTCCCTGCATGGTCCCTGCTGATCGAAGCTGCTGCAAAAAAAATTCTAGT,10,30,14,27,27,38,27,53,27,28,28,38,43,53,48.51,72.38310362
hek293t,15988,1,8,ATTATTTCTGTATGCTCCCCACTTCCATCTGGGGGAGGCAAGCAGAACAACAACAAAGTCATACCAGGAAAAAAATTCTAGTTGGTTTAACGCGTAACT,ATTATTTCTGTATGCTCCCCACTTCCATCTGGGGGAGGCGACGGAACAAGCAGAACAACAACAAAGTCATACCAGGAAAAAAATTCTAGTTGGTTTAAC,10,30,14,27,27,47,27,55,27,40,40,47,48,55,33.48,0.186560833
hek293t,14111,1,15,GGCCTTCTCGGACACTCAACCTGTTCTATAGGGCTTTAAAGCAGGTTCCTTGGCAGAATGGGTTAAAAAAAATTCTAGTTGGTTTAACGCGTAACTAGA,GGCCTTCTCGGACACTCAACCTGTTCTATAGGGCTTTAATAGTGAACCGCGCTTAGCAGGTTCCTTGGCAGAATGGGTTAAAAAAAATTCTAGTTGGTT,10,30,14,27,27,43,27,58,27,40,40,43,55,58,19.45,0.08841733
hek293t,14114,1,2,GCTTTCAAGGAGAAGAACAGAGTTTAAGTAGGAACTTAATAAGTCAATCTTGACAAAATACCCAGTAAATCAGATAATAAAAAAAATTCTAGTTGGTTT,GCTTTCAAGGAGAAGAACAGAGTTTAAGTAGGAAGACTTAATAAGTCAATCTTGACAAAATACCCAGTAAATCAGATAATAAAAAAAATTCTAGTTGGT,10,30,14,27,27,42,27,44,27,35,35,42,37,44,58.02,29.09992064
hek293t,14114,1,2,CGCAGCAAGGAGAAGAACAGAGTTTAAGTAGGAACTTAATAAGTCAATCTTGACAAAATACCCAGTAAATCAGATAAAAAAAATTCTAGTTGGTTTAAC,CGCAGCAAGGAGAAGAACAGAGTTTAAGTAGGAAGACTTAATAAGTCAATCTTGACAAAATACCCAGTAAATCAGATAAAAAAAATTCTAGTTGGTTTA,10,30,14,27,27,45,27,47,27,35,35,45,37,47,58.02,27.79448072
hek293t,14116,1,11,GCGTACCCTGTGAATATTACATAGAGCCTTGGAACCATGGAGTAATTTGACTGAAGTGTTCTTTATAATAAAACTAAAAAAAATTCTAGTTGGTTTAAC,GCGTACCCTGTGAATATTACATAGAGCCCACCGGCATGTTTGGAACCATGGAGTAATTTGACTGAAGTGTTCTTTATAATAAAACTAAAAAAAATTCTA,10,30,14,27,27,36,27,47,27,29,29,36,40,47,49.19,0.669344043
hek293t,14118,1,11,ATGCCTCCATGTTCCCACCAACTTACTTCAGGTCCAGCTTCTCCCACACTTCCTCTAACACCAGGAGGTCCAATTGGCAAAAAAATTCTAGTTGGTTTA,ATGCCTCCATGTTCCCACCAACTTACTTCAACGGCAAGTTGGGTCCAGCTTCTCCCACACTTCCTCTAACACCAGGAGGTCCAATTGGCAAAAAAATTC,10,30,14,27,27,34,27,45,27,31,31,34,42,45,26.24,0.0
hek293t,14118,1,11,CAGTCTCCATGTTCCCACCAACTTACTTCAGGTCCAGCTTCTCCCACACTTCCTCTAACACCAGGAGGTCCAATAAAAAAATTCTAGTTGGTTTAACGC,CAGTCTCCATGTTCCCACCAACTTACTTCAACGGCAAGTTGGGTCCAGCTTCTCCCACACTTCCTCTAACACCAGGAGGTCCAATAAAAAAATTCTAGT,10,30,14,27,27,38,27,49,27,31,31,38,42,49,26.24,3.680670867
hek293t,14120,1,11,ATTCTAGTCTGATTTTACCAAACTGGAATAGGCAGAACAGTGCTGGTAGTAACACTACAGTTTCTCTTTAAAAAAAATTCTAGTTGGTTTAACGCGTAA,ATTCTAGTCTGATTTTACCAAACTGGAATAGGCAGAACTCGAAAGTCGGAGTGCTGGTAGTAACACTACAGTTTCTCTTTAAAAAAAATTCTAGTTGGT,10,30,14,27,27,42,27,53,27,39,39,42,50,53,12.62,0.0
hek293t,14121,1,3,GGAATGGATGACAGTCTTAGACATGATACAGGTAGCAACAGCATGTCTTGAGTGATGAGTACAGAAATTAAAAAAAAAAATTCTAGTTGGTTTAACGCG,GGAATGGATGACAGTCTTAGACATGATACAGGTAGCTAAAACAGCATGTCTTGAGTGATGAGTACAGAAATTAAAAAAAAAAATTCTAGTTGGTTTAAC,10,30,14,27,27,47,27,50,27,37,37,47,40,50,48.93,4.554787677
hek293t,14121,1,3,GACTAGGATGACAGTCTTAGACATGATACAGGTAGCAACAGCATGTCTTGAGTGATGAGTACAGAAATTAAAATGAAAAAAAATTCTAGTTGGTTTAAC,GACTAGGATGACAGTCTTAGACATGATACAGGTAGCTAAAACAGCATGTCTTGAGTGATGAGTACAGAAATTAAAATGAAAAAAAATTCTAGTTGGTTT,10,30,14,27,27,44,27,47,27,37,37,44,40,47,48.93,7.144288131
hek293t,14123,1,12,GTCGCTCCAAAAGCAGTGCATGCATCCCCTGGATTAAAGACAACCACAGATGCAAAATAAGATAACCCAAAAAAATTCTAGTTGGTTTAACGCGTAACT,GTCGCTCCAAAAGCAGTGCATGCATCCAGCTGTATCAGGCCTGGATTAAAGACAACCACAGATGCAAAATAAGATAACCCAAAAAAATTCTAGTTGGTT,10,30,14,27,27,43,27,55,27,28,28,43,40,55,62.56,18.50822167
hek293t,14123,1,12,CCCTCTCCAAAAGCAGTGCATGCATCCCCTGGATTAAAGACAACCACAGATGCAAAATAAGATAACCCAGCACATCATGCAAAAAAATTCTAGTTGGTT,CCCTCTCCAAAAGCAGTGCATGCATCCAGCTGTATCAGGCCTGGATTAAAGACAACCACAGATGCAAAATAAGATAACCCAGCACATCATGCAAAAAAA,10,30,14,27,27,31,27,43,27,28,28,31,40,43,62.56,11.07952891
hek293t,14125,1,1,AGATGCAAGAGGATGCCTCAGTACTTCTGAGGTTTGGACAAACACGCATGTATGACTACACTTGTTTTCACTCTTTGATCTGAAAAAAATTCTAGTTGG,AGATGCAAGAGGATGCCTCAGTACTTCTGGAGGTTTGGACAAACACGCATGTATGACTACACTTGTTTTCACTCTTTGATCTGAAAAAAATTCTAGTTG,10,30,14,27,27,40,27,41,27,30,30,40,31,41,60.26,72.53607151
hek293t,14125,1,1,AGAAACAAGAGGATGCCTCAGTACTTCTGAGGTTTGGACAAACACGCATGTATGACTACACTTGTTTTCACTCTTTGATCTGGTGAAAAAAATTCTAGT,AGAAACAAGAGGATGCCTCAGTACTTCTGGAGGTTTGGACAAACACGCATGTATGACTACACTTGTTTTCACTCTTTGATCTGGTGAAAAAAATTCTAG,10,30,14,27,27,37,27,38,27,30,30,37,31,38,60.26,67.45460955
hek293t,14127,1,3,CATATTCTTAAAAAGAAGATTCGTCCACATGGAGGCTCGTTCCTGATTTCCTCAGCAGTTATTTATTACATCATTAAAAAAATTCTAGTTGGTTTAACG,CATATTCTTAAAAAGAAGATTCGTCCACAGTATGGAGGCTCGTTCCTGATTTCCTCAGCAGTTATTTATTACATCATTAAAAAAATTCTAGTTGGTTTA,10,30,14,27,27,45,27,48,27,30,30,45,33,48,27.77,67.9992171
hek293t,14127,1,3,ACATTTCTTAAAAAGAAGATTCGTCCACATGGAGGCTCGTTCCTGATTTCCTCAGCAGTTATTTATTACATCATTTGGGCTTTAAAAAAATTCTAGTTG,ACATTTCTTAAAAAGAAGATTCGTCCACAGTATGGAGGCTCGTTCCTGATTTCCTCAGCAGTTATTTATTACATCATTTGGGCTTTAAAAAAATTCTAG,10,30,14,27,27,37,27,40,27,30,30,37,33,40,27.77,61.46389334
hek293t,14129,1,4,AACACAGAATGGCCATACTCGATTCATCTCGGTGTCCAGGTCTTTTATTTCTTGTCTGCCTTTTTAAATCGATTTGCAAAAAAAATTCTAGTTGGTTTA,AACACAGAATGGCCATACTCGATTCATCTCGGTGTCCAAATAGGTCTTTTATTTCTTGTCTGCCTTTTTAAATCGATTTGCAAAAAAAATTCTAGTTGG,10,30,14,27,27,41,27,45,27,38,38,41,42,45,28.15,0.0
hek293t,14129,1,4,GCGGCAGAATGGCCATACTCGATTCATCTCGGTGTCCAGGTCTTTTATTTCTTGTCTGCCTTTTTAAATCGAAAAAAATTCTAGTTGGTTTAACGCGTA,GCGGCAGAATGGCCATACTCGATTCATCTCGGTGTCCAAATAGGTCTTTTATTTCTTGTCTGCCTTTTTAAATCGAAAAAAATTCTAGTTGGTTTAACG,10,30,14,27,27,48,27,52,27,38,38,48,42,52,28.15,73.44371172
hek293t,14131,1,15,GAGAATAATCATCACTCAAGGACATTTTGAGGTATTGTCATTTTCATCTAGGACTTTTATTCTGATAAACACTTTAAAAAAAAAATTCTAGTTGGTTTA,GAGAATAATCATCACTCAAGGACATTTCTGAGCTTTGCTGATTGAGGTATTGTCATTTTCATCTAGGACTTTTATTCTGATAAACACTTTAAAAAAAAA,10,30,14,27,27,30,27,45,27,27,27,30,42,45,16.95,0.0
hek293t,14131,1,15,TGCGATAATCATCACTCAAGGACATTTTGAGGTATTGTCATTTTCATCTAGGACTTTTATTCTGATAAACACTTAAAAAAATTCTAGTTGGTTTAACGC,TGCGATAATCATCACTCAAGGACATTTCTGAGCTTTGCTGATTGAGGTATTGTCATTTTCATCTAGGACTTTTATTCTGATAAACACTTAAAAAAATTC,10,30,14,27,27,34,27,49,27,27,27,34,42,49,16.95,0.0
hek293t,14133,1,7,TCTCTCCCTGTTTCTCACAGATGCAGTACTGGAGTACCTTTCCTCACTTTTTTGCATGGAGATGCAGGTAGGAAAAAAATTCTAGTTGGTTTAACGCGT,TCTCTCCCTGTTTCTCACAGATGCAGTACTGGAGTACCTTCCACCGATCCTCACTTTTTTGCATGGAGATGCAGGTAGGAAAAAAATTCTAGTTGGTTT,10,30,14,27,27,44,27,51,27,41,41,44,48,51,44.33,0.110011001
hek293t,14135,1,6,CCGGGGTGTCCCATCAAAGGGAGATTTGGAGGAACACAACAGTTAAGCAGTCATGGAACAAACATCCAGCTCTTTAAAAAAATTCTAGTTGGTTTAACG,CCGGGGTGTCCCATCAAAGGGAGATTTGGAGATCTGAGAACACAACAGTTAAGCAGTCATGGAACAAACATCCAGCTCTTTAAAAAAATTCTAGTTGGT,10,30,14,27,27,42,27,48,27,32,32,42,38,48,38.7,48.59150325
hek293t,14135,1,6,CAAGGGTGTCCCATCAAAGGGAGATTTGGAGGAACACAACAGTTAAGCAGTCATGGAACAAACATCCAGCAAAAAAATTCTAGTTGGTTTAACGCGTAA,CAAGGGTGTCCCATCAAAGGGAGATTTGGAGATCTGAGAACACAACAGTTAAGCAGTCATGGAACAAACATCCAGCAAAAAAATTCTAGTTGGTTTAAC,10,30,14,27,27,47,27,53,27,32,32,47,38,53,38.7,48.81511134
hek293t,14137,1,1,AACGAGATATCGAGTATTATTTCCTGCACTGGTGAAATCATCATAGAACCAATATGTTTTACTCTAACAGAAAAAAATTCTAGTTGGTTTAACGCGTAA,AACGAGATATCGAGTATTATTTCCTGCACTGGTGAAGATCATCATAGAACCAATATGTTTTACTCTAACAGAAAAAAATTCTAGTTGGTTTAACGCGTA,10,30,14,27,27,52,27,53,27,37,37,52,38,53,21.95,27.52821065
hek293t,14137,1,1,CGTAGGATATCGAGTATTATTTCCTGCACTGGTGAAATCATCATAGAACCAATATGTTTTACTCTAACAGCATCCAAAAAAATTCTAGTTGGTTTAACG,CGTAGGATATCGAGTATTATTTCCTGCACTGGTGAAGATCATCATAGAACCAATATGTTTTACTCTAACAGCATCCAAAAAAATTCTAGTTGGTTTAAC,10,30,14,27,27,47,27,48,27,37,37,47,38,48,21.95,28.59427483
hek293t,23294,1,14,TCCAGTCTTCATTCCCAGAGCCTTACTGTTGGCTCCTTTTGCAGCCCGTGAGATGCCGGCAGGCCTTGCAAAAAAAATTCTAGTTGGTTTAACGCGTAA,TCCAGTCTTCATTCCCAGAGCCTTACTGTTGGGAGTGGTGATAACGCTCCTTTTGCAGCCCGTGAGATGCCGGCAGGCCTTGCAAAAAAAATTCTAGTT,10,30,14,27,27,39,27,53,27,32,32,39,46,53,56.6,1.783069385
hek293t,23294,1,14,GCTCGTCTTCATTCCCAGAGCCTTACTGTTGGCTCCTTTTGCAGCCCGTGAGATGCCGGCAGGCCTTAAAAAAATTCTAGTTGGTTTAACGCGTAACTA,GCTCGTCTTCATTCCCAGAGCCTTACTGTTGGGAGTGGTGATAACGCTCCTTTTGCAGCCCGTGAGATGCCGGCAGGCCTTAAAAAAATTCTAGTTGGT,10,30,14,27,27,42,27,56,27,32,32,42,46,56,56.6,11.33357066
hek293t,14141,1,8,TAGTTCTGCTCAGAGACAGTCAGTTCATGAGGGAAGTGCTGGTGTCTTAAATTTGATTTGAGCCAGTGCTGTATTTCAAAAAAATTCTAGTTGGTTTAA,TAGTTCTGCTCAGAGACAGTCAGTTCATTGATGTTTGAGGGAAGTGCTGGTGTCTTAAATTTGATTTGAGCCAGTGCTGTATTTCAAAAAAATTCTAGT,10,30,14,27,27,38,27,46,27,28,28,38,36,46,45.6,58.90004103
hek293t,14141,1,8,GAAAACTGCTCAGAGACAGTCAGTTCATGAGGGAAGTGCTGGTGTCTTAAATTTGATTTGAGCCAGTGCTGTAAAAAAATTCTAGTTGGTTTAACGCGT,GAAAACTGCTCAGAGACAGTCAGTTCATTGATGTTTGAGGGAAGTGCTGGTGTCTTAAATTTGATTTGAGCCAGTGCTGTAAAAAAATTCTAGTTGGTT,10,30,14,27,27,43,27,51,27,28,28,43,36,51,45.6,6.948552745
hek293t,14145,1,9,AGCGCGCACTGAGACTATCTGCATCTCTCAGGGGGCCACTAGAAGGAAATTAGCAAAGAATGATGCAAGTTTGCTAGAAGGAAAAAAAATTCTAGTTGG,AGCGCGCACTGAGACTATCTGCATCTCTCACCGGAAACAGGGGGCCACTAGAAGGAAATTAGCAAAGAATGATGCAAGTTTGCTAGAAGGAAAAAAAAT,10,30,14,27,27,32,27,41,27,29,29,32,38,41,31.36,0.0
hek293t,14145,1,9,CCTATGCACTGAGACTATCTGCATCTCTCAGGGGGCCACTAGAAGGAAATTAGCAAAGAATGATGCAAGTAAAAAAATTCTAGTTGGTTTAACGCGTAA,CCTATGCACTGAGACTATCTGCATCTCTCACCGGAAACAGGGGGCCACTAGAAGGAAATTAGCAAAGAATGATGCAAGTAAAAAAATTCTAGTTGGTTT,10,30,14,27,27,44,27,53,27,29,29,44,38,53,31.36,18.20698608
hek293t,14147,1,7,ACAGATTTACATCTTAAGGAATGCTTATTTGGGAGTAAACAAGGTGCTTGGATTCAGACTAAATTGATGGTAGGAAAAAAATTCTAGTTGGTTTAACGC,ACAGATTTACATCTTAAGGAATGCTTATTTGGGAGTAAAGCCACCACAAGGTGCTTGGATTCAGACTAAATTGATGGTAGGAAAAAAATTCTAGTTGGT,10,30,14,27,27,42,27,49,27,39,39,42,46,49,-3.75,0.0
hek293t,14147,1,7,TGTCATTTACATCTTAAGGAATGCTTATTTGGGAGTAAACAAGGTGCTTGGATTCAGACTAAATTGATGGAAAAAAATTCTAGTTGGTTTAACGCGTAA,TGTCATTTACATCTTAAGGAATGCTTATTTGGGAGTAAAGCCACCACAAGGTGCTTGGATTCAGACTAAATTGATGGAAAAAAATTCTAGTTGGTTTAA,10,30,14,27,27,46,27,53,27,39,39,46,46,53,-3.75,10.56745052
hek293t,14149,1,12,TGAGCTCAAAGTAAATTGGGGTGTTAGGTTGGCCCCCCCGATTTTGATGCTATTTTTTAAACACAGGACACTAAAAAAATTCTAGTTGGTTTAACGCGT,TGAGCTCAAAGTAAATTGGGGTGTTAGGTTGGATGACTTGGACGCCCCCCCGATTTTGATGCTATTTTTTAAACACAGGACACTAAAAAAATTCTAGTT,10,30,14,27,27,39,27,51,27,32,32,39,44,51,34.28,0.140646976
hek293t,14153,1,14,AGACTCGGGATGAACTCTTCGCACTAGCTCGGCAGATCTCTCGAGAAGTTACATACAAGTATACTTAAAAAAAATTCTAGTTGGTTTAACGCGTAACTA,AGACTCGGGATGAACTCTTCGCACTAGCTCGGCATGCACTTCGATTGCGATCTCTCGAGAAGTTACATACAAGTATACTTAAAAAAAATTCTAGTTGGT,10,30,14,27,27,42,27,56,27,35,35,42,49,56,51.28,1.390691145
hek293t,14153,1,14,ACAAGCGGGATGAACTCTTCGCACTAGCTCGGCAGATCTCTCGAGAAGTTACATACAAGTATACTTACAGGAAAAAAATTCTAGTTGGTTTAACGCGTA,ACAAGCGGGATGAACTCTTCGCACTAGCTCGGCATGCACTTCGATTGCGATCTCTCGAGAAGTTACATACAAGTATACTTACAGGAAAAAAATTCTAGT,10,30,14,27,27,38,27,52,27,35,35,38,49,52,51.28,0.067613252
hek293t,14155,1,6,TCAGCAAACTGCTAGCTTCCCACCTCTTTTGGAGCAGACCGACTCCTCGCGTGCATCGCCCAGCGGTAAGCTAAAAAAAATTCTAGTTGGTTTAACGCG,TCAGCAAACTGCTAGCTTCCCACCTCTTACTCACTTGGAGCAGACCGACTCCTCGCGTGCATCGCCCAGCGGTAAGCTAAAAAAAATTCTAGTTGGTTT,10,30,14,27,27,44,27,50,27,29,29,44,35,50,2.21,59.05572475
hek293t,14157,1,8,ACAAGAACCCTTCCTGCTTCAACCACTTCAGGTGAGATTATTATTTAAACTCTTTAAACATCATAAAAAAATTCTAGTTGGTTTAACGCGTAACTAGAT,ACAAGAACCCTTCCTGCTTCAACCACTTCAGGTGAGATTATCGTAATTTTATTTAAACTCTTTAAACATCATAAAAAAATTCTAGTTGGTTTAACGCGT,10,30,14,27,27,51,27,59,27,41,41,51,49,59,14.34,1.201201201
hek293t,14157,1,8,ATAAAAACCCTTCCTGCTTCAACCACTTCAGGTGAGATTATTATTTAAACTCTTTAAACATCATCTGAAAAAAATTCTAGTTGGTTTAACGCGTAACTA,ATAAAAACCCTTCCTGCTTCAACCACTTCAGGTGAGATTATCGTAATTTTATTTAAACTCTTTAAACATCATCTGAAAAAAATTCTAGTTGGTTTAACG,10,30,14,27,27,48,27,56,27,41,41,48,49,56,14.34,0.0
hek293t,14159,1,2,AATGACATATTTAGTCTTGATGTAAGCATAGGCAGTTTTTACAGACTGCAGTTTGCCACTGATGATCAAAAAAAATTCTAGTTGGTTTAACGCGTAACT,AATGACATATTTAGTCTTGATGTAAGCATAGGCAGTTCATTTACAGACTGCAGTTTGCCACTGATGATCAAAAAAAATTCTAGTTGGTTTAACGCGTAA,10,30,14,27,27,53,27,55,27,38,38,53,40,55,50.24,75.3817461
hek293t,14159,1,2,TCATGCATATTTAGTCTTGATGTAAGCATAGGCAGTTTTTACAGACTGCAGTTTGCCACTGATGATCATTTCGCCCCATGAAAAAAATTCTAGTTGGTT,TCATGCATATTTAGTCTTGATGTAAGCATAGGCAGTTCATTTACAGACTGCAGTTTGCCACTGATGATCATTTCGCCCCATGAAAAAAATTCTAGTTGG,10,30,14,27,27,41,27,43,27,38,38,41,40,43,50.24,5.737979501
hek293t,4176,1,14,TGTTCAAAAGCCTGCCAGGAGACAAGACTTGGCAAGATATTAAGGAAACAGTATACACTAAGTTTAGAATAGAAAAAAATTCTAGTTGGTTTAACGCGT,TGTTCAAAAGCCTGCCAGGAGACAAGACTTGGCCCCTTGAAACATTAAAGATATTAAGGAAACAGTATACACTAAGTTTAGAATAGAAAAAAATTCTAG,10,30,14,27,27,37,27,51,27,34,34,37,48,51,40.77,0.037835793
hek293t,4176,1,14,ACCGGAAAAGCCTGCCAGGAGACAAGACTTGGCAAGATATTAAGGAAACAGTATACACTAAGTTTAGAAAAAAAATTCTAGTTGGTTTAACGCGTAACT,ACCGGAAAAGCCTGCCAGGAGACAAGACTTGGCCCCTTGAAACATTAAAGATATTAAGGAAACAGTATACACTAAGTTTAGAAAAAAAATTCTAGTTGG,10,30,14,27,27,41,27,55,27,34,34,41,48,55,40.77,0.026518165
hek293t,14165,1,13,AACAGACAGCAGGACTACAGCCAACGAAGAGGACTGGTTCCAGGGCTTACCATCACAGACGCACCCCAAAAAAATTCTAGTTGGTTTAACGCGTAACTA,AACAGACAGCAGGACTACAGCCAACGAAATGTTTTTCGTAAGAGGACTGGTTCCAGGGCTTACCATCACAGACGCACCCCAAAAAAATTCTAGTTGGTT,10,30,14,27,27,43,27,56,27,28,28,43,41,56,67.72,32.44036944
hek293t,14165,1,13,TTGATACAGCAGGACTACAGCCAACGAAGAGGACTGGTTCCAGGGCTTACCATCACAGACGCACCCCGAGTGAAAAAAATTCTAGTTGGTTTAACGCGT,TTGATACAGCAGGACTACAGCCAACGAAATGTTTTTCGTAAGAGGACTGGTTCCAGGGCTTACCATCACAGACGCACCCCGAGTGAAAAAAATTCTAGT,10,30,14,27,27,38,27,51,27,28,28,38,41,51,67.72,7.497544671
hek293t,18261,1,6,TTGTTAAAGGTTTCATTTGAAACCTAACGGGGCTGGCGCAGCAAAGAACAGGGAGGTTTGGGATAGCACTCGTTAAAAAAATTCTAGTTGGTTTAACGC,TTGTTAAAGGTTTCATTTGAAACCTAACGGGGGGACTACTGGCGCAGCAAAGAACAGGGAGGTTTGGGATAGCACTCGTTAAAAAAATTCTAGTTGGTT,10,30,14,27,27,43,27,49,27,33,33,43,39,49,44.54,4.836601307
hek293t,18261,1,6,CTATGAAAGGTTTCATTTGAAACCTAACGGGGCTGGCGCAGCAAAGAACAGGGAGGTTTGGGATAGCACAAAAAAATTCTAGTTGGTTTAACGCGTAAC,CTATGAAAGGTTTCATTTGAAACCTAACGGGGGGACTACTGGCGCAGCAAAGAACAGGGAGGTTTGGGATAGCACAAAAAAATTCTAGTTGGTTTAACG,10,30,14,27,27,48,27,54,27,33,33,48,39,54,44.54,4.295165642
hek293t,14171,1,14,TTAAATGGCCTTCTTAAAGTTACAAAGCCAGGTAGCTGGCAAAACTGGTTCAAGGGAAAGACCAAGTGAAAATTAAAAAAATTCTAGTTGGTTTAACGC,TTAAATGGCCTTCTTAAAGTTACAAAGCCAGGATTGCCTAGACTCGTAGCTGGCAAAACTGGTTCAAGGGAAAGACCAAGTGAAAATTAAAAAAATTCT,10,30,14,27,27,35,27,49,27,32,32,35,46,49,17.68,0.0
hek293t,14172,1,10,GTCCTCCAGAGGAGGGTGGCAGAGGGGTATGGATGTTGTTTTGTGAATGCCACCTCCGCTCAGTGGTAGCTGAGAAAAAAATTCTAGTTGGTTTAACGC,GTCCTCCAGAGGAGGGTGGCAGAGGGGTTACAGTGAATATGGATGTTGTTTTGTGAATGCCACCTCCGCTCAGTGGTAGCTGAGAAAAAAATTCTAGTT,10,30,14,27,27,39,27,49,27,29,29,39,39,49,34.28,3.532934744
hek293t,14174,1,13,CACGCCTCTTTTCTGCATCATGCTGGGGTAGGTAAGTGTTCCCAGCATACTGTGAGATGGTCACTTGACTAAAAAAATTCTAGTTGGTTTAACGCGTAA,CACGCCTCTTTTCTGCATCATGCTGGGGTACATATTTTTAACAGGTAAGTGTTCCCAGCATACTGTGAGATGGTCACTTGACTAAAAAAATTCTAGTTG,10,30,14,27,27,40,27,53,27,30,30,40,43,53,36.33,4.005966127
hek293t,14174,1,13,CACAGCTCTTTTCTGCATCATGCTGGGGTAGGTAAGTGTTCCCAGCATACTGTGAGATGGTCACTAAAAAAATTCTAGTTGGTTTAACGCGTAACTAGA,CACAGCTCTTTTCTGCATCATGCTGGGGTACATATTTTTAACAGGTAAGTGTTCCCAGCATACTGTGAGATGGTCACTAAAAAAATTCTAGTTGGTTTA,10,30,14,27,27,45,27,58,27,30,30,45,43,58,36.33,38.4419256
hek293t,14176,1,5,GCCGCTATTTCAGGAGTTAACTCTCACAGTGGAGTTAAGCTGCAATCAGGTGCCTATAATGCATAAAACATACAACATACACAAAAAAATTCTAGTTGG,GCCGCTATTTCAGGAGTTAACTCTCACAGTGGGTTTTAGTTAAGCTGCAATCAGGTGCCTATAATGCATAAAACATACAACATACACAAAAAAATTCTA,10,30,14,27,27,36,27,41,27,33,33,36,38,41,68.75,1.067152467
hek293t,14176,1,5,GCATCTATTTCAGGAGTTAACTCTCACAGTGGAGTTAAGCTGCAATCAGGTGCCTATAATGCATAAAACAAAAAAAATTCTAGTTGGTTTAACGCGTAA,GCATCTATTTCAGGAGTTAACTCTCACAGTGGGTTTTAGTTAAGCTGCAATCAGGTGCCTATAATGCATAAAACAAAAAAAATTCTAGTTGGTTTAACG,10,30,14,27,27,48,27,53,27,33,33,48,38,53,68.75,10.85059757
hek293t,14178,1,4,GTCAGAAAACAAAGACACAGAAAAAGTTAAGGATAAGACATGTATAGACCCAGATAGTAACATCGCTTACATTAAAAAAATTCTAGTTGGTTTAACGCG,GTCAGAAAACAAAGACACAGAAAAAGTTAAGGATAAGAAATGCATGTATAGACCCAGATAGTAACATCGCTTACATTAAAAAAATTCTAGTTGGTTTAA,10,30,14,27,27,46,27,50,27,39,39,46,43,50,21.76,0.0
hek293t,14178,1,4,GGTTGAAAACAAAGACACAGAAAAAGTTAAGGATAAGACATGTATAGACCCAGATAGTAACATCGCTTACATTCATTAAAAAAATTCTAGTTGGTTTAA,GGTTGAAAACAAAGACACAGAAAAAGTTAAGGATAAGAAATGCATGTATAGACCCAGATAGTAACATCGCTTACATTCATTAAAAAAATTCTAGTTGGT,10,30,14,27,27,42,27,46,27,39,39,42,43,46,21.76,0.058373644
hek293t,14181,1,9,GATCGGCAGGCAAAATGAAACAGCTGCAGAGGGAGAAATGAGAAATGTTCCTTTCAGTAAGGCATAAAAAAATTCTAGTTGGTTTAACGCGTAACTAGA,GATCGGCAGGCAAAATGAAACAGCTGCAGAGGGGGGGCTTCCAGAAATGAGAAATGTTCCTTTCAGTAAGGCATAAAAAAATTCTAGTTGGTTTAACGC,10,30,14,27,27,49,27,58,27,34,34,49,43,58,45.58,1.137720863
hek293t,14181,1,9,ATTCCGCAGGCAAAATGAAACAGCTGCAGAGGGAGAAATGAGAAATGTTCCTTTCAGTAAGGCATGCAGCAGAAAAAAAATTCTAGTTGGTTTAACGCG,ATTCCGCAGGCAAAATGAAACAGCTGCAGAGGGGGGGCTTCCAGAAATGAGAAATGTTCCTTTCAGTAAGGCATGCAGCAGAAAAAAAATTCTAGTTGG,10,30,14,27,27,41,27,50,27,34,34,41,43,50,45.58,0.136612022
hek293t,14183,1,3,TCACTTTTCCCCTCACAAGTGCACTTGAAAGGCTTATAGCAGAACTGTGTTATCTGACTCATGACCAGTTACCAAAGTCAAAGAAAAAAATTCTAGTTG,TCACTTTTCCCCTCACAAGTGCACTTGAAAGGCCGTTTATAGCAGAACTGTGTTATCTGACTCATGACCAGTTACCAAAGTCAAAGAAAAAAATTCTAG,10,30,14,27,27,37,27,40,27,34,34,37,37,40,22.75,24.29261354
hek293t,14183,1,3,GAAGATTTCCCCTCACAAGTGCACTTGAAAGGCTTATAGCAGAACTGTGTTATCTGACTCATGACCAGTTACCAAAGTCAAAAAAATTCTAGTTGGTTT,GAAGATTTCCCCTCACAAGTGCACTTGAAAGGCCGTTTATAGCAGAACTGTGTTATCTGACTCATGACCAGTTACCAAAGTCAAAAAAATTCTAGTTGG,10,30,14,27,27,41,27,44,27,34,34,41,37,44,22.75,74.25426777
hek293t,14187,1,15,GATGTGAAGGAATGGGGGCAAAGTGCAGCAGGAGAAGGCAAAGATAGTAAAAATACAACCTCTAAAAAAAATTCTAGTTGGTTTAACGCGTAACTAGAT,GATGTGAAGGAATGGGGGCAAAGTGCAGCAGGAGAAGGCAGCGGGTTTAACCCATAAGATAGTAAAAATACAACCTCTAAAAAAAATTCTAGTTGGTTT,10,30,14,27,27,44,27,59,27,41,41,44,56,59,41.75,0.165139105
hek293t,14188,1,9,AGTCGCATACCAGGATCATTTCCCTCAAAAGGGCCAACAAACTTGGAGAAGTACCTTCTATTATTCACTGAGAAAAAAATTCTAGTTGGTTTAACGCGT,AGTCGCATACCAGGATCATTTCCCTCAAAAGGGCATGCTTTTGCAACAAACTTGGAGAAGTACCTTCTATTATTCACTGAGAAAAAAATTCTAGTTGGT,10,30,14,27,27,42,27,51,27,35,35,42,44,51,15.87,0.281293952
hek293t,14188,1,9,ACAAACATACCAGGATCATTTCCCTCAAAAGGGCCAACAAACTTGGAGAAGTACCTTCTATTATTCACTGAGTGGTAAAAAAATTCTAGTTGGTTTAAC,ACAAACATACCAGGATCATTTCCCTCAAAAGGGCATGCTTTTGCAACAAACTTGGAGAAGTACCTTCTATTATTCACTGAGTGGTAAAAAAATTCTAGT,10,30,14,27,27,38,27,47,27,35,35,38,44,47,15.87,0.0
hek293t,14190,1,4,GCCACTGCTTCAAAATGTTAAAATAGATTTGGTTCCTTGCTACTGTTTTGGGGTATTTTCCAGGGATTTTTCTGTTTCGACATGTAAAAAAATTCTAGT,GCCACTGCTTCAAAATGTTAAAATAGATTTTATCGGTTCCTTGCTACTGTTTTGGGGTATTTTCCAGGGATTTTTCTGTTTCGACATGTAAAAAAATTC,10,30,14,27,27,34,27,38,27,31,31,34,35,38,0.39,0.0
hek293t,14190,1,4,GGAATTGCTTCAAAATGTTAAAATAGATTTGGTTCCTTGCTACTGTTTTGGGGTATTTTCCAGGGATTTTTCTGTTTCGACAAAAAAATTCTAGTTGGT,GGAATTGCTTCAAAATGTTAAAATAGATTTTATCGGTTCCTTGCTACTGTTTTGGGGTATTTTCCAGGGATTTTTCTGTTTCGACAAAAAAATTCTAGT,10,30,14,27,27,38,27,42,27,31,31,38,35,42,0.39,0.0
hek293t,14192,1,4,CGCTGAAATACTTGCTTATGCAGCTTTACCGGCATACCAGTAGCCCAGATTGCCTTTATCTCCTTCAGTGATCTCATTTAAACAAAAAAAATTCTAGTT,CGCTGAAATACTTGCTTATGCAGCTTTACCGGCAGGCATACCAGTAGCCCAGATTGCCTTTATCTCCTTCAGTGATCTCATTTAAACAAAAAAAATTCT,10,30,14,27,27,35,27,39,27,32,32,35,36,39,11.22,0.0
hek293t,14194,1,1,TATCGCCTGAGACACACACCAGGCCTATTTGGTTCTGCTGCCAAGGAAACACTGTGTTTGTTTTGCTGTTTTTCTCCAAAAAAATTCTAGTTGGTTTAA,TATCGCCTGAGACACACACCAGGCCTATTTGGTTCCTGCTGCCAAGGAAACACTGTGTTTGTTTTGCTGTTTTTCTCCAAAAAAATTCTAGTTGGTTTA,10,30,14,27,27,45,27,46,27,35,35,45,36,46,10.12,80.36445615
hek293t,14194,1,1,AGCCGCCTGAGACACACACCAGGCCTATTTGGTTCTGCTGCCAAGGAAACACTGTGTTTGTTTTGCTGTTTTTCTCCGTGAAAAAAATTCTAGTTGGTT,AGCCGCCTGAGACACACACCAGGCCTATTTGGTTCCTGCTGCCAAGGAAACACTGTGTTTGTTTTGCTGTTTTTCTCCGTGAAAAAAATTCTAGTTGGT,10,30,14,27,27,42,27,43,27,35,35,42,36,43,10.12,79.70340892
hek293t,14197,1,11,AGGATTGCCTGACATGAATCAGTGTGTGTTGGTTTATTACTGTGGTCCTGTCTATGGCTTTTCCAAAAAAATTCTAGTTGGTTTAACGCGTAACTAGAT,AGGATTGCCTGACATGAATCAGTGTGTGTTGGTTTATCGGACGATGCATACTGTGGTCCTGTCTATGGCTTTTCCAAAAAAATTCTAGTTGGTTTAACG,10,30,14,27,27,48,27,59,27,38,38,48,49,59,54.27,6.438915842
hek293t,14198,1,4,GCTGGGCACACTCACAGCCCCACTCAGCTAGGTGCTAAAATGGGACTGGTCCTGTGCTGAGTGAAAAAGGAAAAAAATTCTAGTTGGTTTAACGCGTAA,GCTGGGCACACTCACAGCCCCACTCAGCTAGGTGCCGGCTAAAATGGGACTGGTCCTGTGCTGAGTGAAAAAGGAAAAAAATTCTAGTTGGTTTAACGC,10,30,14,27,27,49,27,53,27,34,34,49,38,53,45.28,1.475186218
hek293t,14198,1,4,TTGTTGCACACTCACAGCCCCACTCAGCTAGGTGCTAAAATGGGACTGGTCCTGTGCTGAGTGAAAAAGGGCATCAAAAAAATTCTAGTTGGTTTAACG,TTGTTGCACACTCACAGCCCCACTCAGCTAGGTGCCGGCTAAAATGGGACTGGTCCTGTGCTGAGTGAAAAAGGGCATCAAAAAAATTCTAGTTGGTTT,10,30,14,27,27,44,27,48,27,34,34,44,38,48,45.28,48.02700305
hek293t,14201,1,14,TAACATAAAGGCAGTAAAATCTGCAATACAGGCATTCTTGCTCTGACTAATGCACTGAAGAAATAAAAAAATTCTAGTTGGTTTAACGCGTAACTAGAT,TAACATAAAGGCAGTAAAATCTGCAATACTTGAGTCAAACATCAGGCATTCTTGCTCTGACTAATGCACTGAAGAAATAAAAAAATTCTAGTTGGTTTA,10,30,14,27,27,45,27,59,27,30,30,45,44,59,22.82,9.111751435
hek293t,14201,1,14,CCAGGTAAAGGCAGTAAAATCTGCAATACAGGCATTCTTGCTCTGACTAATGCACTGAAGAAATGTTTCATTATTCAAAAAAATTCTAGTTGGTTTAAC,CCAGGTAAAGGCAGTAAAATCTGCAATACTTGAGTCAAACATCAGGCATTCTTGCTCTGACTAATGCACTGAAGAAATGTTTCATTATTCAAAAAAATT,10,30,14,27,27,33,27,47,27,30,30,33,44,47,22.82,0.0
hek293t,14203,1,8,CGCGAGAAAACAGCCTGTGATGCGCAAGCAGGACAGCAGTATCATCTGCAATCCCAAGAAACCCTTCAAGCCACTCCAAAAAAATTCTAGTTGGTTTAA,CGCGAGAAAACAGCCTGTGATGCGCAAGCAGGACTGACTTGGAGCAGTATCATCTGCAATCCCAAGAAACCCTTCAAGCCACTCCAAAAAAATTCTAGT,10,30,14,27,27,38,27,46,27,35,35,38,43,46,44.19,4.4457824
hek293t,14203,1,8,GTTTTGAAAACAGCCTGTGATGCGCAAGCAGGACAGCAGTATCATCTGCAATCCCAAGAAACCCTTCAAGCCAAAAAAAATTCTAGTTGGTTTAACGCG,GTTTTGAAAACAGCCTGTGATGCGCAAGCAGGACTGACTTGGAGCAGTATCATCTGCAATCCCAAGAAACCCTTCAAGCCAAAAAAAATTCTAGTTGGT,10,30,14,27,27,42,27,50,27,35,35,42,43,50,44.19,11.17958252
hek293t,14209,1,1,GTAGGGCTAGCTGGGGGAAGAAAGTGAGGAGGAGTTTTAGCGATAACATTTCTTCCGCAGGATGTCCCTAAAAGCTCGAGAAAAAAATTCTAGTTGGTT,GTAGGGCTAGCTGGGGGAAGAAAGTGAAGGAGGAGTTTTAGCGATAACATTTCTTCCGCAGGATGTCCCTAAAAGCTCGAGAAAAAAATTCTAGTTGGT,10,30,14,27,27,42,27,43,27,27,27,42,28,43,62.15,60.49216174
hek293t,14209,1,1,GCACTGCTAGCTGGGGGAAGAAAGTGAGGAGGAGTTTTAGCGATAACATTTCTTCCGCAGGATGTCCCTAAAAGCTCGAGGTCTGAAAAAAATTCTAGT,GCACTGCTAGCTGGGGGAAGAAAGTGAAGGAGGAGTTTTAGCGATAACATTTCTTCCGCAGGATGTCCCTAAAAGCTCGAGGTCTGAAAAAAATTCTAG,10,30,14,27,27,37,27,38,27,27,27,37,28,38,62.15,42.12379813
hek293t,14211,1,8,CACGGAATGCATTCAAGAAATCTCTTTCATGGCAAGCGAAAATATGCATAGTGAATGTACTACAGATTTGAAAAAAATTCTAGTTGGTTTAACGCGTAA,CACGGAATGCATTCAAGAAATCTCTTTCAGAACATCGTGGCAAGCGAAAATATGCATAGTGAATGTACTACAGATTTGAAAAAAATTCTAGTTGGTTTA,10,30,14,27,27,45,27,53,27,30,30,45,38,53,18.59,1.180445787
hek293t,14211,1,8,TTCCAAATGCATTCAAGAAATCTCTTTCATGGCAAGCGAAAATATGCATAGTGAATGTACTACAGATTTGTCTTCAGTAATTAAAAAAATTCTAGTTGG,TTCCAAATGCATTCAAGAAATCTCTTTCAGAACATCGTGGCAAGCGAAAATATGCATAGTGAATGTACTACAGATTTGTCTTCAGTAATTAAAAAAATT,10,30,14,27,27,33,27,41,27,30,30,33,38,41,18.59,0.257033104
hek293t,14213,1,14,CATTGATAGGTAGAACATTCACAGTGAGAAGGGTTTAAATAAGATAATATCTTGTATTAAGACCAAAAAAAATTCTAGTTGGTTTAACGCGTAACTAGA,CATTGATAGGTAGAACATTCACAGTGAGAAGGGTTTCCTTCAACCGATGAAAATAAGATAATATCTTGTATTAAGACCAAAAAAAATTCTAGTTGGTTT,10,30,14,27,27,44,27,58,27,37,37,44,51,58,52.93,0.021381227
hek293t,14214,1,1,AACTCGGGTAAGAAAATAAGCAGCTAACCTGGAAACTAAGCTAGAAATCTTGAGGTGGTTAATAGAATAAAAAAATTCTAGTTGGTTTAACGCGTAACT,AACTCGGGTAAGAAAATAAGCAGCTAACCTGGAAACTAAAGCTAGAAATCTTGAGGTGGTTAATAGAATAAAAAAATTCTAGTTGGTTTAACGCGTAAC,10,30,14,27,27,54,27,55,27,39,39,54,40,55,36.78,5.135279733
hek293t,14214,1,1,GGCGCGGGTAAGAAAATAAGCAGCTAACCTGGAAACTAAGCTAGAAATCTTGAGGTGGTTAATAGAATGGATTTATAAAAAAATTCTAGTTGGTTTAAC,GGCGCGGGTAAGAAAATAAGCAGCTAACCTGGAAACTAAAGCTAGAAATCTTGAGGTGGTTAATAGAATGGATTTATAAAAAAATTCTAGTTGGTTTAA,10,30,14,27,27,46,27,47,27,39,39,46,40,47,36.78,2.415872388
hek293t,14216,1,13,TCCAAATTACTGTATTCCTGAGGGAATACAGGAAATAAAGCAGTTAGCGTTGGAGGATAAAAGACAACTTAAAAAAATTCTAGTTGGTTTAACGCGTAA,TCCAAATTACTGTATTCCTGAGGGAATACAGGAAATTCGGTGGGCTGAGAAAGCAGTTAGCGTTGGAGGATAAAAGACAACTTAAAAAAATTCTAGTTG,10,30,14,27,27,40,27,53,27,37,37,40,50,53,25.97,0.0
hek293t,14217,1,3,GCCGGAACTCACGGACCACAGCCTGCAGTTGGGAAGGTGGGGGCTGATTTCCAGCAACCTTCTGATGTGCAGAAAAAAAAATTCTAGTTGGTTTAACGC,GCCGGAACTCACGGACCACAGCCTGCAGTTGGGAAGGTTGAGGGGGCTGATTTCCAGCAACCTTCTGATGTGCAGAAAAAAAAATTCTAGTTGGTTTAA,10,30,14,27,27,46,27,49,27,39,39,46,42,49,23.86,60.31632482
hek293t,14217,1,3,TGTCTAACTCACGGACCACAGCCTGCAGTTGGGAAGGTGGGGGCTGATTTCCAGCAACCTTCTGATAAAAAAATTCTAGTTGGTTTAACGCGTAACTAG,TGTCTAACTCACGGACCACAGCCTGCAGTTGGGAAGGTTGAGGGGGCTGATTTCCAGCAACCTTCTGATAAAAAAATTCTAGTTGGTTTAACGCGTAAC,10,30,14,27,27,54,27,57,27,39,39,54,42,57,23.86,56.75990383
hek293t,14219,1,2,GTTGCGAGATTACTTAGGAGCTATAAATTTGGCTGCCCTTGCAATATGTTCTCCCTTTTGACAGGAATTATTAGCTCAGTTTGTTGCCAGGAAAAAAAT,GTTGCGAGATTACTTAGGAGCTATAAGTATTTGGCTGCCCTTGCAATATGTTCTCCCTTTTGACAGGAATTATTAGCTCAGTTTGTTGCCAGGAAAAAA,10,30,14,27,27,30,27,32,27,27,27,30,29,32,14.66,1.3027532
hek293t,14219,1,2,GTAATGAGATTACTTAGGAGCTATAAATTTGGCTGCCCTTGCAATATGTTCTCCCTTTTGACAGGAATTATTAGCTCAGTTTGTAAAAAAATTCTAGTT,GTAATGAGATTACTTAGGAGCTATAAGTATTTGGCTGCCCTTGCAATATGTTCTCCCTTTTGACAGGAATTATTAGCTCAGTTTGTAAAAAAATTCTAG,10,30,14,27,27,37,27,39,27,27,27,37,29,39,14.66,37.73680609
hek293t,14221,1,5,AAGTCGCCTCAAACCCTGCTTTTTATTATTGGTAGAGGTGGTTTCAGTTTTGCAGAAACTTTGAGGCGACAAAAAAAAATTCTAGTTGGTTTAACGCGT,AAGTCGCCTCAAACCCTGCTTTTTATTATTCGGATGGTAGAGGTGGTTTCAGTTTTGCAGAAACTTTGAGGCGACAAAAAAAAATTCTAGTTGGTTTAA,10,30,14,27,27,46,27,51,27,31,31,46,36,51,-1.59,0.353101812
hek293t,14224,1,8,ACAAAAACACAGCACTGATGAATCCTGCAAGGAAATTCTCTTGAAATAATAGGATACAGGGGGACTCCCTAAAGAAAAAAATTCTAGTTGGTTTAACGC,ACAAAAACACAGCACTGATGAATCCTGCAAGGAAACTGTGAAATTCTCTTGAAATAATAGGATACAGGGGGACTCCCTAAAGAAAAAAATTCTAGTTGG,10,30,14,27,27,41,27,49,27,34,34,41,42,49,59.93,1.280520458
hek293t,14224,1,8,TAACAAACACAGCACTGATGAATCCTGCAAGGAAATTCTCTTGAAATAATAGGATACAGGGGGACTAAAAAAATTCTAGTTGGTTTAACGCGTAACTAG,TAACAAACACAGCACTGATGAATCCTGCAAGGAAACTGTGAAATTCTCTTGAAATAATAGGATACAGGGGGACTAAAAAAATTCTAGTTGGTTTAACGC,10,30,14,27,27,49,27,57,27,34,34,49,42,57,59.93,3.779267342
hek293t,14226,1,4,GAAGGGCTGTGTTATTTCAGTACAGCAGATGGGAGGGTCAGTACATCGCTTCGAGTGAAAAAGTGAGACTGTTTGGAAAAAAATTCTAGTTGGTTTAAC,GAAGGGCTGTGTTATTTCAGTACAGCAGATGGGAGGGTCACTTAGTACATCGCTTCGAGTGAAAAAGTGAGACTGTTTGGAAAAAAATTCTAGTTGGTT,10,30,14,27,27,43,27,47,27,40,40,43,44,47,22.38,0.0
hek293t,14226,1,4,ACAGGGCTGTGTTATTTCAGTACAGCAGATGGGAGGGTCAGTACATCGCTTCGAGTGAAAAAGTGAGACTGTAAAAAAATTCTAGTTGGTTTAACGCGT,ACAGGGCTGTGTTATTTCAGTACAGCAGATGGGAGGGTCACTTAGTACATCGCTTCGAGTGAAAAAGTGAGACTGTAAAAAAATTCTAGTTGGTTTAAC,10,30,14,27,27,47,27,51,27,40,40,47,44,51,22.38,63.53881404
hek293t,14228,1,14,CTTGGAAAGAAAAACCACCATCATTGTTGAGGTCACTGTGAAGGTCCTGAAAACATCGTTCATCTTAAAAAAAAAATTCTAGTTGGTTTAACGCGTAAC,CTTGGAAAGAAAAACCACCATCATTGTTGAGGTCACGGTTGAATGCCTGGTGTGAAGGTCCTGAAAACATCGTTCATCTTAAAAAAAAAATTCTAGTTG,10,30,14,27,27,40,27,54,27,37,37,40,51,54,43.23,0.0
hek293t,14229,1,5,TGAAGGTTTTAAGGGAAGCAGTCAATGTGAGGTGATCAGGCTTGCAATTTTAATGACATTATTTTGGATGAGATGCAAAAAAAATTCTAGTTGGTTTAA,TGAAGGTTTTAAGGGAAGCAGTCAATGTGAAACCGGGTGATCAGGCTTGCAATTTTAATGACATTATTTTGGATGAGATGCAAAAAAAATTCTAGTTGG,10,30,14,27,27,41,27,46,27,31,31,41,36,46,71.25,75.39253128
hek293t,14229,1,5,TGAGTGTTTTAAGGGAAGCAGTCAATGTGAGGTGATCAGGCTTGCAATTTTAATGACATTATTTTGGATGAGATGCACCAGTAAAAAAAAATTCTAGTT,TGAGTGTTTTAAGGGAAGCAGTCAATGTGAAACCGGGTGATCAGGCTTGCAATTTTAATGACATTATTTTGGATGAGATGCACCAGTAAAAAAAAATTC,10,30,14,27,27,34,27,39,27,31,31,34,36,39,71.25,1.392464365
hek293t,14231,1,9,GCTGGAGCACCTGCCATAAATCACAAAAACGGTTTTGTCAAAAGTAACTAGGGACCAGATGCATCTTTATAAAAAAAATTCTAGTTGGTTTAACGCGTA,GCTGGAGCACCTGCCATAAATCACAAAAACGGTTTTGTCTCTTGTAGAAAAAGTAACTAGGGACCAGATGCATCTTTATAAAAAAAATTCTAGTTGGTT,10,30,14,27,27,43,27,52,27,40,40,43,49,52,33.29,0.0
hek293t,14232,1,13,ATATAATACGCAATTCTTCTTCAGCTGGGAGGATTTTCCCTTTTACAGAATTACAAATTCCTGCAAATGAAAAAAATTCTAGTTGGTTTAACGCGTAAC,ATATAATACGCAATTCTTCTTCAGCTGGGAGGATTTTTCAGTCGCTCCTCCCCTTTTACAGAATTACAAATTCCTGCAAATGAAAAAAATTCTAGTTGG,10,30,14,27,27,41,27,54,27,38,38,41,51,54,45.4,0.061842919
hek293t,14232,1,13,TGTCAATACGCAATTCTTCTTCAGCTGGGAGGATTTTCCCTTTTACAGAATTACAAATTCCTGCAAAAAAAATTCTAGTTGGTTTAACGCGTAACTAGA,TGTCAATACGCAATTCTTCTTCAGCTGGGAGGATTTTTCAGTCGCTCCTCCCCTTTTACAGAATTACAAATTCCTGCAAAAAAAATTCTAGTTGGTTTA,10,30,14,27,27,45,27,58,27,38,38,45,51,58,45.4,0.279617488
hek293t,14236,1,9,CATGTGCCTCCCAAACCTCACACCCAGCTAGGAGCTGATTACTGCTGGCTTAGCTGTTTTAACAAACAGACACCAAAATACGTAAAAAAATTCTAGTTG,CATGTGCCTCCCAAACCTCACACCCAGGCAACCTAACTAGGAGCTGATTACTGCTGGCTTAGCTGTTTTAACAAACAGACACCAAAATACGTAAAAAAA,10,30,14,27,27,31,27,40,27,28,28,31,37,40,47.19,0.0
hek293t,14239,1,2,GTCATCCAATCTTCAGTTTTCCAGATTTCTGGGGAACATAGTTTGAGTAAAAATGATGCTTAGACGTCAAGACTGTGCCCCAAAAAAATTCTAGTTGGT,GTCATCCAATCTTCAGTTTTCCAGATTTCTGGGGAATCCATAGTTTGAGTAAAAATGATGCTTAGACGTCAAGACTGTGCCCCAAAAAAATTCTAGTTG,10,30,14,27,27,40,27,42,27,37,37,40,39,42,3.21,0.0
hek293t,14243,1,9,GTTTATGTGAGTAAGAATTATTGAACTGCTGGATTTAGTACAATGAAAAGAAAAACAGGTACAGAACAATCAAATCCAAAAAAATTCTAGTTGGTTTAA,GTTTATGTGAGTAAGAATTATTGAACTGCAAAACTTAATGGATTTAGTACAATGAAAAGAAAAACAGGTACAGAACAATCAAATCCAAAAAAATTCTAG,10,30,14,27,27,37,27,46,27,30,30,37,39,46,18.75,0.0
hek293t,14243,1,9,CCGAGTGTGAGTAAGAATTATTGAACTGCTGGATTTAGTACAATGAAAAGAAAAACAGGTACAGAACAATCAAAAAAAAAATTCTAGTTGGTTTAACGC,CCGAGTGTGAGTAAGAATTATTGAACTGCAAAACTTAATGGATTTAGTACAATGAAAAGAAAAACAGGTACAGAACAATCAAAAAAAAAATTCTAGTTG,10,30,14,27,27,40,27,49,27,30,30,40,39,49,18.75,0.389668985
hek293t,14245,1,7,TGCCGCAGTAACTGGTGTTTGCTGTGAAGAGGGTCTTCCCAGGTGACACCCAGGGAAGTAACCACAGGAGCAAAAAAATTCTAGTTGGTTTAACGCGTA,TGCCGCAGTAACTGGTGTTTGCTGTGAAGAGGGTCTTTACATACCCCAGGTGACACCCAGGGAAGTAACCACAGGAGCAAAAAAATTCTAGTTGGTTTA,10,30,14,27,27,45,27,52,27,38,38,45,45,52,36.49,34.78772796
hek293t,14246,1,1,CGAGCGTGAAGGTGTTGCATGTAAGCTAAAGGATTGCTGGCTCTCTTAAGCAGGGCTGTGGCTTACCCTGTGCAGTTGAATAAAAAAATTCTAGTTGGT,CGAGCGTGAAGGTGTTGCATGTAAGCTAAAGGAGTTGCTGGCTCTCTTAAGCAGGGCTGTGGCTTACCCTGTGCAGTTGAATAAAAAAATTCTAGTTGG,10,30,14,27,27,41,27,42,27,34,34,41,35,42,25.83,56.41725531
hek293t,14246,1,1,CTATGGTGAAGGTGTTGCATGTAAGCTAAAGGATTGCTGGCTCTCTTAAGCAGGGCTGTGGCTTACCCTGTGCAGTTGAATTCTCAAAAAAATTCTAGT,CTATGGTGAAGGTGTTGCATGTAAGCTAAAGGAGTTGCTGGCTCTCTTAAGCAGGGCTGTGGCTTACCCTGTGCAGTTGAATTCTCAAAAAAATTCTAG,10,30,14,27,27,37,27,38,27,34,34,37,35,38,25.83,2.818337047
hek293t,14248,1,1,CCCTGCAACCCCATAGGTCTTAAATGAGTTGGCGTTCCCCAAATTTTGCTTTTGTGAAAACTTTGTTGCCTTTGTGGCAGCTCAAAAAAATTCTAGTTG,CCCTGCAACCCCATAGGTCTTAAATGAGTTGGCGTATCCCCAAATTTTGCTTTTGTGAAAACTTTGTTGCCTTTGTGGCAGCTCAAAAAAATTCTAGTT,10,30,14,27,27,39,27,40,27,36,36,39,37,40,29.22,0.263504611
hek293t,14248,1,1,ACGTTCAACCCCATAGGTCTTAAATGAGTTGGCGTTCCCCAAATTTTGCTTTTGTGAAAACTTTGTTGCCTTTGTGAAAAAAATTCTAGTTGGTTTAAC,ACGTTCAACCCCATAGGTCTTAAATGAGTTGGCGTATCCCCAAATTTTGCTTTTGTGAAAACTTTGTTGCCTTTGTGAAAAAAATTCTAGTTGGTTTAA,10,30,14,27,27,46,27,47,27,36,36,46,37,47,29.22,45.24794872
hek293t,14250,1,10,TAGCTATCCTCGTTCTTCTGTGATTCTAAAGGATTCCTCTGTGCTGAAGAAATTCCCTTGAGCTGTTTCTGCTAAAAAAATTCTAGTTGGTTTAACGCG,TAGCTATCCTCGTTCTTCTGTGATTCTAAAGGTGTTCAATGAATTCCTCTGTGCTGAAGAAATTCCCTTGAGCTGTTTCTGCTAAAAAAATTCTAGTTG,10,30,14,27,27,40,27,50,27,33,33,40,43,50,17.47,0.305250305
hek293t,14250,1,10,CGATAATCCTCGTTCTTCTGTGATTCTAAAGGATTCCTCTGTGCTGAAGAAATTCCCTTGAGCTGTTTCTGCTGGATAAAAAAATTCTAGTTGGTTTAA,CGATAATCCTCGTTCTTCTGTGATTCTAAAGGTGTTCAATGAATTCCTCTGTGCTGAAGAAATTCCCTTGAGCTGTTTCTGCTGGATAAAAAAATTCTA,10,30,14,27,27,36,27,46,27,33,33,36,43,46,17.47,0.0
hek293t,14252,1,11,CCTCAAGCAGTTGCCATACTGTCTCTAGATGGAACAAGGTGAGCTACTGTAAGTGGTACCCAAACATGTGAAAAAAATTCTAGTTGGTTTAACGCGTAA,CCTCAAGCAGTTGCCATACTGTCTCTAGATGGAACAAGACGCTTATAGCGTGAGCTACTGTAAGTGGTACCCAAACATGTGAAAAAAATTCTAGTTGGT,10,30,14,27,27,42,27,53,27,39,39,42,50,53,39.52,0.0
hek293t,14253,1,15,CTGACTTAAATTTAAATCGAATTACTGTTAGGTAAAACTTAATCTTCCAAATTTGTTTGACTGCTTAAAAAAAATTCTAGTTGGTTTAACGCGTAACTA,CTGACTTAAATTTAAATCGAATTACTGTTAGGTAAAACAATTATGCAAACGGCTTAATCTTCCAAATTTGTTTGACTGCTTAAAAAAAATTCTAGTTGG,10,30,14,27,27,41,27,56,27,38,38,41,53,56,21.84,0.0
hek293t,18905,1,10,ATTAGTTCTTCTCCCTCTTTCTCAAGGAGGGGCAAGTACCATCTTTTATGGTGTTAGCACTATGCTCCTATACAAAAAAAATTCTAGTTGGTTTAACGC,ATTAGTTCTTCTCCCTCTTTCTCAAGGAGGGCGCGATAGCAGCAAGTACCATCTTTTATGGTGTTAGCACTATGCTCCTATACAAAAAAAATTCTAGTT,10,30,14,27,27,39,27,49,27,32,32,39,42,49,52.25,11.82836161
hek293t,18905,1,10,CGTAGTTCTTCTCCCTCTTTCTCAAGGAGGGGCAAGTACCATCTTTTATGGTGTTAGCACTATGCTCCTATAAAAAAATTCTAGTTGGTTTAACGCGTA,CGTAGTTCTTCTCCCTCTTTCTCAAGGAGGGCGCGATAGCAGCAAGTACCATCTTTTATGGTGTTAGCACTATGCTCCTATAAAAAAATTCTAGTTGGT,10,30,14,27,27,42,27,52,27,32,32,42,42,52,52.25,24.28416159
hek293t,14256,1,15,AATGCAAAATGCTATGTCCCTTACAAAAGAGGGCAAAGAAAAGGGCATAGGTGAAGGAGGACTGAAAAAAATTCTAGTTGGTTTAACGCGTAACTAGAT,AATGCAAAATGCTATGTCCCTTACAAAAGAGGGTATATGGTTTACCATCAAAGAAAAGGGCATAGGTGAAGGAGGACTGAAAAAAATTCTAGTTGGTTT,10,30,14,27,27,44,27,59,27,34,34,44,49,59,37.32,1.266809657
hek293t,14256,1,15,GACGGAAAATGCTATGTCCCTTACAAAAGAGGGCAAAGAAAAGGGCATAGGTGAAGGAGGACTGATCTTCTAAAAAAATTCTAGTTGGTTTAACGCGTA,GACGGAAAATGCTATGTCCCTTACAAAAGAGGGTATATGGTTTACCATCAAAGAAAAGGGCATAGGTGAAGGAGGACTGATCTTCTAAAAAAATTCTAG,10,30,14,27,27,37,27,52,27,34,34,37,49,52,37.32,0.051440329
hek293t,14258,1,6,TCGCAGAGCAAAATCTGCTTTGGATGCTCAGGGCGTTATTGGCATGTGCCGTTGAACAGTCTGTCCTAAGCCAAAAAAATTCTAGTTGGTTTAACGCGT,TCGCAGAGCAAAATCTGCTTTGGATGCTCAGGGCACACGGGTTATTGGCATGTGCCGTTGAACAGTCTGTCCTAAGCCAAAAAAATTCTAGTTGGTTTA,10,30,14,27,27,45,27,51,27,35,35,45,41,51,26.8,61.91789919
hek293t,14260,1,10,CAAGTCCCAATGCCTAGACAGATGGTGACAGGAAGTTGGTGAATGAGTGGGAATTTCTAGAACTCCAGTATCAGAAAAAAAAATTCTAGTTGGTTTAAC,CAAGTCCCAATGCCTAGACAGATGGTGACAGGATGGATCGAAAAGTTGGTGAATGAGTGGGAATTTCTAGAACTCCAGTATCAGAAAAAAAAATTCTAG,10,30,14,27,27,37,27,47,27,34,34,37,44,47,63.43,0.213598584
hek293t,14260,1,10,CCGCTCCCAATGCCTAGACAGATGGTGACAGGAAGTTGGTGAATGAGTGGGAATTTCTAGAACTCCAGTAAAAAAATTCTAGTTGGTTTAACGCGTAAC,CCGCTCCCAATGCCTAGACAGATGGTGACAGGATGGATCGAAAAGTTGGTGAATGAGTGGGAATTTCTAGAACTCCAGTAAAAAAATTCTAGTTGGTTT,10,30,14,27,27,44,27,54,27,34,34,44,44,54,63.43,2.01166448
hek293t,14262,1,1,GTTATGAAATTACAGCCATGGATGTACTCTGGACAAACCTACAACCAGAGCAAAGTTTTCAGTAAACAGCTGAGAAAAAAATTCTAGTTGGTTTAACGC,GTTATGAAATTACAGCCATGGATGTACTCTGGCACAAACCTACAACCAGAGCAAAGTTTTCAGTAAACAGCTGAGAAAAAAATTCTAGTTGGTTTAACG,10,30,14,27,27,48,27,49,27,33,33,48,34,49,55.45,82.60173698
hek293t,14262,1,1,GAACTGAAATTACAGCCATGGATGTACTCTGGACAAACCTACAACCAGAGCAAAGTTTTCAGTAAACAGCTGAGACTTAAAAAAAATTCTAGTTGGTTT,GAACTGAAATTACAGCCATGGATGTACTCTGGCACAAACCTACAACCAGAGCAAAGTTTTCAGTAAACAGCTGAGACTTAAAAAAAATTCTAGTTGGTT,10,30,14,27,27,43,27,44,27,33,33,43,34,44,55.45,85.60182653
hek293t,14264,1,2,CTCGAGCCAGTCTGTTAGAACTTTTGTTGCGGACCCCCCCGCAGGATTGTTAGGAAGGTAACTAATTGGTATCAAACACAATGAAAAAAAATTCTAGTT,CTCGAGCCAGTCTGTTAGAACTTTTGTTGTCCGGACCCCCCCGCAGGATTGTTAGGAAGGTAACTAATTGGTATCAAACACAATGAAAAAAAATTCTAG,10,30,14,27,27,37,27,39,27,30,30,37,32,39,37.62,6.595005419
hek293t,14266,1,5,CCGATATTCTTAGTGGTTATCTTATTCAAAGGAATGATTTGAACTGATGGTAACTCTGAACAGAGTTAAAAAAATTCTAGTTGGTTTAACGCGTAACTA,CCGATATTCTTAGTGGTTATCTTATTCAAAGGAATGATTTCAGACGAACTGATGGTAACTCTGAACAGAGTTAAAAAAATTCTAGTTGGTTTAACGCGT,10,30,14,27,27,51,27,56,27,41,41,51,46,56,43.67,3.440655093
hek293t,18885,1,15,ATGAATGCTGATAAGTGTATGTATGGAACAGGCTCATGGGTAGAGATGTGCTGTTTATGTCCTGTCCGAAGCACAGAAAAAAATTCTAGTTGGTTTAAC,ATGAATGCTGATAAGTGTATGTATGGAATATAAAATTACGACGCAGGCTCATGGGTAGAGATGTGCTGTTTATGTCCTGTCCGAAGCACAGAAAAAAAT,10,30,14,27,27,32,27,47,27,29,29,32,44,47,49.05,0.082508251
hek293t,18885,1,15,GTGCGTGCTGATAAGTGTATGTATGGAACAGGCTCATGGGTAGAGATGTGCTGTTTATGTCCTGTCCGAAGCAAAAAAATTCTAGTTGGTTTAACGCGT,GTGCGTGCTGATAAGTGTATGTATGGAATATAAAATTACGACGCAGGCTCATGGGTAGAGATGTGCTGTTTATGTCCTGTCCGAAGCAAAAAAATTCTA,10,30,14,27,27,36,27,51,27,29,29,36,44,51,49.05,0.761460761
hek293t,14269,1,15,TAGTTCCCTAACTCATGATGTTCATAAGAAGGGTAGCTAGAGATTTTATATTCTATGGGTGTAGGGAACCACAAGCAAAAAAATTCTAGTTGGTTTAAC,TAGTTCCCTAACTCATGATGTTCATAAGCACATTAGAGTCTCGAAGGGTAGCTAGAGATTTTATATTCTATGGGTGTAGGGAACCACAAGCAAAAAAAT,10,30,14,27,27,32,27,47,27,29,29,32,44,47,41.61,0.0
hek293t,14269,1,15,GAAAACCCTAACTCATGATGTTCATAAGAAGGGTAGCTAGAGATTTTATATTCTATGGGTGTAGGGAACCACAAAAAAATTCTAGTTGGTTTAACGCGT,GAAAACCCTAACTCATGATGTTCATAAGCACATTAGAGTCTCGAAGGGTAGCTAGAGATTTTATATTCTATGGGTGTAGGGAACCACAAAAAAATTCTA,10,30,14,27,27,36,27,51,27,29,29,36,44,51,41.61,28.76366033
hek293t,14271,1,7,GAGACCATGAATCATGCAGCACATGGAAAAGGAGATTACACTTGAGAATTGAATATATGGCTATTTTTATCCTAACACACAATGAAAAAAATTCTAGTT,GAGACCATGAATCATGCAGCACATGGAATGTCTGCAAGGAGATTACACTTGAGAATTGAATATATGGCTATTTTTATCCTAACACACAATGAAAAAAAT,10,30,14,27,27,32,27,39,27,29,29,32,36,39,39.46,0.464218861
hek293t,14271,1,7,TCGATCATGAATCATGCAGCACATGGAAAAGGAGATTACACTTGAGAATTGAATATATGGCTATTTTTATCCAAAAAAATTCTAGTTGGTTTAACGCGT,TCGATCATGAATCATGCAGCACATGGAATGTCTGCAAGGAGATTACACTTGAGAATTGAATATATGGCTATTTTTATCCAAAAAAATTCTAGTTGGTTT,10,30,14,27,27,44,27,51,27,29,29,44,36,51,39.46,15.65872325
hek293t,14273,1,5,GGACATTAATTTTAATCATTGAAAAGAATAGGGTGGGACAAGGAGACTCTTAGGCTGACACAGCAGTGCTGGGAATAACAAAAAAATTCTAGTTGGTTT,GGACATTAATTTTAATCATTGAAAAGAATAGGGTGCGATCGGACAAGGAGACTCTTAGGCTGACACAGCAGTGCTGGGAATAACAAAAAAATTCTAGTT,10,30,14,27,27,39,27,44,27,36,36,39,41,44,-1.87,0.0
hek293t,14273,1,5,AAGTATTAATTTTAATCATTGAAAAGAATAGGGTGGGACAAGGAGACTCTTAGGCTGACACAGCAGTAAAAAAATTCTAGTTGGTTTAACGCGTAACTA,AAGTATTAATTTTAATCATTGAAAAGAATAGGGTGCGATCGGACAAGGAGACTCTTAGGCTGACACAGCAGTAAAAAAATTCTAGTTGGTTTAACGCGT,10,30,14,27,27,51,27,56,27,36,36,51,41,56,-1.87,0.0
hek293t,14275,1,7,ATATCTTCATTGTAATGTAAGTACTGTCTTGGATGTTTGGTCAAGAAGCTCATTTCTAAGATAATGATTGAATCTTAAAAAAAAATTCTAGTTGGTTTA,ATATCTTCATTGTAATGTAAGTACTGTCTTAGATACTGGATGTTTGGTCAAGAAGCTCATTTCTAAGATAATGATTGAATCTTAAAAAAAAATTCTAGT,10,30,14,27,27,38,27,45,27,31,31,38,38,45,48.62,3.512814862
hek293t,14275,1,7,ACCCTTTCATTGTAATGTAAGTACTGTCTTGGATGTTTGGTCAAGAAGCTCATTTCTAAGATAATGATTGAAAAAAATTCTAGTTGGTTTAACGCGTAA,ACCCTTTCATTGTAATGTAAGTACTGTCTTAGATACTGGATGTTTGGTCAAGAAGCTCATTTCTAAGATAATGATTGAAAAAAATTCTAGTTGGTTTAA,10,30,14,27,27,46,27,53,27,31,31,46,38,53,48.62,1.958930244
hek293t,14279,1,3,AGCTAAGTCGGAATGCAAAAAGTATTTATAGGACCGATTCTATGCAAATTCTCAGCTATTTTCACAACAGCCTGAAAAAAATTCTAGTTGGTTTAACGC,AGCTAAGTCGGAATGCAAAAAGTATTTATAGGACCGATGGGTCTATGCAAATTCTCAGCTATTTTCACAACAGCCTGAAAAAAATTCTAGTTGGTTTAA,10,30,14,27,27,46,27,49,27,39,39,46,42,49,7.85,0.0
hek293t,14279,1,3,ATCTGAGTCGGAATGCAAAAAGTATTTATAGGACCGATTCTATGCAAATTCTCAGCTATTTTCACAAAAAAAATTCTAGTTGGTTTAACGCGTAACTAG,ATCTGAGTCGGAATGCAAAAAGTATTTATAGGACCGATGGGTCTATGCAAATTCTCAGCTATTTTCACAAAAAAAATTCTAGTTGGTTTAACGCGTAAC,10,30,14,27,27,54,27,57,27,39,39,54,42,57,7.85,0.924824602
hek293t,14281,1,4,GAGATTCTTACCAAACAATCACATTTTAGAGGTTAAAAGCAAAGCTTCAGTATACATAGTATCATAATGCCTTTATATTAAAAAAAATTCTAGTTGGTT,GAGATTCTTACCAAACAATCACATTTTAGAGGTGAGTTAAAAGCAAAGCTTCAGTATACATAGTATCATAATGCCTTTATATTAAAAAAAATTCTAGTT,10,30,14,27,27,39,27,43,27,32,32,39,36,43,16.78,2.911005554
hek293t,14281,1,4,TAATCTCTTACCAAACAATCACATTTTAGAGGTTAAAAGCAAAGCTTCAGTATACATAGTATCATAATGCCTAAAAAAATTCTAGTTGGTTTAACGCGT,TAATCTCTTACCAAACAATCACATTTTAGAGGTGAGTTAAAAGCAAAGCTTCAGTATACATAGTATCATAATGCCTAAAAAAATTCTAGTTGGTTTAAC,10,30,14,27,27,47,27,51,27,32,32,47,36,51,16.78,0.615384615
hek293t,14283,1,5,GCTAGGAGGAAAGTTTGTTATTATTGTTCAGGAAGAGAAAGTGGAGTAGATGCAAGCGCAAGGTCTGTCCTCCAGCAGAAAAAAATTCTAGTTGGTTTA,GCTAGGAGGAAAGTTTGTTATTATTGTTCATAGCAGGAAGAGAAAGTGGAGTAGATGCAAGCGCAAGGTCTGTCCTCCAGCAGAAAAAAATTCTAGTTG,10,30,14,27,27,40,27,45,27,30,30,40,35,45,11.15,10.8894194
hek293t,14283,1,5,CTCGAGAGGAAAGTTTGTTATTATTGTTCAGGAAGAGAAAGTGGAGTAGATGCAAGCGCAAGGTCTGTCCTCCAAAAAAATTCTAGTTGGTTTAACGCG,CTCGAGAGGAAAGTTTGTTATTATTGTTCATAGCAGGAAGAGAAAGTGGAGTAGATGCAAGCGCAAGGTCTGTCCTCCAAAAAAATTCTAGTTGGTTTA,10,30,14,27,27,45,27,50,27,30,30,45,35,50,11.15,1.492737207
hek293t,14285,1,4,TTGTTGGATATGTGTAACAGCATGCCAAATGGTGTTACTTTCTTTCTGATAAACGCATACTGCAGCATTCTTAATACCACAAAAAAATTCTAGTTGGTT,TTGTTGGATATGTGTAACAGCATGCCAAATGTTAGGTGTTACTTTCTTTCTGATAAACGCATACTGCAGCATTCTTAATACCACAAAAAAATTCTAGTT,10,30,14,27,27,39,27,43,27,32,32,39,36,43,28.57,79.45540706
hek293t,14285,1,4,TGCGGGGATATGTGTAACAGCATGCCAAATGGTGTTACTTTCTTTCTGATAAACGCATACTGCAGCATTCTTAAAAAAATTCTAGTTGGTTTAACGCGT,TGCGGGGATATGTGTAACAGCATGCCAAATGTTAGGTGTTACTTTCTTTCTGATAAACGCATACTGCAGCATTCTTAAAAAAATTCTAGTTGGTTTAAC,10,30,14,27,27,47,27,51,27,32,32,47,36,51,28.57,78.15873597
hek293t,14287,1,3,GGATTTTGTTCGTGGGTGAAGTCACGGTTTGGTGCGGTGCTGAGGCTCCTCCGCTGTTAAATAATGTTGGGGTAAAAAAAATTCTAGTTGGTTTAACGC,GGATTTTGTTCGTGGGTGAAGTCACGGTTTGGTGCGGTTTGGCTGAGGCTCCTCCGCTGTTAAATAATGTTGGGGTAAAAAAAATTCTAGTTGGTTTAA,10,30,14,27,27,46,27,49,27,39,39,46,42,49,53.21,24.76260944
hek293t,14287,1,3,ACGGCTTGTTCGTGGGTGAAGTCACGGTTTGGTGCGGTGCTGAGGCTCCTCCGCTGTTAAATAATGTTGGGGTAATAGAAAAAAATTCTAGTTGGTTTA,ACGGCTTGTTCGTGGGTGAAGTCACGGTTTGGTGCGGTTTGGCTGAGGCTCCTCCGCTGTTAAATAATGTTGGGGTAATAGAAAAAAATTCTAGTTGGT,10,30,14,27,27,42,27,45,27,39,39,42,42,45,53.21,0.075735171
hek293t,14289,1,12,TTGAACGGGCAGAGGAATGTCACTCTGCCAGGACCCCTCCCCATCCTGCGTGTTTTGTTTTCTTCAAAAAAATTCTAGTTGGTTTAACGCGTAACTAGA,TTGAACGGGCAGAGGAATGTCACTCTGCCATACTACCTCACCGGACCCCTCCCCATCCTGCGTGTTTTGTTTTCTTCAAAAAAATTCTAGTTGGTTTAA,10,30,14,27,27,46,27,58,27,31,31,46,43,58,43.27,2.257003366
hek293t,14291,1,6,ATTATCATATAAGAAGCATATTTTAAATATGGACTTAACATTCTTTCTTGTTTAATCAAGCAAGCTTTTGATTGCCTTAGAAAAAAAATTCTAGTTGGT,ATTATCATATAAGAAGCATATTTTAAATGGGTTGATGGACTTAACATTCTTTCTTGTTTAATCAAGCAAGCTTTTGATTGCCTTAGAAAAAAAATTCTA,10,30,14,27,27,36,27,42,27,29,29,36,35,42,2.57,0.0
hek293t,14291,1,6,ATCTGCATATAAGAAGCATATTTTAAATATGGACTTAACATTCTTTCTTGTTTAATCAAGCAAGCTTTTGATTGCCTTAGAATGCAAAAAAATTCTAGT,ATCTGCATATAAGAAGCATATTTTAAATGGGTTGATGGACTTAACATTCTTTCTTGTTTAATCAAGCAAGCTTTTGATTGCCTTAGAATGCAAAAAAAT,10,30,14,27,27,32,27,38,27,29,29,32,35,38,2.57,0.0
hek293t,14293,1,5,CCAGTTTTGTATTTTGGAACTACCAGGGCAGGGGGAGGGTGGCTGAGTACCTTGTGGTACTGAACTTTTCAGCTCTATCAAAAAAAAATTCTAGTTGGT,CCAGTTTTGTATTTTGGAACTACCAGGGCTATAAAGGGGGAGGGTGGCTGAGTACCTTGTGGTACTGAACTTTTCAGCTCTATCAAAAAAAAATTCTAG,10,30,14,27,27,37,27,42,27,30,30,37,35,42,13.51,15.31369557
hek293t,14295,1,13,GGCTGCAGATCACAACTTACATCTTTGAAAGGTCTTCACATGTTACACAAGTCCTAATTAGAGGTCACTGAAGGAAAAAAATTCTAGTTGGTTTAACGC,GGCTGCAGATCACAACTTACATCTTTGAAAGGTCTTTTCCGATTCTCTTCACATGTTACACAAGTCCTAATTAGAGGTCACTGAAGGAAAAAAATTCTA,10,30,14,27,27,36,27,49,27,33,33,36,46,49,36.56,0.0
hek293t,14295,1,13,ATCCGCAGATCACAACTTACATCTTTGAAAGGTCTTCACATGTTACACAAGTCCTAATTAGAGGTCAAAAAAAATTCTAGTTGGTTTAACGCGTAACTA,ATCCGCAGATCACAACTTACATCTTTGAAAGGTCTTTTCCGATTCTCTTCACATGTTACACAAGTCCTAATTAGAGGTCAAAAAAAATTCTAGTTGGTT,10,30,14,27,27,43,27,56,27,33,33,43,46,56,36.56,0.0
hek293t,22858,1,14,ATGTTCAAAATTGTACAATTGTGTGCATGAGGATATGATGCTACTTAAGGAGCATATGCTTTGATCAAAAAAATTCTAGTTGGTTTAACGCGTAACTAG,ATGTTCAAAATTGTACAATTGTGTGCATGAGGATATGATGCGAGTTGGGAGTCGCTACTTAAGGAGCATATGCTTTGATCAAAAAAATTCTAGTTGGTT,10,30,14,27,27,43,27,57,27,40,40,43,54,57,27.28,0.0
hek293t,734,1,13,GAATCGCTTTCTCTTTTAACCAGAAGGGAAGGAAGAACATACACACCCTGCAAGTCAGGGCCAAACAAAAAAATTCTAGTTGGTTTAACGCGTAACTAG,GAATCGCTTTCTCTTTTAACCAGAAGGGAAGGATAGTGTGATCGAGAGAACATACACACCCTGCAAGTCAGGGCCAAACAAAAAAATTCTAGTTGGTTT,10,30,14,27,27,44,27,57,27,34,34,44,47,57,38.58,1.492889849
hek293t,734,1,13,GCGCAGCTTTCTCTTTTAACCAGAAGGGAAGGAAGAACATACACACCCTGCAAGTCAGGGCCAAACTACAAGGAAAAAAATTCTAGTTGGTTTAACGCG,GCGCAGCTTTCTCTTTTAACCAGAAGGGAAGGATAGTGTGATCGAGAGAACATACACACCCTGCAAGTCAGGGCCAAACTACAAGGAAAAAAATTCTAG,10,30,14,27,27,37,27,50,27,34,34,37,47,50,38.58,0.0
hek293t,14300,1,5,CCTCAACGTCAGTCTAAAGGTTTCTTTAATGGAGGATTGATAAATTCATGAAGAACTGTGCAGTGCAGAGGTACCAGAGAAAAAAATTCTAGTTGGTTT,CCTCAACGTCAGTCTAAAGGTTTCTTTAATGGAGGCACTAATTGATAAATTCATGAAGAACTGTGCAGTGCAGAGGTACCAGAGAAAAAAATTCTAGTT,10,30,14,27,27,39,27,44,27,36,36,39,41,44,7.71,0.0
hek293t,14300,1,5,AGACAACGTCAGTCTAAAGGTTTCTTTAATGGAGGATTGATAAATTCATGAAGAACTGTGCAGTGCAGAGGTACCAAAAAAATTCTAGTTGGTTTAACG,AGACAACGTCAGTCTAAAGGTTTCTTTAATGGAGGCACTAATTGATAAATTCATGAAGAACTGTGCAGTGCAGAGGTACCAAAAAAATTCTAGTTGGTT,10,30,14,27,27,43,27,48,27,36,36,43,41,48,7.71,1.847244608
hek293t,14302,1,3,GAGTATAGATTACGCGAGCTCCTCGACTCTGGAAGGTACGCGGTCTTTCTCAGGCACCCTTGTAGAAAAAAAAATTCTAGTTGGTTTAACGCGTAACTA,GAGTATAGATTACGCGAGCTCCTCGACTCTGGAAGGTACGACGCGGTCTTTCTCAGGCACCCTTGTAGAAAAAAAAATTCTAGTTGGTTTAACGCGTAA,10,30,14,27,27,53,27,56,27,38,38,53,41,56,59.25,85.86432182
hek293t,14302,1,3,CTGCATAGATTACGCGAGCTCCTCGACTCTGGAAGGTACGCGGTCTTTCTCAGGCACCCTTGTAGAATAGGGCTGAAAAAAATTCTAGTTGGTTTAACG,CTGCATAGATTACGCGAGCTCCTCGACTCTGGAAGGTACGACGCGGTCTTTCTCAGGCACCCTTGTAGAATAGGGCTGAAAAAAATTCTAGTTGGTTTA,10,30,14,27,27,45,27,48,27,38,38,45,41,48,59.25,15.76616477
hek293t,14304,1,12,ATGCATATGGCAGAGGCCTGAAGGCAACGAGGGCTGTACCAGGGAAGTGCTCTGAAATCCCAGACCACGTGGCAAGGAAAAAAATTCTAGTTGGTTTAA,ATGCATATGGCAGAGGCCTGAAGGCACGTCTTTTTTGCACGAGGGCTGTACCAGGGAAGTGCTCTGAAATCCCAGACCACGTGGCAAGGAAAAAAATTC,10,30,14,27,27,34,27,46,27,27,27,34,39,46,74.0,7.092858079
hek293t,14306,1,1,CACCGCTGTGTGTCCTCCCTGCCACCTCCAGGAAATGTGCAGCTTTGAACTCTGACACTGCTGAATGGGTTGAAATGGGTGTTTTAAAAAAATTCTAGT,CACCGCTGTGTGTCCTCCCTGCCACCTCCAGGAGAATGTGCAGCTTTGAACTCTGACACTGCTGAATGGGTTGAAATGGGTGTTTTAAAAAAATTCTAG,10,30,14,27,27,37,27,38,27,34,34,37,35,38,30.35,16.38357728
hek293t,14306,1,1,CCATCCTGTGTGTCCTCCCTGCCACCTCCAGGAAATGTGCAGCTTTGAACTCTGACACTGCTGAATGGGTTGAAATGGGTGAAAAAAATTCTAGTTGGT,CCATCCTGTGTGTCCTCCCTGCCACCTCCAGGAGAATGTGCAGCTTTGAACTCTGACACTGCTGAATGGGTTGAAATGGGTGAAAAAAATTCTAGTTGG,10,30,14,27,27,41,27,42,27,34,34,41,35,42,30.35,81.53605537
hek293t,14308,1,4,TCGAAATGTCAATCTCTGAGCACACACAGAGGCAGAGTCTCATTCTCCTTGGCTCTGCAAGAGCAGAGATGGTGACATCTAAAAAAATTCTAGTTGGTT,TCGAAATGTCAATCTCTGAGCACACACACACAGAGGCAGAGTCTCATTCTCCTTGGCTCTGCAAGAGCAGAGATGGTGACATCTAAAAAAATTCTAGTT,10,30,14,27,27,39,27,43,27,29,29,39,33,43,68.38,75.07798092
hek293t,14308,1,4,GTGCTATGTCAATCTCTGAGCACACACAGAGGCAGAGTCTCATTCTCCTTGGCTCTGCAAGAGCAGAGATGGTGACATCTCCTACGAAAAAAAATTCTA,GTGCTATGTCAATCTCTGAGCACACACACACAGAGGCAGAGTCTCATTCTCCTTGGCTCTGCAAGAGCAGAGATGGTGACATCTCCTACGAAAAAAAAT,10,30,14,27,27,32,27,36,27,29,29,32,33,36,68.38,66.92849624
hek293t,14310,1,2,CGGTGAAAATGGGCTTGAAGACAAATAGGAGGACAGGAAAAGGATGTGGATATTGCAAGAACGTGATACTCAAGAGAAAAAAATTCTAGTTGGTTTAAC,CGGTGAAAATGGGCTTGAAGACAAATAGGAGGACAGGGCAAAAGGATGTGGATATTGCAAGAACGTGATACTCAAGAGAAAAAAATTCTAGTTGGTTTA,10,30,14,27,27,45,27,47,27,38,38,45,40,47,69.98,2.666423313
hek293t,14310,1,2,ACGGCAAAATGGGCTTGAAGACAAATAGGAGGACAGGAAAAGGATGTGGATATTGCAAGAACGTGATACTCAAAAAAAAATTCTAGTTGGTTTAACGCG,ACGGCAAAATGGGCTTGAAGACAAATAGGAGGACAGGGCAAAAGGATGTGGATATTGCAAGAACGTGATACTCAAAAAAAAATTCTAGTTGGTTTAACG,10,30,14,27,27,48,27,50,27,38,38,48,40,50,69.98,0.940381571
hek293t,14314,1,7,GATATTTCACAGACTTTCTTGCATGTAAAAGGGGAAGCCAATGTTGGCTATAAGCCAATAAACTGATAAAAAAAAATTCTAGTTGGTTTAACGCGTAAC,GATATTTCACAGACTTTCTTGCATGTAAAAGGGGAAGCCGCTAAGTAATGTTGGCTATAAGCCAATAAACTGATAAAAAAAAATTCTAGTTGGTTTAAC,10,30,14,27,27,47,27,54,27,40,40,47,47,54,8.65,0.0
hek293t,21064,1,7,CGGGTCAGAAGTGGTGAATAACATCTCACAGGAGCACTGACAGCCCCCCCCCAATTCTCTTACCTTAGTATAAGTAAAAACAAAAAAAATTCTAGTTGG,CGGGTCAGAAGTGGTGAATAACATCTCACATTAACTGGGAGCACTGACAGCCCCCCCCCAATTCTCTTACCTTAGTATAAGTAAAAACAAAAAAAATTC,10,30,14,27,27,34,27,41,27,31,31,34,38,41,60.63,3.828175371
hek293t,14317,1,9,TCGAGATTAGGAATTGTTTAATATGAAAGAGGGATTAAAAAGAAAAATGCAACCTCAAAAGAGGCAGCAAGTCCTAGAAGAAAAAAATTCTAGTTGGTT,TCGAGATTAGGAATTGTTTAATATGAAAGACATCCATTCGGGATTAAAAAGAAAAATGCAACCTCAAAAGAGGCAGCAAGTCCTAGAAGAAAAAAATTC,10,30,14,27,27,34,27,43,27,31,31,34,40,43,15.97,0.0
hek293t,14317,1,9,GTGTCATTAGGAATTGTTTAATATGAAAGAGGGATTAAAAAGAAAAATGCAACCTCAAAAGAGGCAGCAAGTCAAAAAAATTCTAGTTGGTTTAACGCG,GTGTCATTAGGAATTGTTTAATATGAAAGACATCCATTCGGGATTAAAAAGAAAAATGCAACCTCAAAAGAGGCAGCAAGTCAAAAAAATTCTAGTTGG,10,30,14,27,27,41,27,50,27,31,31,41,40,50,15.97,0.35004302
hek293t,14319,1,8,ACGCCCCTATGATTTACTGGGTCTTATCCTGGTAAATATATGTTTGGTTTATTTCTTTTGCCTATTTGATGGTAAAAAAAATTCTAGTTGGTTTAACGC,ACGCCCCTATGATTTACTGGGTCTTATCCTGGTCCCAAAATAAATATATGTTTGGTTTATTTCTTTTGCCTATTTGATGGTAAAAAAAATTCTAGTTGG,10,30,14,27,27,41,27,49,27,34,34,41,42,49,31.08,0.0
hek293t,14324,1,5,ATCCGGTTAACTGAAATGGTAACTCACTGTGGACAAACTTGCTTTTATAGAAATAGAATAATGTAAAAAAATTCTAGTTGGTTTAACGCGTAACTAGAT,ATCCGGTTAACTGAAATGGTAACTCACTGTGGACAAACTCAGTTTGCTTTTATAGAAATAGAATAATGTAAAAAAATTCTAGTTGGTTTAACGCGTAAC,10,30,14,27,27,54,27,59,27,39,39,54,44,59,59.59,1.847531477
hek293t,14324,1,5,TTACGGTTAACTGAAATGGTAACTCACTGTGGACAAACTTGCTTTTATAGAAATAGAATAATGTGAAGATAAAAAAAAATTCTAGTTGGTTTAACGCGT,TTACGGTTAACTGAAATGGTAACTCACTGTGGACAAACTCAGTTTGCTTTTATAGAAATAGAATAATGTGAAGATAAAAAAAAATTCTAGTTGGTTTAA,10,30,14,27,27,46,27,51,27,39,39,46,44,51,59.59,0.560323389
hek293t,14326,1,10,GAGGATGTGCAAAGTGGTTTTTTACTCATTGGCTTATAAAGGCCTAGCAAAGCTGGGAAGAGCCCCCCCAAAAAAATTCTAGTTGGTTTAACGCGTAAC,GAGGATGTGCAAAGTGGTTTTTTACTCACGTAGTGGGGTTGGCTTATAAAGGCCTAGCAAAGCTGGGAAGAGCCCCCCCAAAAAAATTCTAGTTGGTTT,10,30,14,27,27,44,27,54,27,29,29,44,39,54,2.25,2.990230066
hek293t,14327,1,2,CATATCTGCAGTTGCAGTGAGGAGCGTGATGGGTTGTGTCCTTGTAGGAACAGGAGTAGGAGAAATGCTGAGAGAACCAAAAAAATTCTAGTTGGTTTA,CATATCTGCAGTTGCAGTGAGGAGCGTTGGATGGGTTGTGTCCTTGTAGGAACAGGAGTAGGAGAAATGCTGAGAGAACCAAAAAAATTCTAGTTGGTT,10,30,14,27,27,43,27,45,27,28,28,43,30,45,52.18,83.73943025
hek293t,14327,1,2,TCGCCCTGCAGTTGCAGTGAGGAGCGTGATGGGTTGTGTCCTTGTAGGAACAGGAGTAGGAGAAATGCTGAGAGAACCCCCCCAAAAAAATTCTAGTTG,TCGCCCTGCAGTTGCAGTGAGGAGCGTTGGATGGGTTGTGTCCTTGTAGGAACAGGAGTAGGAGAAATGCTGAGAGAACCCCCCCAAAAAAATTCTAGT,10,30,14,27,27,38,27,40,27,28,28,38,30,40,52.18,85.95391612
hek293t,14331,1,14,ATAAGAAAGTTGCTCTAGAGGAGTGCAGTTGGAATGTAAGGTGATGTTTTGTTTGAGAGTAATCTGGGGAAAAAAATTCTAGTTGGTTTAACGCGTAAC,ATAAGAAAGTTGCTCTAGAGGAGTGCAGTTGGAATGATTTATACCTGTGGTAAGGTGATGTTTTGTTTGAGAGTAATCTGGGGAAAAAAATTCTAGTTG,10,30,14,27,27,40,27,54,27,37,37,40,51,54,42.34,0.0
hek293t,14334,1,12,ATTGTATATGTGTGCTTCTGTGGTGTTTATGGCCAAGCACTCCCAACTGAGTATGTGCTAATGGGTACGTTTACGCCCCCAAAAAAATTCTAGTTGGTT,ATTGTATATGTGTGCTTCTGTGGTGTTTACAGGACGCGCTATGGCCAAGCACTCCCAACTGAGTATGTGCTAATGGGTACGTTTACGCCCCCAAAAAAA,10,30,14,27,27,31,27,43,27,28,28,31,40,43,18.63,0.167887668
hek293t,14334,1,12,CTAGGATATGTGTGCTTCTGTGGTGTTTATGGCCAAGCACTCCCAACTGAGTATGTGCTAATGGGTACAAAAAAATTCTAGTTGGTTTAACGCGTAACT,CTAGGATATGTGTGCTTCTGTGGTGTTTACAGGACGCGCTATGGCCAAGCACTCCCAACTGAGTATGTGCTAATGGGTACAAAAAAATTCTAGTTGGTT,10,30,14,27,27,43,27,55,27,28,28,43,40,55,18.63,13.30886694
hek293t,14338,1,1,CGACGGGCTGCAGACTGCCTTTCCCGAGCAGGCACGTCGCAGCAGAGATGCGCCTGGGCATCCCAAACCCGGGCCACTGACTTCGCCTCTTAAAAAAAT,CGACGGGCTGCAGACTGCCTTTCCCGATGCAGGCACGTCGCAGCAGAGATGCGCCTGGGCATCCCAAACCCGGGCCACTGACTTCGCCTCTTAAAAAAA,10,30,14,27,27,31,27,32,27,28,28,31,29,32,42.66,55.85179315
hek293t,14338,1,1,CTTCTGGCTGCAGACTGCCTTTCCCGAGCAGGCACGTCGCAGCAGAGATGCGCCTGGGCATCCCAAACCCGGGCCACTGACTTCGCCAAAAAAATTCTA,CTTCTGGCTGCAGACTGCCTTTCCCGATGCAGGCACGTCGCAGCAGAGATGCGCCTGGGCATCCCAAACCCGGGCCACTGACTTCGCCAAAAAAATTCT,10,30,14,27,27,35,27,36,27,28,28,35,29,36,42.66,73.49053599
hek293t,14340,1,14,GGGACTACAGGAGTTAGGTCTTTAATGACAGGTAGGTCCCCATCCTAGGACACCCCCCCCAGTATAAAAAAATTCTAGTTGGTTTAACGCGTAACTAGA,GGGACTACAGGAGTTAGGTCTTTAATGACAGGTAGGTTCCTTGGTGCCAATCCCCATCCTAGGACACCCCCCCCAGTATAAAAAAATTCTAGTTGGTTT,10,30,14,27,27,44,27,58,27,37,37,44,51,58,58.03,0.04492363
hek293t,14340,1,14,CTGGTTACAGGAGTTAGGTCTTTAATGACAGGTAGGTCCCCATCCTAGGACACCCCCCCCAGTATACTCAAAAAAATTCTAGTTGGTTTAACGCGTAAC,CTGGTTACAGGAGTTAGGTCTTTAATGACAGGTAGGTTCCTTGGTGCCAATCCCCATCCTAGGACACCCCCCCCAGTATACTCAAAAAAATTCTAGTTG,10,30,14,27,27,40,27,54,27,37,37,40,51,54,58.03,1.148624539
hek293t,14342,1,15,GATTGCCTGAGCTGCAGGAAGACAACTGATGGTTACACCCCCGCTATTGATAATTTTGGACTTTAAAAAAAATTCTAGTTGGTTTAACGCGTAACTAGA,GATTGCCTGAGCTGCAGGAAGACAACTGATGGTTACACCTGGTATCCAAGGGGTCCCGCTATTGATAATTTTGGACTTTAAAAAAAATTCTAGTTGGTT,10,30,14,27,27,43,27,58,27,40,40,43,55,58,46.16,0.084817642
hek293t,14345,1,4,TATGTCTTTAGTGGATGAGTGGAACAGAGGGGTGCCGTGAGGCCTGCCCTGGCATCCTGCTCCCTGGGTGTGCTCTGCAAAAAAATTCTAGTTGGTTTA,TATGTCTTTAGTGGATGAGTGGAACAGAGGCGTTGGTGCCGTGAGGCCTGCCCTGGCATCCTGCTCCCTGGGTGTGCTCTGCAAAAAAATTCTAGTTGG,10,30,14,27,27,41,27,45,27,31,31,41,35,45,68.91,81.48438946
hek293t,14345,1,4,TATCGCTTTAGTGGATGAGTGGAACAGAGGGGTGCCGTGAGGCCTGCCCTGGCATCCTGCTCCCTGGGTGTGCTCTGCCTGCACCAAAAAAATTCTAGT,TATCGCTTTAGTGGATGAGTGGAACAGAGGCGTTGGTGCCGTGAGGCCTGCCCTGGCATCCTGCTCCCTGGGTGTGCTCTGCCTGCACCAAAAAAATTC,10,30,14,27,27,34,27,38,27,31,31,34,35,38,68.91,23.51071164
hek293t,14347,1,14,CCATGAAATACATATGCACATATTTGACAAGGTAAACCCCCCCCCGCATTTCAGTCTTACGGTGGAAAAAAATTCTAGTTGGTTTAACGCGTAACTAGA,CCATGAAATACATATGCACATATTTGACACAACCTTAAGGGCAAGGTAAACCCCCCCCCGCATTTCAGTCTTACGGTGGAAAAAAATTCTAGTTGGTTT,10,30,14,27,27,44,27,58,27,29,29,44,43,58,35.16,21.57151105
hek293t,14347,1,14,TGTCAAAATACATATGCACATATTTGACAAGGTAAACCCCCCCCCGCATTTCAGTCTTACGGTGGGCCTCAGAAAAAAAATTCTAGTTGGTTTAACGCG,TGTCAAAATACATATGCACATATTTGACACAACCTTAAGGGCAAGGTAAACCCCCCCCCGCATTTCAGTCTTACGGTGGGCCTCAGAAAAAAAATTCTA,10,30,14,27,27,36,27,50,27,29,29,36,43,50,35.16,0.915802831
hek293t,14349,1,13,GGGGGCACTCAAGGCAATCTCCTCATCTTTGGCTTCCTGCATCATGACGCTAATAATCTCAGAGAAGAAAAAAAAATTCTAGTTGGTTTAACGCGTAAC,GGGGGCACTCAAGGCAATCTCCTCATCTTTGGCTTCCAGGAGGAGTCCGTTGCATCATGACGCTAATAATCTCAGAGAAGAAAAAAAAATTCTAGTTGG,10,30,14,27,27,41,27,54,27,38,38,41,51,54,35.73,0.0
hek293t,14352,1,6,TAAAGCTCCACAGAAACAGACTTTTAAATTGGGGATGGGTCAAGAGAACACACTTGAAATGACTTCTGACAAAAAAAATTCTAGTTGGTTTAACGCGTA,TAAAGCTCCACAGAAACAGACTTTTAAATTCAGTGTGGGGATGGGTCAAGAGAACACACTTGAAATGACTTCTGACAAAAAAAATTCTAGTTGGTTTAA,10,30,14,27,27,46,27,52,27,31,31,46,37,52,2.41,2.55724201
hek293t,14352,1,6,AGTTGCTCCACAGAAACAGACTTTTAAATTGGGGATGGGTCAAGAGAACACACTTGAAATGACTTCTGACAAGCAGCTGACATAAAAAAATTCTAGTTG,AGTTGCTCCACAGAAACAGACTTTTAAATTCAGTGTGGGGATGGGTCAAGAGAACACACTTGAAATGACTTCTGACAAGCAGCTGACATAAAAAAATTC,10,30,14,27,27,34,27,40,27,31,31,34,37,40,2.41,5.080693401
hek293t,17501,1,7,GCATAAGCACAGGAATAGGTTTGTAGAGATGGTATTGTTGGTTTTGGGTCTATGCAAAGAGGTCAACATGCAGGTTGCCCTAAAAAAAATTCTAGTTGG,GCATAAGCACAGGAATAGGTTTGTAGAGATGATACTTGGTATTGTTGGTTTTGGGTCTATGCAAAGAGGTCAACATGCAGGTTGCCCTAAAAAAAATTC,10,30,14,27,27,34,27,41,27,31,31,34,38,41,46.08,32.88379668
hek293t,17501,1,7,AGTAGAGCACAGGAATAGGTTTGTAGAGATGGTATTGTTGGTTTTGGGTCTATGCAAAGAGGTCAACATGCAGGTTGCAAAAAAATTCTAGTTGGTTTA,AGTAGAGCACAGGAATAGGTTTGTAGAGATGATACTTGGTATTGTTGGTTTTGGGTCTATGCAAAGAGGTCAACATGCAGGTTGCAAAAAAATTCTAGT,10,30,14,27,27,38,27,45,27,31,31,38,38,45,46.08,28.43290207
hek293t,14356,1,2,AGGGGGTGACTGTGCTTGTTGCTTGCTCAAGGATTTAAGCCATTTACTTTGTTTGTTTATAATAGAGTTCTGGTGGAAAAAAATTCTAGTTGGTTTAAC,AGGGGGTGACTGTGCTTGTTGCTTGCTCAAGGATTCTTAAGCCATTTACTTTGTTTGTTTATAATAGAGTTCTGGTGGAAAAAAATTCTAGTTGGTTTA,10,30,14,27,27,45,27,47,27,35,35,45,37,47,25.45,36.53759385
hek293t,14356,1,2,TGTATGTGACTGTGCTTGTTGCTTGCTCAAGGATTTAAGCCATTTACTTTGTTTGTTTATAATAGAGTTCTGGTGGGAAGGCAAAAAAAATTCTAGTTG,TGTATGTGACTGTGCTTGTTGCTTGCTCAAGGATTCTTAAGCCATTTACTTTGTTTGTTTATAATAGAGTTCTGGTGGGAAGGCAAAAAAAATTCTAGT,10,30,14,27,27,38,27,40,27,35,35,38,37,40,25.45,0.0
hek293t,14358,1,7,TATTAGAGCAGAAATCTCAGAGTGGGGGCTGGCTTTCAAACGTGTCCAAGGCCTCCCCGCGAGCCTGTTGGCCAGCTCCAAAAAAATTCTAGTTGGTTT,TATTAGAGCAGAAATCTCAGAGTGGGCACCGCCGGCTGGCTTTCAAACGTGTCCAAGGCCTCCCCGCGAGCCTGTTGGCCAGCTCCAAAAAAATTCTAG,10,30,14,27,27,37,27,44,27,27,27,37,34,44,29.11,78.25257077
hek293t,14360,1,3,GGTCGTTTATGTTTATCACTGAGCTTCATAGGAAGCAGACTGGAAGCCTGAGTATCGATACTCATCTGAACAGAAAGTGCTACCTGTTAAAAAAATTCT,GGTCGTTTATGTTTATCACTGAGCTTCATGTTAGGAAGCAGACTGGAAGCCTGAGTATCGATACTCATCTGAACAGAAAGTGCTACCTGTTAAAAAAAT,10,30,14,27,27,32,27,35,27,29,29,32,32,35,10.17,1.400445129
hek293t,14360,1,3,CCTTCTTTATGTTTATCACTGAGCTTCATAGGAAGCAGACTGGAAGCCTGAGTATCGATACTCATCTGAACAGAAAGTGCTAAAAAAATTCTAGTTGGT,CCTTCTTTATGTTTATCACTGAGCTTCATGTTAGGAAGCAGACTGGAAGCCTGAGTATCGATACTCATCTGAACAGAAAGTGCTAAAAAAATTCTAGTT,10,30,14,27,27,39,27,42,27,29,29,39,32,42,10.17,72.84171841
hek293t,14362,1,9,TCAATTCCTATATTCCTCATTACAGCTCTTGGACCTACTGTTTGTCTTGCAACAGTATTTATGCAAAAAAAATTCTAGTTGGTTTAACGCGTAACTAGA,TCAATTCCTATATTCCTCATTACAGCTCTTGGACCTACCAAGCGGTTTGTTTGTCTTGCAACAGTATTTATGCAAAAAAAATTCTAGTTGGTTTAACGC,10,30,14,27,27,49,27,58,27,39,39,49,48,58,27.97,44.04228717
hek293t,14366,1,12,AGAGTCAAATCAAATCAGGTCTGTCAGTGTGGACATGGCCAGCCTATGCACTGCTTGCTGCATGCTTAATGAGAAAAAAATTCTAGTTGGTTTAACGCG,AGAGTCAAATCAAATCAGGTCTGTCAGTGTTGCCCGGTTCGAGGACATGGCCAGCCTATGCACTGCTTGCTGCATGCTTAATGAGAAAAAAATTCTAGT,10,30,14,27,27,38,27,50,27,31,31,38,43,50,49.45,3.354722381
hek293t,14366,1,12,TCACGCAAATCAAATCAGGTCTGTCAGTGTGGACATGGCCAGCCTATGCACTGCTTGCTGCATGCTTAATAAAAAAATTCTAGTTGGTTTAACGCGTAA,TCACGCAAATCAAATCAGGTCTGTCAGTGTTGCCCGGTTCGAGGACATGGCCAGCCTATGCACTGCTTGCTGCATGCTTAATAAAAAAATTCTAGTTGG,10,30,14,27,27,41,27,53,27,31,31,41,43,53,49.45,6.382246992
hek293t,14368,1,3,GGTGCGTCATCAAAAGGTCTGGGCGATAAAGGGAGAAGCAGAGAGCTAGGGCAGAGGCAGCTCCTCTTGCTCCCACCGCTCTCAAAAAAATTCTAGTTG,GGTGCGTCATCAAAAGGTCTGGGCGATAATCGAGGGAGAAGCAGAGAGCTAGGGCAGAGGCAGCTCCTCTTGCTCCCACCGCTCTCAAAAAAATTCTAG,10,30,14,27,27,37,27,40,27,30,30,37,33,40,19.36,21.3969158
hek293t,14368,1,3,GTTTGGTCATCAAAAGGTCTGGGCGATAAAGGGAGAAGCAGAGAGCTAGGGCAGAGGCAGCTCCTCTTGCTCCCAAAAAAAATTCTAGTTGGTTTAACG,GTTTGGTCATCAAAAGGTCTGGGCGATAATCGAGGGAGAAGCAGAGAGCTAGGGCAGAGGCAGCTCCTCTTGCTCCCAAAAAAAATTCTAGTTGGTTTA,10,30,14,27,27,45,27,48,27,30,30,45,33,48,19.36,16.96248883
hek293t,14370,1,13,ATCAGTTCCCAGCCTTGAAAAATCATCGCTGGTCTAACTTTTGAGTTACCCTTCTCATAAAATTAAAAAAATTCTAGTTGGTTTAACGCGTAACTAGAT,ATCAGTTCCCAGCCTTGAAAAATCATCGCTGCAGGCAGCGAAAGGTCTAACTTTTGAGTTACCCTTCTCATAAAATTAAAAAAATTCTAGTTGGTTTAA,10,30,14,27,27,46,27,59,27,31,31,46,44,59,43.32,0.0
hek293t,14370,1,13,GGTCATTCCCAGCCTTGAAAAATCATCGCTGGTCTAACTTTTGAGTTACCCTTCTCATAAAATTGTAACAGGAAAAAAATTCTAGTTGGTTTAACGCGT,GGTCATTCCCAGCCTTGAAAAATCATCGCTGCAGGCAGCGAAAGGTCTAACTTTTGAGTTACCCTTCTCATAAAATTGTAACAGGAAAAAAATTCTAGT,10,30,14,27,27,38,27,51,27,31,31,38,44,51,43.32,0.0
hek293t,14373,1,1,TTAACGAGCTGGTAATTATAGGCTCCCTCAGGTAAAATAAGTCTTCCCTCAGAAACTTGTTATGAGGTATTCAGTGTTGCTGAAAAAAATTCTAGTTGG,TTAACGAGCTGGTAATTATAGGCTCCCTCAGGTAAAAATAAGTCTTCCCTCAGAAACTTGTTATGAGGTATTCAGTGTTGCTGAAAAAAATTCTAGTTG,10,30,14,27,27,40,27,41,27,37,37,40,38,41,36.93,0.0
hek293t,14373,1,1,TACTGGAGCTGGTAATTATAGGCTCCCTCAGGTAAAATAAGTCTTCCCTCAGAAACTTGTTATGAGGTATAAAAAAATTCTAGTTGGTTTAACGCGTAA,TACTGGAGCTGGTAATTATAGGCTCCCTCAGGTAAAAATAAGTCTTCCCTCAGAAACTTGTTATGAGGTATAAAAAAATTCTAGTTGGTTTAACGCGTA,10,30,14,27,27,52,27,53,27,37,37,52,38,53,36.93,5.556385901
hek293t,14375,1,9,GATCCATGAAAGTGCCCAATGAAAACTTTAGGGCCCCCCCCTCTGTGCAGAGACTTCAAGCAAACAACAGGTAAGAAAAAAAAATTCTAGTTGGTTTAA,GATCCATGAAAGTGCCCAATGAAAACCGCCACCTTTTTAGGGCCCCCCCCTCTGTGCAGAGACTTCAAGCAAACAACAGGTAAGAAAAAAAAATTCTAG,10,30,14,27,27,37,27,46,27,27,27,37,36,46,10.43,50.3811421
hek293t,14375,1,9,AACGCATGAAAGTGCCCAATGAAAACTTTAGGGCCCCCCCCTCTGTGCAGAGACTTCAAGCAAACAACAGGTAAGAAGTTAAAAAAATTCTAGTTGGTT,AACGCATGAAAGTGCCCAATGAAAACCGCCACCTTTTTAGGGCCCCCCCCTCTGTGCAGAGACTTCAAGCAAACAACAGGTAAGAAGTTAAAAAAATTC,10,30,14,27,27,34,27,43,27,27,27,34,36,43,10.43,4.4663509
hek293t,14377,1,5,ATTGGAAAAGTTTTGCTGAAATGATTTTTTGGTTTTGATATAGCAACTTTTTGATAAAATTTCTTAATGGAAAAAAATTCTAGTTGGTTTAACGCGTAA,ATTGGAAAAGTTTTGCTGAAATGATTTTTTGGCGCTGTTTTGATATAGCAACTTTTTGATAAAATTTCTTAATGGAAAAAAATTCTAGTTGGTTTAACG,10,30,14,27,27,48,27,53,27,33,33,48,38,53,-2.23,0.135501355
hek293t,19024,1,15,CGGTCAGATACCTCATTTCAAACCTAGAGTGGGGCTAATATTTAAGGTTGGACATCAGCTTTTTAAACAAAAAAAATTCTAGTTGGTTTAACGCGTAAC,CGGTCAGATACCTCATTTCAAACCTAGAGGGGTGCTGGAGGCGGTGGGGCTAATATTTAAGGTTGGACATCAGCTTTTTAAACAAAAAAAATTCTAGTT,10,30,14,27,27,39,27,54,27,29,29,39,44,54,33.06,2.495298687
hek293t,19024,1,15,CGTAGAGATACCTCATTTCAAACCTAGAGTGGGGCTAATATTTAAGGTTGGACATCAGCTTTTTAAACAGTTACAGAAAAAAATTCTAGTTGGTTTAAC,CGTAGAGATACCTCATTTCAAACCTAGAGGGGTGCTGGAGGCGGTGGGGCTAATATTTAAGGTTGGACATCAGCTTTTTAAACAGTTACAGAAAAAAAT,10,30,14,27,27,32,27,47,27,29,29,32,44,47,33.06,0.0
hek293t,14381,1,8,ACCGTTCCAGGAATGGTCAAATCTTTATCAGGCCTCTCATAACTGTTCTCAGTAATCCAGCTCACTTACAAAATAAAAAAATTCTAGTTGGTTTAACGC,ACCGTTCCAGGAATGGTCAAATCTTTATCAGTAACGATGGCCTCTCATAACTGTTCTCAGTAATCCAGCTCACTTACAAAATAAAAAAATTCTAGTTGG,10,30,14,27,27,41,27,49,27,31,31,41,39,49,10.25,48.90030785
hek293t,14381,1,8,CACTATCCAGGAATGGTCAAATCTTTATCAGGCCTCTCATAACTGTTCTCAGTAATCCAGCTCACTTACAAAATCAGAAAAAAATTCTAGTTGGTTTAA,CACTATCCAGGAATGGTCAAATCTTTATCAGTAACGATGGCCTCTCATAACTGTTCTCAGTAATCCAGCTCACTTACAAAATCAGAAAAAAATTCTAGT,10,30,14,27,27,38,27,46,27,31,31,38,39,46,10.25,22.34572693
hek293t,14383,1,6,GAGATATTTTGTAATACAAATTACTTATCTGGTATGTAGACTTTCCAGAGAGACTCCAGAGTCCCCTCATGAAGTTCAAAAAAATTCTAGTTGGTTTAA,GAGATATTTTGTAATACAAATTACTTATCTGTCAATGGTATGTAGACTTTCCAGAGAGACTCCAGAGTCCCCTCATGAAGTTCAAAAAAATTCTAGTTG,10,30,14,27,27,40,27,46,27,30,30,40,36,46,2.59,2.247999407
hek293t,14383,1,6,GTAGAATTTTGTAATACAAATTACTTATCTGGTATGTAGACTTTCCAGAGAGACTCCAGAGTCCCCTCATGAAGTTCTCACCTTAAAAAAATTCTAGTT,GTAGAATTTTGTAATACAAATTACTTATCTGTCAATGGTATGTAGACTTTCCAGAGAGACTCCAGAGTCCCCTCATGAAGTTCTCACCTTAAAAAAATT,10,30,14,27,27,33,27,39,27,30,30,33,36,39,2.59,0.0
hek293t,14387,1,3,TAACGCCAGGCCTCTTATTTAATTCAAGAAGGCTATAAACTGAGTCTCCTATTGTGGAGATGTCTGGCTTTGTTTCAGAAAAAAATTCTAGTTGGTTTA,TAACGCCAGGCCTCTTATTTAATTCAAGAAGGCTATAAATAACTGAGTCTCCTATTGTGGAGATGTCTGGCTTTGTTTCAGAAAAAAATTCTAGTTGGT,10,30,14,27,27,42,27,45,27,39,39,42,42,45,14.67,0.0
hek293t,14387,1,3,ATGTACCAGGCCTCTTATTTAATTCAAGAAGGCTATAAACTGAGTCTCCTATTGTGGAGATGTCTGAAAAAAATTCTAGTTGGTTTAACGCGTAACTAG,ATGTACCAGGCCTCTTATTTAATTCAAGAAGGCTATAAATAACTGAGTCTCCTATTGTGGAGATGTCTGAAAAAAATTCTAGTTGGTTTAACGCGTAAC,10,30,14,27,27,54,27,57,27,39,39,54,42,57,14.67,6.559722183
hek293t,14389,1,9,TACTCTCTTTGGTGGAATGAGGTTTGCTGAGGCTCGAGCTCATGACTAGGCTGAAGTTATAAATAGTAAAAAAATTCTAGTTGGTTTAACGCGTAACTA,TACTCTCTTTGGTGGAATGAGGTTTGCTGAGGCTCGGATGCCGACAGCTCATGACTAGGCTGAAGTTATAAATAGTAAAAAAATTCTAGTTGGTTTAAC,10,30,14,27,27,47,27,56,27,37,37,47,46,56,57.25,7.519115587
hek293t,14390,1,1,TAGGATTCAGGAGTTAGGCTTGATGGAGATGGATGTTGCAAAGGGCCAGGGGTGAAGCTATGGCACAAAGCTTAAAAAAATTCTAGTTGGTTTAACGCG,TAGGATTCAGGAGTTAGGCTTGATGGAGATGGATGTTGCCAAAGGGCCAGGGGTGAAGCTATGGCACAAAGCTTAAAAAAATTCTAGTTGGTTTAACGC,10,30,14,27,27,49,27,50,27,39,39,49,40,50,51.91,67.8820751
hek293t,14390,1,1,TTACATTCAGGAGTTAGGCTTGATGGAGATGGATGTTGCAAAGGGCCAGGGGTGAAGCTATGGCACAAAAAAAAATTCTAGTTGGTTTAACGCGTAACT,TTACATTCAGGAGTTAGGCTTGATGGAGATGGATGTTGCCAAAGGGCCAGGGGTGAAGCTATGGCACAAAAAAAAATTCTAGTTGGTTTAACGCGTAAC,10,30,14,27,27,54,27,55,27,39,39,54,40,55,51.91,72.48895431
hek293t,17411,1,12,TTGGGATGTCATTCAATGTCAAGTGGCAAAGGCTGGGTAGGCTTGCCAAATCCACAAGGAGACTTTTAAAAAAATTCTAGTTGGTTTAACGCGTAACTA,TTGGGATGTCATTCAATGTCAAGTGGCAAAGGCTGGCCGTCCTTGGACGTAGGCTTGCCAAATCCACAAGGAGACTTTTAAAAAAATTCTAGTTGGTTT,10,30,14,27,27,44,27,56,27,37,37,44,49,56,20.39,14.31343707
hek293t,14393,1,7,TCGACCAAGGCCCCCCCCCTTCATACATGGGGCATCTTTGTTGACGTTACCAGCAGGCAAGTAGAAATGAAGAAAAAAATTCTAGTTGGTTTAACGCGT,TCGACCAAGGCCCCCCCCCTTCATACATGGGGCCCTTACTATCTTTGTTGACGTTACCAGCAGGCAAGTAGAAATGAAGAAAAAAATTCTAGTTGGTTT,10,30,14,27,27,44,27,51,27,34,34,44,41,51,51.15,0.997613425
hek293t,14393,1,7,TATCGCAAGGCCCCCCCCCTTCATACATGGGGCATCTTTGTTGACGTTACCAGCAGGCAAGTAGAAATGAAGCCAAAAAAAATTCTAGTTGGTTTAACG,TATCGCAAGGCCCCCCCCCTTCATACATGGGGCCCTTACTATCTTTGTTGACGTTACCAGCAGGCAAGTAGAAATGAAGCCAAAAAAAATTCTAGTTGG,10,30,14,27,27,41,27,48,27,34,34,41,41,48,51.15,0.562043067
hek293t,14395,1,4,ACGCTATCACCTCCACTACCATATAGATTAGGGCAGTTATCACTATATTCTCAACCCCCCCCTAGTGAAACCAAGCAAAAAAATTCTAGTTGGTTTAAC,ACGCTATCACCTCCACTACCATATAGATTAGGGCATGATGTTATCACTATATTCTCAACCCCCCCCTAGTGAAACCAAGCAAAAAAATTCTAGTTGGTT,10,30,14,27,27,43,27,47,27,36,36,43,40,47,34.86,59.10998571
hek293t,14397,1,10,ACTGAGACACAGAAAGACGCAGGAGTGGGGGGACCGTCTGCACTCCGCCTTTTGCAAACCAGGCAGTTAGAAAAAAATTCTAGTTGGTTTAACGCGTAA,ACTGAGACACAGAAAGACGCAGGAGTGGGGGGACCTTTGCTAAGGGTCTGCACTCCGCCTTTTGCAAACCAGGCAGTTAGAAAAAAATTCTAGTTGGTT,10,30,14,27,27,43,27,53,27,36,36,43,46,53,59.16,0.941115264
hek293t,14397,1,10,ACACTGACACAGAAAGACGCAGGAGTGGGGGGACCGTCTGCACTCCGCCTTTTGCAAACCAGGCAGTTAGACCAAAAAAAATTCTAGTTGGTTTAACGC,ACACTGACACAGAAAGACGCAGGAGTGGGGGGACCTTTGCTAAGGGTCTGCACTCCGCCTTTTGCAAACCAGGCAGTTAGACCAAAAAAAATTCTAGTT,10,30,14,27,27,39,27,49,27,36,36,39,46,49,59.16,0.0
hek293t,4001,1,7,CGCACTACTTTCCTGTGGTAAAAATAAGGTGGGAATTTAAGGAACAGTTATTCCAGTGAAAGATTAAAAAAATTCTAGTTGGTTTAACGCGTAACTAGA,CGCACTACTTTCCTGTGGTAAAAATAAGGTGGGAATTTAAGTACCGCGGAACAGTTATTCCAGTGAAAGATTAAAAAAATTCTAGTTGGTTTAACGCGT,10,30,14,27,27,51,27,58,27,41,41,51,48,58,36.7,0.0
hek293t,14400,1,5,TACAAAGTAGCATTTCTTGCTGTGGAAGCCGGTGAACAGCATGTGACATCTATGGCGGTTTTAATTTAGCAGGAAAAAAATTCTAGTTGGTTTAACGCG,TACAAAGTAGCATTTCTTGCTGTGGAAGCCGGTGAACGGTGTAGCATGTGACATCTATGGCGGTTTTAATTTAGCAGGAAAAAAATTCTAGTTGGTTTA,10,30,14,27,27,45,27,50,27,38,38,45,43,50,23.78,29.95786591
hek293t,14400,1,5,TACACAGTAGCATTTCTTGCTGTGGAAGCCGGTGAACAGCATGTGACATCTATGGCGGTTTTAATAAAAAAATTCTAGTTGGTTTAACGCGTAACTAGA,TACACAGTAGCATTTCTTGCTGTGGAAGCCGGTGAACGGTGTAGCATGTGACATCTATGGCGGTTTTAATAAAAAAATTCTAGTTGGTTTAACGCGTAA,10,30,14,27,27,53,27,58,27,38,38,53,43,58,23.78,33.51926333
hek293t,14402,1,2,GACTTAGGCAACAACAAGTGAGAACCTAATGGCTACCCCCCCCCAATTCATACAAAATGACTTATTAAGCAGTATTTGAACCAAAAAAATTCTAGTTGG,GACTTAGGCAACAACAAGTGAGAACCTAATGGCTACCCCCCCCCCCAATTCATACAAAATGACTTATTAAGCAGTATTTGAACCAAAAAAATTCTAGTT,10,30,14,27,27,39,27,41,27,36,36,39,38,41,18.91,0.0
hek293t,14404,1,12,GTTTGACACTGCATAGGTTTGGAGCAGGGGGGAGTTGAATTCTTCTGCTGAAAGCAACATTTTGCCATTATGCATATAGAAAAAAAATTCTAGTTGGTT,GTTTGACACTGCATAGGTTTGGAGCAGTGCAGGTCAGGGGGGGGAGTTGAATTCTTCTGCTGAAAGCAACATTTTGCCATTATGCATATAGAAAAAAAA,10,30,14,27,27,31,27,43,27,28,28,31,40,43,59.98,8.201376344
hek293t,14404,1,12,AATTAACACTGCATAGGTTTGGAGCAGGGGGGAGTTGAATTCTTCTGCTGAAAGCAACATTTTGCCATTATGCAAAAAAATTCTAGTTGGTTTAACGCG,AATTAACACTGCATAGGTTTGGAGCAGTGCAGGTCAGGGGGGGGAGTTGAATTCTTCTGCTGAAAGCAACATTTTGCCATTATGCAAAAAAATTCTAGT,10,30,14,27,27,38,27,50,27,28,28,38,40,50,59.98,5.200979782
hek293t,14406,1,12,TAAACGTTCAGTTATTGGTACAATTACAGTGGAAGCATCCCTGTGTAATCACAGTACACAGGGAAAAAAAATTCTAGTTGGTTTAACGCGTAACTAGAT,TAAACGTTCAGTTATTGGTACAATTACAGTGCGGAAGACCGGCGAAGCATCCCTGTGTAATCACAGTACACAGGGAAAAAAAATTCTAGTTGGTTTAAC,10,30,14,27,27,47,27,59,27,32,32,47,44,59,57.32,10.00083418
hek293t,14406,1,12,GTCCCGTTCAGTTATTGGTACAATTACAGTGGAAGCATCCCTGTGTAATCACAGTACACAGGGAACAAAGCAAAAAAAATTCTAGTTGGTTTAACGCGT,GTCCCGTTCAGTTATTGGTACAATTACAGTGCGGAAGACCGGCGAAGCATCCCTGTGTAATCACAGTACACAGGGAACAAAGCAAAAAAAATTCTAGTT,10,30,14,27,27,39,27,51,27,32,32,39,44,51,57.32,4.316085559
hek293t,14408,1,15,CAACGACTTCAGCTTTACTTCAGGGTAGCAGGCAGCAAATCTTTAAAAGTACACTACTTATGGGCAAAAAAATTCTAGTTGGTTTAACGCGTAACTAGA,CAACGACTTCAGCTTTACTTCAGGGTAGCAGGTGAAAATACCCTGGTCAGCAAATCTTTAAAAGTACACTACTTATGGGCAAAAAAATTCTAGTTGGTT,10,30,14,27,27,43,27,58,27,33,33,43,48,58,28.33,1.49667586
hek293t,3904,1,7,CTGAGAAACTGGTATGTTAAACTTGCCTGAGGCATCTGGCACAGAATTCTTTGGTCTGAATACTTCACACTAGGCTATGATAAAAAAAAATTCTAGTTG,CTGAGAAACTGGTATGTTAAACTTGCCTGATTGGTCAGGCATCTGGCACAGAATTCTTTGGTCTGAATACTTCACACTAGGCTATGATAAAAAAAAATT,10,30,14,27,27,33,27,40,27,30,30,33,37,40,55.74,2.936966721
hek293t,3904,1,7,TGGCTAAACTGGTATGTTAAACTTGCCTGAGGCATCTGGCACAGAATTCTTTGGTCTGAATACTTCACACTAGGCTATGAAAAAAATTCTAGTTGGTTT,TGGCTAAACTGGTATGTTAAACTTGCCTGATTGGTCAGGCATCTGGCACAGAATTCTTTGGTCTGAATACTTCACACTAGGCTATGAAAAAAATTCTAG,10,30,14,27,27,37,27,44,27,30,30,37,37,44,55.74,1.575874051
hek293t,14412,1,7,AGTTCCCGAGACACCCGGCCTCCCAGAACAGGCAGCGAGATGGTCGGTAGAGGTGGGTGGTGTAACATCTCGCTGCGCTGAAAAAAATTCTAGTTGGTT,AGTTCCCGAGACACCCGGCCTCCCAGAACAGGCTTTGCTCAGCGAGATGGTCGGTAGAGGTGGGTGGTGTAACATCTCGCTGCGCTGAAAAAAATTCTA,10,30,14,27,27,36,27,43,27,33,33,36,40,43,57.63,4.442494442
hek293t,14414,1,14,CTGTGTCCAAGGACATTTTACTGTCCGGATGGGCCCATGAGGGCAACAGATTCTGTTGCATCCTAAAAAAATTCTAGTTGGTTTAACGCGTAACTAGAT,CTGTGTCCAAGGACATTTTACTGTCCGGATGGGCAATGACAAGTAAGACCATGAGGGCAACAGATTCTGTTGCATCCTAAAAAAATTCTAGTTGGTTTA,10,30,14,27,27,45,27,59,27,35,35,45,49,59,24.11,2.269035341
hek293t,14414,1,14,GGAGCTCCAAGGACATTTTACTGTCCGGATGGGCCCATGAGGGCAACAGATTCTGTTGCATCCTCTTCTCCAAAAAAATTCTAGTTGGTTTAACGCGTA,GGAGCTCCAAGGACATTTTACTGTCCGGATGGGCAATGACAAGTAAGACCATGAGGGCAACAGATTCTGTTGCATCCTCTTCTCCAAAAAAATTCTAGT,10,30,14,27,27,38,27,52,27,35,35,38,49,52,24.11,0.0
hek293t,14416,1,14,GGTCAAGTAGTAGCCAAGTTCTTAGCAAATGGATTGCTTTAACACATACACAAGCTTAAAGGGCAAAGAGAAAAAAAATTCTAGTTGGTTTAACGCGTA,GGTCAAGTAGTAGCCAAGTTCTTAGCAGTGCTAAAGTGTTAAATGGATTGCTTTAACACATACACAAGCTTAAAGGGCAAAGAGAAAAAAAATTCTAGT,10,30,14,27,27,38,27,52,27,28,28,38,42,52,25.85,8.033493451
hek293t,14416,1,14,TTTTAAGTAGTAGCCAAGTTCTTAGCAAATGGATTGCTTTAACACATACACAAGCTTAAAGGGCAAAGAGAGTAGTACAAAAAAATTCTAGTTGGTTTA,TTTTAAGTAGTAGCCAAGTTCTTAGCAGTGCTAAAGTGTTAAATGGATTGCTTTAACACATACACAAGCTTAAAGGGCAAAGAGAGTAGTACAAAAAAA,10,30,14,27,27,31,27,45,27,28,28,31,42,45,25.85,0.555771089
hek293t,14420,1,11,GAGACCTTAGTCACGCTCACCTCTTCAGGAGGGTCGCCGTCAGGCCTTCCCTTCCTGGCCTGGCATCAAACACTTCTGGGAAAAAAAATTCTAGTTGGT,GAGACCTTAGTCACGCTCACCTCTTCAACCCGACCGCGGGAGGGTCGCCGTCAGGCCTTCCCTTCCTGGCCTGGCATCAAACACTTCTGGGAAAAAAAA,10,30,14,27,27,31,27,42,27,28,28,31,39,42,49.59,2.14904568
hek293t,14420,1,11,CCTATCTTAGTCACGCTCACCTCTTCAGGAGGGTCGCCGTCAGGCCTTCCCTTCCTGGCCTGGCATCAAACACTAAAAAAATTCTAGTTGGTTTAACGC,CCTATCTTAGTCACGCTCACCTCTTCAACCCGACCGCGGGAGGGTCGCCGTCAGGCCTTCCCTTCCTGGCCTGGCATCAAACACTAAAAAAATTCTAGT,10,30,14,27,27,38,27,49,27,28,28,38,39,49,49.59,66.76282562
hek293t,14422,1,11,AATGGCAGAAGCAGTTTCCATCATAATATCGGGCTAGGGGCTCTCGCTGTGATGTATCTAAACACTGGACAAAAAAATTCTAGTTGGTTTAACGCGTAA,AATGGCAGAAGCAGTTTCCATCATAATATCGGGCTAGGACGAGTTCAACGGCTCTCGCTGTGATGTATCTAAACACTGGACAAAAAAATTCTAGTTGGT,10,30,14,27,27,42,27,53,27,39,39,42,50,53,11.66,0.0
hek293t,14423,1,5,CCCTCAAACACTGGTTAACTCCTGCCTAGAGGCTACCAGAAGGAACTTGAGGACATCAGGAATCTACCATCTAGATTTCAGAAAAAAATTCTAGTTGGT,CCCTCAAACACTGGTTAACTCCTGCCCAAGCTAGAGGCTACCAGAAGGAACTTGAGGACATCAGGAATCTACCATCTAGATTTCAGAAAAAAATTCTAG,10,30,14,27,27,37,27,42,27,27,27,37,32,42,49.53,83.0894828
hek293t,14423,1,5,CGTCCAAACACTGGTTAACTCCTGCCTAGAGGCTACCAGAAGGAACTTGAGGACATCAGGAATCTACCATCTAGATTTCAGTCGGTTGAAAAAAATTCT,CGTCCAAACACTGGTTAACTCCTGCCCAAGCTAGAGGCTACCAGAAGGAACTTGAGGACATCAGGAATCTACCATCTAGATTTCAGTCGGTTGAAAAAA,10,30,14,27,27,30,27,35,27,27,27,30,32,35,49.53,14.865379
hek293t,13203,1,10,CGTGCCCTCCTCTGTCCAAGGCTTGAAGCAGGAGGCACTTAATTTGCAGATAAAGAACAGGCTCAAAAAAATTCTAGTTGGTTTAACGCGTAACTAGAT,CGTGCCCTCCTCTGTCCAAGGCTTGAAGCAGGATGGAGTAATGGGCACTTAATTTGCAGATAAAGAACAGGCTCAAAAAAATTCTAGTTGGTTTAACGC,10,30,14,27,27,49,27,59,27,34,34,49,44,59,36.86,2.652457762
hek293t,13203,1,10,CCGTGCCTCCTCTGTCCAAGGCTTGAAGCAGGAGGCACTTAATTTGCAGATAAAGAACAGGCTCAAACTTTCCCCCAAAAAAATTCTAGTTGGTTTAAC,CCGTGCCTCCTCTGTCCAAGGCTTGAAGCAGGATGGAGTAATGGGCACTTAATTTGCAGATAAAGAACAGGCTCAAACTTTCCCCCAAAAAAATTCTAG,10,30,14,27,27,37,27,47,27,34,34,37,44,47,36.86,0.0
hek293t,14427,1,3,TATTATTGGATTCTTTTTGAGTATAAACTTGGAGTTCTGAAGCTTTCTGATGAGAAAACAGGAGAAAAAGTAAAAAAATTCTAGTTGGTTTAACGCGTA,TATTATTGGATTCTTTTTGAGTATAAACTTGGAGTTCTTGTGAAGCTTTCTGATGAGAAAACAGGAGAAAAAGTAAAAAAATTCTAGTTGGTTTAACGC,10,30,14,27,27,49,27,52,27,39,39,49,42,52,10.88,8.049867483
hek293t,14427,1,3,TTCAATTGGATTCTTTTTGAGTATAAACTTGGAGTTCTGAAGCTTTCTGATGAGAAAACAGGAGAAAAAGTAGGAAAAAAATTCTAGTTGGTTTAACGC,TTCAATTGGATTCTTTTTGAGTATAAACTTGGAGTTCTTGTGAAGCTTTCTGATGAGAAAACAGGAGAAAAAGTAGGAAAAAAATTCTAGTTGGTTTAA,10,30,14,27,27,46,27,49,27,39,39,46,42,49,10.88,5.423212557
hek293t,14431,1,3,TTGCGTCCAAATACCCCCCCCAGCCACTGTGGGGAAATCTGTAACATGCAGATGTGATAATTTAAGCATAAAATGAAAAAAAATTCTAGTTGGTTTAAC,TTGCGTCCAAATACCCCCCCCAGCCACTAGCGTGGGGAAATCTGTAACATGCAGATGTGATAATTTAAGCATAAAATGAAAAAAAATTCTAGTTGGTTT,10,30,14,27,27,44,27,47,27,29,29,44,32,47,53.96,32.75357236
hek293t,14433,1,13,ACAAGAGTTTGTAATGTTAGCTAGTGCACTGGTTAGTATCTGAGTAGTTTTCATGAGACATGTATGGAAAAAAAAATTCTAGTTGGTTTAACGCGTAAC,ACAAGAGTTTGTAATGTTAGCTAGTGCACTGGTTAGTGGTTCAATCTGCGATCTGAGTAGTTTTCATGAGACATGTATGGAAAAAAAAATTCTAGTTGG,10,30,14,27,27,41,27,54,27,38,38,41,51,54,51.87,0.0
hek293t,14434,1,9,CGAAAATTAACTCTGAGAGACAGAGCAAATGGGAAGAGATTTTAGTCAGGAACATAGAGGATGAATGTAAATGGTTTACAAAAAAATTCTAGTTGGTTT,CGAAAATTAACTCTGAGAGACAGAGCAAATGGGGTCACTAGGAAGAGATTTTAGTCAGGAACATAGAGGATGAATGTAAATGGTTTACAAAAAAATTCT,10,30,14,27,27,35,27,44,27,32,32,35,41,44,28.14,0.0
hek293t,14434,1,9,TCCGAATTAACTCTGAGAGACAGAGCAAATGGGAAGAGATTTTAGTCAGGAACATAGAGGATGAATGTAAATGGTAAAAAAATTCTAGTTGGTTTAACG,TCCGAATTAACTCTGAGAGACAGAGCAAATGGGGTCACTAGGAAGAGATTTTAGTCAGGAACATAGAGGATGAATGTAAATGGTAAAAAAATTCTAGTT,10,30,14,27,27,39,27,48,27,32,32,39,41,48,28.14,0.649900276
hek293t,14436,1,3,CCACCTTGAGATGAAGGCTATGACAAATGTGGAACAGCTTTACTGTTTTTCTTAAATGCAATAACTAATTCTAAAAAAAAAATTCTAGTTGGTTTAACG,CCACCTTGAGATGAAGGCTATGACAAATGTGGAACAGTTTCTTTACTGTTTTTCTTAAATGCAATAACTAATTCTAAAAAAAAAATTCTAGTTGGTTTA,10,30,14,27,27,45,27,48,27,38,38,45,41,48,66.48,67.52262447
hek293t,14436,1,3,AGAGGTTGAGATGAAGGCTATGACAAATGTGGAACAGCTTTACTGTTTTTCTTAAATGCAATAACTAATTCTAAAAAAATTCTAGTTGGTTTAACGCGT,AGAGGTTGAGATGAAGGCTATGACAAATGTGGAACAGTTTCTTTACTGTTTTTCTTAAATGCAATAACTAATTCTAAAAAAATTCTAGTTGGTTTAACG,10,30,14,27,27,48,27,51,27,38,38,48,41,51,66.48,65.18587718
hek293t,14440,1,11,CTAGTAGCGCTGCCGGCGGTTTGTAAGGGTGGTCCTCAGTCAACTCAATGTTATTTCTGTTGCATGACACAGACTAAAAAAATTCTAGTTGGTTTAACG,CTAGTAGCGCTGCCGGCGGTTTGTAAGGGGGGTTCCTAGTTGGTCCTCAGTCAACTCAATGTTATTTCTGTTGCATGACACAGACTAAAAAAATTCTAG,10,30,14,27,27,37,27,48,27,30,30,37,41,48,51.52,0.0
hek293t,14442,1,1,GAAAAGTACAGCATCACGTTTACTTGACATGGGTATCATACAAATTCATATTAAACATAGCAATTAAAAAAAATTCTAGTTGGTTTAACGCGTAACTAG,GAAAAGTACAGCATCACGTTTACTTGACATGGGTATCATATCAAATTCATATTAAACATAGCAATTAAAAAAAATTCTAGTTGGTTTAACGCGTAACTA,10,30,14,27,27,56,27,57,27,41,41,56,42,57,22.11,26.93790122
hek293t,14442,1,1,TCTCAGTACAGCATCACGTTTACTTGACATGGGTATCATACAAATTCATATTAAACATAGCAATTACACCTAAAAAAATTCTAGTTGGTTTAACGCGTA,TCTCAGTACAGCATCACGTTTACTTGACATGGGTATCATATCAAATTCATATTAAACATAGCAATTACACCTAAAAAAATTCTAGTTGGTTTAACGCGT,10,30,14,27,27,51,27,52,27,41,41,51,42,52,22.11,55.17163037
hek293t,3331,1,7,GTGTTCACACGAGCAACTTGGCAGGTTGGAGGAAGTGGTGGAGATAAATGACACATGACTTCAAGGAAAAAAATTCTAGTTGGTTTAACGCGTAACTAG,GTGTTCACACGAGCAACTTGGCAGGTTGGAGGAAGTGGTGGACTCAGGAGATAAATGACACATGACTTCAAGGAAAAAAATTCTAGTTGGTTTAACGCG,10,30,14,27,27,50,27,57,27,40,40,50,47,57,59.43,6.499601415
hek293t,21908,1,6,CCGCATTCAGAAAGATACAGATAAGGATATGGATATGAGAGCAACCAGGCTTTTTCACAGCCACGTAAAAAAATTCTAGTTGGTTTAACGCGTAACTAG,CCGCATTCAGAAAGATACAGATAAGGATATGGATATGAGAGACAAAGCAACCAGGCTTTTTCACAGCCACGTAAAAAAATTCTAGTTGGTTTAACGCGT,10,30,14,27,27,51,27,57,27,41,41,51,47,57,49.26,5.930368566
hek293t,20630,1,4,AGACCTTGCTTTTATTGTTATGAATTGTGTGGATAATTGATGGCAGATTGCCTAGAGCCTGGGATAGGCCTCAAAAAAATTCTAGTTGGTTTAACGCGT,AGACCTTGCTTTTATTGTTATGAATTGTGTGACCAGATAATTGATGGCAGATTGCCTAGAGCCTGGGATAGGCCTCAAAAAAATTCTAGTTGGTTTAAC,10,30,14,27,27,47,27,51,27,32,32,47,36,51,21.17,19.12408003
hek293t,20630,1,4,CTTTCTTGCTTTTATTGTTATGAATTGTGTGGATAATTGATGGCAGATTGCCTAGAGCCTGGGATAGGCCTCTTTTTAAAAAAATTCTAGTTGGTTTAA,CTTTCTTGCTTTTATTGTTATGAATTGTGTGACCAGATAATTGATGGCAGATTGCCTAGAGCCTGGGATAGGCCTCTTTTTAAAAAAATTCTAGTTGGT,10,30,14,27,27,42,27,46,27,32,32,42,36,46,21.17,32.34377678
hek293t,14448,1,12,GATAACTAAAATCATAAAATCATATAAGTAGGTGCCCAACATTGCATAGAAATATAAAGGTGTTATTGAAAAAAATTCTAGTTGGTTTAACGCGTAACT,GATAACTAAAATCATAAAATCATATAAGTAGGTGCCCAATGCATTGGAGTACATTGCATAGAAATATAAAGGTGTTATTGAAAAAAATTCTAGTTGGTT,10,30,14,27,27,43,27,55,27,40,40,43,52,55,37.57,0.0
hek293t,14449,1,2,GGACGACAAAAGCCAGCAAAAGGTTGGGCTGGTTAAATCCTAAGAGGCATTAGGAACAGTGAGGTGTGCTACGCCCCAAAAAAATTCTAGTTGGTTTAA,GGACGACAAAAGCCAGCAAAAGGTTGGGTACTGGTTAAATCCTAAGAGGCATTAGGAACAGTGAGGTGTGCTACGCCCCAAAAAAATTCTAGTTGGTTT,10,30,14,27,27,44,27,46,27,29,29,44,31,46,44.32,11.01682715
hek293t,14449,1,2,CATGAACAAAAGCCAGCAAAAGGTTGGGCTGGTTAAATCCTAAGAGGCATTAGGAACAGTGAGGTGTGCTACGCCCCGGGGTGGGTCACAAAAAAATTC,CATGAACAAAAGCCAGCAAAAGGTTGGGTACTGGTTAAATCCTAAGAGGCATTAGGAACAGTGAGGTGTGCTACGCCCCGGGGTGGGTCACAAAAAAAT,10,30,14,27,27,32,27,34,27,29,29,32,31,34,44.32,0.0
hek293t,14451,1,10,TGACCGTATCTTATTTAGAAAGAGTAAAGGGGGTCTAGTTGGTGCCTCTGACCTACCTTGGATGTGAGATAAAAAAATTCTAGTTGGTTTAACGCGTAA,TGACCGTATCTTATTTAGAAAGAGTAAAGGGGGTCAAGCTGTCGGTAGTTGGTGCCTCTGACCTACCTTGGATGTGAGATAAAAAAATTCTAGTTGGTT,10,30,14,27,27,43,27,53,27,36,36,43,46,53,30.41,0.0
hek293t,14451,1,10,ATAGCGTATCTTATTTAGAAAGAGTAAAGGGGGTCTAGTTGGTGCCTCTGACCTACCTTGGATGTGAAAAAAAATTCTAGTTGGTTTAACGCGTAACTA,ATAGCGTATCTTATTTAGAAAGAGTAAAGGGGGTCAAGCTGTCGGTAGTTGGTGCCTCTGACCTACCTTGGATGTGAAAAAAAATTCTAGTTGGTTTAA,10,30,14,27,27,46,27,56,27,36,36,46,46,56,30.41,0.166676917
hek293t,14453,1,7,GCGTATCTGCTTCCCAGGTGGCGGGGGAGAGGGGCTCGAGTTGACGCTGGTTTGCTAAGACCCGCAGTGTTGGACTAAAAAAATTCTAGTTGGTTTAAC,GCGTATCTGCTTCCCAGGTGGCGGGGGAGAGGGGCTAGCGTGCCGAGTTGACGCTGGTTTGCTAAGACCCGCAGTGTTGGACTAAAAAAATTCTAGTTG,10,30,14,27,27,40,27,47,27,37,37,40,44,47,6.72,0.0
hek293t,14453,1,7,GGGCCTCTGCTTCCCAGGTGGCGGGGGAGAGGGGCTCGAGTTGACGCTGGTTTGCTAAGACCCGCAGTGTTGAAAAAAATTCTAGTTGGTTTAACGCGT,GGGCCTCTGCTTCCCAGGTGGCGGGGGAGAGGGGCTAGCGTGCCGAGTTGACGCTGGTTTGCTAAGACCCGCAGTGTTGAAAAAAATTCTAGTTGGTTT,10,30,14,27,27,44,27,51,27,37,37,44,44,51,6.72,0.0
hek293t,14455,1,9,ACCACTCAGGACTTACATATACTCAGTGACGGAAATGTTGCACTTCACCTTGCACACATTTATGAACCTGCCAAAAAAAAAATTCTAGTTGGTTTAACG,ACCACTCAGGACTTACATATACTCAGTGCAAGTCTAAACGGAAATGTTGCACTTCACCTTGCACACATTTATGAACCTGCCAAAAAAAAAATTCTAGTT,10,30,14,27,27,39,27,48,27,29,29,39,38,48,68.17,19.09470783
hek293t,14455,1,9,GAAAATCAGGACTTACATATACTCAGTGACGGAAATGTTGCACTTCACCTTGCACACATTTATGAACCTGCCAAACTGCGCAAAAAAAATTCTAGTTGG,GAAAATCAGGACTTACATATACTCAGTGCAAGTCTAAACGGAAATGTTGCACTTCACCTTGCACACATTTATGAACCTGCCAAACTGCGCAAAAAAAAT,10,30,14,27,27,32,27,41,27,29,29,32,38,41,68.17,0.0
hek293t,14457,1,13,CCTCGTTTCTTGTGCTCTTTTTATTAAGGAGGAATATGACCTGACACTTATCACTAGAAGCAGCATGCAAAAAAAATTCTAGTTGGTTTAACGCGTAAC,CCTCGTTTCTTGTGCTCTTTTTATTAAGGACTCATATCTTACGGGAATATGACCTGACACTTATCACTAGAAGCAGCATGCAAAAAAAATTCTAGTTGG,10,30,14,27,27,41,27,54,27,31,31,41,44,54,6.53,0.058892815
hek293t,14457,1,13,TGCGTTTTCTTGTGCTCTTTTTATTAAGGAGGAATATGACCTGACACTTATCACTAGAAGCAGCAAAAAAATTCTAGTTGGTTTAACGCGTAACTAGAT,TGCGTTTTCTTGTGCTCTTTTTATTAAGGACTCATATCTTACGGGAATATGACCTGACACTTATCACTAGAAGCAGCAAAAAAATTCTAGTTGGTTTAA,10,30,14,27,27,46,27,59,27,31,31,46,44,59,6.53,0.549238201
hek293t,14459,1,4,GCCACTGAACCTACTGTATGTGATGATATAGGCGTTGCTAAGCAACAAGTGATGATTGTTATAACCAATATTCAGAAAAAAATTCTAGTTGGTTTAACG,GCCACTGAACCTACTGTATGTGATGATATAGGCCCCTGTTGCTAAGCAACAAGTGATGATTGTTATAACCAATATTCAGAAAAAAATTCTAGTTGGTTT,10,30,14,27,27,44,27,48,27,34,34,44,38,48,34.33,71.24776501
hek293t,14459,1,4,GGCCATGAACCTACTGTATGTGATGATATAGGCGTTGCTAAGCAACAAGTGATGATTGTTATAACCAATAAAAAAAATTCTAGTTGGTTTAACGCGTAA,GGCCATGAACCTACTGTATGTGATGATATAGGCCCCTGTTGCTAAGCAACAAGTGATGATTGTTATAACCAATAAAAAAAATTCTAGTTGGTTTAACGC,10,30,14,27,27,49,27,53,27,34,34,49,38,53,34.33,79.42257992
hek293t,14461,1,15,ATCGTAACAGGCTTTTTGGGGCAAGGTCCTGGAGACCAAGCTGTAATACACAGGACTAGATCACTGAGACACGTAAAAAAATTCTAGTTGGTTTAACGC,ATCGTAACAGGCTTTTTGGGGCAAGGAACATATTTCGAATCTCCTGGAGACCAAGCTGTAATACACAGGACTAGATCACTGAGACACGTAAAAAAATTC,10,30,14,27,27,34,27,49,27,27,27,34,42,49,18.67,6.159961096
hek293t,14463,1,12,TGAGTCCAGAAACTAATATCCCAAATCCTAGGGATACCAGATCCCCTCTTTTGAAAATCAAGCAATAAAAAAATTCTAGTTGGTTTAACGCGTAACTAG,TGAGTCCAGAAACTAATATCCCAAATCCTAGGGAAGTGGAAGTTGGTACCAGATCCCCTCTTTTGAAAATCAAGCAATAAAAAAATTCTAGTTGGTTTA,10,30,14,27,27,45,27,57,27,35,35,45,47,57,51.45,3.863780147
hek293t,14463,1,12,GCAACCCAGAAACTAATATCCCAAATCCTAGGGATACCAGATCCCCTCTTTTGAAAATCAAGCAATGCAAAAAAAATTCTAGTTGGTTTAACGCGTAAC,GCAACCCAGAAACTAATATCCCAAATCCTAGGGAAGTGGAAGTTGGTACCAGATCCCCTCTTTTGAAAATCAAGCAATGCAAAAAAAATTCTAGTTGGT,10,30,14,27,27,42,27,54,27,35,35,42,47,54,51.45,1.103713487
hek293t,14465,1,12,TATAAGAATGCCATTGAAAAGAGGATTCAAGGCAATGAAGGACTGTCGCTGGAGGGAAGAACACCATTTAAAAAAATTCTAGTTGGTTTAACGCGTAAC,TATAAGAATGCCATTGAAAAGAGGATTCAAGGCAGAGAAAGAGCACATGAAGGACTGTCGCTGGAGGGAAGAACACCATTTAAAAAAATTCTAGTTGGT,10,30,14,27,27,42,27,54,27,35,35,42,47,54,30.52,0.17398343
hek293t,14466,1,6,AGTATCAAATGGATAACATTTCTTAAAAGTGGCATGCAGTAGTGACTGTTACACGCTATGTATTTCATCTGCAGTGTTCAGGAAAAAAAATTCTAGTTG,AGTATCAAATGGATAACATTTCTTAATATTTAAAGTGGCATGCAGTAGTGACTGTTACACGCTATGTATTTCATCTGCAGTGTTCAGGAAAAAAAATTC,10,30,14,27,27,34,27,40,27,27,27,34,33,40,25.06,3.353638238
hek293t,14468,1,14,TTCCCTGAATACATAAATATTTTTGGTTTTGGTCAGTCTAGCAGGAAGCTGATAGTTAGGAGCATAAAAAAATTCTAGTTGGTTTAACGCGTAACTAGA,TTCCCTGAATACATAAATATTTTTGGTTAACCATGCCGGTAATTGGTCAGTCTAGCAGGAAGCTGATAGTTAGGAGCATAAAAAAATTCTAGTTGGTTT,10,30,14,27,27,44,27,58,27,29,29,44,43,58,-1.91,0.0
hek293t,14470,1,12,ATGTACTTGCTGAAACTATTAACAGTTTGAGGGAGTTTGGGGATTATAACTGGGCTTTTCTTTTTACAGTATGAAAAAAATTCTAGTTGGTTTAACGCG,ATGTACTTGCTGAAACTATTAACAGTTTGAAGGGTACAAGAAGGGAGTTTGGGGATTATAACTGGGCTTTTCTTTTTACAGTATGAAAAAAATTCTAGT,10,30,14,27,27,38,27,50,27,31,31,38,43,50,8.15,0.0
hek293t,14470,1,12,AATAGCTTGCTGAAACTATTAACAGTTTGAGGGAGTTTGGGGATTATAACTGGGCTTTTCTTTTTACAGTATGCTTTAAAAAAATTCTAGTTGGTTTAA,AATAGCTTGCTGAAACTATTAACAGTTTGAAGGGTACAAGAAGGGAGTTTGGGGATTATAACTGGGCTTTTCTTTTTACAGTATGCTTTAAAAAAATTC,10,30,14,27,27,34,27,46,27,31,31,34,43,46,8.15,0.0
hek293t,14476,1,7,TGGCATTGATTTTGATCATGAAATAAAATTGGCTAACTTCTAATATATTGGCGATTTTAAAACTGTACTGTGCAAAAAAATTCTAGTTGGTTTAACGCG,TGGCATTGATTTTGATCATGAAATAAAATTGGATTGCATCTAACTTCTAATATATTGGCGATTTTAAAACTGTACTGTGCAAAAAAATTCTAGTTGGTT,10,30,14,27,27,43,27,50,27,33,33,43,40,50,1.32,0.0
hek293t,14478,1,1,CATACAATGCAAATTTATCTGCATGGCTATGGCTGGAGAATACCTGAGAGGAGTAGGTGGGTGTGCAGATAACTAGAAGATTAAAAAAATTCTAGTTGG,CATACAATGCAAATTTATCTGCATGGCTATGGGCTGGAGAATACCTGAGAGGAGTAGGTGGGTGTGCAGATAACTAGAAGATTAAAAAAATTCTAGTTG,10,30,14,27,27,40,27,41,27,33,33,40,34,41,18.93,78.92754903
hek293t,14478,1,1,AGCCTAATGCAAATTTATCTGCATGGCTATGGCTGGAGAATACCTGAGAGGAGTAGGTGGGTGTGCAGATAACTAGAAGAAAAAAATTCTAGTTGGTTT,AGCCTAATGCAAATTTATCTGCATGGCTATGGGCTGGAGAATACCTGAGAGGAGTAGGTGGGTGTGCAGATAACTAGAAGAAAAAAATTCTAGTTGGTT,10,30,14,27,27,43,27,44,27,33,33,43,34,44,18.93,76.49782981
hek293t,14482,1,14,GGGCTTCCAAACACTAAATAAACACAAACAGGAAAATCCTCAGAAAACAAATCTTAGACAACTAAAAAAAAAAAATTCTAGTTGGTTTAACGCGTAACT,GGGCTTCCAAACACTAAATAAACACAAACAGGATGGGGAGTCCAGGCAAATCCTCAGAAAACAAATCTTAGACAACTAAAAAAAAAAAATTCTAGTTGG,10,30,14,27,27,41,27,55,27,34,34,41,48,55,14.94,0.0
hek293t,14482,1,14,CATTTTCCAAACACTAAATAAACACAAACAGGAAAATCCTCAGAAAACAAATCTTAGACAACTAAAAAAAAATTCTAGTTGGTTTAACGCGTAACTAGA,CATTTTCCAAACACTAAATAAACACAAACAGGATGGGGAGTCCAGGCAAATCCTCAGAAAACAAATCTTAGACAACTAAAAAAAAATTCTAGTTGGTTT,10,30,14,27,27,44,27,58,27,34,34,44,48,58,14.94,0.0
hek293t,14484,1,2,ATGCATAATGTGACCTGAAAGAAGAAATCAGGAAAAACAAATAAACATTGGGCTTTTCTCATGTATTAGGATAAACAAAAAAATTCTAGTTGGTTTAAC,ATGCATAATGTGACCTGAAAGAAGAAATCAGGAATCAAACAAATAAACATTGGGCTTTTCTCATGTATTAGGATAAACAAAAAAATTCTAGTTGGTTTA,10,30,14,27,27,45,27,47,27,35,35,45,37,47,37.49,1.090497713
hek293t,14484,1,2,CACGATAATGTGACCTGAAAGAAGAAATCAGGAAAAACAAATAAACATTGGGCTTTTCTCATGTATTAGGAAAAAAAATTCTAGTTGGTTTAACGCGTA,CACGATAATGTGACCTGAAAGAAGAAATCAGGAATCAAACAAATAAACATTGGGCTTTTCTCATGTATTAGGAAAAAAAATTCTAGTTGGTTTAACGCG,10,30,14,27,27,50,27,52,27,35,35,50,37,52,37.49,0.720432027
hek293t,14486,1,3,ACGCTGATAATCAAAGATTTCTACATTTCTGGCCAACTAGAAACATGGTGAACCTCAGCAGTATCTTCAAGAACGGCATAAAAAAATTCTAGTTGGTTT,ACGCTGATAATCAAAGATTTCTACATTTCTCTGGGCCAACTAGAAACATGGTGAACCTCAGCAGTATCTTCAAGAACGGCATAAAAAAATTCTAGTTGG,10,30,14,27,27,41,27,44,27,31,31,41,34,44,1.52,77.89294763
hek293t,14486,1,3,ACAAGGATAATCAAAGATTTCTACATTTCTGGCCAACTAGAAACATGGTGAACCTCAGCAGTATCTTCAAGAACGGCATTTCAAAAAAATTCTAGTTGG,ACAAGGATAATCAAAGATTTCTACATTTCTCTGGGCCAACTAGAAACATGGTGAACCTCAGCAGTATCTTCAAGAACGGCATTTCAAAAAAATTCTAGT,10,30,14,27,27,38,27,41,27,31,31,38,34,41,1.52,83.57092311
hek293t,14488,1,7,CTGAACTTAGGGTAGGATGGTTGGTTTGGAGGATGAAGAAAAAATATTACATGACAAAAAATCTCTAGAGAGATAATCAAAAAAAATTCTAGTTGGTTT,CTGAACTTAGGGTAGGATGGTTGGTTGACCTCCTGGAGGATGAAGAAAAAATATTACATGACAAAAAATCTCTAGAGAGATAATCAAAAAAAATTCTAG,10,30,14,27,27,37,27,44,27,27,27,37,34,44,52.06,42.47671796
hek293t,14488,1,7,CCTCTCTTAGGGTAGGATGGTTGGTTTGGAGGATGAAGAAAAAATATTACATGACAAAAAATCTCTAGAGAGATAATCAGTAAAAAAAATTCTAGTTGG,CCTCTCTTAGGGTAGGATGGTTGGTTGACCTCCTGGAGGATGAAGAAAAAATATTACATGACAAAAAATCTCTAGAGAGATAATCAGTAAAAAAAATTC,10,30,14,27,27,34,27,41,27,27,27,34,34,41,52.06,18.88736064
hek293t,14490,1,2,GTTTGTCCTGAGCTCAAGAGCGGTATGTTAGGTTTTTATTTATGCCAATAGCAGCAGATCTTGGTTTTTGCTGAAAAAAAAATTCTAGTTGGTTTAACG,GTTTGTCCTGAGCTCAAGAGCGGTATGTTAGGTTTATTTATTTATGCCAATAGCAGCAGATCTTGGTTTTTGCTGAAAAAAAAATTCTAGTTGGTTTAA,10,30,14,27,27,46,27,48,27,36,36,46,38,48,40.91,71.26121933
hek293t,14494,1,8,GCAGTCATTGGGACATACTGAAAAAGAAATGGTTAAACATGCTTACTAGTGAAAGTTGCATATCTGACATTGAAAAAAATTCTAGTTGGTTTAACGCGT,GCAGTCATTGGGACATACTGAAAAAGACACGAGATAATGGTTAAACATGCTTACTAGTGAAAGTTGCATATCTGACATTGAAAAAAATTCTAGTTGGTT,10,30,14,27,27,43,27,51,27,28,28,43,36,51,34.07,0.155601947
hek293t,14494,1,8,CGCCTCATTGGGACATACTGAAAAAGAAATGGTTAAACATGCTTACTAGTGAAAGTTGCATATCTGACATTGAATTAATAAAAAAAATTCTAGTTGGTT,CGCCTCATTGGGACATACTGAAAAAGACACGAGATAATGGTTAAACATGCTTACTAGTGAAAGTTGCATATCTGACATTGAATTAATAAAAAAAATTCT,10,30,14,27,27,35,27,43,27,28,28,35,36,43,34.07,0.018705574
hek293t,14497,1,2,AGTATGTTTAAATATATTACTCAAGCAGCTGGTAAACCCGTAGCACTGGCCCCCAGTACGTGTTCTGCTGAATGAGAGAAAAAAAATTCTAGTTGGTTT,AGTATGTTTAAATATATTACTCAAGCGGAGCTGGTAAACCCGTAGCACTGGCCCCCAGTACGTGTTCTGCTGAATGAGAGAAAAAAAATTCTAGTTGGT,10,30,14,27,27,42,27,44,27,27,27,42,29,44,21.13,72.29185892
hek293t,14497,1,2,AATATGTTTAAATATATTACTCAAGCAGCTGGTAAACCCGTAGCACTGGCCCCCAGTACGTGTTCTGCTGAATGAGAGACTGAGGAAAAAAAAATTCTA,AATATGTTTAAATATATTACTCAAGCGGAGCTGGTAAACCCGTAGCACTGGCCCCCAGTACGTGTTCTGCTGAATGAGAGACTGAGGAAAAAAAAATTC,10,30,14,27,27,34,27,36,27,27,27,34,29,36,21.13,67.49619576
hek293t,14499,1,3,GCTGTGTGCTGCATGGCTGTAGTGGAGCAAGGAATGGCAGTACTCTTTTTCCTGTGGTGAGCCTGGGAATGGAAAAAAATTCTAGTTGGTTTAACGCGT,GCTGTGTGCTGCATGGCTGTAGTGGAGCAAGGAATGGATCCAGTACTCTTTTTCCTGTGGTGAGCCTGGGAATGGAAAAAAATTCTAGTTGGTTTAACG,10,30,14,27,27,48,27,51,27,38,38,48,41,51,65.94,84.19742518
hek293t,14499,1,3,CGAAGGTGCTGCATGGCTGTAGTGGAGCAAGGAATGGCAGTACTCTTTTTCCTGTGGTGAGCCTGGGAAAAAAATTCTAGTTGGTTTAACGCGTAACTA,CGAAGGTGCTGCATGGCTGTAGTGGAGCAAGGAATGGATCCAGTACTCTTTTTCCTGTGGTGAGCCTGGGAAAAAAATTCTAGTTGGTTTAACGCGTAA,10,30,14,27,27,53,27,56,27,38,38,53,41,56,65.94,80.49183162
hek293t,14501,1,6,ATGTGTTAATCAAAAGAATTGACAAAATCAGGCTTTAAGACATGGAAAATCAGGCTTTATGGTGAAAAGAAAAAAAAAATTCTAGTTGGTTTAACGCGT,ATGTGTTAATCAAAAGAATTGACAAAATCAAAATTAGGCTTTAAGACATGGAAAATCAGGCTTTATGGTGAAAAGAAAAAAAAAATTCTAGTTGGTTTA,10,30,14,27,27,45,27,51,27,30,30,45,36,51,6.11,0.0
hek293t,14501,1,6,ACGTATTAATCAAAAGAATTGACAAAATCAGGCTTTAAGACATGGAAAATCAGGCTTTATGGTGAAAAGAAAATTGAAAAAAAATTCTAGTTGGTTTAA,ACGTATTAATCAAAAGAATTGACAAAATCAAAATTAGGCTTTAAGACATGGAAAATCAGGCTTTATGGTGAAAAGAAAATTGAAAAAAAATTCTAGTTG,10,30,14,27,27,40,27,46,27,30,30,40,36,46,6.11,0.0
hek293t,14503,1,3,GACAGATTATTCAGACACTCATGGTTCACAGGCTTTAAAACTGATAGGGAGCTGTTAATGGACTAGAGACATTACATACAACAGTAAAAAAATTCTAGT,GACAGATTATTCAGACACTCATGGTTCACAGCCGGCTTTAAAACTGATAGGGAGCTGTTAATGGACTAGAGACATTACATACAACAGTAAAAAAATTCT,10,30,14,27,27,35,27,38,27,32,32,35,35,38,33.02,0.0
hek293t,14503,1,3,CTTCCATTATTCAGACACTCATGGTTCACAGGCTTTAAAACTGATAGGGAGCTGTTAATGGACTAGAGACATTACATACAAAAAAAAATTCTAGTTGGT,CTTCCATTATTCAGACACTCATGGTTCACAGCCGGCTTTAAAACTGATAGGGAGCTGTTAATGGACTAGAGACATTACATACAAAAAAAAATTCTAGTT,10,30,14,27,27,39,27,42,27,32,32,39,35,42,33.02,77.64891889
hek293t,14505,1,14,TGATTAAGCAAAAACAACATATGTCAGTTAGGCACCAGCTTGAAAGGCAAGAGGCAAGTGATTTTAGGCAAAAAAAATTCTAGTTGGTTTAACGCGTAA,TGATTAAGCAAAAACAACATATGTCAGTTAGGCACGACCTATAGAATACCAGCTTGAAAGGCAAGAGGCAAGTGATTTTAGGCAAAAAAAATTCTAGTT,10,30,14,27,27,39,27,53,27,36,36,39,50,53,22.81,0.0
hek293t,14505,1,14,CCTGGAAGCAAAAACAACATATGTCAGTTAGGCACCAGCTTGAAAGGCAAGAGGCAAGTGATTTTAAAAAAAATTCTAGTTGGTTTAACGCGTAACTAG,CCTGGAAGCAAAAACAACATATGTCAGTTAGGCACGACCTATAGAATACCAGCTTGAAAGGCAAGAGGCAAGTGATTTTAAAAAAAATTCTAGTTGGTT,10,30,14,27,27,43,27,57,27,36,36,43,50,57,22.81,0.265913269
hek293t,16183,1,4,CAGTAACTAATTCAAACTAGTGTTGCAGGTGGCAGACAGCTGCGGTGCACCGTCTTGACCAGCATAAAAAAATTCTAGTTGGTTTAACGCGTAACTAGA,CAGTAACTAATTCAAACTAGTGTTGCAGGTGGCAGACAGGCGGCTGCGGTGCACCGTCTTGACCAGCATAAAAAAATTCTAGTTGGTTTAACGCGTAAC,10,30,14,27,27,54,27,58,27,39,39,54,43,58,42.55,82.30578546
hek293t,16183,1,4,GAACTACTAATTCAAACTAGTGTTGCAGGTGGCAGACAGCTGCGGTGCACCGTCTTGACCAGCATCCTGCCAGAAAAAAATTCTAGTTGGTTTAACGCG,GAACTACTAATTCAAACTAGTGTTGCAGGTGGCAGACAGGCGGCTGCGGTGCACCGTCTTGACCAGCATCCTGCCAGAAAAAAATTCTAGTTGGTTTAA,10,30,14,27,27,46,27,50,27,39,39,46,43,50,42.55,22.93016364
hek293t,14509,1,7,GACACATGCTTGGCGGTTTAGGGAACATTAGGCTGAGGTCCACATATTTCAGGAGAATTTTTGGGCCTCAGTTAAAAAAATTCTAGTTGGTTTAACGCG,GACACATGCTTGGCGGTTTAGGGAACATTAGGCTGAGGTTAAATCTCCACATATTTCAGGAGAATTTTTGGGCCTCAGTTAAAAAAATTCTAGTTGGTT,10,30,14,27,27,43,27,50,27,40,40,43,47,50,32.06,0.0
hek293t,14509,1,7,TGCTAATGCTTGGCGGTTTAGGGAACATTAGGCTGAGGTCCACATATTTCAGGAGAATTTTTGGGCCTCAAAAAAATTCTAGTTGGTTTAACGCGTAAC,TGCTAATGCTTGGCGGTTTAGGGAACATTAGGCTGAGGTTAAATCTCCACATATTTCAGGAGAATTTTTGGGCCTCAAAAAAATTCTAGTTGGTTTAAC,10,30,14,27,27,47,27,54,27,40,40,47,47,54,32.06,0.933752034
hek293t,14511,1,7,ACTATTTAAACCATAGCAACAGTTGCTAATGGAACATGTACTTAAACCTAAAGACAGTTTTTGCTCAAAAAAATTCTAGTTGGTTTAACGCGTAACTAG,ACTATTTAAACCATAGCAACAGTTGCTAATGGAAGAGAAAGCATGTACTTAAACCTAAAGACAGTTTTTGCTCAAAAAAATTCTAGTTGGTTTAACGCG,10,30,14,27,27,50,27,57,27,35,35,50,42,57,25.56,17.88261494
hek293t,14511,1,7,AGCCTTTAAACCATAGCAACAGTTGCTAATGGAACATGTACTTAAACCTAAAGACAGTTTTTGCTCAATCAGTTAAAAAAATTCTAGTTGGTTTAACGC,AGCCTTTAAACCATAGCAACAGTTGCTAATGGAAGAGAAAGCATGTACTTAAACCTAAAGACAGTTTTTGCTCAATCAGTTAAAAAAATTCTAGTTGGT,10,30,14,27,27,42,27,49,27,35,35,42,42,49,25.56,4.459307701
hek293t,14515,1,3,CCTCATTAATTAATGACAACTCTTCACAATGGCCTTCGAATAGCACTTAAGACAGCAATTAAGAGCATATGTGAGACTTGCAAAAAAATTCTAGTTGGT,CCTCATTAATTAATGACAACTCTTCACACGGATGGCCTTCGAATAGCACTTAAGACAGCAATTAAGAGCATATGTGAGACTTGCAAAAAAATTCTAGTT,10,30,14,27,27,39,27,42,27,29,29,39,32,42,64.32,48.66083487
hek293t,14515,1,3,CTCGATTAATTAATGACAACTCTTCACAATGGCCTTCGAATAGCACTTAAGACAGCAATTAAGAGCATATGTGAGACTTGCTATAAAAAAATTCTAGTT,CTCGATTAATTAATGACAACTCTTCACACGGATGGCCTTCGAATAGCACTTAAGACAGCAATTAAGAGCATATGTGAGACTTGCTATAAAAAAATTCTA,10,30,14,27,27,36,27,39,27,29,29,36,32,39,64.32,47.99249316
hek293t,14517,1,9,CGGCCCAAGGCTAAGGAAAGGGACTCTTGGGGCCTTCTATTATTTTGTAGTGTAAATTAAACTTCCCTTTGATAGAAAAAAATTCTAGTTGGTTTAACG,CGGCCCAAGGCTAAGGAAAGGGACTCTTGGGGCCTCGAGCACACTCTATTATTTTGTAGTGTAAATTAAACTTCCCTTTGATAGAAAAAAATTCTAGTT,10,30,14,27,27,39,27,48,27,36,36,39,45,48,58.07,8.500474653
hek293t,14517,1,9,GATTCCAAGGCTAAGGAAAGGGACTCTTGGGGCCTTCTATTATTTTGTAGTGTAAATTAAACTTCCCTAAAAAAATTCTAGTTGGTTTAACGCGTAACT,GATTCCAAGGCTAAGGAAAGGGACTCTTGGGGCCTCGAGCACACTCTATTATTTTGTAGTGTAAATTAAACTTCCCTAAAAAAATTCTAGTTGGTTTAA,10,30,14,27,27,46,27,55,27,36,36,46,45,55,58.07,7.86771297
hek293t,14519,1,11,CGGACATTTTTCTGAACCAATACTATGCAAGGTATATACATATTTTATTTACATATGAGACTTCCTTCTGAAAAAAATTCTAGTTGGTTTAACGCGTAA,CGGACATTTTTCTGAACCAATACTATGCAAGGTATATAAGACAAACAATCATATTTTATTTACATATGAGACTTCCTTCTGAAAAAAATTCTAGTTGGT,10,30,14,27,27,42,27,53,27,39,39,42,50,53,47.1,0.0
hek293t,14520,1,7,TCTTGTTGGTCGTACGGCTACTGCGTAATAGGGTACCAAACTACTCCCCAAAGAACTGAAGAAGAAAGTTACACACAACTGAAAAAAATTCTAGTTGGT,TCTTGTTGGTCGTACGGCTACTGCGTATTTGCAGATAGGGTACCAAACTACTCCCCAAAGAACTGAAGAAGAAAGTTACACACAACTGAAAAAAATTCT,10,30,14,27,27,35,27,42,27,28,28,35,35,42,19.96,11.76748262
hek293t,14520,1,7,ACCATTTGGTCGTACGGCTACTGCGTAATAGGGTACCAAACTACTCCCCAAAGAACTGAAGAAGAAAGTTACACACAACTGCAACAAAAAAATTCTAGT,ACCATTTGGTCGTACGGCTACTGCGTATTTGCAGATAGGGTACCAAACTACTCCCCAAAGAACTGAAGAAGAAAGTTACACACAACTGCAACAAAAAAA,10,30,14,27,27,31,27,38,27,28,28,31,35,38,19.96,0.305810398
hek293t,14524,1,11,AGTTATAGAGGACAACAGAAGAACAAAGAAGGAAAGGAAATCTTGAGAGGTAAATATTTTTCTTAGAGAAAAAAATTCTAGTTGGTTTAACGCGTAACT,AGTTATAGAGGACAACAGAAGAACAAAGTTACAGTACTCAAGGAAAGGAAATCTTGAGAGGTAAATATTTTTCTTAGAGAAAAAAATTCTAGTTGGTTT,10,30,14,27,27,44,27,55,27,29,29,44,40,55,60.83,1.194321021
hek293t,14524,1,11,GAACGTAGAGGACAACAGAAGAACAAAGAAGGAAAGGAAATCTTGAGAGGTAAATATTTTTCTTAGAGAGGCAAATAAAAAAATTCTAGTTGGTTTAAC,GAACGTAGAGGACAACAGAAGAACAAAGTTACAGTACTCAAGGAAAGGAAATCTTGAGAGGTAAATATTTTTCTTAGAGAGGCAAATAAAAAAATTCTA,10,30,14,27,27,36,27,47,27,29,29,36,40,47,60.83,1.509175816
hek293t,14526,1,8,CCCTGCACAACTGTCACTGTATGTAGAGAAGGATGGAAAATGATTATCATAAAGCAGGAGGGTCTGAACTGACAAAAAAATTCTAGTTGGTTTAACGCG,CCCTGCACAACTGTCACTGTATGTAGAGAAGGATTAACTGCAGGAAAATGATTATCATAAAGCAGGAGGGTCTGAACTGACAAAAAAATTCTAGTTGGT,10,30,14,27,27,42,27,50,27,35,35,42,43,50,60.03,2.079959093
hek293t,14526,1,8,GCAGGCACAACTGTCACTGTATGTAGAGAAGGATGGAAAATGATTATCATAAAGCAGGAGGGTCTGAACTGACTGCTAAAAAAATTCTAGTTGGTTTAA,GCAGGCACAACTGTCACTGTATGTAGAGAAGGATTAACTGCAGGAAAATGATTATCATAAAGCAGGAGGGTCTGAACTGACTGCTAAAAAAATTCTAGT,10,30,14,27,27,38,27,46,27,35,35,38,43,46,60.03,1.217342872
hek293t,18411,1,11,CCAACACTGATGTGACTTACATAAGCTTTTGGAAGAGTAAAAGCCTTTCAGGTATTTCTTGCATCAAAAAAATTCTAGTTGGTTTAACGCGTAACTAGA,CCAACACTGATGTGACTTACATAAGCTTTTGGAAGAGTAGAAGGCTTTCAAAAGCCTTTCAGGTATTTCTTGCATCAAAAAAATTCTAGTTGGTTTAAC,10,30,14,27,27,47,27,58,27,40,40,47,51,58,32.11,0.0
hek293t,14529,1,7,CCCATGAATAAGAATTGGTGTAAAGCGGGAGGAAACACTCTGCTTGTCAGGAAACTCACAAAAAATAATTGACTGTAGAAAAAAATTCTAGTTGGTTTA,CCCATGAATAAGAATTGGTGTAAAGCGGGAGGAAACGGACGACACTCTGCTTGTCAGGAAACTCACAAAAAATAATTGACTGTAGAAAAAAATTCTAGT,10,30,14,27,27,38,27,45,27,35,35,38,42,45,41.51,0.0
hek293t,14529,1,7,TAGTCGAATAAGAATTGGTGTAAAGCGGGAGGAAACACTCTGCTTGTCAGGAAACTCACAAAAAATAAAAAAATTCTAGTTGGTTTAACGCGTAACTAG,TAGTCGAATAAGAATTGGTGTAAAGCGGGAGGAAACGGACGACACTCTGCTTGTCAGGAAACTCACAAAAAATAAAAAAATTCTAGTTGGTTTAACGCG,10,30,14,27,27,50,27,57,27,35,35,50,42,57,41.51,1.874514797
hek293t,14531,1,1,GGCGATAAAGTAATTTTTAAAAAACCTGAAGGATAACTCTGGTTAATTGGCCACTTCCAATCTGAAAGAATATTACTCTAAAAGAAAAAAATTCTAGTT,GGCGATAAAGTAATTTTTAAAAAACCTGAATGGATAACTCTGGTTAATTGGCCACTTCCAATCTGAAAGAATATTACTCTAAAAGAAAAAAATTCTAGT,10,30,14,27,27,38,27,39,27,31,31,38,32,39,5.43,0.114547537
hek293t,14531,1,1,AGTGGTAAAGTAATTTTTAAAAAACCTGAAGGATAACTCTGGTTAATTGGCCACTTCCAATCTGAAAGAATATTACAAAAAAATTCTAGTTGGTTTAAC,AGTGGTAAAGTAATTTTTAAAAAACCTGAATGGATAACTCTGGTTAATTGGCCACTTCCAATCTGAAAGAATATTACAAAAAAATTCTAGTTGGTTTAA,10,30,14,27,27,46,27,47,27,31,31,46,32,47,5.43,0.043975374
hek293t,14533,1,3,CAGTGAGGCTTTTGCAGAAAGCACAAGACAGGGTACATAATAAGCATGTTCTTTTTTCAAAATTGTTATACAGTTCTCAACAAAAAAATTCTAGTTGGT,CAGTGAGGCTTTTGCAGAAAGCACAAGATCACAGGGTACATAATAAGCATGTTCTTTTTTCAAAATTGTTATACAGTTCTCAACAAAAAAATTCTAGTT,10,30,14,27,27,39,27,42,27,29,29,39,32,42,27.3,34.69062123
hek293t,14533,1,3,AGTCGAGGCTTTTGCAGAAAGCACAAGACAGGGTACATAATAAGCATGTTCTTTTTTCAAAATTGTTATACAGTTCAAAAAAATTCTAGTTGGTTTAAC,AGTCGAGGCTTTTGCAGAAAGCACAAGATCACAGGGTACATAATAAGCATGTTCTTTTTTCAAAATTGTTATACAGTTCAAAAAAATTCTAGTTGGTTT,10,30,14,27,27,44,27,47,27,29,29,44,32,47,27.3,8.336076702
hek293t,14535,1,2,ACCCTAAGCAAGCGATTATATGTGAAATGCGGTAGATAGGAAAGATTTAAAAAATGGCCATGTCAGCAAGAATACCAAAAAAATTCTAGTTGGTTTAAC,ACCCTAAGCAAGCGATTATATGTGAAATGTGCGGTAGATAGGAAAGATTTAAAAAATGGCCATGTCAGCAAGAATACCAAAAAAATTCTAGTTGGTTTA,10,30,14,27,27,45,27,47,27,30,30,45,32,47,62.05,5.36792015
hek293t,14535,1,2,CGGGGAAGCAAGCGATTATATGTGAAATGCGGTAGATAGGAAAGATTTAAAAAATGGCCATGTCAGCAAGAATACCTGGCTATGAAAAAAATTCTAGTT,CGGGGAAGCAAGCGATTATATGTGAAATGTGCGGTAGATAGGAAAGATTTAAAAAATGGCCATGTCAGCAAGAATACCTGGCTATGAAAAAAATTCTAG,10,30,14,27,27,37,27,39,27,30,30,37,32,39,62.05,32.5442085
hek293t,14538,1,14,TGGATCCTTTTACCCTGAGGGTGAGGCACTGGCTACTGGCATGTGATATAGAGGGTTATCATCCAGTCAGGACTAAAAAAATTCTAGTTGGTTTAACGC,TGGATCCTTTTACCCTGAGGGTGAGGCCACCCCTCCTATGCACTGGCTACTGGCATGTGATATAGAGGGTTATCATCCAGTCAGGACTAAAAAAATTCT,10,30,14,27,27,35,27,49,27,28,28,35,42,49,53.65,9.294222386
hek293t,14538,1,14,AACTCCCTTTTACCCTGAGGGTGAGGCACTGGCTACTGGCATGTGATATAGAGGGTTATCATCCAGTCAGGACTCTACAAAAAAATTCTAGTTGGTTTA,AACTCCCTTTTACCCTGAGGGTGAGGCCACCCCTCCTATGCACTGGCTACTGGCATGTGATATAGAGGGTTATCATCCAGTCAGGACTCTACAAAAAAA,10,30,14,27,27,31,27,45,27,28,28,31,42,45,53.65,0.0
hek293t,14540,1,14,GGGGATAGTAAGGATTCAATCTACCCTCTAGGCCCCCCCCGCCTCTATTTCAGCGCTTCTCTTTCCTTACAAAAAAATTCTAGTTGGTTTAACGCGTAA,GGGGATAGTAAGGATTCAATCTACCCTCTAGGCCCCTCTCCCCGATACGCCCCCGCCTCTATTTCAGCGCTTCTCTTTCCTTACAAAAAAATTCTAGTT,10,30,14,27,27,39,27,53,27,36,36,39,50,53,41.0,1.041666667
hek293t,14541,1,6,ATTTGGGGTTGTAGTTTTGTTTCTTGTCTTGGAGACTGAAACCACTCAAGTGAGTGTTGTTCTTGAATGAAAAAAATTCTAGTTGGTTTAACGCGTAAC,ATTTGGGGTTGTAGTTTTGTTTCTTGTCTTGGTAATTGAGACTGAAACCACTCAAGTGAGTGTTGTTCTTGAATGAAAAAAATTCTAGTTGGTTTAACG,10,30,14,27,27,48,27,54,27,33,33,48,39,54,1.3,0.936354889
hek293t,14543,1,6,ATTATACAAGCAGAGGACAAAAAGCTTAGTGGGTATTCAAAGGTTCTGATTTGCTTAAGAGGATGGATTTCAAAAAAATTCTAGTTGGTTTAACGCGTA,ATTATACAAGCAGAGGACAAAAAGCTTAGTGGGTAGCATTTTTCAAAGGTTCTGATTTGCTTAAGAGGATGGATTTCAAAAAAATTCTAGTTGGTTTAA,10,30,14,27,27,46,27,52,27,36,36,46,42,52,38.08,0.0
hek293t,14543,1,6,TGTGCACAAGCAGAGGACAAAAAGCTTAGTGGGTATTCAAAGGTTCTGATTTGCTTAAGAGGATGGATTTCTACATTCAAAAAAATTCTAGTTGGTTTA,TGTGCACAAGCAGAGGACAAAAAGCTTAGTGGGTAGCATTTTTCAAAGGTTCTGATTTGCTTAAGAGGATGGATTTCTACATTCAAAAAAATTCTAGTT,10,30,14,27,27,39,27,45,27,36,36,39,42,45,38.08,0.0
hek293t,14545,1,13,GGAGTAAAATATATAGATACAGGCATTTTTGGTGAAGTACAGGTTTTGGTTCAGCCAGCCACCTCTAAAAAAAAATTCTAGTTGGTTTAACGCGTAACT,GGAGTAAAATATATAGATACAGGCATTTTTGTGAAATGTTTAGCGTGAAGTACAGGTTTTGGTTCAGCCAGCCACCTCTAAAAAAAAATTCTAGTTGGT,10,30,14,27,27,42,27,55,27,32,32,42,45,55,4.62,1.970340734
hek293t,14547,1,1,TGGTGTCCCCAGTTACTTAAAATCTCTCTCGGTATGAATAACACTTCGTATAGTTGTCAGAAATACAATATATGCCAAAAAAATTCTAGTTGGTTTAAC,TGGTGTCCCCAGTTACTTAAAATCTCTCTCGGTATGAACTAACACTTCGTATAGTTGTCAGAAATACAATATATGCCAAAAAAATTCTAGTTGGTTTAA,10,30,14,27,27,46,27,47,27,39,39,46,40,47,26.21,10.02642286
hek293t,14549,1,4,CTTACAAATACAAGTGAGCCAAAGGTTTGAGGGTTACTCATGGGAACAATACACCAGCCTGGGATCTGCCCAAAAAAAAAATTCTAGTTGGTTTAACGC,CTTACAAATACAAGTGAGCCAAAGGTTTGAAAGAGGGTTACTCATGGGAACAATACACCAGCCTGGGATCTGCCCAAAAAAAAAATTCTAGTTGGTTTA,10,30,14,27,27,45,27,49,27,30,30,45,34,49,33.73,64.02718098
hek293t,14549,1,4,GTGGTAAATACAAGTGAGCCAAAGGTTTGAGGGTTACTCATGGGAACAATACACCAGCCTGGGATCTGCCCAAAGTCATAAAAAAATTCTAGTTGGTTT,GTGGTAAATACAAGTGAGCCAAAGGTTTGAAAGAGGGTTACTCATGGGAACAATACACCAGCCTGGGATCTGCCCAAAGTCATAAAAAAATTCTAGTTG,10,30,14,27,27,40,27,44,27,30,30,40,34,44,33.73,71.54866079
hek293t,14551,1,4,TGAAGTATTGCTTCATTTCGTAAATATAATGGCATGCAATACTCAGTTAAATGCCGTGTCTACTTTGACAAGCTGCCCCCAAAAAAATTCTAGTTGGTT,TGAAGTATTGCTTCATTTCGTAAATATAGCACATGGCATGCAATACTCAGTTAAATGCCGTGTCTACTTTGACAAGCTGCCCCCAAAAAAATTCTAGTT,10,30,14,27,27,39,27,43,27,29,29,39,33,43,9.58,19.05004915
hek293t,14551,1,4,CCTGCTATTGCTTCATTTCGTAAATATAATGGCATGCAATACTCAGTTAAATGCCGTGTCTACTTTGACAAGCTGCCCCCCCCAAAAAAATTCTAGTTG,CCTGCTATTGCTTCATTTCGTAAATATAGCACATGGCATGCAATACTCAGTTAAATGCCGTGTCTACTTTGACAAGCTGCCCCCCCCAAAAAAATTCTA,10,30,14,27,27,36,27,40,27,29,29,36,33,40,9.58,29.37450766
hek293t,14553,1,2,CGGATTGCGACTGCTTCCCACAGCTTCCCAGGAGGGGAGCAGTTTTGGAGCACTGTGTGGTTGCTGCTCCCAAAAAAATTCTAGTTGGTTTAACGCGTA,CGGATTGCGACTGCTTCCCACAGCTTCCCAGGAGGGGAGAACAGTTTTGGAGCACTGTGTGGTTGCTGCTCCCAAAAAAATTCTAGTTGGTTTAACGCG,10,30,14,27,27,50,27,52,27,40,40,50,42,52,46.64,66.65703474
hek293t,14553,1,2,TATGTTGCGACTGCTTCCCACAGCTTCCCAGGAGGGGAGCAGTTTTGGAGCACTGTGTGGTTGCTGCTCCCTAGAAAAAAATTCTAGTTGGTTTAACGC,TATGTTGCGACTGCTTCCCACAGCTTCCCAGGAGGGGAGAACAGTTTTGGAGCACTGTGTGGTTGCTGCTCCCTAGAAAAAAATTCTAGTTGGTTTAAC,10,30,14,27,27,47,27,49,27,40,40,47,42,49,46.64,62.46592933
hek293t,17495,1,6,TATACTGGGGATCATGCAGCTTTGACGGGAGGGTCACCAGCTCCAGTTTTGCAAAACTGAAGGAAGATAAACATTTTCAAATAAAAAAATTCTAGTTGG,TATACTGGGGATCATGCAGCTTTGACGCGATAAGGAGGGTCACCAGCTCCAGTTTTGCAAAACTGAAGGAAGATAAACATTTTCAAATAAAAAAATTCT,10,30,14,27,27,35,27,41,27,28,28,35,34,41,49.98,45.13629973
hek293t,17495,1,6,TTTCTTGGGGATCATGCAGCTTTGACGGGAGGGTCACCAGCTCCAGTTTTGCAAAACTGAAGGAAGATAAACATAAAAAAATTCTAGTTGGTTTAACGC,TTTCTTGGGGATCATGCAGCTTTGACGCGATAAGGAGGGTCACCAGCTCCAGTTTTGCAAAACTGAAGGAAGATAAACATAAAAAAATTCTAGTTGGTT,10,30,14,27,27,43,27,49,27,28,28,43,34,49,49.98,67.67343723
hek293t,14557,1,6,GTATTTCTTCTTAGCACAGCAATTTTCACCGGACTGCTGGTCATCATCCTTAGCACGTGTGAGTTACGTATGAAAAAAATTCTAGTTGGTTTAACGCGT,GTATTTCTTCTTAGCACAGCAATTTTCACCGGACTGCGACTTATGGTCATCATCCTTAGCACGTGTGAGTTACGTATGAAAAAAATTCTAGTTGGTTTA,10,30,14,27,27,45,27,51,27,38,38,45,44,51,13.67,1.898360496
hek293t,2954,1,5,GTGTAATATGGCATTTTGTTCCTTAGTCTTGGGCCAGTCCTTTAACTGTCCGGTTTTAAATTCTAAAAAAATTCTAGTTGGTTTAACGCGTAACTAGAT,GTGTAATATGGCATTTTGTTCCTTAGTCTTGGGCCAGTGGCCGCCTTTAACTGTCCGGTTTTAAATTCTAAAAAAATTCTAGTTGGTTTAACGCGTAAC,10,30,14,27,27,54,27,59,27,39,39,54,44,59,15.29,22.32466483
hek293t,14561,1,5,TCCACATTAGCAATGGGTCTGTTCATTGAAGGATAACCACTCATACCTAGTTTTCTACATTCATTTATTAAATCAGAAAAAAATTCTAGTTGGTTTAAC,TCCACATTAGCAATGGGTCTGTTCATTGAAGGATTTGCCAACCACTCATACCTAGTTTTCTACATTCATTTATTAAATCAGAAAAAAATTCTAGTTGGT,10,30,14,27,27,42,27,47,27,35,35,42,40,47,40.89,49.14108978
hek293t,14561,1,5,TAGAGATTAGCAATGGGTCTGTTCATTGAAGGATAACCACTCATACCTAGTTTTCTACATTCATTTATTAAATAAAAAAATTCTAGTTGGTTTAACGCG,TAGAGATTAGCAATGGGTCTGTTCATTGAAGGATTTGCCAACCACTCATACCTAGTTTTCTACATTCATTTATTAAATAAAAAAATTCTAGTTGGTTTA,10,30,14,27,27,45,27,50,27,35,35,45,40,50,40.89,79.30588348
hek293t,14563,1,5,ATGAGGTAGGGGTAAATCCATGGAAAATGAGGGTCACGAAGTCTCTTCTGAGTTAAGTTTTACTGAAGTTAAATAAAAAAATTCTAGTTGGTTTAACGC,ATGAGGTAGGGGTAAATCCATGGAAAATAACTCGAGGGTCACGAAGTCTCTTCTGAGTTAAGTTTTACTGAAGTTAAATAAAAAAATTCTAGTTGGTTT,10,30,14,27,27,44,27,49,27,29,29,44,34,49,58.95,20.10363407
hek293t,3961,1,9,TATCCAAGGCATTATTGTTATTAGGAAAATGGGCACTTATCCTCCCCGCAAGAGCTCTGCATGTGGACATGAAAAAAATTCTAGTTGGTTTAACGCGTA,TATCCAAGGCATTATTGTTATTAGGAAAATGGGCACTTACTCTAGCCCTCCTCCCCGCAAGAGCTCTGCATGTGGACATGAAAAAAATTCTAGTTGGTT,10,30,14,27,27,43,27,52,27,40,40,43,49,52,0.48,0.316452168
hek293t,3961,1,9,CGTTAAAGGCATTATTGTTATTAGGAAAATGGGCACTTATCCTCCCCGCAAGAGCTCTGCATGTAAAAAAATTCTAGTTGGTTTAACGCGTAACTAGAT,CGTTAAAGGCATTATTGTTATTAGGAAAATGGGCACTTACTCTAGCCCTCCTCCCCGCAAGAGCTCTGCATGTAAAAAAATTCTAGTTGGTTTAACGCG,10,30,14,27,27,50,27,59,27,40,40,50,49,59,0.48,1.022095825
hek293t,2749,1,7,AGTACTAATATTTTGAACTTATAATGGTGTGGCGGACAGGACTTTTGCCTTAAACATTTCTTGGTACATAAGGTGCAAAAAAAATTCTAGTTGGTTTAA,AGTACTAATATTTTGAACTTATAATGGTGTGACAATTAGCGGACAGGACTTTTGCCTTAAACATTTCTTGGTACATAAGGTGCAAAAAAAATTCTAGTT,10,30,14,27,27,39,27,46,27,32,32,39,39,46,36.38,1.717443363
hek293t,2749,1,7,CCGTTTAATATTTTGAACTTATAATGGTGTGGCGGACAGGACTTTTGCCTTAAACATTTCTTGGTACATAAGGTAAAAAAATTCTAGTTGGTTTAACGC,CCGTTTAATATTTTGAACTTATAATGGTGTGACAATTAGCGGACAGGACTTTTGCCTTAAACATTTCTTGGTACATAAGGTAAAAAAATTCTAGTTGGT,10,30,14,27,27,42,27,49,27,32,32,42,39,49,36.38,2.263470881
hek293t,14573,1,2,TGGCATAAATGGAGACAGTAGAAAAAGTGAGGCAAAAAAGTTTGTGTGTTAATACTGAATGCACTGGTCTCATACTCAGGATGGGAAAAAAAATTCTAG,TGGCATAAATGGAGACAGTAGAAAAAGCCTGAGGCAAAAAAGTTTGTGTGTTAATACTGAATGCACTGGTCTCATACTCAGGATGGGAAAAAAAATTCT,10,30,14,27,27,35,27,37,27,28,28,35,30,37,62.29,0.524934383
hek293t,14573,1,2,CAGAGTAAATGGAGACAGTAGAAAAAGTGAGGCAAAAAAGTTTGTGTGTTAATACTGAATGCACTGGTCTCATACTCAGGATGGGAGTTGAAAAAAATT,CAGAGTAAATGGAGACAGTAGAAAAAGCCTGAGGCAAAAAAGTTTGTGTGTTAATACTGAATGCACTGGTCTCATACTCAGGATGGGAGTTGAAAAAAA,10,30,14,27,27,31,27,33,27,28,28,31,30,33,62.29,0.0
hek293t,14577,1,12,GAGTCGTAAATAAACACGGCACTCAGTGGTGGAGAAGTTACTTGGCTGTACAACGTACAGAAAGCAAAAAAAATTCTAGTTGGTTTAACGCGTAACTAG,GAGTCGTAAATAAACACGGCACTCAGTGGAGTCGAATGTAATGGAGAAGTTACTTGGCTGTACAACGTACAGAAAGCAAAAAAAATTCTAGTTGGTTTA,10,30,14,27,27,45,27,57,27,30,30,45,42,57,57.04,26.20264506
hek293t,14578,1,14,TATATTTATTTACATAGACATGAATAGACTGGCAGACAATGAAATGAACAGTTTCCAAATTTCTAAAGGGAAAAAAAATTCTAGTTGGTTTAACGCGTA,TATATTTATTTACATAGACATGAATAGCCATATTCATCCAAACTGGCAGACAATGAAATGAACAGTTTCCAAATTTCTAAAGGGAAAAAAAATTCTAGT,10,30,14,27,27,38,27,52,27,28,28,38,42,52,41.56,6.84902947
hek293t,14578,1,14,TGAAGTTATTTACATAGACATGAATAGACTGGCAGACAATGAAATGAACAGTTTCCAAATTTCTAAAGGGAAAGCTTTAAAAAAATTCTAGTTGGTTTA,TGAAGTTATTTACATAGACATGAATAGCCATATTCATCCAAACTGGCAGACAATGAAATGAACAGTTTCCAAATTTCTAAAGGGAAAGCTTTAAAAAAA,10,30,14,27,27,31,27,45,27,28,28,31,42,45,41.56,0.0
hek293t,14580,1,13,ACCAGAAATTTCAGCCAAAAACATTCCACTGGAATAATCTGAAAGCAAAACTACCTTCTGCAGCAAAAAAATTCTAGTTGGTTTAACGCGTAACTAGAT,ACCAGAAATTTCAGCCAAAAACATTCCACTGTTCCTGTCTAGAGGAATAATCTGAAAGCAAAACTACCTTCTGCAGCAAAAAAATTCTAGTTGGTTTAA,10,30,14,27,27,46,27,59,27,31,31,46,44,59,35.97,0.0
hek293t,14580,1,13,GCGCAAAATTTCAGCCAAAAACATTCCACTGGAATAATCTGAAAGCAAAACTACCTTCTGCAGCAAAATATTAAAGAAAAAAATTCTAGTTGGTTTAAC,GCGCAAAATTTCAGCCAAAAACATTCCACTGTTCCTGTCTAGAGGAATAATCTGAAAGCAAAACTACCTTCTGCAGCAAAATATTAAAGAAAAAAATTC,10,30,14,27,27,34,27,47,27,31,31,34,44,47,35.97,0.0
hek293t,14584,1,7,TTGTAAAGTGGTGGCAGCAGTTCTAAAATTGGGAAATATTGAATTTAAACCTGAATCTCGAGTGAATGAAAAAAATTCTAGTTGGTTTAACGCGTAACT,TTGTAAAGTGGTGGCAGCAGTTCTAAAATTGGCTAAGACGAAATATTGAATTTAAACCTGAATCTCGAGTGAATGAAAAAAATTCTAGTTGGTTTAACG,10,30,14,27,27,48,27,55,27,33,33,48,40,55,14.65,0.272764987
hek293t,14588,1,3,ACTATTCAGACCCCGATTTACTAACCGTGTGGAGAAGCACATGCGTTTTCTTTTAGAAGGTCAGTATCATAAAAAAATTCTAGTTGGTTTAACGCGTAA,ACTATTCAGACCCCGATTTACTAACCGTGTGGAGAAGCAAGTCATGCGTTTTCTTTTAGAAGGTCAGTATCATAAAAAAATTCTAGTTGGTTTAACGCG,10,30,14,27,27,50,27,53,27,40,40,50,43,53,63.4,29.24866901
hek293t,14588,1,3,TTCTCTCAGACCCCGATTTACTAACCGTGTGGAGAAGCACATGCGTTTTCTTTTAGAAGGTCAGTATCATTTAAAAAAAATTCTAGTTGGTTTAACGCG,TTCTCTCAGACCCCGATTTACTAACCGTGTGGAGAAGCAAGTCATGCGTTTTCTTTTAGAAGGTCAGTATCATTTAAAAAAAATTCTAGTTGGTTTAAC,10,30,14,27,27,47,27,50,27,40,40,47,43,50,63.4,29.45656394
hek293t,14590,1,6,GTCACTTCTCTCTTCAAACAGACAGGCTCCGGTAAATTATATCCTCAAAAATGAGGACTGCTGATTTCTTTAAGTCTCCTCCTGCAAAAAAATTCTAGT,GTCACTTCTCTCTTCAAACAGACAGGCTGTTTGGCCGGTAAATTATATCCTCAAAAATGAGGACTGCTGATTTCTTTAAGTCTCCTCCTGCAAAAAAAT,10,30,14,27,27,32,27,38,27,29,29,32,35,38,46.27,0.0
hek293t,21203,1,4,TCATGACCCCTGCAGCACTTGCCCCTTTCTGGTTTCCACCAATTCCTTCACCAAGTTTAGTTTAGTTATTCATGTTTCTCTTTCAAAAAAAATTCTAGT,TCATGACCCCTGCAGCACTTGCCCCTTTCTGCATGGTTTCCACCAATTCCTTCACCAAGTTTAGTTTAGTTATTCATGTTTCTCTTTCAAAAAAAATTC,10,30,14,27,27,34,27,38,27,31,31,34,35,38,7.24,1.269177937
hek293t,14594,1,3,CCCGATAATATTACAAACCCCAAATTTTAAGGACATAATGGCATTCTGCATTCCTTCCTGAATAAACAGAAAAAACAAAAAAATTCTAGTTGGTTTAAC,CCCGATAATATTACAAACCCCAAATTTTAAGGACATAATGTGTGCATTCTGCATTCCTTCCTGAATAAACAGAAAAAACAAAAAAATTCTAGTTGGTTT,10,30,14,27,27,44,27,47,27,41,41,44,44,47,2.62,0.0
hek293t,14594,1,3,CTTTCTAATATTACAAACCCCAAATTTTAAGGACATAATGGCATTCTGCATTCCTTCCTGAATAAAAAAAATTCTAGTTGGTTTAACGCGTAACTAGAT,CTTTCTAATATTACAAACCCCAAATTTTAAGGACATAATGTGTGCATTCTGCATTCCTTCCTGAATAAAAAAAATTCTAGTTGGTTTAACGCGTAACTA,10,30,14,27,27,56,27,59,27,41,41,56,44,59,2.62,1.042460045
hek293t,14596,1,13,GGGGTTGCGATAGATGGATTCTTGACCAGGGGCTTAACAACCACTGGTCCAAATCCAATAAATCTTATCAAAAAAATTCTAGTTGGTTTAACGCGTAAC,GGGGTTGCGATAGATGGATTCTTGACCAGGGGCTTAAAAAAGTGCCCGTCCAACCACTGGTCCAAATCCAATAAATCTTATCAAAAAAATTCTAGTTGG,10,30,14,27,27,41,27,54,27,38,38,41,51,54,67.66,0.731315468
hek293t,1961,1,1,CGCAGAGCTCCATTCCAGAAATAAAATCATGGAGGTGTGAACACAGTATTGTGCTTTAATAAACTGTAAGAGAATCCCATAAAAAAATTCTAGTTGGTT,CGCAGAGCTCCATTCCAGAAATAAAATTCATGGAGGTGTGAACACAGTATTGTGCTTTAATAAACTGTAAGAGAATCCCATAAAAAAATTCTAGTTGGT,10,30,14,27,27,42,27,43,27,27,27,42,28,43,57.1,0.0
hek293t,1961,1,1,CCTAAAGCTCCATTCCAGAAATAAAATCATGGAGGTGTGAACACAGTATTGTGCTTTAATAAACTGTAAGAGAATCCCATTATTCAGAAAAAAAATTCT,CCTAAAGCTCCATTCCAGAAATAAAATTCATGGAGGTGTGAACACAGTATTGTGCTTTAATAAACTGTAAGAGAATCCCATTATTCAGAAAAAAAATTC,10,30,14,27,27,34,27,35,27,27,27,34,28,35,57.1,0.0
hek293t,14599,1,9,TTGTGTGCAAGCAACAGTTCCAACCATGAAGGACAAACATAATTTAGATTGTTGCATGACAGCACAATAAGCATCAAAAAAATTCTAGTTGGTTTAACG,TTGTGTGCAAGCAACAGTTCCAACCATGTAACACGACAAGGACAAACATAATTTAGATTGTTGCATGACAGCACAATAAGCATCAAAAAAATTCTAGTT,10,30,14,27,27,39,27,48,27,29,29,39,38,48,52.69,12.82741988
hek293t,14599,1,9,TAATATGCAAGCAACAGTTCCAACCATGAAGGACAAACATAATTTAGATTGTTGCATGACAGCACAATAAGCATCAATAGATAAAAAAATTCTAGTTGG,TAATATGCAAGCAACAGTTCCAACCATGTAACACGACAAGGACAAACATAATTTAGATTGTTGCATGACAGCACAATAAGCATCAATAGATAAAAAAAT,10,30,14,27,27,32,27,41,27,29,29,32,38,41,52.69,0.679130156
hek293t,14601,1,11,TGCTCGGCTTTAAGTGCTTATTTGCTTTGTGGAATAAAGATGAAACATGGAGGCAGGTGTGAAAAAAAAAATTCTAGTTGGTTTAACGCGTAACTAGAT,TGCTCGGCTTTAAGTGCTTATTTGCTTTGTGGAATAAATAACACAATTAGATGAAACATGGAGGCAGGTGTGAAAAAAAAAATTCTAGTTGGTTTAACG,10,30,14,27,27,48,27,59,27,38,38,48,49,59,2.72,0.034153005
hek293t,14601,1,11,TGCATGGCTTTAAGTGCTTATTTGCTTTGTGGAATAAAGATGAAACATGGAGGCAGGTGTGAAATGCAAAAAAATTCTAGTTGGTTTAACGCGTAACTA,TGCATGGCTTTAAGTGCTTATTTGCTTTGTGGAATAAATAACACAATTAGATGAAACATGGAGGCAGGTGTGAAATGCAAAAAAATTCTAGTTGGTTTA,10,30,14,27,27,45,27,56,27,38,38,45,49,56,2.72,0.0
hek293t,14603,1,3,GGCGCGGTTATTGTATCATACTGTCAGCAAGGTTTTTAATAAGTAGGTACAATTATTTTAGGCATGAACAAAGTATAAGAAATATCTGCAAAAAAATTC,GGCGCGGTTATTGTATCATACTGTCAGACCCAAGGTTTTTAATAAGTAGGTACAATTATTTTAGGCATGAACAAAGTATAAGAAATATCTGCAAAAAAA,10,30,14,27,27,31,27,34,27,28,28,31,31,34,46.01,2.473516663
hek293t,14603,1,3,TGTTGGGTTATTGTATCATACTGTCAGCAAGGTTTTTAATAAGTAGGTACAATTATTTTAGGCATGAACAAAGTATAAAAAAAATTCTAGTTGGTTTAA,TGTTGGGTTATTGTATCATACTGTCAGACCCAAGGTTTTTAATAAGTAGGTACAATTATTTTAGGCATGAACAAAGTATAAAAAAAATTCTAGTTGGTT,10,30,14,27,27,43,27,46,27,28,28,43,31,46,46.01,55.64599661
hek293t,14605,1,3,GGCAAGAAAGAGCTGAAGTAACATTTAAGAGGAGAGGGAAGATGAGTGAGAAAGAATCAGGCTAAGCTTTTCCCCCCCCCAAAAAAATTCTAGTTGGTT,GGCAAGAAAGAGCTGAAGTAACATTTAAGGTGAGGAGAGGGAAGATGAGTGAGAAAGAATCAGGCTAAGCTTTTCCCCCCCCCAAAAAAATTCTAGTTG,10,30,14,27,27,40,27,43,27,30,30,40,33,43,46.85,11.66582
hek293t,14606,1,2,CGGACAAATCAGTTTAGCAACAAAGTCAGTGGAGCTATGCTGATACATTCCCCTGGAAAGACCAGATTCCCACCGTCATCCCCTAAAAAAATTCTAGTT,CGGACAAATCAGTTTAGCAACAAAGTCAGTGGACTGCTATGCTGATACATTCCCCTGGAAAGACCAGATTCCCACCGTCATCCCCTAAAAAAATTCTAG,10,30,14,27,27,37,27,39,27,34,34,37,36,39,39.87,2.135040316
hek293t,14606,1,2,GGCTCAAATCAGTTTAGCAACAAAGTCAGTGGAGCTATGCTGATACATTCCCCTGGAAAGACCAGATTCCCAAAAAAAATTCTAGTTGGTTTAACGCGT,GGCTCAAATCAGTTTAGCAACAAAGTCAGTGGACTGCTATGCTGATACATTCCCCTGGAAAGACCAGATTCCCAAAAAAAATTCTAGTTGGTTTAACGC,10,30,14,27,27,49,27,51,27,34,34,49,36,51,39.87,27.77280609
hek293t,14610,1,7,GAGGTGTATATAATTTATGCATGTAGTCGTGGAAGAAATTTTGTCCCAGTTTGTGTGGTAGATAGGCAAAAAAATTCTAGTTGGTTTAACGCGTAACTA,GAGGTGTATATAATTTATGCATGTAGTCGTGGAAGAAAGTTGATCTTTTGTCCCAGTTTGTGTGGTAGATAGGCAAAAAAATTCTAGTTGGTTTAACGC,10,30,14,27,27,49,27,56,27,39,39,49,46,56,26.4,13.12547798
hek293t,14611,1,5,AAGGTACTGAAAATGGATACAACTGGTATTGGTGTTAATGAAGCAAAAAGGAAATGAAATGCATTAAGGTAAAAATAAAAAAAATTCTAGTTGGTTTAA,AAGGTACTGAAAATGGATACAACTGGTATTGGTGTTAGCACAATGAAGCAAAAAGGAAATGAAATGCATTAAGGTAAAAATAAAAAAAATTCTAGTTGG,10,30,14,27,27,41,27,46,27,38,38,41,43,46,23.1,0.851581509
hek293t,14611,1,5,CCCGAACTGAAAATGGATACAACTGGTATTGGTGTTAATGAAGCAAAAAGGAAATGAAATGCATTAAGGTAAAAAAAAAATTCTAGTTGGTTTAACGCG,CCCGAACTGAAAATGGATACAACTGGTATTGGTGTTAGCACAATGAAGCAAAAAGGAAATGAAATGCATTAAGGTAAAAAAAAAATTCTAGTTGGTTTA,10,30,14,27,27,45,27,50,27,38,38,45,43,50,23.1,12.20368136
hek293t,14613,1,3,GACTAAGCATTTCAGAAAGTTCACATGTATGGTTTAGATGACAAACAAGATGGTTCAGATAGCAAAATTGAATATTCTGGTAAAAAAATTCTAGTTGGT,GACTAAGCATTTCAGAAAGTTCACATGTGTAATGGTTTAGATGACAAACAAGATGGTTCAGATAGCAAAATTGAATATTCTGGTAAAAAAATTCTAGTT,10,30,14,27,27,39,27,42,27,29,29,39,32,42,36.4,27.61791624
hek293t,14613,1,3,CCTGCAGCATTTCAGAAAGTTCACATGTATGGTTTAGATGACAAACAAGATGGTTCAGATAGCAAAATTGAATATTCTGGTAAAAAAAAAATTCTAGTT,CCTGCAGCATTTCAGAAAGTTCACATGTGTAATGGTTTAGATGACAAACAAGATGGTTCAGATAGCAAAATTGAATATTCTGGTAAAAAAAAAATTCTA,10,30,14,27,27,36,27,39,27,29,29,36,32,39,36.4,15.72056658
hek293t,14615,1,5,CTAACAGGCTGAGATGGTGAGAAAAGCACTGGAAGAGAAGTATTGCAATTTTAACGCCTCACTTTCATTAGAAAAAAATTCTAGTTGGTTTAACGCGTA,CTAACAGGCTGAGATGGTGAGAAAAGCACTGGAAGACGGACGAAGTATTGCAATTTTAACGCCTCACTTTCATTAGAAAAAAATTCTAGTTGGTTTAAC,10,30,14,27,27,47,27,52,27,37,37,47,42,52,67.54,15.3123076
hek293t,14615,1,5,TGCGTAGGCTGAGATGGTGAGAAAAGCACTGGAAGAGAAGTATTGCAATTTTAACGCCTCACTTTCATTAGTGCTGATAAAAAAATTCTAGTTGGTTTA,TGCGTAGGCTGAGATGGTGAGAAAAGCACTGGAAGACGGACGAAGTATTGCAATTTTAACGCCTCACTTTCATTAGTGCTGATAAAAAAATTCTAGTTG,10,30,14,27,27,40,27,45,27,37,37,40,42,45,67.54,0.086355786
hek293t,14619,1,7,CCCGGGTATTGAGAAGAGGGAACTTAAGTAGGCAGGGGAGGCTGTCAAGGCAGTTTGTCCTCAACAAACTTCTAAAAAAAATTCTAGTTGGTTTAACGC,CCCGGGTATTGAGAAGAGGGAACTTAAGTAGGCAGGGGTCACGGCAGGCTGTCAAGGCAGTTTGTCCTCAACAAACTTCTAAAAAAAATTCTAGTTGGT,10,30,14,27,27,42,27,49,27,39,39,42,46,49,56.28,2.103587837
hek293t,14622,1,11,TGCCGCACGTTCATAGACATACTTACACGTGGATTTCAAGTGACCACTTTATGATGTCTTGGAAGATAAAAAAATTCTAGTTGGTTTAACGCGTAACTA,TGCCGCACGTTCATAGACATACTTACACGTGGATTTCCACGATACGCCAAGTGACCACTTTATGATGTCTTGGAAGATAAAAAAATTCTAGTTGGTTTA,10,30,14,27,27,45,27,56,27,38,38,45,49,56,63.73,0.332514862
hek293t,14622,1,11,CGGTTCACGTTCATAGACATACTTACACGTGGATTTCAAGTGACCACTTTATGATGTCTTGGAAGATTTGCAAAAAAATTCTAGTTGGTTTAACGCGTA,CGGTTCACGTTCATAGACATACTTACACGTGGATTTCCACGATACGCCAAGTGACCACTTTATGATGTCTTGGAAGATTTGCAAAAAAATTCTAGTTGG,10,30,14,27,27,41,27,52,27,38,38,41,49,52,63.73,0.0
hek293t,14627,1,12,TGTATGAGCTACTTCAAGCTCTGAAGCTGGGGATTAAGGCCAATATTATTTCAAGAGAAAATACCTTGAAAAAAATTCTAGTTGGTTTAACGCGTAACT,TGTATGAGCTACTTCAAGCTCTGAAGCTGGGGTGATAAGATGTCATTAAGGCCAATATTATTTCAAGAGAAAATACCTTGAAAAAAATTCTAGTTGGTT,10,30,14,27,27,43,27,55,27,33,33,43,45,55,59.79,3.545175749
hek293t,14627,1,12,GCGGCGAGCTACTTCAAGCTCTGAAGCTGGGGATTAAGGCCAATATTATTTCAAGAGAAAATACCTTGGAAGTTTAAAAAAATTCTAGTTGGTTTAACG,GCGGCGAGCTACTTCAAGCTCTGAAGCTGGGGTGATAAGATGTCATTAAGGCCAATATTATTTCAAGAGAAAATACCTTGGAAGTTTAAAAAAATTCTA,10,30,14,27,27,36,27,48,27,33,33,36,45,48,59.79,0.0
hek293t,14629,1,10,AGGGCTCTCCACAGGTGAGCAGATGGAAGTGGAACAATTAAAAATGTGGGTCATTGTAATTTAGAAATTTGTTTCCAAAAAAATTCTAGTTGGTTTAAC,AGGGCTCTCCACAGGTGAGCAGATGGAAGTCCCCGGTGCTGGAACAATTAAAAATGTGGGTCATTGTAATTTAGAAATTTGTTTCCAAAAAAATTCTAG,10,30,14,27,27,37,27,47,27,30,30,37,40,47,51.2,0.548153601
hek293t,14632,1,9,CTAATGCTGGCATTTTAGTGAAACAAAGCTGGAGGAAGGGTTCTGAAGAAGCTAACCTCTGGGCTTGTAGCTCTAAAAAAATTCTAGTTGGTTTAACGC,CTAATGCTGGCATTTTAGTGAAACAAAGCTGGGTGTAGAATAGGAAGGGTTCTGAAGAAGCTAACCTCTGGGCTTGTAGCTCTAAAAAAATTCTAGTTG,10,30,14,27,27,40,27,49,27,33,33,40,42,49,21.52,0.130229776
hek293t,14632,1,9,TGTCCGCTGGCATTTTAGTGAAACAAAGCTGGAGGAAGGGTTCTGAAGAAGCTAACCTCTGGGCTTGTAGCAAAAAAATTCTAGTTGGTTTAACGCGTA,TGTCCGCTGGCATTTTAGTGAAACAAAGCTGGGTGTAGAATAGGAAGGGTTCTGAAGAAGCTAACCTCTGGGCTTGTAGCAAAAAAATTCTAGTTGGTT,10,30,14,27,27,43,27,52,27,33,33,43,42,52,21.52,0.90227873
hek293t,14634,1,15,GATCGATACACAAAGTTATGTGATCCACAAGGAAAACAGATTGCAGTTAAGTTATTTATGACAATAAAAAAATTCTAGTTGGTTTAACGCGTAACTAGA,GATCGATACACAAAGTTATGTGATCCACAAGGAAAATTTGTCAGGCGTCTACAGATTGCAGTTAAGTTATTTATGACAATAAAAAAATTCTAGTTGGTT,10,30,14,27,27,43,27,58,27,36,36,43,51,58,45.79,1.860375082
hek293t,14635,1,15,GGGAATTGTGTTGCCAGAGTCTGAGTCCCAGGATTTTTTCCACAGGCCTGCAATCTCCTAACCAAAAAAAATTCTAGTTGGTTTAACGCGTAACTAGAT,GGGAATTGTGTTGCCAGAGTCTGAGTCCCAGGAACGACCCATAGTACGTTTTTTCCACAGGCCTGCAATCTCCTAACCAAAAAAAATTCTAGTTGGTTT,10,30,14,27,27,44,27,59,27,34,34,44,49,59,56.36,3.448275862
hek293t,14637,1,11,GTCCACCCCCCCCAGAAATTTGAAAATATAGGAAAACACACAATGTTGATAGGCTCATTACTTAGTAGTAAAAAAATTCTAGTTGGTTTAACGCGTAAC,GTCCACCCCCCCCAGAAATTTGAAAATATAGGTAATAAGTGACAAAACACACAATGTTGATAGGCTCATTACTTAGTAGTAAAAAAATTCTAGTTGGTT,10,30,14,27,27,43,27,54,27,33,33,43,44,54,12.97,0.0
hek293t,14637,1,11,GGCTTCCCCCCCCAGAAATTTGAAAATATAGGAAAACACACAATGTTGATAGGCTCATTACTTAGTAGTGCTGTGCAAAAAAATTCTAGTTGGTTTAAC,GGCTTCCCCCCCCAGAAATTTGAAAATATAGGTAATAAGTGACAAAACACACAATGTTGATAGGCTCATTACTTAGTAGTGCTGTGCAAAAAAATTCTA,10,30,14,27,27,36,27,47,27,33,33,36,44,47,12.97,0.0
hek293t,14639,1,2,ACCAGGGTCATGGGGTCTACTCCGAAGAGCGGACTGTATGTGCAGCTTGGCCGCACACCAACTCACCAACAAAAAAATTCTAGTTGGTTTAACGCGTAA,ACCAGGGTCATGGGGTCTACTCCGAAGAGCGGACTAAGTATGTGCAGCTTGGCCGCACACCAACTCACCAACAAAAAAATTCTAGTTGGTTTAACGCGT,10,30,14,27,27,51,27,53,27,36,36,51,38,53,66.87,48.03443726
hek293t,14639,1,2,ATTGGGGTCATGGGGTCTACTCCGAAGAGCGGACTGTATGTGCAGCTTGGCCGCACACCAACTCACCAACTTCTGCATGATGAAAAAAATTCTAGTTGG,ATTGGGGTCATGGGGTCTACTCCGAAGAGCGGACTAAGTATGTGCAGCTTGGCCGCACACCAACTCACCAACTTCTGCATGATGAAAAAAATTCTAGTT,10,30,14,27,27,39,27,41,27,36,36,39,38,41,66.87,0.805840431
hek293t,14641,1,2,GGGTCTGTTAGCTTGCAGTTCTAAACTTATGGCCCTAGAAAAATCCCAGGAATTCCAGCATCAGCTGTTTGTTTTCAGAAGCAAAGTAAAAAAATTCTA,GGGTCTGTTAGCTTGCAGTTCTAAACCGTTATGGCCCTAGAAAAATCCCAGGAATTCCAGCATCAGCTGTTTGTTTTCAGAAGCAAAGTAAAAAAATTC,10,30,14,27,27,34,27,36,27,27,27,34,29,36,16.9,45.49355902
hek293t,14641,1,2,GTTGTTGTTAGCTTGCAGTTCTAAACTTATGGCCCTAGAAAAATCCCAGGAATTCCAGCATCAGCTGTTTGTTTTCAGAAAAAAAATTCTAGTTGGTTT,GTTGTTGTTAGCTTGCAGTTCTAAACCGTTATGGCCCTAGAAAAATCCCAGGAATTCCAGCATCAGCTGTTTGTTTTCAGAAAAAAAATTCTAGTTGGT,10,30,14,27,27,42,27,44,27,27,27,42,29,44,16.9,55.62918663
hek293t,14643,1,10,CGTTACACAAAAGGAAGATTAATGAAAGATGGGTAAGAAAGAGAAATAGAAGCAAAATATCCAAGTAATTTAAAAAAAAAAAATTCTAGTTGGTTTAAC,CGTTACACAAAAGGAAGATTAATGAAAGATGTACGTAAATGGGTAAGAAAGAGAAATAGAAGCAAAATATCCAAGTAATTTAAAAAAAAAAAATTCTAG,10,30,14,27,27,37,27,47,27,30,30,37,40,47,39.34,0.0
hek293t,14643,1,10,CCGTTCACAAAAGGAAGATTAATGAAAGATGGGTAAGAAAGAGAAATAGAAGCAAAATATCCAAGTAATTTAAAAAAAAATTCTAGTTGGTTTAACGCG,CCGTTCACAAAAGGAAGATTAATGAAAGATGTACGTAAATGGGTAAGAAAGAGAAATAGAAGCAAAATATCCAAGTAATTTAAAAAAAAATTCTAGTTG,10,30,14,27,27,40,27,50,27,30,30,40,40,50,39.34,0.127388535
hek293t,14645,1,15,TAAATTATGATTATACAATAAAATCTGAACGGAACACAAAGCCAGGTACTAAACTGTAGCAATAATATGAAAAAAATTCTAGTTGGTTTAACGCGTAAC,TAAATTATGATTATACAATAAAATCTGAACGGCAAATGTCGGTAGCGAACACAAAGCCAGGTACTAAACTGTAGCAATAATATGAAAAAAATTCTAGTT,10,30,14,27,27,39,27,54,27,32,32,39,47,54,32.42,0.0
hek293t,14645,1,15,CCCTCTATGATTATACAATAAAATCTGAACGGAACACAAAGCCAGGTACTAAACTGTAGCAATAATATGCTCAAAAAAAATTCTAGTTGGTTTAACGCG,CCCTCTATGATTATACAATAAAATCTGAACGGCAAATGTCGGTAGCGAACACAAAGCCAGGTACTAAACTGTAGCAATAATATGCTCAAAAAAAATTCT,10,30,14,27,27,35,27,50,27,32,32,35,47,50,32.42,0.0
hek293t,14647,1,10,GAAATCTCCTCAACGCTCTGCGTAGAGGCAGGATTGTCAGTTGTTAAGAGCATTTCTTCCTGTTATTGCCACTTTTAAAAAAATTCTAGTTGGTTTAAC,GAAATCTCCTCAACGCTCTGCGTAGAGGCGGCCCTTGTCAGGATTGTCAGTTGTTAAGAGCATTTCTTCCTGTTATTGCCACTTTTAAAAAAATTCTAG,10,30,14,27,27,37,27,47,27,30,30,37,40,47,57.39,0.225225225
hek293t,14647,1,10,TACCGCTCCTCAACGCTCTGCGTAGAGGCAGGATTGTCAGTTGTTAAGAGCATTTCTTCCTGTTATTGCCACTTTTTCAAAAAAAAATTCTAGTTGGTT,TACCGCTCCTCAACGCTCTGCGTAGAGGCGGCCCTTGTCAGGATTGTCAGTTGTTAAGAGCATTTCTTCCTGTTATTGCCACTTTTTCAAAAAAAAATT,10,30,14,27,27,33,27,43,27,30,30,33,40,43,57.39,0.0
hek293t,14649,1,3,GGTGAAAGAGCAACATTAGATTATTGTAGAGGTTATGAAGCCAATATGAAATTTCAAATTAAAATTAAAAAAATTCTAGTTGGTTTAACGCGTAACTAG,GGTGAAAGAGCAACATTAGATTATTGTAGAGGTTATGATATAGCCAATATGAAATTTCAAATTAAAATTAAAAAAATTCTAGTTGGTTTAACGCGTAAC,10,30,14,27,27,54,27,57,27,39,39,54,42,57,41.2,2.636063202
hek293t,14649,1,3,CGGTTAAGAGCAACATTAGATTATTGTAGAGGTTATGAAGCCAATATGAAATTTCAAATTAAAATTTGAGATATAAAAAAATTCTAGTTGGTTTAACGC,CGGTTAAGAGCAACATTAGATTATTGTAGAGGTTATGATATAGCCAATATGAAATTTCAAATTAAAATTTGAGATATAAAAAAATTCTAGTTGGTTTAA,10,30,14,27,27,46,27,49,27,39,39,46,42,49,41.2,25.8305703
hek293t,14651,1,4,CAGACCCATGCATGAACAGAGGACACGAGGGGAGCTGATTGTCTAGAGGATAGTCAAGGGTGCAAATTGACAGGAATTTAAAAAAATTCTAGTTGGTTT,CAGACCCATGCATGAACAGAGGACACGAGCAGCGGGAGCTGATTGTCTAGAGGATAGTCAAGGGTGCAAATTGACAGGAATTTAAAAAAATTCTAGTTG,10,30,14,27,27,40,27,44,27,30,30,40,34,44,59.81,80.13762707
hek293t,14651,1,4,TATGACCATGCATGAACAGAGGACACGAGGGGAGCTGATTGTCTAGAGGATAGTCAAGGGTGCAAATTGACAGGAATTTGATAAAAAAATTCTAGTTGG,TATGACCATGCATGAACAGAGGACACGAGCAGCGGGAGCTGATTGTCTAGAGGATAGTCAAGGGTGCAAATTGACAGGAATTTGATAAAAAAATTCTAG,10,30,14,27,27,37,27,41,27,30,30,37,34,41,59.81,61.56051854
hek293t,14655,1,10,GGAGGCCGTTAATTCATACTGTTGATAAATGGAAAATGAGCATCCTAAGGAGATAGTGTGCGCAGGATGCTAAAAAAATTCTAGTTGGTTTAACGCGTA,GGAGGCCGTTAATTCATACTGTTGATAAATGGGGCGATGGAGAAAATGAGCATCCTAAGGAGATAGTGTGCGCAGGATGCTAAAAAAATTCTAGTTGGT,10,30,14,27,27,42,27,52,27,32,32,42,42,52,10.28,0.889454953
hek293t,14655,1,10,GTTCGCCGTTAATTCATACTGTTGATAAATGGAAAATGAGCATCCTAAGGAGATAGTGTGCGCAGGATGCTTTGAAAAAAATTCTAGTTGGTTTAACGC,GTTCGCCGTTAATTCATACTGTTGATAAATGGGGCGATGGAGAAAATGAGCATCCTAAGGAGATAGTGTGCGCAGGATGCTTTGAAAAAAATTCTAGTT,10,30,14,27,27,39,27,49,27,32,32,39,42,49,10.28,0.0
hek293t,14659,1,4,TATATCAATGGCATTTTTGTTAATATATGAGGTAGCATTCTTACACAAAGGGAGAGGAGAAGCTTATATACAAACAACGCACAAAAAAAATTCTAGTTG,TATATCAATGGCATTTTTGTTAATATATGAGGTGAGTAGCATTCTTACACAAAGGGAGAGGAGAAGCTTATATACAAACAACGCACAAAAAAAATTCTA,10,30,14,27,27,36,27,40,27,33,33,36,37,40,9.11,0.0
hek293t,14659,1,4,CTGCACAATGGCATTTTTGTTAATATATGAGGTAGCATTCTTACACAAAGGGAGAGGAGAAGCTTATATACAAACAAAAAAAATTCTAGTTGGTTTAAC,CTGCACAATGGCATTTTTGTTAATATATGAGGTGAGTAGCATTCTTACACAAAGGGAGAGGAGAAGCTTATATACAAACAAAAAAAATTCTAGTTGGTT,10,30,14,27,27,43,27,47,27,33,33,43,37,47,9.11,15.30082429
hek293t,14661,1,12,GCCACTGGTTATATTGCCTAAGTTCATCAAGGTAAAGATTGTGTTTTCCATGTGTCTTTCCTTACCAAAAGCTAATGAAAAAAATTCTAGTTGGTTTAA,GCCACTGGTTATATTGCCTAAGTTCATCAACTTCATACCATTGGTAAAGATTGTGTTTTCCATGTGTCTTTCCTTACCAAAAGCTAATGAAAAAAATTC,10,30,14,27,27,34,27,46,27,31,31,34,43,46,61.97,0.0
hek293t,14663,1,11,CTCTTAGAAGCAGCTGCTAATGAGGTGAAAGGATTTTTACTGAATTCTTAAATAAGAGATTGCAGGAAAAAAATTCTAGTTGGTTTAACGCGTAACTAG,CTCTTAGAAGCAGCTGCTAATGAGGTGAAAGAACTGGATCTGGATTTTTACTGAATTCTTAAATAAGAGATTGCAGGAAAAAAATTCTAGTTGGTTTAA,10,30,14,27,27,46,27,57,27,31,31,46,42,57,64.44,9.247869385
hek293t,14663,1,11,TAGTGAGAAGCAGCTGCTAATGAGGTGAAAGGATTTTTACTGAATTCTTAAATAAGAGATTGCAGGATACAAAATAGTAAAAAAATTCTAGTTGGTTTA,TAGTGAGAAGCAGCTGCTAATGAGGTGAAAGAACTGGATCTGGATTTTTACTGAATTCTTAAATAAGAGATTGCAGGATACAAAATAGTAAAAAAATTC,10,30,14,27,27,34,27,45,27,31,31,34,42,45,64.44,0.0
hek293t,14665,1,10,TTTTTACAATTAAGCAAGCTTCTATAAAATGGCTACTGACTTTCAATACCTAGACCAAGCCACCTAAAAAAATTCTAGTTGGTTTAACGCGTAACTAGA,TTTTTACAATTAAGCAAGCTTCTATAAAATGGCTACTAATACCAGCTGACTTTCAATACCTAGACCAAGCCACCTAAAAAAATTCTAGTTGGTTTAACG,10,30,14,27,27,48,27,58,27,38,38,48,48,58,14.0,1.132844512
hek293t,14665,1,10,ATAGAACAATTAAGCAAGCTTCTATAAAATGGCTACTGACTTTCAATACCTAGACCAAGCCACCTTAGAAAAAAATTCTAGTTGGTTTAACGCGTAACT,ATAGAACAATTAAGCAAGCTTCTATAAAATGGCTACTAATACCAGCTGACTTTCAATACCTAGACCAAGCCACCTTAGAAAAAAATTCTAGTTGGTTTA,10,30,14,27,27,45,27,55,27,38,38,45,48,55,14.0,0.839563716
hek293t,14669,1,4,GACAGTCATAGTACCTATTGTAGAGAATATGGTACAGGGCAGTGCCTCATCTTCCATGGTGAATTCATACAAAAAAATTCTAGTTGGTTTAACGCGTAA,GACAGTCATAGTACCTATTGTAGAGAATATGGTTAGTACAGGGCAGTGCCTCATCTTCCATGGTGAATTCATACAAAAAAATTCTAGTTGGTTTAACGC,10,30,14,27,27,49,27,53,27,34,34,49,38,53,31.6,82.78073602
hek293t,14669,1,4,GAACCTCATAGTACCTATTGTAGAGAATATGGTACAGGGCAGTGCCTCATCTTCCATGGTGAATTCATACCTGTTTCCAAAAAAATTCTAGTTGGTTTA,GAACCTCATAGTACCTATTGTAGAGAATATGGTTAGTACAGGGCAGTGCCTCATCTTCCATGGTGAATTCATACCTGTTTCCAAAAAAATTCTAGTTGG,10,30,14,27,27,41,27,45,27,34,34,41,38,45,31.6,81.98415361
hek293t,14671,1,4,TGGGTGGCTATAGTAAACCCCTTTTCAAATGGAATTGCTGTATACAGAGTACATCTGGAGCAGAGCCCAAAAAAATTCTAGTTGGTTTAACGCGTAACT,TGGGTGGCTATAGTAAACCCCTTTTCAAATGGAATTGCTGTGTTTATACAGAGTACATCTGGAGCAGAGCCCAAAAAAATTCTAGTTGGTTTAACGCGT,10,30,14,27,27,51,27,55,27,41,41,51,45,55,8.51,58.62172515
hek293t,14672,1,10,TGAGATTCAGGGAAAATAAATGTGAATTATGGTTCAATGAGACCCTTGACTGTGCACTTGAGGTGTAAAAAAATTCTAGTTGGTTTAACGCGTAACTAG,TGAGATTCAGGGAAAATAAATGTGAATTATGGTTCACTGCGACCGCATGAGACCCTTGACTGTGCACTTGAGGTGTAAAAAAATTCTAGTTGGTTTAAC,10,30,14,27,27,47,27,57,27,37,37,47,47,57,28.56,2.729506816
hek293t,14673,1,9,GGTCGGAAAACTGCAGAGAAGCAGCAACACGGAACATAAATTCTCCAGGAGGACTCTCATATATAGAGAGATACCAAAAAAAATTCTAGTTGGTTTAAC,GGTCGGAAAACTGCAGAGAAGCAGCAAGAGCGTTCGCACGGAACATAAATTCTCCAGGAGGACTCTCATATATAGAGAGATACCAAAAAAAATTCTAGT,10,30,14,27,27,38,27,47,27,28,28,38,37,47,79.71,38.90179062
hek293t,14673,1,9,CTTTCGAAAACTGCAGAGAAGCAGCAACACGGAACATAAATTCTCCAGGAGGACTCTCATATATAGAGAGATACCAAATAAAAAAATTCTAGTTGGTTT,CTTTCGAAAACTGCAGAGAAGCAGCAAGAGCGTTCGCACGGAACATAAATTCTCCAGGAGGACTCTCATATATAGAGAGATACCAAATAAAAAAATTCT,10,30,14,27,27,35,27,44,27,28,28,35,37,44,79.71,1.867484799
hek293t,14675,1,4,TCAATGCGGTGCTCGGGAGCCTGTGGGTGCGGGGGACTTGGTGGTCCTCTTCCCAGGCTACCGCAGGGCCTCGGTGTCTCCTGAAAAAAATTCTAGTTG,TCAATGCGGTGCTCGGGAGCCTGTGGGTGCGGGGAGGGGACTTGGTGGTCCTCTTCCCAGGCTACCGCAGGGCCTCGGTGTCTCCTGAAAAAAATTCTA,10,30,14,27,27,36,27,40,27,33,33,36,37,40,28.87,1.246480248
hek293t,14677,1,15,GTCTTTTTTGGCCCCCCCGTTCAAGGAAGCGGAGTGAGAGCATAAGAGCAAAAGCTGGTCGCGGGAGTAGCCGGTACGAAAAAAATTCTAGTTGGTTTA,GTCTTTTTTGGCCCCCCCGTTCAAGGAATATTGCGCGACTTAAGCGGAGTGAGAGCATAAGAGCAAAAGCTGGTCGCGGGAGTAGCCGGTACGAAAAAA,10,30,14,27,27,30,27,45,27,27,27,30,42,45,40.79,0.0
hek293t,14679,1,9,TCCTTCAGAAATGCTGCAGAGAGGAGAGGTGGTTTTAGCTGACTTTCTTGCCTACATGTAGGGAGCACAGTAGGTAAAAAAAAATTCTAGTTGGTTTAA,TCCTTCAGAAATGCTGCAGAGAGGAGAGGTTCTAGAGCTGGTTTTAGCTGACTTTCTTGCCTACATGTAGGGAGCACAGTAGGTAAAAAAAAATTCTAG,10,30,14,27,27,37,27,46,27,30,30,37,39,46,58.35,3.518111051
hek293t,14679,1,9,TCTATCAGAAATGCTGCAGAGAGGAGAGGTGGTTTTAGCTGACTTTCTTGCCTACATGTAGGGAGCACAGTAGGTAACTTAAAAAAAATTCTAGTTGGT,TCTATCAGAAATGCTGCAGAGAGGAGAGGTTCTAGAGCTGGTTTTAGCTGACTTTCTTGCCTACATGTAGGGAGCACAGTAGGTAACTTAAAAAAAATT,10,30,14,27,27,33,27,42,27,30,30,33,39,42,58.35,0.898822667
hek293t,1442,1,11,CGGTCAACCAGAGGAAGTGGACAGCTCAGAGGCATGCAATCCACCTTCAGTCTAACAACACTTTTTCAAAAAAAATTCTAGTTGGTTTAACGCGTAACT,CGGTCAACCAGAGGAAGTGGACAGCTCAGAGGCATGCAATACCTGGTATAGCCACCTTCAGTCTAACAACACTTTTTCAAAAAAAATTCTAGTTGGTTT,10,30,14,27,27,44,27,55,27,41,41,44,52,55,77.7,0.366300366
hek293t,14682,1,14,CGGCAAAGCCAACCTTACACTCAAATTCAAGGTGGATTTAGAATTAAAATAAACTTGAAACACCAAAAATACCTTTAAAAAAAAATTCTAGTTGGTTTA,CGGCAAAGCCAACCTTACACTCAAATTACCGCTTACTCCGTCAAGGTGGATTTAGAATTAAAATAAACTTGAAACACCAAAAATACCTTTAAAAAAAAA,10,30,14,27,27,31,27,45,27,28,28,31,42,45,21.45,0.0
hek293t,14682,1,14,TCCGGAAGCCAACCTTACACTCAAATTCAAGGTGGATTTAGAATTAAAATAAACTTGAAACACCAAAAATAAAAAAAATTCTAGTTGGTTTAACGCGTA,TCCGGAAGCCAACCTTACACTCAAATTACCGCTTACTCCGTCAAGGTGGATTTAGAATTAAAATAAACTTGAAACACCAAAAATAAAAAAAATTCTAGT,10,30,14,27,27,38,27,52,27,28,28,38,42,52,21.45,3.202698483
hek293t,14684,1,14,GATGGTCTGTGGGTTGTATTTAAAAGGTAAGGTAATAGCCATTATTAATTCATAACCACTTTCTTCATTGGAAAAAAATTCTAGTTGGTTTAACGCGTA,GATGGTCTGTGGGTTGTATTTAAAAGGTAAAATGTCCATTTTCCGGTAATAGCCATTATTAATTCATAACCACTTTCTTCATTGGAAAAAAATTCTAGT,10,30,14,27,27,38,27,52,27,31,31,38,45,52,38.6,0.0
hek293t,14686,1,7,TTTACTATCTTTGTGAGATCTTTGCCACTTGGAAATTGTTCTTTTGGTCATTACATATGCACCTAAGAATTGTCAAAAAAAATTCTAGTTGGTTTAACG,TTTACTATCTTTGTGAGATCTTTGCCACTTGGAAAGTTTAAATTGTTCTTTTGGTCATTACATATGCACCTAAGAATTGTCAAAAAAAATTCTAGTTGG,10,30,14,27,27,41,27,48,27,34,34,41,41,48,16.3,0.0
hek293t,14686,1,7,GAAAGTATCTTTGTGAGATCTTTGCCACTTGGAAATTGTTCTTTTGGTCATTACATATGCACCTAAGAAAAAAATTCTAGTTGGTTTAACGCGTAACTA,GAAAGTATCTTTGTGAGATCTTTGCCACTTGGAAAGTTTAAATTGTTCTTTTGGTCATTACATATGCACCTAAGAAAAAAATTCTAGTTGGTTTAACGC,10,30,14,27,27,49,27,56,27,34,34,49,41,56,16.3,3.798045631
hek293t,14688,1,15,CAGTCAGCATTCCAAAGGTATCATTTACAAGGATAGTGTTAGACTGTCAAAGGGATGCAGTGACTAAAAAAAATTCTAGTTGGTTTAACGCGTAACTAG,CAGTCAGCATTCCAAAGGTATCATTTGTTAGCCCTTATCCTACAAGGATAGTGTTAGACTGTCAAAGGGATGCAGTGACTAAAAAAAATTCTAGTTGGT,10,30,14,27,27,42,27,57,27,27,27,42,42,57,21.11,12.95874452
hek293t,14688,1,15,TAAAGAGCATTCCAAAGGTATCATTTACAAGGATAGTGTTAGACTGTCAAAGGGATGCAGTGACTACTAGACTTAACTAAAAAAATTCTAGTTGGTTTA,TAAAGAGCATTCCAAAGGTATCATTTGTTAGCCCTTATCCTACAAGGATAGTGTTAGACTGTCAAAGGGATGCAGTGACTACTAGACTTAACTAAAAAA,10,30,14,27,27,30,27,45,27,27,27,30,42,45,21.11,0.0
hek293t,14690,1,2,CTAAGGTTTTATCAGATTGTAATGGTAGCAGGTTAATTGGGAGGGTAATGATGGCATCTTTGGGCTTTTAGAGACTGATAAAAAAAAAATTCTAGTTGG,CTAAGGTTTTATCAGATTGTAATGGTAGGGCAGGTTAATTGGGAGGGTAATGATGGCATCTTTGGGCTTTTAGAGACTGATAAAAAAAAAATTCTAGTT,10,30,14,27,27,39,27,41,27,29,29,39,31,41,17.91,50.22412532
hek293t,14690,1,2,ACTACGTTTTATCAGATTGTAATGGTAGCAGGTTAATTGGGAGGGTAATGATGGCATCTTTGGGCTTTTAGAGACTGAAAAAAATTCTAGTTGGTTTAA,ACTACGTTTTATCAGATTGTAATGGTAGGGCAGGTTAATTGGGAGGGTAATGATGGCATCTTTGGGCTTTTAGAGACTGAAAAAAATTCTAGTTGGTTT,10,30,14,27,27,44,27,46,27,29,29,44,31,46,17.91,30.88980122
hek293t,14692,1,5,TTAGTCAACTCAGCTAACCCCTGTTCCTGTGGAGCCAGAGTATATGGAAGGCAGCCATGCAGCTGACATCGGTTGACAAAAAAATTCTAGTTGGTTTAA,TTAGTCAACTCAGCTAACCCCTGTTCCTGTGGAAATGAGCCAGAGTATATGGAAGGCAGCCATGCAGCTGACATCGGTTGACAAAAAAATTCTAGTTGG,10,30,14,27,27,41,27,46,27,34,34,41,39,46,57.41,51.30914412
hek293t,14692,1,5,GTACCCAACTCAGCTAACCCCTGTTCCTGTGGAGCCAGAGTATATGGAAGGCAGCCATGCAGCTGACATAAAAAAATTCTAGTTGGTTTAACGCGTAAC,GTACCCAACTCAGCTAACCCCTGTTCCTGTGGAAATGAGCCAGAGTATATGGAAGGCAGCCATGCAGCTGACATAAAAAAATTCTAGTTGGTTTAACGC,10,30,14,27,27,49,27,54,27,34,34,49,39,54,57.41,52.70157535
hek293t,14694,1,11,TCCGTAATTTACACTTCTCTGATAAAGTAAGGGAAACTTAAAATGGGGGTATGCATTATACCACCATGAAAAAAAATTCTAGTTGGTTTAACGCGTAAC,TCCGTAATTTACACTTCTCTGATAAAGTAAGGGAAACTTTCTGAGTAATAAAAATGGGGGTATGCATTATACCACCATGAAAAAAAATTCTAGTTGGTT,10,30,14,27,27,43,27,54,27,40,40,43,51,54,30.09,0.0
hek293t,14694,1,11,AGTCAAATTTACACTTCTCTGATAAAGTAAGGGAAACTTAAAATGGGGGTATGCATTATACCACCAAAAAAATTCTAGTTGGTTTAACGCGTAACTAGA,AGTCAAATTTACACTTCTCTGATAAAGTAAGGGAAACTTTCTGAGTAATAAAAATGGGGGTATGCATTATACCACCAAAAAAATTCTAGTTGGTTTAAC,10,30,14,27,27,47,27,58,27,40,40,47,51,58,30.09,0.0
hek293t,14696,1,10,ATGGTATAAATGGGGCTCTGGGAATATGTTGGAATTCTTCACAGTGATAACTGTTGCCATGCAGAAAAAAATTCTAGTTGGTTTAACGCGTAACTAGAT,ATGGTATAAATGGGGCTCTGGGAATATGTTGGAATTCTGACAAGGAATTCACAGTGATAACTGTTGCCATGCAGAAAAAAATTCTAGTTGGTTTAACGC,10,30,14,27,27,49,27,59,27,39,39,49,49,59,50.28,0.414585635
hek293t,14697,1,10,GTGTTGTTTTTCATCTACAGTTCATTTTTAGGTAAAGTCAGTTCACAGACAGGTGGTCACCATTTTGCACAAAAAAATTCTAGTTGGTTTAACGCGTAA,GTGTTGTTTTTCATCTACAGTTCATTTTTAGGTAAAGTCAAACCATTAGAGTTCACAGACAGGTGGTCACCATTTTGCACAAAAAAATTCTAGTTGGTT,10,30,14,27,27,43,27,53,27,40,40,43,50,53,1.48,0.0
hek293t,14698,1,10,TTGCTGAAAGAAGAATTAGGCCAAGTTTTAGGGAAGAATTATTTAAGTTAATTTGTTTTACCAGGTTAGCAAAAAAATTCTAGTTGGTTTAACGCGTAA,TTGCTGAAAGAAGAATTAGGCCAAGTTTTAGGGAAGAATCGTGTTCACTTATTTAAGTTAATTTGTTTTACCAGGTTAGCAAAAAAATTCTAGTTGGTT,10,30,14,27,27,43,27,53,27,40,40,43,50,53,5.4,0.0
hek293t,14699,1,15,TATTCTAATTTGCCTTTAAGAGGGTTTTTTGGATGATACCATACAGAATAGGTCTGTAGAAATTTTAAAAAAAATTCTAGTTGGTTTAACGCGTAACTA,TATTCTAATTTGCCTTTAAGAGGGTTTTTTGGGAATCTGGATTTTGGATGATACCATACAGAATAGGTCTGTAGAAATTTTAAAAAAAATTCTAGTTGG,10,30,14,27,27,41,27,56,27,31,31,41,46,56,-9.4,0.24618709
hek293t,14699,1,15,TGGTATAATTTGCCTTTAAGAGGGTTTTTTGGATGATACCATACAGAATAGGTCTGTAGAAATTTTATAACAACAAAAAAATTCTAGTTGGTTTAACGC,TGGTATAATTTGCCTTTAAGAGGGTTTTTTGGGAATCTGGATTTTGGATGATACCATACAGAATAGGTCTGTAGAAATTTTATAACAACAAAAAAATTC,10,30,14,27,27,34,27,49,27,31,31,34,46,49,-9.4,0.0
hek293t,14701,1,3,ACGCTCTTCCTTCTTAGTTTTTGAAGTAGTGGGATCATTCACTCATTTTCAAACGTTCTTATTCTATTTAGCTTGTAAAAAAATTCTAGTTGGTTTAAC,ACGCTCTTCCTTCTTAGTTTTTGAAGTAGTGGGATCAATATTCACTCATTTTCAAACGTTCTTATTCTATTTAGCTTGTAAAAAAATTCTAGTTGGTTT,10,30,14,27,27,44,27,47,27,37,37,44,40,47,-0.99,0.213675214
hek293t,14705,1,12,TGGTACCAATATGGAAAAAGGAGATCTGTTGGTATGCAAAGTCTATTTCAACAAGCCACAAGTGATACTAAAAAAATTCTAGTTGGTTTAACGCGTAAC,TGGTACCAATATGGAAAAAGGAGATCTGTTGCATGTACACTCTGTATGCAAAGTCTATTTCAACAAGCCACAAGTGATACTAAAAAAATTCTAGTTGGT,10,30,14,27,27,42,27,54,27,32,32,42,44,54,60.63,1.692083675
hek293t,14705,1,12,AGGCACCAATATGGAAAAAGGAGATCTGTTGGTATGCAAAGTCTATTTCAACAAGCCACAAGTGATACTTGATAATAAAAAAATTCTAGTTGGTTTAAC,AGGCACCAATATGGAAAAAGGAGATCTGTTGCATGTACACTCTGTATGCAAAGTCTATTTCAACAAGCCACAAGTGATACTTGATAATAAAAAAATTCT,10,30,14,27,27,35,27,47,27,32,32,35,44,47,60.63,0.0
hek293t,14707,1,8,AGCACACAGCTGATGTACTGGCTGGGGTTTGGATATCTTGGGCAATTTGCAACAGGAGCTAACTGAAGGAATCCCTTGAAAAAAAATTCTAGTTGGTTT,AGCACACAGCTGATGTACTGGCTGGGGTTTGGTCGGGAGCATATCTTGGGCAATTTGCAACAGGAGCTAACTGAAGGAATCCCTTGAAAAAAAATTCTA,10,30,14,27,27,36,27,44,27,33,33,36,41,44,47.98,0.289855072
hek293t,14707,1,8,ACTGCACAGCTGATGTACTGGCTGGGGTTTGGATATCTTGGGCAATTTGCAACAGGAGCTAACTGAAGGAATAAAAAAATTCTAGTTGGTTTAACGCGT,ACTGCACAGCTGATGTACTGGCTGGGGTTTGGTCGGGAGCATATCTTGGGCAATTTGCAACAGGAGCTAACTGAAGGAATAAAAAAATTCTAGTTGGTT,10,30,14,27,27,43,27,51,27,33,33,43,41,51,47.98,22.10429918
hek293t,22511,1,7,ACGTTATTCTGTAGAAGTTATGTGGTGTCAGGCGCATGTACTACAAGGTACCATGACTGCAAATGAACAAAAAAAATTCTAGTTGGTTTAACGCGTAAC,ACGTTATTCTGTAGAAGTTATGTGGTGTCAGGCGCAGCCATCCTGTACTACAAGGTACCATGACTGCAAATGAACAAAAAAAATTCTAGTTGGTTTAAC,10,30,14,27,27,47,27,54,27,37,37,47,44,54,46.17,36.14066372
hek293t,22511,1,7,CAAGGATTCTGTAGAAGTTATGTGGTGTCAGGCGCATGTACTACAAGGTACCATGACTGCAAATGAACAGGTAAAAAAATTCTAGTTGGTTTAACGCGT,CAAGGATTCTGTAGAAGTTATGTGGTGTCAGGCGCAGCCATCCTGTACTACAAGGTACCATGACTGCAAATGAACAGGTAAAAAAATTCTAGTTGGTTT,10,30,14,27,27,44,27,51,27,37,37,44,44,51,46.17,1.350982779
hek293t,14711,1,6,TTAAGTTTAAACCCATATCATTTAAGGTACGGAACTACAGTTATAGGAAGGCCTTAGCCCTGAAGTTATTACCTTTACAAAAAAATTCTAGTTGGTTTA,TTAAGTTTAAACCCATATCATTTAAGGTACGGAACCCGGACTACAGTTATAGGAAGGCCTTAGCCCTGAAGTTATTACCTTTACAAAAAAATTCTAGTT,10,30,14,27,27,39,27,45,27,36,36,39,42,45,43.29,0.0
hek293t,14711,1,6,CCGGCTTTAAACCCATATCATTTAAGGTACGGAACTACAGTTATAGGAAGGCCTTAGCCCTGAAGTTATTAAAAAAAATTCTAGTTGGTTTAACGCGTA,CCGGCTTTAAACCCATATCATTTAAGGTACGGAACCCGGACTACAGTTATAGGAAGGCCTTAGCCCTGAAGTTATTAAAAAAAATTCTAGTTGGTTTAA,10,30,14,27,27,46,27,52,27,36,36,46,42,52,43.29,7.462982485
hek293t,14713,1,7,AGTAGGCAGTACAGAACAGCATGAGAAACAGGTGCTTGCTACTGATCAGGAGGCATAGCCCCCCCGGAAAAAAAATTCTAGTTGGTTTAACGCGTAACT,AGTAGGCAGTACAGAACAGCATGAGAAACAGGTGCTTTCGAGGAGCTACTGATCAGGAGGCATAGCCCCCCCGGAAAAAAAATTCTAGTTGGTTTAACG,10,30,14,27,27,48,27,55,27,38,38,48,45,55,29.51,15.85522592
hek293t,18173,1,3,GCGGTACACAGAATTTTCAGGTATGCAGGAGGGCTGTGCACGGTTATAAAGACACATGGCAAAACTTCAGACAGTGTCTTCTCCAAAAAAATTCTAGTT,GCGGTACACAGAATTTTCAGGTATGCAGGGGGAGGGCTGTGCACGGTTATAAAGACACATGGCAAAACTTCAGACAGTGTCTTCTCCAAAAAAATTCTA,10,30,14,27,27,36,27,39,27,29,29,36,32,39,34.67,33.43764569
hek293t,18173,1,3,CACGCACACAGAATTTTCAGGTATGCAGGAGGGCTGTGCACGGTTATAAAGACACATGGCAAAACTTCAGACAGTGTCTTCAAAAAAATTCTAGTTGGT,CACGCACACAGAATTTTCAGGTATGCAGGGGGAGGGCTGTGCACGGTTATAAAGACACATGGCAAAACTTCAGACAGTGTCTTCAAAAAAATTCTAGTT,10,30,14,27,27,39,27,42,27,29,29,39,32,42,34.67,47.92454247
hek293t,14716,1,11,GAACGTCAGGCAAGAGTTTGTATTCTGAAAGGTTTTTTGCACTGGGCAGTTGAGAACCAAGGGGGTAAAAAAATTCTAGTTGGTTTAACGCGTAACTAG,GAACGTCAGGCAAGAGTTTGTATTCTGAAAGGTTTTTTGGAGAGGACTAGCACTGGGCAGTTGAGAACCAAGGGGGTAAAAAAATTCTAGTTGGTTTAA,10,30,14,27,27,46,27,57,27,39,39,46,50,57,30.82,1.018640123
hek293t,14717,1,2,TGCTTTCTAGGATTATCCATCAATGTCAGTGGGAAGTGTAGACTAATACACAGCATGTACCTACTCTCATTGAAAAAAAATTCTAGTTGGTTTAACGCG,TGCTTTCTAGGATTATCCATCAATGTCAGTGGGAAGTGTAGTGACTAATACACAGCATGTACCTACTCTCATTGAAAAAAAATTCTAGTTGGTTTAACG,10,30,14,27,27,48,27,50,27,41,41,48,43,50,42.98,61.46061586
hek293t,14719,1,2,CCCCTTATCTTTTTAAACATAATGCTATTTGGTTTTACTTGCAATCAGCTTGTTTAGAGTCATGTTCTATTACCACCACAAAAAGAAAAAAATTCTAGT,CCCCTTATCTTTTTAAACATAATGCTATTTGGGCTTTTACTTGCAATCAGCTTGTTTAGAGTCATGTTCTATTACCACCACAAAAAGAAAAAAATTCTA,10,30,14,27,27,36,27,38,27,33,33,36,35,38,0.78,0.0
hek293t,14721,1,3,AATCCCACAGAGATTGTTGTCCTCATTGGAGGCATACCACCTCCAGGATGTTGACATTTGCAAGCACTGTAAAAAAATTCTAGTTGGTTTAACGCGTAA,AATCCCACAGAGATTGTTGTCCTCATTGGAGGCATACCAGCTCCTCCAGGATGTTGACATTTGCAAGCACTGTAAAAAAATTCTAGTTGGTTTAACGCG,10,30,14,27,27,50,27,53,27,40,40,50,43,53,69.23,78.62721919
hek293t,14721,1,3,AAAAGCACAGAGATTGTTGTCCTCATTGGAGGCATACCACCTCCAGGATGTTGACATTTGCAAGCACTGTCAAGGTCAAAAAAATTCTAGTTGGTTTAA,AAAAGCACAGAGATTGTTGTCCTCATTGGAGGCATACCAGCTCCTCCAGGATGTTGACATTTGCAAGCACTGTCAAGGTCAAAAAAATTCTAGTTGGTT,10,30,14,27,27,43,27,46,27,40,40,43,43,46,69.23,1.466088845
hek293t,14725,1,5,CTGATCTGTAATCTGGTCTCTTGTAAAGCTGGGTCACACCAAATATCTAATTGGTAGTAATAACTTCAAGCAATTAACTCCTAAACTGAAAAAAATTCT,CTGATCTGTAATCTGGTCTCTTGTAACAGAAAGCTGGGTCACACCAAATATCTAATTGGTAGTAATAACTTCAAGCAATTAACTCCTAAACTGAAAAAA,10,30,14,27,27,30,27,35,27,27,27,30,32,35,21.77,0.924273622
hek293t,20940,1,14,CGCGCGGTCATTTCATTTAGGAAATGGAGAGGGTAGTTGCTAAAAGGTAATCTTGTCTCACTTTACCTGGAAAAAAATTCTAGTTGGTTTAACGCGTAA,CGCGCGGTCATTTCATTTAGGAAATGGAGAGGGACGATGTTCGCCGGTAGTTGCTAAAAGGTAATCTTGTCTCACTTTACCTGGAAAAAAATTCTAGTT,10,30,14,27,27,39,27,53,27,32,32,39,46,53,33.86,0.534686514
hek293t,20940,1,14,ATTGAGGTCATTTCATTTAGGAAATGGAGAGGGTAGTTGCTAAAAGGTAATCTTGTCTCACTTTACCTGGCAGTAAAAAAATTCTAGTTGGTTTAACGC,ATTGAGGTCATTTCATTTAGGAAATGGAGAGGGACGATGTTCGCCGGTAGTTGCTAAAAGGTAATCTTGTCTCACTTTACCTGGCAGTAAAAAAATTCT,10,30,14,27,27,35,27,49,27,32,32,35,46,49,33.86,0.0
hek293t,14729,1,12,GCATATTAAAACAACCATAGATTCAGGAAAGGTTGACATGCTTTAGTGAAAAATTTGCAGAAACATTTAATTCTTAAAAAAATTCTAGTTGGTTTAACG,GCATATTAAAACAACCATAGATTCAGGATGGACGCAGGGTAAGGTTGACATGCTTTAGTGAAAAATTTGCAGAAACATTTAATTCTTAAAAAAATTCTA,10,30,14,27,27,36,27,48,27,29,29,36,41,48,40.59,3.528706858
hek293t,14729,1,12,TTGACTTAAAACAACCATAGATTCAGGAAAGGTTGACATGCTTTAGTGAAAAATTTGCAGAAACATTTAATTCTTTTTTAAAAAAATTCTAGTTGGTTT,TTGACTTAAAACAACCATAGATTCAGGATGGACGCAGGGTAAGGTTGACATGCTTTAGTGAAAAATTTGCAGAAACATTTAATTCTTTTTTAAAAAAAT,10,30,14,27,27,32,27,44,27,29,29,32,41,44,40.59,0.325203252
hek293t,14731,1,8,CTCTGTCGCAGTGGCAGTGCTGGCCAAATTGGCAATATTTGCTATCGTGATAACCAGGATATAGCACATCGTCTAGATGGGAAAAAAATTCTAGTTGGT,CTCTGTCGCAGTGGCAGTGCTGGCCAAATTCTCCAACCGGCAATATTTGCTATCGTGATAACCAGGATATAGCACATCGTCTAGATGGGAAAAAAATTC,10,30,14,27,27,34,27,42,27,31,31,34,39,42,15.22,0.316192834
hek293t,14733,1,6,GTTAAATATATGTTAACTCTTTGCTAGTTCGGGGTGCTAGGCTCTTGAGAATCACAGCAAGGAATGCAGATTTTCACATGTAAAAAAATTCTAGTTGGT,GTTAAATATATGTTAACTCTTTGCTAGTTCGGACTCTAGGTGCTAGGCTCTTGAGAATCACAGCAAGGAATGCAGATTTTCACATGTAAAAAAATTCTA,10,30,14,27,27,36,27,42,27,33,33,36,39,42,2.94,4.781842479
hek293t,14733,1,6,TCGTCATATATGTTAACTCTTTGCTAGTTCGGGGTGCTAGGCTCTTGAGAATCACAGCAAGGAATGCAGAAAAAAATTCTAGTTGGTTTAACGCGTAAC,TCGTCATATATGTTAACTCTTTGCTAGTTCGGACTCTAGGTGCTAGGCTCTTGAGAATCACAGCAAGGAATGCAGAAAAAAATTCTAGTTGGTTTAACG,10,30,14,27,27,48,27,54,27,33,33,48,39,54,2.94,20.78753521
hek293t,14735,1,15,ATTAAACTCTTATCAAGATATTCTGAATATGGGTGACTATCGGCTCCATTAGCATCAGGTCACAGGCAAAAAAAATTCTAGTTGGTTTAACGCGTAACT,ATTAAACTCTTATCAAGATATTCTGAATATGGGTGATAACACACCTGAGCGCTATCGGCTCCATTAGCATCAGGTCACAGGCAAAAAAAATTCTAGTTG,10,30,14,27,27,40,27,55,27,37,37,40,52,55,5.6,0.0
hek293t,14736,1,1,AAGATTGGCATATCCATCTCTGTTCGACCTGGGGCAGTGCCCTGCGATCCCTCTGCCTGCTCCGGTCTGAGGTAATGCGTAACAGGCTGAAAAAAATTC,AAGATTGGCATATCCATCTCTGTTCGACCGTGGGGCAGTGCCCTGCGATCCCTCTGCCTGCTCCGGTCTGAGGTAATGCGTAACAGGCTGAAAAAAATT,10,30,14,27,27,33,27,34,27,30,30,33,31,34,50.19,16.47027667
hek293t,1271,1,8,TGCCTTCGATAATGTTGGCGTATACTGTTTGGGACTTGGTTTCAGCTGGCTGGCATTTTTATCAAACACAAAAAGCCTTAAAAAAATTCTAGTTGGTTT,TGCCTTCGATAATGTTGGCGTATACTGTCTCTACTGTTGGGACTTGGTTTCAGCTGGCTGGCATTTTTATCAAACACAAAAAGCCTTAAAAAAATTCTA,10,30,14,27,27,36,27,44,27,29,29,36,37,44,32.61,3.81585476
hek293t,14741,1,2,CCTAATGTGTCAAGAAATGCAGCCTTTTGTGGCTGTTTTCTGTCAGAGACCTCTAGGCTTTGCAGCTGGGTAAAAAAATTCTAGTTGGTTTAACGCGTA,CCTAATGTGTCAAGAAATGCAGCCTTTTGTGGCTAGGTTTTCTGTCAGAGACCTCTAGGCTTTGCAGCTGGGTAAAAAAATTCTAGTTGGTTTAACGCG,10,30,14,27,27,50,27,52,27,35,35,50,37,52,13.73,0.542382057
hek293t,14741,1,2,CAACTTGTGTCAAGAAATGCAGCCTTTTGTGGCTGTTTTCTGTCAGAGACCTCTAGGCTTTGCAGCTGGGTCAGTTTGGAAAAAAATTCTAGTTGGTTT,CAACTTGTGTCAAGAAATGCAGCCTTTTGTGGCTAGGTTTTCTGTCAGAGACCTCTAGGCTTTGCAGCTGGGTCAGTTTGGAAAAAAATTCTAGTTGGT,10,30,14,27,27,42,27,44,27,35,35,42,37,44,13.73,0.366300366
hek293t,14743,1,1,TAAAGAGGCATAGTTCCTGTCTTACTGTTTGGATGCTTCTTGCCTGTAATTGAGGGCAGAATGGATACAGCCAGTGGTAAAAAAAATTCTAGTTGGTTT,TAAAGAGGCATAGTTCCTGTCTTACTGTTTGGATGCTTCTTTGCCTGTAATTGAGGGCAGAATGGATACAGCCAGTGGTAAAAAAAATTCTAGTTGGTT,10,30,14,27,27,43,27,44,27,40,40,43,41,44,50.77,0.529100529
hek293t,14743,1,1,CACGTAGGCATAGTTCCTGTCTTACTGTTTGGATGCTTCTTGCCTGTAATTGAGGGCAGAATGGATAAAAAAAATTCTAGTTGGTTTAACGCGTAACTA,CACGTAGGCATAGTTCCTGTCTTACTGTTTGGATGCTTCTTTGCCTGTAATTGAGGGCAGAATGGATAAAAAAAATTCTAGTTGGTTTAACGCGTAACT,10,30,14,27,27,55,27,56,27,40,40,55,41,56,50.77,77.128881
hek293t,14745,1,9,TCACTAATTTCTGTTGCTCTTAAAAATATTGGTGAGTGAAACGTTACTCAGAGAAAAGTAGTTATCTCATTATAAAAAAATTCTAGTTGGTTTAACGCG,TCACTAATTTCTGTTGCTCTTAAAAATATTGGTTGCTGATGTGAGTGAAACGTTACTCAGAGAAAAGTAGTTATCTCATTATAAAAAAATTCTAGTTGG,10,30,14,27,27,41,27,50,27,34,34,41,43,50,6.42,0.28922632
hek293t,14747,1,7,TGTCGTCCTATTTAGAATAGCAAATGAGAAGGAAAGAAAGAAATTTTTAGTCTTTAGTTGCATACCTCTCCTTTTTTAAAAAAATTCTAGTTGGTTTAA,TGTCGTCCTATTTAGAATAGCAAATGAGTTTCACCAAGGAAAGAAAGAAATTTTTAGTCTTTAGTTGCATACCTCTCCTTTTTTAAAAAAATTCTAGTT,10,30,14,27,27,39,27,46,27,29,29,39,36,46,35.09,1.560181219
hek293t,14747,1,7,ATGGTTCCTATTTAGAATAGCAAATGAGAAGGAAAGAAAGAAATTTTTAGTCTTTAGTTGCATACCTCTCCTAAAAAAATTCTAGTTGGTTTAACGCGT,ATGGTTCCTATTTAGAATAGCAAATGAGTTTCACCAAGGAAAGAAAGAAATTTTTAGTCTTTAGTTGCATACCTCTCCTAAAAAAATTCTAGTTGGTTT,10,30,14,27,27,44,27,51,27,29,29,44,36,51,35.09,0.061661985
hek293t,14753,1,11,CAGTTAGGTGGTGTAAAGATACCACTATTTGGTCCACCAGCAGGATCTTATGTTTAGTAAAAAATACAAGTTCTTAAAAAAATTCTAGTTGGTTTAACG,CAGTTAGGTGGTGTAAAGATACCACTATTGGTTTTGAATTTGGTCCACCAGCAGGATCTTATGTTTAGTAAAAAATACAAGTTCTTAAAAAAATTCTAG,10,30,14,27,27,37,27,48,27,27,27,37,38,48,25.29,5.360927791
hek293t,14755,1,12,TTATCGGACATGACACTCTGAGATGATCAAGGACATGGAGATGAAGCTCAAAGTGAGGCAGATTCTATTGCAAAAAAATTCTAGTTGGTTTAACGCGTA,TTATCGGACATGACACTCTGAGATGATCAAGGAACCCGTTCGACACATGGAGATGAAGCTCAAAGTGAGGCAGATTCTATTGCAAAAAAATTCTAGTTG,10,30,14,27,27,40,27,52,27,33,33,40,45,52,70.64,7.220824403
hek293t,14755,1,12,GTGTTGGACATGACACTCTGAGATGATCAAGGACATGGAGATGAAGCTCAAAGTGAGGCAGATTCTATAAAAAAATTCTAGTTGGTTTAACGCGTAACT,GTGTTGGACATGACACTCTGAGATGATCAAGGAACCCGTTCGACACATGGAGATGAAGCTCAAAGTGAGGCAGATTCTATAAAAAAATTCTAGTTGGTT,10,30,14,27,27,43,27,55,27,33,33,43,45,55,70.64,26.54588113
hek293t,14757,1,15,TATGTAGGGCAATTCACACTGAAAACACACGGATTTCAAGTCTCAAAGCAGGGAACCAGAGTATAAAAAAATTCTAGTTGGTTTAACGCGTAACTAGAT,TATGTAGGGCAATTCACACTGAAAACACACGGATTTCAAGGCGGTTTACCACACTTCTCAAAGCAGGGAACCAGAGTATAAAAAAATTCTAGTTGGTTT,10,30,14,27,27,44,27,59,27,41,41,44,56,59,40.77,0.0
hek293t,14758,1,15,GGCCCGGAAGTAAAACCACTAGTGCACTGAGGCTCATCTTACAGGCATAGATTATTAGCTATCTTTAAACCAAAAAAATTCTAGTTGGTTTAACGCGTA,GGCCCGGAAGTAAAACCACTAGTGCATATTCCCGGGCAAGTCTGAGGCTCATCTTACAGGCATAGATTATTAGCTATCTTTAAACCAAAAAAATTCTAG,10,30,14,27,27,37,27,52,27,27,27,37,42,52,79.84,38.78031718
hek293t,14758,1,15,ATCACGGAAGTAAAACCACTAGTGCACTGAGGCTCATCTTACAGGCATAGATTATTAGCTATCTTTAAACCTGCTTCCAAAAAAATTCTAGTTGGTTTA,ATCACGGAAGTAAAACCACTAGTGCATATTCCCGGGCAAGTCTGAGGCTCATCTTACAGGCATAGATTATTAGCTATCTTTAAACCTGCTTCCAAAAAA,10,30,14,27,27,30,27,45,27,27,27,30,42,45,79.84,1.798063624
hek293t,14760,1,1,TTCTAGTTGGGGCTTTAATTAGCATCTGGCGGGTGGCTGTGGGCTCTCGGCGCCTTAATTCAGGTACGAGCGCTGGTGTCCGCAGATGAAAAAAATTCT,TTCTAGTTGGGGCTTTAATTAGCATCTGGCTGGGTGGCTGTGGGCTCTCGGCGCCTTAATTCAGGTACGAGCGCTGGTGTCCGCAGATGAAAAAAATTC,10,30,14,27,27,34,27,35,27,31,31,34,32,35,41.31,5.022533211
hek293t,14760,1,1,TACTAGTTGGGGCTTTAATTAGCATCTGGCGGGTGGCTGTGGGCTCTCGGCGCCTTAATTCAGGTACGAGCGCTGGTGTCCGCAAAAAAAATTCTAGTT,TACTAGTTGGGGCTTTAATTAGCATCTGGCTGGGTGGCTGTGGGCTCTCGGCGCCTTAATTCAGGTACGAGCGCTGGTGTCCGCAAAAAAAATTCTAGT,10,30,14,27,27,38,27,39,27,31,31,38,32,39,41.31,65.3897151
hek293t,14762,1,13,GGCGGACGCTGAGAAACTCCCTTGAAAGCAGGTGCACAGCAGGCTGCCGCCCGCACGGCTCCTGGGCAAAAAAATTCTAGTTGGTTTAACGCGTAACTA,GGCGGACGCTGAGAAACTCCCTTGAAAGCAGGTGCACAGTTACCCAACCTTGCAGGCTGCCGCCCGCACGGCTCCTGGGCAAAAAAATTCTAGTTGGTT,10,30,14,27,27,43,27,56,27,40,40,43,53,56,44.26,1.210260247
hek293t,14763,1,13,CCCTCATATCCGTTCACAAATGCAGAAACTGGCACACATTTTCCTTACTCAAATTGGATGGAACCATTTAAAAAAATTCTAGTTGGTTTAACGCGTAAC,CCCTCATATCCGTTCACAAATGCAGAAACTGGCTAATCCATTGATTACACATTTTCCTTACTCAAATTGGATGGAACCATTTAAAAAAATTCTAGTTGG,10,30,14,27,27,41,27,54,27,34,34,41,47,54,40.95,0.0
hek293t,14764,1,6,TTTGCCTCAGATAGCTGTTAAAAATCAGCAGGGACCTGAAACTGGCACATGTTACCAGGCATCAGATTTAATGTGTAAAAAAATTCTAGTTGGTTTAAC,TTTGCCTCAGATAGCTGTTAAAAATCAGCAGGGACCTCCGCTAGAAACTGGCACATGTTACCAGGCATCAGATTTAATGTGTAAAAAAATTCTAGTTGG,10,30,14,27,27,41,27,47,27,38,38,41,44,47,24.73,0.0
hek293t,14769,1,10,TAGAAGGATCAGTGAGATCCAATGAAACCAGGTAAAAGGGGAAGATTTGTGGTTCCCTGGGCAATGTGGCATTGAAAAAAATTCTAGTTGGTTTAACGC,TAGAAGGATCAGTGAGATCCAATGAAACCAGGTAACGACTTAAGAAAGGGGAAGATTTGTGGTTCCCTGGGCAATGTGGCATTGAAAAAAATTCTAGTT,10,30,14,27,27,39,27,49,27,36,36,39,46,49,61.12,0.0
hek293t,14770,1,14,CACGGTTACTGACATTCTCAGACCAGGAAAGGAAAGGTTCCAGTTTAGTCATTTAAATGCTAATAAAAAAAATTCTAGTTGGTTTAACGCGTAACTAGA,CACGGTTACTGACATTCTCAGACCAGGAAAGGATCACAGTCTACGAAAAGGTTCCAGTTTAGTCATTTAAATGCTAATAAAAAAAATTCTAGTTGGTTT,10,30,14,27,27,44,27,58,27,34,34,44,48,58,23.69,0.0
hek293t,14771,1,12,GAGTGACCAGTTCAAAAACTGGTCAGTGCTGGCAGACCTAAAAAAGCCTGACAACTGGTCACTGAATGCAAAAAAATTCTAGTTGGTTTAACGCGTAAC,GAGTGACCAGTTCAAAAACTGGTCAGTGCTGGCAGACCTGACAATATGCTTAAAAAAGCCTGACAACTGGTCACTGAATGCAAAAAAATTCTAGTTGGT,10,30,14,27,27,42,27,54,27,39,39,42,51,54,57.57,0.42408821
hek293t,14774,1,2,TATACATTGCTGGGTCAAGAAAGCAAAGCTGGCATCTGAGGCAATGTGTTCACTACCTAAAAAAGATATGTTAAAAAAATTCTAGTTGGTTTAACGCGT,TATACATTGCTGGGTCAAGAAAGCAAAGCTGGCATCTGTTAGGCAATGTGTTCACTACCTAAAAAAGATATGTTAAAAAAATTCTAGTTGGTTTAACGC,10,30,14,27,27,49,27,51,27,39,39,49,41,51,44.3,17.27105228
hek293t,14774,1,2,GCAGGATTGCTGGGTCAAGAAAGCAAAGCTGGCATCTGAGGCAATGTGTTCACTACCTAAAAAAGATAAAAAAATTCTAGTTGGTTTAACGCGTAACTA,GCAGGATTGCTGGGTCAAGAAAGCAAAGCTGGCATCTGTTAGGCAATGTGTTCACTACCTAAAAAAGATAAAAAAATTCTAGTTGGTTTAACGCGTAAC,10,30,14,27,27,54,27,56,27,39,39,54,41,56,44.3,12.32712889
hek293t,14776,1,1,GCTACATGAATTCCAACTAATGTTTCTTAAGGCTTGAATAAGCCCAATAAAGTTCTCTGTCTTACTCTCCTCCCTCCTAACTCACAAAAAAATTCTAGT,GCTACATGAATTCCAACTAATGTTTCTTAAGGCATTGAATAAGCCCAATAAAGTTCTCTGTCTTACTCTCCTCCCTCCTAACTCACAAAAAAATTCTAG,10,30,14,27,27,37,27,38,27,34,34,37,35,38,11.51,0.956758884
hek293t,14776,1,1,CCTCAATGAATTCCAACTAATGTTTCTTAAGGCTTGAATAAGCCCAATAAAGTTCTCTGTCTTACTCTCCTCCCTCCTAAAAAAATTCTAGTTGGTTTA,CCTCAATGAATTCCAACTAATGTTTCTTAAGGCATTGAATAAGCCCAATAAAGTTCTCTGTCTTACTCTCCTCCCTCCTAAAAAAATTCTAGTTGGTTT,10,30,14,27,27,44,27,45,27,34,34,44,35,45,11.51,68.7955704
hek293t,2400,1,5,TCAGGTCAGAATGGTTGTGTTGAGGGAGGCGGCAACATACATAAAGTAGTAAAAATGCCTTAAAAACCTACTGTGCAGAAAAAAATTCTAGTTGGTTTA,TCAGGTCAGAATGGTTGTGTTGAGGGAGGGATGGCGGCAACATACATAAAGTAGTAAAAATGCCTTAAAAACCTACTGTGCAGAAAAAAATTCTAGTTG,10,30,14,27,27,40,27,45,27,30,30,40,35,45,46.94,66.99859471
hek293t,2400,1,5,ATCGGTCAGAATGGTTGTGTTGAGGGAGGCGGCAACATACATAAAGTAGTAAAAATGCCTTAAAAACCTACTGAAAAAAATTCTAGTTGGTTTAACGCG,ATCGGTCAGAATGGTTGTGTTGAGGGAGGGATGGCGGCAACATACATAAAGTAGTAAAAATGCCTTAAAAACCTACTGAAAAAAATTCTAGTTGGTTTA,10,30,14,27,27,45,27,50,27,30,30,45,35,50,46.94,55.74416072
hek293t,14780,1,10,GCCCATGAAACTCAGTGCCCTTTGGTAAATGGAAGAATTTTGGTTACATGTATACCCCCCCCTGTTTCTGTTAAAAAAATTCTAGTTGGTTTAACGCGT,GCCCATGAAACTCAGTGCCCTTTGGTAAATAGCGAAGGGGGGAAGAATTTTGGTTACATGTATACCCCCCCCTGTTTCTGTTAAAAAAATTCTAGTTGG,10,30,14,27,27,41,27,51,27,31,31,41,41,51,18.09,24.43116156
hek293t,14780,1,10,CCTTATGAAACTCAGTGCCCTTTGGTAAATGGAAGAATTTTGGTTACATGTATACCCCCCCCTGTTTCTGTTGGTAAAAAAATTCTAGTTGGTTTAACG,CCTTATGAAACTCAGTGCCCTTTGGTAAATAGCGAAGGGGGGAAGAATTTTGGTTACATGTATACCCCCCCCTGTTTCTGTTGGTAAAAAAATTCTAGT,10,30,14,27,27,38,27,48,27,31,31,38,41,48,18.09,6.038601604
hek293t,14782,1,5,TCTGAACCTCAGCTTGTCATTATGGTAGTAGGCTAAGCCCTCACTCATACTGGCTCGCGGTTTACCTTTTCTGAGTCTAAAAAAATTCTAGTTGGTTTA,TCTGAACCTCAGCTTGTCATTATGGTAGTTGCCCAGGCTAAGCCCTCACTCATACTGGCTCGCGGTTTACCTTTTCTGAGTCTAAAAAAATTCTAGTTG,10,30,14,27,27,40,27,45,27,30,30,40,35,45,32.94,68.35947583
hek293t,14782,1,5,ATATCACCTCAGCTTGTCATTATGGTAGTAGGCTAAGCCCTCACTCATACTGGCTCGCGGTTTACCTTTTCTGAGTCTACAAAAAAAATTCTAGTTGGT,ATATCACCTCAGCTTGTCATTATGGTAGTTGCCCAGGCTAAGCCCTCACTCATACTGGCTCGCGGTTTACCTTTTCTGAGTCTACAAAAAAAATTCTAG,10,30,14,27,27,37,27,42,27,30,30,37,35,42,32.94,82.05991043
hek293t,14784,1,6,GGCCTACAGGAATCTACAACGTAACAGTAAGGAACTCTGGAATGTATCTATAATGCTGTTGTATCTGCTGGGTGTATTAAAAAAATTCTAGTTGGTTTA,GGCCTACAGGAATCTACAACGTAACAGTAAGGAACGATTTTTCTGGAATGTATCTATAATGCTGTTGTATCTGCTGGGTGTATTAAAAAAATTCTAGTT,10,30,14,27,27,39,27,45,27,36,36,39,42,45,61.25,0.538152148
hek293t,14784,1,6,TCTCAACAGGAATCTACAACGTAACAGTAAGGAACTCTGGAATGTATCTATAATGCTGTTGTATCTAAAAAAATTCTAGTTGGTTTAACGCGTAACTAG,TCTCAACAGGAATCTACAACGTAACAGTAAGGAACGATTTTTCTGGAATGTATCTATAATGCTGTTGTATCTAAAAAAATTCTAGTTGGTTTAACGCGT,10,30,14,27,27,51,27,57,27,36,36,51,42,57,61.25,36.54675486
hek293t,14786,1,10,GACACGACAGAAAAAGAAACATACAGCCGGGGGTCAGGTCTCCCCAGGCACCAGGAAGTGGACAAGGAGGGGACTGGAAAAAAATTCTAGTTGGTTTAA,GACACGACAGAAAAAGAAACATACAGCCGTGTCGAGCAGGGGGTCAGGTCTCCCCAGGCACCAGGAAGTGGACAAGGAGGGGACTGGAAAAAAATTCTA,10,30,14,27,27,36,27,46,27,29,29,36,39,46,54.1,3.596267925
hek293t,14786,1,10,CCGTCGACAGAAAAAGAAACATACAGCCGGGGGTCAGGTCTCCCCAGGCACCAGGAAGTGGACAAGGAGGGGACTGGTTTTAAAAAAATTCTAGTTGGT,CCGTCGACAGAAAAAGAAACATACAGCCGTGTCGAGCAGGGGGTCAGGTCTCCCCAGGCACCAGGAAGTGGACAAGGAGGGGACTGGTTTTAAAAAAAT,10,30,14,27,27,32,27,42,27,29,29,32,39,42,54.1,1.756716432
hek293t,14788,1,11,TCAGTATTGAGGTGTCTCTAGACTGTAAAAGGGTCATTATCTCCCCACTGTTCTTAAATGTCTTTCGAAAAAAATTCTAGTTGGTTTAACGCGTAACTA,TCAGTATTGAGGTGTCTCTAGACTGTAAAAGGGTGGACAAAGAGCCATTATCTCCCCACTGTTCTTAAATGTCTTTCGAAAAAAATTCTAGTTGGTTTA,10,30,14,27,27,45,27,56,27,35,35,45,46,56,15.64,2.495463875
hek293t,14789,1,10,TGGGCAGAGTTTTAATGGCATCAGGAGCCAGGAAATGATGTGACTTTATTGCAGAGCTGCCTTCACCAAAAAAATTCTAGTTGGTTTAACGCGTAACTA,TGGGCAGAGTTTTAATGGCATCAGGAGCCAGTCCCGGGGCGGAAATGATGTGACTTTATTGCAGAGCTGCCTTCACCAAAAAAATTCTAGTTGGTTTAA,10,30,14,27,27,46,27,56,27,31,31,46,41,56,14.89,9.194464222
hek293t,14793,1,15,GTATGCATTTGAATCCTTAATTCTGCTTTTGGTTTTAAACTCTGGACATCAACAAAATTCTAACTAAACGCATAAAAAAATTCTAGTTGGTTTAACGCG,GTATGCATTTGAATCCTTAATTCTGCTTTTGCTTTCCCAGCCTCTTGTTTTAAACTCTGGACATCAACAAAATTCTAACTAAACGCATAAAAAAATTCT,10,30,14,27,27,35,27,50,27,32,32,35,47,50,0.3,0.0
hek293t,14795,1,7,CTTCTTGAAAAGGTGGGAAAGTCGTCTTCAGGAAGTGAAAATTCCTCTATAAATTGGAAGACCTAATAAGAGTTTGTTTGGTGCAAAAAAATTCTAGTT,CTTCTTGAAAAGGTGGGAAAGTCGTCTTGTGTACACAGGAAGTGAAAATTCCTCTATAAATTGGAAGACCTAATAAGAGTTTGTTTGGTGCAAAAAAAT,10,30,14,27,27,32,27,39,27,29,29,32,36,39,25.36,4.836472765
hek293t,14795,1,7,AAAGATGAAAAGGTGGGAAAGTCGTCTTCAGGAAGTGAAAATTCCTCTATAAATTGGAAGACCTAATAAGAGTTTGTTTGAAAAAAATTCTAGTTGGTT,AAAGATGAAAAGGTGGGAAAGTCGTCTTGTGTACACAGGAAGTGAAAATTCCTCTATAAATTGGAAGACCTAATAAGAGTTTGTTTGAAAAAAATTCTA,10,30,14,27,27,36,27,43,27,29,29,36,36,43,25.36,19.78514163
hek293t,14797,1,8,ATGAGGATCTTTATGAAAGTCTGTTTTTGAGGCAGGCTCCAGTGCTGCTATCATCAAGGTAGCAAAGTATGAAGTAGTCAAGGAAAAAAATTCTAGTTG,ATGAGGATCTTTATGAAAGTCTGTTTTTGAATATAGGAGGCAGGCTCCAGTGCTGCTATCATCAAGGTAGCAAAGTATGAAGTAGTCAAGGAAAAAAAT,10,30,14,27,27,32,27,40,27,29,29,32,37,40,12.14,0.0
hek293t,14797,1,8,GTTGGGATCTTTATGAAAGTCTGTTTTTGAGGCAGGCTCCAGTGCTGCTATCATCAAGGTAGCAAAGTATGAAGTAGTCAAAAAAATTCTAGTTGGTTT,GTTGGGATCTTTATGAAAGTCTGTTTTTGAATATAGGAGGCAGGCTCCAGTGCTGCTATCATCAAGGTAGCAAAGTATGAAGTAGTCAAAAAAATTCTA,10,30,14,27,27,36,27,44,27,29,29,36,37,44,12.14,3.32545424
hek293t,14799,1,8,TCAGGCCTACTTGCTATCATGTACTGCGGAGGCTATCCTTTGGGCATCTTCATTCTGCAAATCTAGAAAAAAAATTCTAGTTGGTTTAACGCGTAACTA,TCAGGCCTACTTGCTATCATGTACTGCGGAGGCTATCCTTACACTTAGTGGGCATCTTCATTCTGCAAATCTAGAAAAAAAATTCTAGTTGGTTTAACG,10,30,14,27,27,48,27,56,27,41,41,48,49,56,61.46,0.534770576
hek293t,14799,1,8,GCTTTCCTACTTGCTATCATGTACTGCGGAGGCTATCCTTTGGGCATCTTCATTCTGCAAATCTAAAAAAATTCTAGTTGGTTTAACGCGTAACTAGAT,GCTTTCCTACTTGCTATCATGTACTGCGGAGGCTATCCTTACACTTAGTGGGCATCTTCATTCTGCAAATCTAAAAAAATTCTAGTTGGTTTAACGCGT,10,30,14,27,27,51,27,59,27,41,41,51,49,59,61.46,1.131035771
hek293t,14801,1,7,TGCAGATTACTCCCTGGAGCAAGCTCTGCTGGGAGATGCAATCATGCACACTCAAGGAAGATGGGGAAAAATGCAAATTAGCAAAAAAATTCTAGTTGG,TGCAGATTACTCCCTGGAGCAAGCTCAAGCAACTGCTGGGAGATGCAATCATGCACACTCAAGGAAGATGGGGAAAAATGCAAATTAGCAAAAAAATTC,10,30,14,27,27,34,27,41,27,27,27,34,34,41,18.15,29.47706476
hek293t,14801,1,7,CTCAGATTACTCCCTGGAGCAAGCTCTGCTGGGAGATGCAATCATGCACACTCAAGGAAGATGGGGAAAAATGCAAATTAAAAAAATTCTAGTTGGTTT,CTCAGATTACTCCCTGGAGCAAGCTCAAGCAACTGCTGGGAGATGCAATCATGCACACTCAAGGAAGATGGGGAAAAATGCAAATTAAAAAAATTCTAG,10,30,14,27,27,37,27,44,27,27,27,37,34,44,18.15,34.16617502
hek293t,14803,1,11,TTAATTCATGATTTACAAATGGTGTTGGAAGGGTCTGAAAAGTTTTCATAGAATCCAAGGATCTAAGAAAAAAATTCTAGTTGGTTTAACGCGTAACTA,TTAATTCATGATTTACAAATGGTGTTGGAAGGGTCTGTTAGCCAAGTTAAAAGTTTTCATAGAATCCAAGGATCTAAGAAAAAAATTCTAGTTGGTTTA,10,30,14,27,27,45,27,56,27,38,38,45,49,56,47.43,0.092592593
hek293t,14804,1,8,ATTAACAGGCCTGGTCCAAGCAGTTTTTGAGGTACGGCGTTTGAACTCAGCCCTAATTAAACATAAAAAAATTCTAGTTGGTTTAACGCGTAACTAGAT,ATTAACAGGCCTGGTCCAAGCAGTTTTTGAGGTACGGCGTCGTCTAATTTGAACTCAGCCCTAATTAAACATAAAAAAATTCTAGTTGGTTTAACGCGT,10,30,14,27,27,51,27,59,27,41,41,51,49,59,19.25,1.0721295
hek293t,14806,1,14,AGTACATAAGACACAGGGATCTGCGAATTTGGAGCCAGTTATGAGACAATCCCCCCCCGAAGCAAACAACAACAATCAAAAAAAATTCTAGTTGGTTTA,AGTACATAAGACACAGGGATCTGCGAATCGGCAAGAAGGCGTTTGGAGCCAGTTATGAGACAATCCCCCCCCGAAGCAAACAACAACAATCAAAAAAAA,10,30,14,27,27,31,27,45,27,28,28,31,42,45,10.74,0.201837433
hek293t,14806,1,14,GGTCAATAAGACACAGGGATCTGCGAATTTGGAGCCAGTTATGAGACAATCCCCCCCCGAAGCAAAAAAAAAATTCTAGTTGGTTTAACGCGTAACTAG,GGTCAATAAGACACAGGGATCTGCGAATCGGCAAGAAGGCGTTTGGAGCCAGTTATGAGACAATCCCCCCCCGAAGCAAAAAAAAAATTCTAGTTGGTT,10,30,14,27,27,43,27,57,27,28,28,43,42,57,10.74,42.17642781
hek293t,10802,1,1,CTAGGTAGTACAAAATCCCATGGCGGGGGAGGAAAGGAGGGTTGATATGGATCAGTATAATGATCCTGTATATATTTTGAAAATAAAAAAATTCTAGTT,CTAGGTAGTACAAAATCCCATGGCGGGGGATGGAAAGGAGGGTTGATATGGATCAGTATAATGATCCTGTATATATTTTGAAAATAAAAAAATTCTAGT,10,30,14,27,27,38,27,39,27,31,31,38,32,39,42.69,73.09331356
hek293t,20120,1,12,TATATCAGAATGACACCTTTTGCTATTTTCGGTGGAACTTTTTTCTGAAGAGTCAGATTTTAAAAGGCGAAAAAAATTCTAGTTGGTTTAACGCGTAAC,TATATCAGAATGACACCTTTTGCTATTTTCGGTGGCGGCTCTGGTGGAACTTTTTTCTGAAGAGTCAGATTTTAAAAGGCGAAAAAAATTCTAGTTGGT,10,30,14,27,27,42,27,54,27,32,32,42,44,54,4.58,0.0
hek293t,14812,1,9,CCCGGAACATCAGTTCAGCATGTAAATCAAGGCTAAATACTGTTACACAGAGCAAAGCCCACACACACTTTGGTATAAAAAAATTCTAGTTGGTTTAAC,CCCGGAACATCAGTTCAGCATGTAAATGGACCGATGCAAGGCTAAATACTGTTACACAGAGCAAAGCCCACACACACTTTGGTATAAAAAAATTCTAGT,10,30,14,27,27,38,27,47,27,28,28,38,37,47,63.53,8.048301131
hek293t,14812,1,9,ACCCTAACATCAGTTCAGCATGTAAATCAAGGCTAAATACTGTTACACAGAGCAAAGCCCACACACACTTTGGTATGTACAAAAAAAAAATTCTAGTTG,ACCCTAACATCAGTTCAGCATGTAAATGGACCGATGCAAGGCTAAATACTGTTACACAGAGCAAAGCCCACACACACTTTGGTATGTACAAAAAAAAAA,10,30,14,27,27,31,27,40,27,28,28,31,37,40,63.53,0.211736237
hek293t,8235,1,1,GCATAGATGGGGAGCCCATTCTGCTGATTTGGAGGCTCAGGGTATACCATCTGCAGGCAGTGCCAGTCCTCATAACGGCAAAAAAATTCTAGTTGGTTT,GCATAGATGGGGAGCCCATTCTGCTGATTTGGAGGCTCATGGGTATACCATCTGCAGGCAGTGCCAGTCCTCATAACGGCAAAAAAATTCTAGTTGGTT,10,30,14,27,27,43,27,44,27,40,40,43,41,44,14.35,2.229819133
hek293t,8235,1,1,AATACGATGGGGAGCCCATTCTGCTGATTTGGAGGCTCAGGGTATACCATCTGCAGGCAGTGCCAGTCCTCATAAAAAAAAATTCTAGTTGGTTTAACG,AATACGATGGGGAGCCCATTCTGCTGATTTGGAGGCTCATGGGTATACCATCTGCAGGCAGTGCCAGTCCTCATAAAAAAAAATTCTAGTTGGTTTAAC,10,30,14,27,27,47,27,48,27,40,40,47,41,48,14.35,74.71855041
hek293t,14816,1,2,AGGAGGTTCAGTACCTTGTCCAAAGCCAACGGAAATATTTCTTTTTGCAGACAGTGTAGCGTTTATGCAGCGTATTGTAAGCCAAAAAAATTCTAGTTG,AGGAGGTTCAGTACCTTGTCCAAAGCCGGAACGGAAATATTTCTTTTTGCAGACAGTGTAGCGTTTATGCAGCGTATTGTAAGCCAAAAAAATTCTAGT,10,30,14,27,27,38,27,40,27,28,28,38,30,40,53.67,83.99914549
hek293t,9771,1,10,AGGAGGTGCTTTTGAGCTTTCATTCCCACAGGGAGAGGTTGGTACAAAGATTAAATGCTGATTTGATGATAACTTTTGTAAAAAAATTCTAGTTGGTTT,AGGAGGTGCTTTTGAGCTTTCATTCCCACATGAGTTATGCGGGAGAGGTTGGTACAAAGATTAAATGCTGATTTGATGATAACTTTTGTAAAAAAATTC,10,30,14,27,27,34,27,44,27,31,31,34,41,44,14.15,0.0
hek293t,9771,1,10,CCCTGGTGCTTTTGAGCTTTCATTCCCACAGGGAGAGGTTGGTACAAAGATTAAATGCTGATTTGATAAAAAAATTCTAGTTGGTTTAACGCGTAACTA,CCCTGGTGCTTTTGAGCTTTCATTCCCACATGAGTTATGCGGGAGAGGTTGGTACAAAGATTAAATGCTGATTTGATAAAAAAATTCTAGTTGGTTTAA,10,30,14,27,27,46,27,56,27,31,31,46,41,56,14.15,0.891826186
hek293t,14820,1,3,GGGGGGTCATTGCTTAATACAGTCAACTGCGGCCCTCATTTCCATGCATGAATGGCCATTTCCATATCATTACCCATAAAAAAAATTCTAGTTGGTTTA,GGGGGGTCATTGCTTAATACAGTCAACTGCGGCCCTCAGCCTTTCCATGCATGAATGGCCATTTCCATATCATTACCCATAAAAAAAATTCTAGTTGGT,10,30,14,27,27,42,27,45,27,39,39,42,42,45,69.77,8.029983901
hek293t,14820,1,3,GCCCTGTCATTGCTTAATACAGTCAACTGCGGCCCTCATTTCCATGCATGAATGGCCATTTCCATATCATTAAAAAAATTCTAGTTGGTTTAACGCGTA,GCCCTGTCATTGCTTAATACAGTCAACTGCGGCCCTCAGCCTTTCCATGCATGAATGGCCATTTCCATATCATTAAAAAAATTCTAGTTGGTTTAACGC,10,30,14,27,27,49,27,52,27,39,39,49,42,52,69.77,46.78180542
hek293t,14822,1,3,TCGCCAGAGAAATTTTTAGTTACTATTAATGGATCCAGGTTTAGTGGAATTCTAGGGTAAGTGACCTTTAATGGTCGTCTACTTTAAAAAAATTCTAGT,TCGCCAGAGAAATTTTTAGTTACTATTAGCAATGGATCCAGGTTTAGTGGAATTCTAGGGTAAGTGACCTTTAATGGTCGTCTACTTTAAAAAAATTCT,10,30,14,27,27,35,27,38,27,28,28,35,31,38,-0.76,14.83644528
hek293t,14822,1,3,GCGTTAGAGAAATTTTTAGTTACTATTAATGGATCCAGGTTTAGTGGAATTCTAGGGTAAGTGACCTTTAATGGTCGTCTACAAAAAAATTCTAGTTGG,GCGTTAGAGAAATTTTTAGTTACTATTAGCAATGGATCCAGGTTTAGTGGAATTCTAGGGTAAGTGACCTTTAATGGTCGTCTACAAAAAAATTCTAGT,10,30,14,27,27,38,27,41,27,28,28,38,31,41,-0.76,13.93019567
hek293t,14824,1,9,GGAGGACAAAATATTTGTGTATCTCTACCTGGAACGTTTGCTAGAGAGAGAGCACCACTGCCCACGCTTTAAAAAAATTCTAGTTGGTTTAACGCGTAA,GGAGGACAAAATATTTGTGTATCTCTACCTGGAACGTGGACGAACTTTGCTAGAGAGAGAGCACCACTGCCCACGCTTTAAAAAAATTCTAGTTGGTTT,10,30,14,27,27,44,27,53,27,37,37,44,46,53,32.45,2.714182189
hek293t,14824,1,9,ATGAAACAAAATATTTGTGTATCTCTACCTGGAACGTTTGCTAGAGAGAGAGCACCACTGCCCACGCTTTGCACAAAAAAATTCTAGTTGGTTTAACGC,ATGAAACAAAATATTTGTGTATCTCTACCTGGAACGTGGACGAACTTTGCTAGAGAGAGAGCACCACTGCCCACGCTTTGCACAAAAAAATTCTAGTTG,10,30,14,27,27,40,27,49,27,37,37,40,46,49,32.45,0.0
hek293t,14826,1,11,TACCTCAATGGATGTATGCTAATCTTCCTAGGCTAAATTTGCAGGTATGAGCATAGCAAAAATAGTTGCCGAACATAATGGTAAAAAAATTCTAGTTGG,TACCTCAATGGATGTATGCTAATCTTTGGAAAGGCTACCTAGGCTAAATTTGCAGGTATGAGCATAGCAAAAATAGTTGCCGAACATAATGGTAAAAAA,10,30,14,27,27,30,27,41,27,27,27,30,38,41,28.6,0.441501104
hek293t,14828,1,4,GGGGCCAGTAGTACCTCTCTTGAGCAGCATGGGATCACCTGGATTCAGAGAAATCCCTTTTCTTCCCAAAAAAAATTCTAGTTGGTTTAACGCGTAACT,GGGGCCAGTAGTACCTCTCTTGAGCAGCATGGGATACAACACCTGGATTCAGAGAAATCCCTTTTCTTCCCAAAAAAAATTCTAGTTGGTTTAACGCGT,10,30,14,27,27,51,27,55,27,36,36,51,40,55,61.65,71.50805596
hek293t,14828,1,4,ATATACAGTAGTACCTCTCTTGAGCAGCATGGGATCACCTGGATTCAGAGAAATCCCTTTTCTTCCCAGCAGGCTAGGCAAAAAAAATTCTAGTTGGTT,ATATACAGTAGTACCTCTCTTGAGCAGCATGGGATACAACACCTGGATTCAGAGAAATCCCTTTTCTTCCCAGCAGGCTAGGCAAAAAAAATTCTAGTT,10,30,14,27,27,39,27,43,27,36,36,39,40,43,61.65,0.975192912
hek293t,14830,1,1,TCCAGGCATTGTCAGTAGTTCTTGTTTTCTGGATACAACAGGAGCTTTCAAGCACATAGGAATTCTCCTCTTCATCAGGTTTCTGCAAAAAAATTCTAG,TCCAGGCATTGTCAGTAGTTCTTGTTTTCCTGGATACAACAGGAGCTTTCAAGCACATAGGAATTCTCCTCTTCATCAGGTTTCTGCAAAAAAATTCTA,10,30,14,27,27,36,27,37,27,29,29,36,30,37,0.09,24.08821014
hek293t,14830,1,1,AAAAGGCATTGTCAGTAGTTCTTGTTTTCTGGATACAACAGGAGCTTTCAAGCACATAGGAATTCTCCTCTTCATCAGGTTTCAAAAAAATTCTAGTTG,AAAAGGCATTGTCAGTAGTTCTTGTTTTCCTGGATACAACAGGAGCTTTCAAGCACATAGGAATTCTCCTCTTCATCAGGTTTCAAAAAAATTCTAGTT,10,30,14,27,27,39,27,40,27,29,29,39,30,40,0.09,41.94935133
hek293t,14832,1,11,GTGTTTCCCTTCTTTCTTCTCTTTATTAGAGGAGCACAAAGTTTGTTCTACCGGAAGACTCAAATATTGAAAAAAATTCTAGTTGGTTTAACGCGTAAC,GTGTTTCCCTTCTTTCTTCTCTTTATTAGAGGAGCCGTCGAGCAATACAAAGTTTGTTCTACCGGAAGACTCAAATATTGAAAAAAATTCTAGTTGGTT,10,30,14,27,27,43,27,54,27,36,36,43,47,54,2.94,0.0
hek293t,14834,1,6,GTTGAGGAGAGGCCCAGCACAGGAGTAGGAGGGATGGAAATTTGCCCTGGTGTGAATTGTGGTAACTACATGGGGAAAAAAAATTCTAGTTGGTTTAAC,GTTGAGGAGAGGCCCAGCACAGGAGTAGGAATTTACGGGATGGAAATTTGCCCTGGTGTGAATTGTGGTAACTACATGGGGAAAAAAAATTCTAGTTGG,10,30,14,27,27,41,27,47,27,31,31,41,37,47,63.63,30.09981657
hek293t,14834,1,6,CATCAGGAGAGGCCCAGCACAGGAGTAGGAGGGATGGAAATTTGCCCTGGTGTGAATTGTGGTAACTACATGGGGAAGTCTGCAAAAAAATTCTAGTTG,CATCAGGAGAGGCCCAGCACAGGAGTAGGAATTTACGGGATGGAAATTTGCCCTGGTGTGAATTGTGGTAACTACATGGGGAAGTCTGCAAAAAAATTC,10,30,14,27,27,34,27,40,27,31,31,34,37,40,63.63,1.907002274
hek293t,14836,1,7,CAACCGCCAGGCTCTCCCCTCCTCCTCTCCGGCCCACTACTGGGAGCCGTTCGCATTTCTCCCCCACCTCACTGCCGTAAAAAAATTCTAGTTGGTTTA,CAACCGCCAGGCTCTCCCCTCCTCCTCTCCGCATTTAGGCCCACTACTGGGAGCCGTTCGCATTTCTCCCCCACCTCACTGCCGTAAAAAAATTCTAGT,10,30,14,27,27,38,27,45,27,31,31,38,38,45,28.41,28.24495095
hek293t,14838,1,5,GTCGGGCAGTACTGGGAACTCAATGGCACAGGCTAAACTACTACCTGCTGCAAGGAGCTGAAATACCAGAATAATAAAAAAATTCTAGTTGGTTTAACG,GTCGGGCAGTACTGGGAACTCAATGGCACAGGCTAAACTTGCATACTACCTGCTGCAAGGAGCTGAAATACCAGAATAATAAAAAAATTCTAGTTGGTT,10,30,14,27,27,43,27,48,27,40,40,43,45,48,56.21,1.988717165
hek293t,14839,1,13,GTCGTAAAGACTGAAATTAGAATGAAGAGAGGGTGACCCTTGTTTCAGATAGCAGAGTATTGAGGTGGTACAAAAAAAAATTCTAGTTGGTTTAACGCG,GTCGTAAAGACTGAAATTAGAATGAACCATAGTGCTTGTGAGAGGGTGACCCTTGTTTCAGATAGCAGAGTATTGAGGTGGTACAAAAAAAAATTCTAG,10,30,14,27,27,37,27,50,27,27,27,37,40,50,53.42,2.068528018
hek293t,14839,1,13,GGAAAAAAGACTGAAATTAGAATGAAGAGAGGGTGACCCTTGTTTCAGATAGCAGAGTATTGAGGTGGTACAATGAAAAAAAATTCTAGTTGGTTTAAC,GGAAAAAAGACTGAAATTAGAATGAACCATAGTGCTTGTGAGAGGGTGACCCTTGTTTCAGATAGCAGAGTATTGAGGTGGTACAATGAAAAAAAATTC,10,30,14,27,27,34,27,47,27,27,27,34,40,47,53.42,0.387527476
hek293t,14841,1,15,GATCTCGAAAGTAGCACAGCGATACAAGTAGGCACCAGTAGCCATCGCTCACGCGGCTGAATGAGAAAAAAAATTCTAGTTGGTTTAACGCGTAACTAG,GATCTCGAAAGTAGCACAGCGATACAATCTTCGCGCTTGCGAGTAGGCACCAGTAGCCATCGCTCACGCGGCTGAATGAGAAAAAAAATTCTAGTTGGT,10,30,14,27,27,42,27,57,27,27,27,42,42,57,61.92,67.76417569
hek293t,14843,1,11,CATCGGGAAAGACATGGGTGTTTAAGCATAGGTCAGAATAATGTGGCCTATGAACAGTAGGCAAAAAAAAAAAAATTCTAGTTGGTTTAACGCGTAACT,CATCGGGAAAGACATGGGTGTTTAAGCAGGGTCGCAGGCTAGGTCAGAATAATGTGGCCTATGAACAGTAGGCAAAAAAAAAAAAATTCTAGTTGGTTT,10,30,14,27,27,44,27,55,27,29,29,44,40,55,58.35,1.235373069
hek293t,14843,1,11,GCATCGGAAAGACATGGGTGTTTAAGCATAGGTCAGAATAATGTGGCCTATGAACAGTAGGCAAAAAAGCCACTTCATGCAAAAAAATTCTAGTTGGTT,GCATCGGAAAGACATGGGTGTTTAAGCAGGGTCGCAGGCTAGGTCAGAATAATGTGGCCTATGAACAGTAGGCAAAAAAGCCACTTCATGCAAAAAAAT,10,30,14,27,27,32,27,43,27,29,29,32,40,43,58.35,0.561214865
hek293t,14845,1,3,TGCTCTAAGCAGCTAAAGAAATGGCTTGTTGGTTTCTAAACATGTACCACAGTACTGCAAACTGCCAGGGACATTACTTCAGGGCGAAAAAAAAATTCT,TGCTCTAAGCAGCTAAAGAAATGGCTTGACGTTGGTTTCTAAACATGTACCACAGTACTGCAAACTGCCAGGGACATTACTTCAGGGCGAAAAAAAAAT,10,30,14,27,27,32,27,35,27,29,29,32,32,35,24.29,0.538502962
hek293t,14845,1,3,CGGGCTAAGCAGCTAAAGAAATGGCTTGTTGGTTTCTAAACATGTACCACAGTACTGCAAACTGCCAGGGACATTACTTCAGGGAAAAAAATTCTAGTT,CGGGCTAAGCAGCTAAAGAAATGGCTTGACGTTGGTTTCTAAACATGTACCACAGTACTGCAAACTGCCAGGGACATTACTTCAGGGAAAAAAATTCTA,10,30,14,27,27,36,27,39,27,29,29,36,32,39,24.29,37.50628258
hek293t,14847,1,5,ACGTCTATGTTTTTCCTAATTAAATTCAATGGTGAAAATCTCAAGTTGAAATTTTAGTCATTTCAAACCAAAAAAAAATTCTAGTTGGTTTAACGCGTA,ACGTCTATGTTTTTCCTAATTAAATTCAATGGTGAAGATTAAATCTCAAGTTGAAATTTTAGTCATTTCAAACCAAAAAAAAATTCTAGTTGGTTTAAC,10,30,14,27,27,47,27,52,27,37,37,47,42,52,-0.46,0.0
hek293t,14847,1,5,ACCGCTATGTTTTTCCTAATTAAATTCAATGGTGAAAATCTCAAGTTGAAATTTTAGTCATTTCAAAAAAAAATTCTAGTTGGTTTAACGCGTAACTAG,ACCGCTATGTTTTTCCTAATTAAATTCAATGGTGAAGATTAAATCTCAAGTTGAAATTTTAGTCATTTCAAAAAAAAATTCTAGTTGGTTTAACGCGTA,10,30,14,27,27,52,27,57,27,37,37,52,42,57,-0.46,0.0
hek293t,14849,1,13,GACTGGCTGCAGCCGCCCCTCTGGTTACGTGGGTTATGTTGTTCAGGTCCCCACTGATGTGAGAAATAAAAAAATTCTAGTTGGTTTAACGCGTAACTA,GACTGGCTGCAGCCGCCCCTCTGGTTACGTGGGTTATGTGTGTACTTCCCTCTGTTCAGGTCCCCACTGATGTGAGAAATAAAAAAATTCTAGTTGGTT,10,30,14,27,27,43,27,56,27,40,40,43,53,56,36.36,0.157977883
hek293t,14850,1,12,ATCTTTCTTCAGTGTAAAATATTTCCAATAGGTTTGCAGTAAGACCATTTTAATGCAGAACTACAGCCTTCAAAAAAATTCTAGTTGGTTTAACGCGTA,ATCTTTCTTCAGTGTAAAATATTTCCAATGCAGTTTCTTACAGGTTTGCAGTAAGACCATTTTAATGCAGAACTACAGCCTTCAAAAAAATTCTAGTTG,10,30,14,27,27,40,27,52,27,30,30,40,42,52,4.91,0.0
hek293t,14852,1,8,CCTGTGTCTGTTACTTCACTGAGCACTGAAGGTTCATAAAGAAGTGCATAGGAGACATAAGGAAGAGAGAATAAGTTCAAAAAAAATTCTAGTTGGTTT,CCTGTGTCTGTTACTTCACTGAGCACTGGAATGTGAAAGGTTCATAAAGAAGTGCATAGGAGACATAAGGAAGAGAGAATAAGTTCAAAAAAAATTCTA,10,30,14,27,27,36,27,44,27,29,29,36,37,44,46.35,5.316404557
hek293t,14852,1,8,CACCAGTCTGTTACTTCACTGAGCACTGAAGGTTCATAAAGAAGTGCATAGGAGACATAAGGAAGAGAGAAAAAAAAATTCTAGTTGGTTTAACGCGTA,CACCAGTCTGTTACTTCACTGAGCACTGGAATGTGAAAGGTTCATAAAGAAGTGCATAGGAGACATAAGGAAGAGAGAAAAAAAAATTCTAGTTGGTTT,10,30,14,27,27,44,27,52,27,29,29,44,37,52,46.35,6.286035513
hek293t,7824,1,9,CCATGACTGTTGAAAAAATAACTGTTTTTTGGCATGGAATACTTACTGGTGCTTGGAGATCATGGTCATCTGGAAGATGCAAAAAAATTCTAGTTGGTT,CCATGACTGTTGAAAAAATAACTGTTTTTTAGTGTTTTCGGCATGGAATACTTACTGGTGCTTGGAGATCATGGTCATCTGGAAGATGCAAAAAAATTC,10,30,14,27,27,34,27,43,27,31,31,34,40,43,2.13,0.0
hek293t,7824,1,9,TGCGGACTGTTGAAAAAATAACTGTTTTTTGGCATGGAATACTTACTGGTGCTTGGAGATCATGGTCATCTGGAAAAAAATTCTAGTTGGTTTAACGCG,TGCGGACTGTTGAAAAAATAACTGTTTTTTAGTGTTTTCGGCATGGAATACTTACTGGTGCTTGGAGATCATGGTCATCTGGAAAAAAATTCTAGTTGG,10,30,14,27,27,41,27,50,27,31,31,41,40,50,2.13,0.0
hek293t,14857,1,2,TCTGAAAGATTTTACTACTACGGTTGGGGAGGCCCCCCCCGGAGGGTACAATGTAAGTGCTAATACAGACAGTAAAAAAAATTCTAGTTGGTTTAACGC,TCTGAAAGATTTTACTACTACGGTTGGGGAGGCCCCCCCTCCGGAGGGTACAATGTAAGTGCTAATACAGACAGTAAAAAAAATTCTAGTTGGTTTAAC,10,30,14,27,27,47,27,49,27,40,40,47,42,49,35.67,16.26425812
hek293t,14857,1,2,GATCCAAGATTTTACTACTACGGTTGGGGAGGCCCCCCCCGGAGGGTACAATGTAAGTGCTAATACAGACAAAAAAAATTCTAGTTGGTTTAACGCGTA,GATCCAAGATTTTACTACTACGGTTGGGGAGGCCCCCCCTCCGGAGGGTACAATGTAAGTGCTAATACAGACAAAAAAAATTCTAGTTGGTTTAACGCG,10,30,14,27,27,50,27,52,27,40,40,50,42,52,35.67,34.73219663
hek293t,14859,1,6,AATTTAAGAATAAAACCTCCATAAATCTCAGGATTTAACCTCAGCTTCCTCCAGCTGAAGCAAATATCTGGATCAAAAAAAATTCTAGTTGGTTTAACG,AATTTAAGAATAAAACCTCCATAAATGTAATGCTCAGGATTTAACCTCAGCTTCCTCCAGCTGAAGCAAATATCTGGATCAAAAAAAATTCTAGTTGGT,10,30,14,27,27,42,27,48,27,27,27,42,33,48,30.02,7.924697998
hek293t,14859,1,6,TTCGCAAGAATAAAACCTCCATAAATCTCAGGATTTAACCTCAGCTTCCTCCAGCTGAAGCAAATATCTGGATCACTGAGCTATAGTAAAAAAATTCTA,TTCGCAAGAATAAAACCTCCATAAATGTAATGCTCAGGATTTAACCTCAGCTTCCTCCAGCTGAAGCAAATATCTGGATCACTGAGCTATAGTAAAAAA,10,30,14,27,27,30,27,36,27,27,27,30,33,36,30.02,0.0
hek293t,14861,1,4,CCTATTTGCCATTTCCTTAAAGACCAAAATGGAGAGCTCTCCAGGAGAATGACTTTTATTGCAAATGTTCTTTCAAAAAAATTCTAGTTGGTTTAACGC,CCTATTTGCCATTTCCTTAAAGACCAAAATGGAGAGCGTGTTCTCCAGGAGAATGACTTTTATTGCAAATGTTCTTTCAAAAAAATTCTAGTTGGTTTA,10,30,14,27,27,45,27,49,27,38,38,45,42,49,12.87,1.368173295
hek293t,14861,1,4,GCACATTGCCATTTCCTTAAAGACCAAAATGGAGAGCTCTCCAGGAGAATGACTTTTATTGCAAATGTTCTTTCTGAGAAAAAAATTCTAGTTGGTTTA,GCACATTGCCATTTCCTTAAAGACCAAAATGGAGAGCGTGTTCTCCAGGAGAATGACTTTTATTGCAAATGTTCTTTCTGAGAAAAAAATTCTAGTTGG,10,30,14,27,27,41,27,45,27,38,38,41,42,45,12.87,0.0
hek293t,14863,1,8,CGCCCTTTGGAGCTGGTAGGTGGTGTTACTGGTTGCAATAGGCAAGGACGGCAAGGGTGCTGAGAGGCCCAGGGTTTTGACTAAAAAAATTCTAGTTGG,CGCCCTTTGGAGCTGGTAGGTGGTGTTACTTCTTAGATGGTTGCAATAGGCAAGGACGGCAAGGGTGCTGAGAGGCCCAGGGTTTTGACTAAAAAAATT,10,30,14,27,27,33,27,41,27,30,30,33,38,41,32.91,3.584211016
hek293t,14864,1,3,ACGGCCAAGAATAGCAATTTTCAATAGTTTGGCAACTTCAAATAGAATTTCCTAGACTAAAGTGATTTGTGAAGAGCTAAAAAAATTCTAGTTGGTTTA,ACGGCCAAGAATAGCAATTTTCAATAGTTTGGCAAACACTTCAAATAGAATTTCCTAGACTAAAGTGATTTGTGAAGAGCTAAAAAAATTCTAGTTGGT,10,30,14,27,27,42,27,45,27,35,35,42,38,45,6.31,13.57874602
hek293t,14864,1,3,GGGAGCAAGAATAGCAATTTTCAATAGTTTGGCAACTTCAAATAGAATTTCCTAGACTAAAGTGATTTGTGAAGAAAAAAAATTCTAGTTGGTTTAACG,GGGAGCAAGAATAGCAATTTTCAATAGTTTGGCAAACACTTCAAATAGAATTTCCTAGACTAAAGTGATTTGTGAAGAAAAAAAATTCTAGTTGGTTTA,10,30,14,27,27,45,27,48,27,35,35,45,38,48,6.31,18.74618842
hek293t,6208,1,3,GTGATATCACTGCAACTCAAGTGGATGGGAGGTAAATACATCTGCTTATCTGATACGAGTGCCATGTTGTGGCACCAAAAAAATTCTAGTTGGTTTAAC,GTGATATCACTGCAACTCAAGTGGATGGGAGGTACCAAATACATCTGCTTATCTGATACGAGTGCCATGTTGTGGCACCAAAAAAATTCTAGTTGGTTT,10,30,14,27,27,44,27,47,27,34,34,44,37,47,63.55,78.8137455
hek293t,6208,1,3,ACCCTATCACTGCAACTCAAGTGGATGGGAGGTAAATACATCTGCTTATCTGATACGAGTGCCATGTTGTGGCACCATATTGTAAAAAAATTCTAGTTG,ACCCTATCACTGCAACTCAAGTGGATGGGAGGTACCAAATACATCTGCTTATCTGATACGAGTGCCATGTTGTGGCACCATATTGTAAAAAAATTCTAG,10,30,14,27,27,37,27,40,27,34,34,37,37,40,63.55,0.86032852
hek293t,20337,1,10,GCGATAGCCCCCCCCGGCATTCAGAAAACAGGATTCGGTTACATAAATGCCTGTAAGATCTGTCCTCAGGCAAAAAAAATTCTAGTTGGTTTAACGCGT,GCGATAGCCCCCCCCGGCATTCAGAAAACAGGAAGCGGCCATATTCGGTTACATAAATGCCTGTAAGATCTGTCCTCAGGCAAAAAAAATTCTAGTTGG,10,30,14,27,27,41,27,51,27,34,34,41,44,51,24.62,0.0
hek293t,14870,1,2,GAGAGATACTCACATCATGCTCTAAGTGTAGGCAAGTAAGTTATTACGCAACAAATGATATTCTGACTTTGCTGGTTAAAAAAATTCTAGTTGGTTTAA,GAGAGATACTCACATCATGCTCTAAGTGTAGGCAAGGCTAAGTTATTACGCAACAAATGATATTCTGACTTTGCTGGTTAAAAAAATTCTAGTTGGTTT,10,30,14,27,27,44,27,46,27,37,37,44,39,46,63.63,73.52281817
hek293t,14870,1,2,ATAGCATACTCACATCATGCTCTAAGTGTAGGCAAGTAAGTTATTACGCAACAAATGATATTCTGACTTTGCTGGTTCTGTAAAAAAATTCTAGTTGGT,ATAGCATACTCACATCATGCTCTAAGTGTAGGCAAGGCTAAGTTATTACGCAACAAATGATATTCTGACTTTGCTGGTTCTGTAAAAAAATTCTAGTTG,10,30,14,27,27,40,27,42,27,37,37,40,39,42,63.63,0.314480684
hek293t,14872,1,12,ACCGACTTTTCGGTCAATCACATACATAGAGGGTATGAAAGGCAGAGTTGCAGTAAGCAGAGTTGAAAAAAATTCTAGTTGGTTTAACGCGTAACTAGA,ACCGACTTTTCGGTCAATCACATACATAGATCCTCGAGAGCTGGGTATGAAAGGCAGAGTTGCAGTAAGCAGAGTTGAAAAAAATTCTAGTTGGTTTAA,10,30,14,27,27,46,27,58,27,31,31,46,43,58,54.06,2.555430349
hek293t,14872,1,12,GCGGTCTTTTCGGTCAATCACATACATAGAGGGTATGAAAGGCAGAGTTGCAGTAAGCAGAGTTGCCACAAAAAAAATTCTAGTTGGTTTAACGCGTAA,GCGGTCTTTTCGGTCAATCACATACATAGATCCTCGAGAGCTGGGTATGAAAGGCAGAGTTGCAGTAAGCAGAGTTGCCACAAAAAAAATTCTAGTTGG,10,30,14,27,27,41,27,53,27,31,31,41,43,53,54.06,3.267570694
hek293t,14874,1,11,GGCAATAGTAGCCTAGCTTTCCCCTGATCAGGTGTCTCAAAAGGAGTTCCCTTAACTGCATGCAAAAAAAATTCTAGTTGGTTTAACGCGTAACTAGAT,GGCAATAGTAGCCTAGCTTTCCCCTGATCAGGTGTCTCAACAAAAAGTTTCAAGGAGTTCCCTTAACTGCATGCAAAAAAAATTCTAGTTGGTTTAACG,10,30,14,27,27,48,27,59,27,41,41,48,52,59,32.79,0.0
hek293t,14875,1,10,TCAAATATGAAAAAGTGGCTGCTGAATGCTGGTATGGAAATACTTCCAGTTTCTATTTCGGATTGACTACATATAAAAAAAATTCTAGTTGGTTTAACG,TCAAATATGAAAAAGTGGCTGCTGAATCTTCAGCCGTGCTGGTATGGAAATACTTCCAGTTTCTATTTCGGATTGACTACATATAAAAAAAATTCTAGT,10,30,14,27,27,38,27,48,27,28,28,38,38,48,56.0,27.41206295
hek293t,14875,1,10,AATAGTATGAAAAAGTGGCTGCTGAATGCTGGTATGGAAATACTTCCAGTTTCTATTTCGGATTGACTACATATATTTGCACAAAAAAATTCTAGTTGG,AATAGTATGAAAAAGTGGCTGCTGAATCTTCAGCCGTGCTGGTATGGAAATACTTCCAGTTTCTATTTCGGATTGACTACATATATTTGCACAAAAAAA,10,30,14,27,27,31,27,41,27,28,28,31,38,41,56.0,1.57379057
hek293t,14877,1,15,TCGCTGCAGAGTTCTTCACAGTCTGTACTAGGTTTTGAAATTTCCATTCTGTAAGACAGTAATTCACTGTCACTTTTAAAAAAATTCTAGTTGGTTTAA,TCGCTGCAGAGTTCTTCACAGTCTGTAGGGGCGCAATCTTTCCTAGGTTTTGAAATTTCCATTCTGTAAGACAGTAATTCACTGTCACTTTTAAAAAAA,10,30,14,27,27,31,27,46,27,28,28,31,43,46,38.63,0.159299016
hek293t,14877,1,15,AACAAGCAGAGTTCTTCACAGTCTGTACTAGGTTTTGAAATTTCCATTCTGTAAGACAGTAATTCACTGTAAAAAAATTCTAGTTGGTTTAACGCGTAA,AACAAGCAGAGTTCTTCACAGTCTGTAGGGGCGCAATCTTTCCTAGGTTTTGAAATTTCCATTCTGTAAGACAGTAATTCACTGTAAAAAAATTCTAGT,10,30,14,27,27,38,27,53,27,28,28,38,43,53,38.63,5.310410384
hek293t,14881,1,2,TTAATGCGATGTTTAAAGTAAGGGCTCTGGGGCTCTTTGGTGTGGGCAGGATTCCAATTATAGGTAACACAAAAAAATTCTAGTTGGTTTAACGCGTAA,TTAATGCGATGTTTAAAGTAAGGGCTCTGGGGCTCATTTTGGTGTGGGCAGGATTCCAATTATAGGTAACACAAAAAAATTCTAGTTGGTTTAACGCGT,10,30,14,27,27,51,27,53,27,36,36,51,38,53,51.09,66.74281154
hek293t,14881,1,2,GTACCGCGATGTTTAAAGTAAGGGCTCTGGGGCTCTTTGGTGTGGGCAGGATTCCAATTATAGGTAACACAGCAGAAAAAAATTCTAGTTGGTTTAACG,GTACCGCGATGTTTAAAGTAAGGGCTCTGGGGCTCATTTTGGTGTGGGCAGGATTCCAATTATAGGTAACACAGCAGAAAAAAATTCTAGTTGGTTTAA,10,30,14,27,27,46,27,48,27,36,36,46,38,48,51.09,78.50390669
hek293t,7147,1,15,CCTAACGGCTCCTTCCCCCGCGGCCACGGCGGTTCCAGGGGAACGCGGGAGCAGAGCTGCGGCCAGGCCCAAAAAAATTCTAGTTGGTTTAACGCGTAA,CCTAACGGCTCCTTCCCCCGCGGCCACGGCGGTTCGGCGTGGTTCTACTCCAGGGGAACGCGGGAGCAGAGCTGCGGCCAGGCCCAAAAAAATTCTAGT,10,30,14,27,27,38,27,53,27,35,35,38,50,53,68.99,0.0
hek293t,14884,1,8,TAATTGCTAGATTTCTGTTACTGTGATCATGGAAAAAGCTCTGAATTTGTCAATCAGCTAGTGTGATATTAAAAGATTAAAAAAATTCTAGTTGGTTTA,TAATTGCTAGATTTCTGTTACTGTGATCATGGAAGGTTCTTAAAAGCTCTGAATTTGTCAATCAGCTAGTGTGATATTAAAAGATTAAAAAAATTCTAG,10,30,14,27,27,37,27,45,27,34,34,37,42,45,31.77,0.185185185
hek293t,14884,1,8,GTCCCGCTAGATTTCTGTTACTGTGATCATGGAAAAAGCTCTGAATTTGTCAATCAGCTAGTGTGAAAAAAAATTCTAGTTGGTTTAACGCGTAACTAG,GTCCCGCTAGATTTCTGTTACTGTGATCATGGAAGGTTCTTAAAAGCTCTGAATTTGTCAATCAGCTAGTGTGAAAAAAAATTCTAGTTGGTTTAACGC,10,30,14,27,27,49,27,57,27,34,34,49,42,57,31.77,3.692253603
hek293t,14886,1,13,AGAGCCTTCTGCTAAGCAAAAGGAAATGCTGGTCAGATTTAATTCTAATGGAAGAACCATTCTTACAAGGATGGAAGTAAAAAAAATTCTAGTTGGTTT,AGAGCCTTCTGCTAAGCAAAAGGAAATCGGGTTGTCCCTCGCTGGTCAGATTTAATTCTAATGGAAGAACCATTCTTACAAGGATGGAAGTAAAAAAAA,10,30,14,27,27,31,27,44,27,28,28,31,41,44,61.95,0.0
hek293t,14886,1,13,TATCACTTCTGCTAAGCAAAAGGAAATGCTGGTCAGATTTAATTCTAATGGAAGAACCATTCTTACAAAAAAAATTCTAGTTGGTTTAACGCGTAACTA,TATCACTTCTGCTAAGCAAAAGGAAATCGGGTTGTCCCTCGCTGGTCAGATTTAATTCTAATGGAAGAACCATTCTTACAAAAAAAATTCTAGTTGGTT,10,30,14,27,27,43,27,56,27,28,28,43,41,56,61.95,0.2832728
hek293t,14888,1,5,TCGAATGACTTTTTCTGTTGTTTTTACCCTGGTAAAATATATTTAAATTAATTAGTTATTAAATTTACAATCCAAAAAAATTCTAGTTGGTTTAACGCG,TCGAATGACTTTTTCTGTTGTTTTTACCCTGGTAAAACTCATTATATTTAAATTAATTAGTTATTAAATTTACAATCCAAAAAAATTCTAGTTGGTTTA,10,30,14,27,27,45,27,50,27,38,38,45,43,50,15.03,0.0
hek293t,14890,1,5,AGGGTCATGCATACAGATGTTACATATGCTGGTAGCATTTCTGATTTTGTACGAGATTAGCAGGTGACTAGATGAAAAAAAAATTCTAGTTGGTTTAAC,AGGGTCATGCATACAGATGTTACATATGCTGGTTTAGTAGCATTTCTGATTTTGTACGAGATTAGCAGGTGACTAGATGAAAAAAAAATTCTAGTTGGT,10,30,14,27,27,42,27,47,27,32,32,42,37,47,49.19,26.72143211
hek293t,14890,1,5,CAGCTCATGCATACAGATGTTACATATGCTGGTAGCATTTCTGATTTTGTACGAGATTAGCAGGTGACTAGAAAAAAATTCTAGTTGGTTTAACGCGTA,CAGCTCATGCATACAGATGTTACATATGCTGGTTTAGTAGCATTTCTGATTTTGTACGAGATTAGCAGGTGACTAGAAAAAAATTCTAGTTGGTTTAAC,10,30,14,27,27,47,27,52,27,32,32,47,37,52,49.19,25.27563256
hek293t,14894,1,11,AGACAATATTCTGGACTTAGCGATTTTTCTGGTGATTACTGTCTATAGTTCCAAACTGCTCTTTCTGTTTTTTAAATGAAAAAAATTCTAGTTGGTTTA,AGACAATATTCTGGACTTAGCGATTTCTTAGAGTAAGTTCTGGTGATTACTGTCTATAGTTCCAAACTGCTCTTTCTGTTTTTTAAATGAAAAAAATTC,10,30,14,27,27,34,27,45,27,27,27,34,38,45,5.82,2.42200225
hek293t,14896,1,13,GGTATTTCCCATTCAGAAAGAACTGTGTTTGGACCCTGTGCCAGAAGCATAGTTATTTAAACACAAAAAAAAAAAATTCTAGTTGGTTTAACGCGTAAC,GGTATTTCCCATTCAGAAAGAACTGTGTTTGTTTATTACGCTGGGACCCTGTGCCAGAAGCATAGTTATTTAAACACAAAAAAAAAAAATTCTAGTTGG,10,30,14,27,27,41,27,54,27,31,31,41,44,54,33.89,0.713647282
hek293t,14896,1,13,ACAGATTCCCATTCAGAAAGAACTGTGTTTGGACCCTGTGCCAGAAGCATAGTTATTTAAACACAAAAAATGCAGCAAAAAAATTCTAGTTGGTTTAAC,ACAGATTCCCATTCAGAAAGAACTGTGTTTGTTTATTACGCTGGGACCCTGTGCCAGAAGCATAGTTATTTAAACACAAAAAATGCAGCAAAAAAATTC,10,30,14,27,27,34,27,47,27,31,31,34,44,47,33.89,0.178135775
hek293t,14898,1,9,ATGGCGCCACGTTTTGGAAGTAGCTGAGAAGGGAGAAGGCGGCTGGGCTGGCAGAGGCAGCGTTAAAAAAAATTCTAGTTGGTTTAACGCGTAACTAGA,ATGGCGCCACGTTTTGGAAGTAGCTGAGAAGGGGACCGTTAAAGAAGGCGGCTGGGCTGGCAGAGGCAGCGTTAAAAAAAATTCTAGTTGGTTTAACGC,10,30,14,27,27,49,27,58,27,34,34,49,43,58,39.44,5.165199609
hek293t,14898,1,9,TACTTGCCACGTTTTGGAAGTAGCTGAGAAGGGAGAAGGCGGCTGGGCTGGCAGAGGCAGCGTTAGGCGTAAAAAAATTCTAGTTGGTTTAACGCGTAA,TACTTGCCACGTTTTGGAAGTAGCTGAGAAGGGGACCGTTAAAGAAGGCGGCTGGGCTGGCAGAGGCAGCGTTAGGCGTAAAAAAATTCTAGTTGGTTT,10,30,14,27,27,44,27,53,27,34,34,44,43,53,39.44,7.82427027
hek293t,14900,1,12,ACAGCCTTACGTGTGACAGCCGTCCATCACGGCCCGACGCCTGCAGCAGCCGCAGCTCCTGCCAGGGAAAAAAATTCTAGTTGGTTTAACGCGTAACTA,ACAGCCTTACGTGTGACAGCCGTCCATCACGGCCCGAGTCTACGCCGCACGCCTGCAGCAGCCGCAGCTCCTGCCAGGGAAAAAAATTCTAGTTGGTTT,10,30,14,27,27,44,27,56,27,37,37,44,49,56,58.15,1.266147171
hek293t,14902,1,7,TCGCGGCAGTCACTGTGAAACTGGCTAAAAGGACCTGCCGATAGTGCGAGAACTGTTTGCGATGCAAGGGAAAAAAATTCTAGTTGGTTTAACGCGTAA,TCGCGGCAGTCACTGTGAAACTGGCTAAAAGGACCTGCATCGTACCGATAGTGCGAGAACTGTTTGCGATGCAAGGGAAAAAAATTCTAGTTGGTTTAA,10,30,14,27,27,46,27,53,27,39,39,46,46,53,33.36,47.46335818
hek293t,14903,1,11,GGAAAACATACCTTCAAATTCACAAATAGAGGTTTGCTGCAGCTGTAAAACACTGTCCATTTCAAACAGAGCCAAAAAAATTCTAGTTGGTTTAACGCG,GGAAAACATACCTTCAAATTCACAAATAGCCGAAAGTCGGAGGTTTGCTGCAGCTGTAAAACACTGTCCATTTCAAACAGAGCCAAAAAAATTCTAGTT,10,30,14,27,27,39,27,50,27,29,29,39,40,50,32.97,11.6397308
hek293t,14903,1,11,TCGGGACATACCTTCAAATTCACAAATAGAGGTTTGCTGCAGCTGTAAAACACTGTCCATTTCAAACAAAAAAAATTCTAGTTGGTTTAACGCGTAACT,TCGGGACATACCTTCAAATTCACAAATAGCCGAAAGTCGGAGGTTTGCTGCAGCTGTAAAACACTGTCCATTTCAAACAAAAAAAATTCTAGTTGGTTT,10,30,14,27,27,44,27,55,27,29,29,44,40,55,32.97,3.205787987
hek293t,14907,1,5,TCGGGAAGCAGTCTTGGTTTCTAAAACTTAGGCAGTATAAAGATCTTCATTTCATTTCTCTGTTTATTATTTTGGATGCATAGTAAAAAAATTCTAGTT,TCGGGAAGCAGTCTTGGTTTCTAAAACTTATCTTAGGCAGTATAAAGATCTTCATTTCATTTCTCTGTTTATTATTTTGGATGCATAGTAAAAAAATTC,10,30,14,27,27,34,27,39,27,31,31,34,36,39,56.95,0.0
hek293t,14907,1,5,TGAATAAGCAGTCTTGGTTTCTAAAACTTAGGCAGTATAAAGATCTTCATTTCATTTCTCTGTTTATTATTTTGGATGCAAAAAAAATTCTAGTTGGTT,TGAATAAGCAGTCTTGGTTTCTAAAACTTATCTTAGGCAGTATAAAGATCTTCATTTCATTTCTCTGTTTATTATTTTGGATGCAAAAAAAATTCTAGT,10,30,14,27,27,38,27,43,27,31,31,38,36,43,56.95,0.804842462
hek293t,14909,1,5,CTATGCCCAAGCCACGAGATACAACCAAACGGTAATTTCCTGTACCTGCCTCTTGCTTCCTTCATTTCGGGATCAAGTATTAAAAAAATTCTAGTTGGT,CTATGCCCAAGCCACGAGATACAACCAAAACCCACGGTAATTTCCTGTACCTGCCTCTTGCTTCCTTCATTTCGGGATCAAGTATTAAAAAAATTCTAG,10,30,14,27,27,37,27,42,27,30,30,37,35,42,50.74,27.02319272
hek293t,14909,1,5,GGTTGCCCAAGCCACGAGATACAACCAAACGGTAATTTCCTGTACCTGCCTCTTGCTTCCTTCATTTCGGGATCAAGTATTTACCAAAAAAATTCTAGT,GGTTGCCCAAGCCACGAGATACAACCAAAACCCACGGTAATTTCCTGTACCTGCCTCTTGCTTCCTTCATTTCGGGATCAAGTATTTACCAAAAAAATT,10,30,14,27,27,33,27,38,27,30,30,33,35,38,50.74,0.196078431
hek293t,14911,1,9,GGTTCGTTTTGGTTACGTGGAAGAGAAATTGGGATTCTGTGAGTGGAAAGGAAAGAAGGAGGAAAAGATTATAGTAAAAAAATTCTAGTTGGTTTAACG,GGTTCGTTTTGGTTACGTGGAAGAGAAATTGTACGCCCGAGGATTCTGTGAGTGGAAAGGAAAGAAGGAGGAAAAGATTATAGTAAAAAAATTCTAGTT,10,30,14,27,27,39,27,48,27,32,32,39,41,48,13.26,14.26826908
hek293t,14911,1,9,CTATTGTTTTGGTTACGTGGAAGAGAAATTGGGATTCTGTGAGTGGAAAGGAAAGAAGGAGGAAAAGAAAAAAATTCTAGTTGGTTTAACGCGTAACTA,CTATTGTTTTGGTTACGTGGAAGAGAAATTGTACGCCCGAGGATTCTGTGAGTGGAAAGGAAAGAAGGAGGAAAAGAAAAAAATTCTAGTTGGTTTAAC,10,30,14,27,27,47,27,56,27,32,32,47,41,56,13.26,6.629799532
hek293t,14913,1,10,TGATCGGAAGAAGGTGGCTCTGACTTATGTGGATAACCCCACACTGACTAAATATCAGTACAGTAATGGATGAGAGAAAAAAATTCTAGTTGGTTTAAC,TGATCGGAAGAAGGTGGCTCTGACTTGGGCTAGATTATGTGGATAACCCCACACTGACTAAATATCAGTACAGTAATGGATGAGAGAAAAAAATTCTAG,10,30,14,27,27,37,27,47,27,27,27,37,37,47,33.35,23.5356465
hek293t,14913,1,10,AGGACGGAAGAAGGTGGCTCTGACTTATGTGGATAACCCCACACTGACTAAATATCAGTACAGTAATGGATGAGAGGGTAAAAAAATTCTAGTTGGTTT,AGGACGGAAGAAGGTGGCTCTGACTTGGGCTAGATTATGTGGATAACCCCACACTGACTAAATATCAGTACAGTAATGGATGAGAGGGTAAAAAAATTC,10,30,14,27,27,34,27,44,27,27,27,34,37,44,33.35,8.466722498
hek293t,14915,1,11,CCCCAGCGTAGCCAGAAAGTCTATTAAGGAGGTCTTTTTTATAAATGAATACCTGCACTTACTATTTTTAAAAAAAATTCTAGTTGGTTTAACGCGTAA,CCCCAGCGTAGCCAGAAAGTCTATTAAGGAGGTCCTGGCGTGATTTTTTTTATAAATGAATACCTGCACTTACTATTTTTAAAAAAAATTCTAGTTGGT,10,30,14,27,27,42,27,53,27,35,35,42,46,53,57.96,0.0
hek293t,14916,1,2,CGGTGTGGATTCCTGCTTCTCGAGAACAAAGGCTCAAAGGATATCTCCAAGAAAAATACAGCCCAAAAAAAAAAATTCTAGTTGGTTTAACGCGTAACT,CGGTGTGGATTCCTGCTTCTCGAGAACAAAGGCTCAAATAGGATATCTCCAAGAAAAATACAGCCCAAAAAAAAAAATTCTAGTTGGTTTAACGCGTAA,10,30,14,27,27,53,27,55,27,38,38,53,40,55,57.93,57.6120656
hek293t,14916,1,2,CGCGGTGGATTCCTGCTTCTCGAGAACAAAGGCTCAAAGGATATCTCCAAGAAAAATACAGCCCAAAATGGGCATCAAAAAAATTCTAGTTGGTTTAAC,CGCGGTGGATTCCTGCTTCTCGAGAACAAAGGCTCAAATAGGATATCTCCAAGAAAAATACAGCCCAAAATGGGCATCAAAAAAATTCTAGTTGGTTTA,10,30,14,27,27,45,27,47,27,38,38,45,40,47,57.93,40.54969845
hek293t,14920,1,2,ACGCGGTTGTTTGAATATTTATTTCTAGCTGGTGTTCTGTAGTGTCAGCAAACCTGAGACTTGACAAAAAAAATTCTAGTTGGTTTAACGCGTAACTAG,ACGCGGTTGTTTGAATATTTATTTCTAGCTGGTGTTCTGGCTAGTGTCAGCAAACCTGAGACTTGACAAAAAAAATTCTAGTTGGTTTAACGCGTAACT,10,30,14,27,27,55,27,57,27,40,40,55,42,57,2.65,0.320440807
hek293t,14920,1,2,GGCCCGTTGTTTGAATATTTATTTCTAGCTGGTGTTCTGTAGTGTCAGCAAACCTGAGACTTGACATGCTTTGGTTTAAAAAAAATTCTAGTTGGTTTA,GGCCCGTTGTTTGAATATTTATTTCTAGCTGGTGTTCTGGCTAGTGTCAGCAAACCTGAGACTTGACATGCTTTGGTTTAAAAAAAATTCTAGTTGGTT,10,30,14,27,27,43,27,45,27,40,40,43,42,45,2.65,0.0
hek293t,14922,1,12,TCCACTGAAAGTAATCTAGGAGACTGTCTAGGACCCTAGGTCATGGGAGAAGAGAGGGCCCTACTTTAAAAAAAATTCTAGTTGGTTTAACGCGTAACT,TCCACTGAAAGTAATCTAGGAGACTGTCTAGGACCCTAGCATCATTACGAGGTCATGGGAGAAGAGAGGGCCCTACTTTAAAAAAAATTCTAGTTGGTT,10,30,14,27,27,43,27,55,27,40,40,43,52,55,42.94,0.588418028
hek293t,14923,1,4,GTCGCCTCGTAGGGAGTTGAAGCGTATGCAGGCGTGCTGTTGCTTTCCTGTTCACTAGGTCATTTTTGGACTGGGTCGACTCCAAAAAAAAATTCTAGT,GTCGCCTCGTAGGGAGTTGAAGCGTAATGCTGCAGGCGTGCTGTTGCTTTCCTGTTCACTAGGTCATTTTTGGACTGGGTCGACTCCAAAAAAAAATTC,10,30,14,27,27,34,27,38,27,27,27,34,31,38,59.34,56.86814952
hek293t,14925,1,4,CAAACGAAAGGCCTCGGTTAACAGAGGGCAGGAAATCCCTCGTTGCTCTGTGCGTTCTGTGCATGAGGACATGTAAAAAAAATTCTAGTTGGTTTAACG,CAAACGAAAGGCCTCGGTTAACAGAGGGCAGGAGCATAATCCCTCGTTGCTCTGTGCGTTCTGTGCATGAGGACATGTAAAAAAAATTCTAGTTGGTTT,10,30,14,27,27,44,27,48,27,34,34,44,38,48,42.77,64.05825689
hek293t,14925,1,4,TGAGGGAAAGGCCTCGGTTAACAGAGGGCAGGAAATCCCTCGTTGCTCTGTGCGTTCTGTGCATGAGGACATGTAAAAAAAAAAATTCTAGTTGGTTTA,TGAGGGAAAGGCCTCGGTTAACAGAGGGCAGGAGCATAATCCCTCGTTGCTCTGTGCGTTCTGTGCATGAGGACATGTAAAAAAAAAAATTCTAGTTGG,10,30,14,27,27,41,27,45,27,34,34,41,38,45,42.77,44.78783082
hek293t,14927,1,2,AACCAAAATTAGCTGAAGTATTGTGGAAGTGGTATCCTTACTCTGAGCCCCCCCACTGCATCCAAATAAAAAAATTCTAGTTGGTTTAACGCGTAACTA,AACCAAAATTAGCTGAAGTATTGTGGAAGTGGTATCCTATTACTCTGAGCCCCCCCACTGCATCCAAATAAAAAAATTCTAGTTGGTTTAACGCGTAAC,10,30,14,27,27,54,27,56,27,39,39,54,41,56,31.69,77.80808596
hek293t,14927,1,2,CACCCAAATTAGCTGAAGTATTGTGGAAGTGGTATCCTTACTCTGAGCCCCCCCACTGCATCCAAATTTAAGACAAAAAAAATTCTAGTTGGTTTAACG,CACCCAAATTAGCTGAAGTATTGTGGAAGTGGTATCCTATTACTCTGAGCCCCCCCACTGCATCCAAATTTAAGACAAAAAAAATTCTAGTTGGTTTAA,10,30,14,27,27,46,27,48,27,39,39,46,41,48,31.69,66.75567973
hek293t,14929,1,6,AATGCGACAAAGCACATACTTGTTTTCCTTGGAGACCTTGAGGACCTCTTGGACCCACTGGACCCTATTAAAAACAAAAAAATTCTAGTTGGTTTAACG,AATGCGACAAAGCACATACTTGTTTTCCTTGGAGACCTGTCACGTGAGGACCTCTTGGACCCACTGGACCCTATTAAAAACAAAAAAATTCTAGTTGGT,10,30,14,27,27,42,27,48,27,39,39,42,45,48,28.45,0.0
hek293t,14929,1,6,CTTTGGACAAAGCACATACTTGTTTTCCTTGGAGACCTTGAGGACCTCTTGGACCCACTGGACCCTATTAAAAAAAAATTCTAGTTGGTTTAACGCGTA,CTTTGGACAAAGCACATACTTGTTTTCCTTGGAGACCTGTCACGTGAGGACCTCTTGGACCCACTGGACCCTATTAAAAAAAAATTCTAGTTGGTTTAA,10,30,14,27,27,46,27,52,27,39,39,46,45,52,28.45,7.57710166
hek293t,14933,1,13,CGCCCTTCCTACTATTAACCACAAAGGTTTGGGCAATTGTAACCTATATAAATCCCCAAAGTGCTGAAAAAAAATTCTAGTTGGTTTAACGCGTAACTA,CGCCCTTCCTACTATTAACCACAAAGGTTTGGGGCAACTGGCCAGGCAATTGTAACCTATATAAATCCCCAAAGTGCTGAAAAAAAATTCTAGTTGGTT,10,30,14,27,27,43,27,56,27,33,33,43,46,56,40.14,4.524406254
hek293t,14935,1,4,ATTCATAGATCAACACATGCTAGATATGAAGGCAGAATAAACTGGGATCCCTTCCAGTAGAAAGGATTTCTCTTGGAAAAAAATTCTAGTTGGTTTAAC,ATTCATAGATCAACACATGCTAGATATGAAGGCAGTGATAATAAACTGGGATCCCTTCCAGTAGAAAGGATTTCTCTTGGAAAAAAATTCTAGTTGGTT,10,30,14,27,27,43,27,47,27,36,36,43,40,47,61.75,1.722646551
hek293t,14935,1,4,AGACCTAGATCAACACATGCTAGATATGAAGGCAGAATAAACTGGGATCCCTTCCAGTAGAAAGGATTAAAAAAATTCTAGTTGGTTTAACGCGTAACT,AGACCTAGATCAACACATGCTAGATATGAAGGCAGTGATAATAAACTGGGATCCCTTCCAGTAGAAAGGATTAAAAAAATTCTAGTTGGTTTAACGCGT,10,30,14,27,27,51,27,55,27,36,36,51,40,55,61.75,19.32031281
hek293t,14937,1,9,GCAATTTTAGCCTGTTCTTCCCAAAACAGGGGAGAGAACCACCTCTGACCCTCACACCGCGATGAAAAAAAATTCTAGTTGGTTTAACGCGTAACTAGA,GCAATTTTAGCCTGTTCTTCCCAAAACAGGGGACGAGCGCAAGAGAACCACCTCTGACCCTCACACCGCGATGAAAAAAAATTCTAGTTGGTTTAACGC,10,30,14,27,27,49,27,58,27,34,34,49,43,58,66.64,6.719159852
hek293t,14937,1,9,GTCCGTTTAGCCTGTTCTTCCCAAAACAGGGGAGAGAACCACCTCTGACCCTCACACCGCGATGAAAGGGAAAAAAATTCTAGTTGGTTTAACGCGTAA,GTCCGTTTAGCCTGTTCTTCCCAAAACAGGGGACGAGCGCAAGAGAACCACCTCTGACCCTCACACCGCGATGAAAGGGAAAAAAATTCTAGTTGGTTT,10,30,14,27,27,44,27,53,27,34,34,44,43,53,66.64,22.21851877
hek293t,14939,1,2,GCTGACAAGGGGGGAAGCACAGTAGTATGGGGAGCAGGGTGCAGATAGAGTGAACTGCCACAGGAGAGAAATCTCTGACCAAAAAAATTCTAGTTGGTT,GCTGACAAGGGGGGAAGCACAGTAGTATGGGGATAGCAGGGTGCAGATAGAGTGAACTGCCACAGGAGAGAAATCTCTGACCAAAAAAATTCTAGTTGG,10,30,14,27,27,41,27,43,27,34,34,41,36,43,71.66,75.96616502
hek293t,14939,1,2,TATGCCAAGGGGGGAAGCACAGTAGTATGGGGAGCAGGGTGCAGATAGAGTGAACTGCCACAGGAGAGAAATCTCTGAAAAAAATTCTAGTTGGTTTAA,TATGCCAAGGGGGGAAGCACAGTAGTATGGGGATAGCAGGGTGCAGATAGAGTGAACTGCCACAGGAGAGAAATCTCTGAAAAAAATTCTAGTTGGTTT,10,30,14,27,27,44,27,46,27,34,34,44,36,46,71.66,80.10003086
hek293t,14941,1,10,CGTCGGGCTACTTTTCTTTGTTCCAGCATTGGCAATGGGCCTTAATTAGGCTAAGTTTCATACTTCAAAAAAATTCTAGTTGGTTTAACGCGTAACTAG,CGTCGGGCTACTTTTCTTTGTTCCAGCATTGGCAATGGGTAACTTTTTCCCTTAATTAGGCTAAGTTTCATACTTCAAAAAAATTCTAGTTGGTTTAAC,10,30,14,27,27,47,27,57,27,40,40,47,50,57,21.31,0.0
hek293t,14942,1,15,ATGGGTTTTGAATATGTGTGTATTTGGTGGGGGCAAGAGGAGAGTTTATGTTTGGTTGTAGGACTTAAAAAAAAATTCTAGTTGGTTTAACGCGTAACT,ATGGGTTTTGAATATGTGTGTATTTGGTGGGGGGCCCTGTTAATCACGCAAGAGGAGAGTTTATGTTTGGTTGTAGGACTTAAAAAAAAATTCTAGTTG,10,30,14,27,27,40,27,55,27,33,33,40,48,55,38.42,0.050581689
hek293t,14942,1,15,ATCCATTTTGAATATGTGTGTATTTGGTGGGGGCAAGAGGAGAGTTTATGTTTGGTTGTAGGACTTAAAGGAAAAAAAATTCTAGTTGGTTTAACGCGT,ATCCATTTTGAATATGTGTGTATTTGGTGGGGGGCCCTGTTAATCACGCAAGAGGAGAGTTTATGTTTGGTTGTAGGACTTAAAGGAAAAAAAATTCTA,10,30,14,27,27,36,27,51,27,33,33,36,48,51,38.42,0.0
hek293t,14944,1,7,GCGCGCGAGGAGAGCACGGCTGGTGCTCTCGGGGCACGTTTGCCTCTATCCTGTGCCCACGTATCGTCCGCTGCAAAAAAATTCTAGTTGGTTTAACGC,GCGCGCGAGGAGAGCACGGCTGGTGCTCTCGGGGTCCCAACCACGTTTGCCTCTATCCTGTGCCCACGTATCGTCCGCTGCAAAAAAATTCTAGTTGGT,10,30,14,27,27,42,27,49,27,35,35,42,42,49,30.52,10.70753193
hek293t,14946,1,3,AGACGTTGTGATGGTACTGTTCTGTGCCCTGGTTAACGCTGTGGCAGAACAGATTACAGCACATTAACTTCTGCCCTGGGAAAAAAAATTCTAGTTGGT,AGACGTTGTGATGGTACTGTTCTGTGCCCGACTGGTTAACGCTGTGGCAGAACAGATTACAGCACATTAACTTCTGCCCTGGGAAAAAAAATTCTAGTT,10,30,14,27,27,39,27,42,27,29,29,39,32,42,55.17,76.59454052
hek293t,14950,1,5,CGTTAGAATTGTTTTGTTTCAAGTCTTTCAGGATTATTTAAACATCTTCCTGGATGTCAGCATGGCTCAGTTTAGCCTTAAAAAAATTCTAGTTGGTTT,CGTTAGAATTGTTTTGTTTCAAGTCTTTCAGCTGCTGATTATTTAAACATCTTCCTGGATGTCAGCATGGCTCAGTTTAGCCTTAAAAAAATTCTAGTT,10,30,14,27,27,39,27,44,27,32,32,39,37,44,0.72,1.263736264
hek293t,14950,1,5,GAAGAGAATTGTTTTGTTTCAAGTCTTTCAGGATTATTTAAACATCTTCCTGGATGTCAGCATGGCTCAGTTTAGCCTTTTTTAAAAAAATTCTAGTTG,GAAGAGAATTGTTTTGTTTCAAGTCTTTCAGCTGCTGATTATTTAAACATCTTCCTGGATGTCAGCATGGCTCAGTTTAGCCTTTTTTAAAAAAATTCT,10,30,14,27,27,35,27,40,27,32,32,35,37,40,0.72,0.0
hek293t,14952,1,13,TGAATTGGTTGATTGTCATATCAAAAAAGAGGTGAAGACATAAGTTTTAGGCTAAACAACAAAAAGAAAAAAATTCTAGTTGGTTTAACGCGTAACTAG,TGAATTGGTTGATTGTCATATCAAAAAAGAGGTGAAGATATTCCTAGTAGACATAAGTTTTAGGCTAAACAACAAAAAGAAAAAAATTCTAGTTGGTTT,10,30,14,27,27,44,27,57,27,37,37,44,50,57,53.4,0.0
hek293t,14953,1,2,TCTTGGGATAGAAACTTGAATTTCAGTAGGGGCTTTGCACTTGTGATACATCTCAGAACCACCTTACTCACACATGAGCAAAAAAATTCTAGTTGGTTT,TCTTGGGATAGAAACTTGAATTTCAGCTTAGGGGCTTTGCACTTGTGATACATCTCAGAACCACCTTACTCACACATGAGCAAAAAAATTCTAGTTGGT,10,30,14,27,27,42,27,44,27,27,27,42,29,44,27.61,83.54190803
hek293t,14953,1,2,TATTAGGATAGAAACTTGAATTTCAGTAGGGGCTTTGCACTTGTGATACATCTCAGAACCACCTTACTCACACATGAGCACCTGCTCAAAAAAATTCTA,TATTAGGATAGAAACTTGAATTTCAGCTTAGGGGCTTTGCACTTGTGATACATCTCAGAACCACCTTACTCACACATGAGCACCTGCTCAAAAAAATTC,10,30,14,27,27,34,27,36,27,27,27,34,29,36,27.61,80.77987187
hek293t,14955,1,9,CGACGTCTGTAGCCGTCCTTAACATCCTGAGGGCTGCAACGTGAAAATGGAACGTGACACAAGAAACAGCAAAAAAATTCTAGTTGGTTTAACGCGTAA,CGACGTCTGTAGCCGTCCTTAACATCCTGAGGGCTGCAACAGGTAAAAAGTGAAAATGGAACGTGACACAAGAAACAGCAAAAAAATTCTAGTTGGTTT,10,30,14,27,27,44,27,53,27,41,41,44,50,53,43.1,0.0
hek293t,14958,1,15,ACTCTGCTTTTCACTTCTGTTAAATACCTAGGAGTGTACTTATCTTACCAAACCTCTGATCCTTTAAAAAAAAAAATTCTAGTTGGTTTAACGCGTAAC,ACTCTGCTTTTCACTTCTGTTAAATACCGAGGTGAACAGAGGCTAGGAGTGTACTTATCTTACCAAACCTCTGATCCTTTAAAAAAAAAAATTCTAGTT,10,30,14,27,27,39,27,54,27,29,29,39,44,54,34.24,0.557880056
hek293t,14958,1,15,CGCCAGCTTTTCACTTCTGTTAAATACCTAGGAGTGTACTTATCTTACCAAACCTCTGATCCTTTAAAATTAAATTAAAAAAATTCTAGTTGGTTTAAC,CGCCAGCTTTTCACTTCTGTTAAATACCGAGGTGAACAGAGGCTAGGAGTGTACTTATCTTACCAAACCTCTGATCCTTTAAAATTAAATTAAAAAAAT,10,30,14,27,27,32,27,47,27,29,29,32,44,47,34.24,0.0
hek293t,14960,1,4,AAAGACCGGCCTCACCGCAGCAGCGGCTCCGGAGAGCAACGCTCCCTTCCCCGCGGCACAGCACTGCCCACAGCAAAAAAATTCTAGTTGGTTTAACGC,AAAGACCGGCCTCACCGCAGCAGCGGCTCCGGAGCTCCAGCAACGCTCCCTTCCCCGCGGCACAGCACTGCCCACAGCAAAAAAATTCTAGTTGGTTTA,10,30,14,27,27,45,27,49,27,35,35,45,39,49,51.19,62.00944767
hek293t,14962,1,14,GAAACCACTTCCCTCTTTAAAACATTTATAGGTTTTATGTGTGTGTATGTTGTATATGTGTCCCCCCCAAAAAAATTCTAGTTGGTTTAACGCGTAACT,GAAACCACTTCCCTCTTTAAAACATTTATAGGTGGCTCAGCTCTGCATTTATGTGTGTGTATGTTGTATATGTGTCCCCCCCAAAAAAATTCTAGTTGG,10,30,14,27,27,41,27,55,27,34,34,41,48,55,3.58,0.0
hek293t,14964,1,15,CGGAGAAAAGGAAATGGATTAAGTTAAACTGGACAGTGAAACAATACTTGACGATTTCATTCCCGTGGTTAAAAAAATTCTAGTTGGTTTAACGCGTAA,CGGAGAAAAGGAAATGGATTAAGTTAAGCCAGACAGGAATTAACTGGACAGTGAAACAATACTTGACGATTTCATTCCCGTGGTTAAAAAAATTCTAGT,10,30,14,27,27,38,27,53,27,28,28,38,43,53,9.39,0.906076782
hek293t,14964,1,15,ACCAGAAAAGGAAATGGATTAAGTTAAACTGGACAGTGAAACAATACTTGACGATTTCATTCCCGAAAAAAATTCTAGTTGGTTTAACGCGTAACTAGA,ACCAGAAAAGGAAATGGATTAAGTTAAGCCAGACAGGAATTAACTGGACAGTGAAACAATACTTGACGATTTCATTCCCGAAAAAAATTCTAGTTGGTT,10,30,14,27,27,43,27,58,27,28,28,43,43,58,9.39,0.734504716
hek293t,14966,1,12,ATCTTCACTTTATGCTTGAGCAGATACTGTGGCTTTTGCATTGAGGCTAGTGGTATCTGCCAGCTTAAAAAAATTCTAGTTGGTTTAACGCGTAACTAG,ATCTTCACTTTATGCTTGAGCAGATACTGTGGCTTTTTATCTAGAGCTTGCATTGAGGCTAGTGGTATCTGCCAGCTTAAAAAAATTCTAGTTGGTTTA,10,30,14,27,27,45,27,57,27,38,38,45,50,57,60.35,0.559261636
hek293t,14967,1,15,CCGAAAGGTAGAAAGAGCAGAATGGACCCTGGCTATTTCTGGAAGCTAGGAGAAGTGGGTTTGAGGCTCTGAAAAAAATTCTAGTTGGTTTAACGCGTA,CCGAAAGGTAGAAAGAGCAGAATGGACCCTGGCCTGAAGACGTCCGTCTATTTCTGGAAGCTAGGAGAAGTGGGTTTGAGGCTCTGAAAAAAATTCTAG,10,30,14,27,27,37,27,52,27,34,34,37,49,52,71.84,0.650406504
hek293t,14967,1,15,TATATAGGTAGAAAGAGCAGAATGGACCCTGGCTATTTCTGGAAGCTAGGAGAAGTGGGTTTGAAAAAAAATTCTAGTTGGTTTAACGCGTAACTAGAT,TATATAGGTAGAAAGAGCAGAATGGACCCTGGCCTGAAGACGTCCGTCTATTTCTGGAAGCTAGGAGAAGTGGGTTTGAAAAAAAATTCTAGTTGGTTT,10,30,14,27,27,44,27,59,27,34,34,44,49,59,71.84,1.270928213
hek293t,14969,1,6,CGAACATTTCAATGCTCTGAATTAAATATTGGTTCCACAGCAGTCATTTGCAAAAATCAGACTTGACCCCAAAAAAAATTCTAGTTGGTTTAACGCGTA,CGAACATTTCAATGCTCTGAATTAAATATTGGTTCCACCCGGGAAGCAGTCATTTGCAAAAATCAGACTTGACCCCAAAAAAAATTCTAGTTGGTTTAA,10,30,14,27,27,46,27,52,27,39,39,46,45,52,10.93,1.460456513
hek293t,14969,1,6,TCTAGATTTCAATGCTCTGAATTAAATATTGGTTCCACAGCAGTCATTTGCAAAAATCAGACTTGACCCCACTGGAAAAAAATTCTAGTTGGTTTAACG,TCTAGATTTCAATGCTCTGAATTAAATATTGGTTCCACCCGGGAAGCAGTCATTTGCAAAAATCAGACTTGACCCCACTGGAAAAAAATTCTAGTTGGT,10,30,14,27,27,42,27,48,27,39,39,42,45,48,10.93,0.0
hek293t,14971,1,3,GCGGGTGAAAGGATACACTGAAGTCTTTGAGGCCATATTTCCACCTATCATGTGTTGATTATGTTTTCAGCTCCTGTCCAAAAAAAATTCTAGTTGGTT,GCGGGTGAAAGGATACACTGAAGTCTTTGAGGCCATTTCATTTCCACCTATCATGTGTTGATTATGTTTTCAGCTCCTGTCCAAAAAAAATTCTAGTTG,10,30,14,27,27,40,27,43,27,37,37,40,40,43,38.37,1.228930014
hek293t,14971,1,3,CATAATGAAAGGATACACTGAAGTCTTTGAGGCCATATTTCCACCTATCATGTGTTGATTATGTTTTCAGCTCAAAAAAATTCTAGTTGGTTTAACGCG,CATAATGAAAGGATACACTGAAGTCTTTGAGGCCATTTCATTTCCACCTATCATGTGTTGATTATGTTTTCAGCTCAAAAAAATTCTAGTTGGTTTAAC,10,30,14,27,27,47,27,50,27,37,37,47,40,50,38.37,78.47458371
hek293t,14973,1,6,CCCTACCATACTTACTGGCAGTGTACTTCTGGTCATTGTAACTGGTTGGGCTGATCTTGACTTCTAGATTCTGTATTAAAAAAATTCTAGTTGGTTTAA,CCCTACCATACTTACTGGCAGTGTACTTCCGGAGCTGGTCATTGTAACTGGTTGGGCTGATCTTGACTTCTAGATTCTGTATTAAAAAAATTCTAGTTG,10,30,14,27,27,40,27,46,27,30,30,40,36,46,28.55,66.2493906
hek293t,14973,1,6,CGTGCCCATACTTACTGGCAGTGTACTTCTGGTCATTGTAACTGGTTGGGCTGATCTTGACTTCTAGATTCTGTATTGTGAAAAAAATTCTAGTTGGTT,CGTGCCCATACTTACTGGCAGTGTACTTCCGGAGCTGGTCATTGTAACTGGTTGGGCTGATCTTGACTTCTAGATTCTGTATTGTGAAAAAAATTCTAG,10,30,14,27,27,37,27,43,27,30,30,37,36,43,28.55,48.53607736
hek293t,14975,1,13,TGACTGATCTCAGGTACCAATAAGCAGAGGGGCTGCAAAGCCTACCTACCTGTTGTGCATGATATCTAACTGGAAAAAAATTCTAGTTGGTTTAACGCG,TGACTGATCTCAGGTACCAATAAGCAGAGTCGGGTGTCAGTAGGGCTGCAAAGCCTACCTACCTGTTGTGCATGATATCTAACTGGAAAAAAATTCTAG,10,30,14,27,27,37,27,50,27,30,30,37,43,50,68.65,3.40185172
hek293t,14975,1,13,CGCTAGATCTCAGGTACCAATAAGCAGAGGGGCTGCAAAGCCTACCTACCTGTTGTGCATGATATCTAACTGGTGACAAAAAAATTCTAGTTGGTTTAA,CGCTAGATCTCAGGTACCAATAAGCAGAGTCGGGTGTCAGTAGGGCTGCAAAGCCTACCTACCTGTTGTGCATGATATCTAACTGGTGACAAAAAAATT,10,30,14,27,27,33,27,46,27,30,30,33,43,46,68.65,0.167059995
hek293t,14977,1,12,ACTTACATCATTGGAAGTGAACAGAAGACAGGATAGGTGGCTTCGATAGGTACAGTGTCAGTGTTACAGGAAAAAAATTCTAGTTGGTTTAACGCGTAA,ACTTACATCATTGGAAGTGAACAGAAGACAGCCACTCATGATGGATAGGTGGCTTCGATAGGTACAGTGTCAGTGTTACAGGAAAAAAATTCTAGTTGG,10,30,14,27,27,41,27,53,27,31,31,41,43,53,55.02,9.899187999
hek293t,14981,1,7,TCGAAAATAGAAGGGAAAGCGGTGATGTCTGGGAAGGGACCTCCAAACCAGCTCTTAATGCATCCTTTCCAGCATCCAGAAAAAAATTCTAGTTGGTTT,TCGAAAATAGAAGGGAAAGCGGTGATGTCTGGGTGTTCGAAAGGGACCTCCAAACCAGCTCTTAATGCATCCTTTCCAGCATCCAGAAAAAAATTCTAG,10,30,14,27,27,37,27,44,27,34,34,37,41,44,31.87,1.010850974
hek293t,14981,1,7,TCGCAAATAGAAGGGAAAGCGGTGATGTCTGGGAAGGGACCTCCAAACCAGCTCTTAATGCATCCTTTCCAGCATAAAAAAATTCTAGTTGGTTTAACG,TCGCAAATAGAAGGGAAAGCGGTGATGTCTGGGTGTTCGAAAGGGACCTCCAAACCAGCTCTTAATGCATCCTTTCCAGCATAAAAAAATTCTAGTTGG,10,30,14,27,27,41,27,48,27,34,34,41,41,48,31.87,25.54637808
hek293t,14983,1,2,GTGGGCTCAGTTACATAAAAAAGAAAGCAAGGCCAAATTCTTTTTTCACTTATCAAATTTCCATTAGCTTCTGTATTGTATTGATAAAAAAATTCTAGT,GTGGGCTCAGTTACATAAAAAAGAAAGCAAGGAGCCAAATTCTTTTTTCACTTATCAAATTTCCATTAGCTTCTGTATTGTATTGATAAAAAAATTCTA,10,30,14,27,27,36,27,38,27,33,33,36,35,38,62.98,0.0
hek293t,14985,1,14,CACGCCAAGCTAAATAATTGCATTACATGGGGGGCAAGGAGGAAGCAGAGAGAAGATTGGTCTACAAAAAAATTCTAGTTGGTTTAACGCGTAACTAGA,CACGCCAAGCTAAATAATTGCATTACATGGGGGGCAAGTCGGAGGTAGGTAGGAGGAAGCAGAGAGAAGATTGGTCTACAAAAAAATTCTAGTTGGTTT,10,30,14,27,27,44,27,58,27,37,37,44,51,58,13.76,0.080128205
hek293t,14986,1,9,TACTAATTTGGAATAGGCTTATTTTGAAAAGGGTGTAAACTTGAATGAGATAGTACTCAACAGGTACTATGTAAAAAAATTCTAGTTGGTTTAACGCGT,TACTAATTTGGAATAGGCTTATTTTGTTGTTCCGAAAAAGGGTGTAAACTTGAATGAGATAGTACTCAACAGGTACTATGTAAAAAAATTCTAGTTGGT,10,30,14,27,27,42,27,51,27,27,27,42,36,51,2.39,2.937004146
hek293t,14986,1,9,CCTTCATTTGGAATAGGCTTATTTTGAAAAGGGTGTAAACTTGAATGAGATAGTACTCAACAGGTACTATGTGAGTTAAATTTGAAAAAAATTCTAGTT,CCTTCATTTGGAATAGGCTTATTTTGTTGTTCCGAAAAAGGGTGTAAACTTGAATGAGATAGTACTCAACAGGTACTATGTGAGTTAAATTTGAAAAAA,10,30,14,27,27,30,27,39,27,27,27,30,36,39,2.39,0.0
hek293t,14988,1,6,CGCGGCCATTGCTAATTTTCACACAGTGATGGTTTAACAGTTGTGTGCCTGTAATTGCAGAGCCTGATTCACCTGAAAAAAATTCTAGTTGGTTTAACG,CGCGGCCATTGCTAATTTTCACACAGTGATGACAGATGTTTAACAGTTGTGTGCCTGTAATTGCAGAGCCTGATTCACCTGAAAAAAATTCTAGTTGGT,10,30,14,27,27,42,27,48,27,32,32,42,38,48,23.85,31.44929808
hek293t,14988,1,6,TATACCCATTGCTAATTTTCACACAGTGATGGTTTAACAGTTGTGTGCCTGTAATTGCAGAGCCTGATTCAAAAAAATTCTAGTTGGTTTAACGCGTAA,TATACCCATTGCTAATTTTCACACAGTGATGACAGATGTTTAACAGTTGTGTGCCTGTAATTGCAGAGCCTGATTCAAAAAAATTCTAGTTGGTTTAAC,10,30,14,27,27,47,27,53,27,32,32,47,38,53,23.85,38.13058967
hek293t,14990,1,7,GTGAGAATGGCCTATTGTCTCTGGCTGTCAGGGTTAGCTGTCTCAAGTTCTGGGAACTGCAGGGCACAGTCAGAAAAAAATTCTAGTTGGTTTAACGCG,GTGAGAATGGCCTATTGTCTCTGGCTGTCAGGGTTAGCTGTTAATAGTCTCAAGTTCTGGGAACTGCAGGGCACAGTCAGAAAAAAATTCTAGTTGGTT,10,30,14,27,27,43,27,50,27,40,40,43,47,50,17.66,0.0
hek293t,14990,1,7,TGATCAATGGCCTATTGTCTCTGGCTGTCAGGGTTAGCTGTCTCAAGTTCTGGGAACTGCAGGGCAAAAAAAATTCTAGTTGGTTTAACGCGTAACTAG,TGATCAATGGCCTATTGTCTCTGGCTGTCAGGGTTAGCTGTTAATAGTCTCAAGTTCTGGGAACTGCAGGGCAAAAAAAATTCTAGTTGGTTTAACGCG,10,30,14,27,27,50,27,57,27,40,40,50,47,57,17.66,13.65147746
hek293t,14992,1,7,CTGAGTCAGCAGCAGTAATTGCGGTGGCTTGGGAATCAGAGAGGAAGGTGAAGAAAGCATAAGTGAAAAAAATTCTAGTTGGTTTAACGCGTAACTAGA,CTGAGTCAGCAGCAGTAATTGCGGTGGCTTGGGAATGTCGCATCAGAGAGGAAGGTGAAGAAAGCATAAGTGAAAAAAATTCTAGTTGGTTTAACGCGT,10,30,14,27,27,51,27,58,27,36,36,51,43,58,20.83,6.178845893
hek293t,14992,1,7,TCCTATCAGCAGCAGTAATTGCGGTGGCTTGGGAATCAGAGAGGAAGGTGAAGAAAGCATAAGTGGAACATAGAAAAAAATTCTAGTTGGTTTAACGCG,TCCTATCAGCAGCAGTAATTGCGGTGGCTTGGGAATGTCGCATCAGAGAGGAAGGTGAAGAAAGCATAAGTGGAACATAGAAAAAAATTCTAGTTGGTT,10,30,14,27,27,43,27,50,27,36,36,43,43,50,20.83,51.89003779
hek293t,14996,1,15,ATGGGGTCCTAGGCAAAGATTGCAGACTTCGGAGAGGTCTAGGAAAGCGCAGTGTTGGTGACATAGCTGATGGAAAAAAATTCTAGTTGGTTTAACGCG,ATGGGGTCCTAGGCAAAGATTGCAGACTTCGGGCTCGAGTGCTCAGGAGAGGTCTAGGAAAGCGCAGTGTTGGTGACATAGCTGATGGAAAAAAATTCT,10,30,14,27,27,35,27,50,27,32,32,35,47,50,54.45,0.0
hek293t,14997,1,15,CCACTATCATATGTTATTAGGCGTCCAAGAGGGTGCCGTTTTTCTTCAAGGAGCAGTAGAGTTGAGAAAAAAAATTCTAGTTGGTTTAACGCGTAACTA,CCACTATCATATGTTATTAGGCGTCCAAGAGGGTGCCTTTCACCAAGCGCACGTTTTTCTTCAAGGAGCAGTAGAGTTGAGAAAAAAAATTCTAGTTGG,10,30,14,27,27,41,27,56,27,38,38,41,53,56,46.06,0.0
hek293t,14998,1,15,GAGCTCCATCAGCCGTTTCCCAGCAGGAGCGGGAACACATCGTAGGACCTGTCTCTCTGTTTGATTTCCAAAAAAATTCTAGTTGGTTTAACGCGTAAC,GAGCTCCATCAGCCGTTTCCCAGCAGGAGATTACATTTCTTTAGCGGGAACACATCGTAGGACCTGTCTCTCTGTTTGATTTCCAAAAAAATTCTAGTT,10,30,14,27,27,39,27,54,27,29,29,39,44,54,46.33,10.21257491
hek293t,14998,1,15,CTGCTCCATCAGCCGTTTCCCAGCAGGAGCGGGAACACATCGTAGGACCTGTCTCTCTGTTTGAAAAAAAATTCTAGTTGGTTTAACGCGTAACTAGAT,CTGCTCCATCAGCCGTTTCCCAGCAGGAGATTACATTTCTTTAGCGGGAACACATCGTAGGACCTGTCTCTCTGTTTGAAAAAAAATTCTAGTTGGTTT,10,30,14,27,27,44,27,59,27,29,29,44,44,59,46.33,23.12409291
hek293t,15000,1,3,CCAAGTAGTTTTCATAGTACTGTGAATGTAGGTGGCTAGTTGGGAATAGTATCTGTTCATGACAAGAGGATGTCCAGTGTTCGAGAAAAAAATTCTAGT,CCAAGTAGTTTTCATAGTACTGTGAATTGGGTAGGTGGCTAGTTGGGAATAGTATCTGTTCATGACAAGAGGATGTCCAGTGTTCGAGAAAAAAATTCT,10,30,14,27,27,35,27,38,27,28,28,35,31,38,54.08,82.75953648
hek293t,15002,1,2,CCGGTGTCTGACAAAGAGGGTGCCTAACTTGGGCCCCTCAGTCATGCACATAAAGACTGGGGTTATTTTTACTCCAAAAAAATTCTAGTTGGTTTAACG,CCGGTGTCTGACAAAGAGGGTGCCTAACTTGGGCCCTCCTCAGTCATGCACATAAAGACTGGGGTTATTTTTACTCCAAAAAAATTCTAGTTGGTTTAA,10,30,14,27,27,46,27,48,27,36,36,46,38,48,19.67,68.8173021
hek293t,15002,1,2,CAGAAGTCTGACAAAGAGGGTGCCTAACTTGGGCCCCTCAGTCATGCACATAAAGACTGGGGTTATTTTTACTCCCTCAAAAAAATTCTAGTTGGTTTA,CAGAAGTCTGACAAAGAGGGTGCCTAACTTGGGCCCTCCTCAGTCATGCACATAAAGACTGGGGTTATTTTTACTCCCTCAAAAAAATTCTAGTTGGTT,10,30,14,27,27,43,27,45,27,36,36,43,38,45,19.67,52.11094416
hek293t,15004,1,15,CAAAAGTTTACTTTCATCTTCTCCGAGATCGGCTGCAACTTGCCCTCCCAGACAAAAGCTAATGCTCAAAAAAATTCTAGTTGGTTTAACGCGTAACTA,CAAAAGTTTACTTTCATCTTCTCCGAGATCGACCACTTTAGAGTAGGCTGCAACTTGCCCTCCCAGACAAAAGCTAATGCTCAAAAAAATTCTAGTTGG,10,30,14,27,27,41,27,56,27,31,31,41,46,56,13.37,5.045937697
hek293t,15004,1,15,TGCTAGTTTACTTTCATCTTCTCCGAGATCGGCTGCAACTTGCCCTCCCAGACAAAAGCTAATGCTCTGAAACAAAAAAAATTCTAGTTGGTTTAACGC,TGCTAGTTTACTTTCATCTTCTCCGAGATCGACCACTTTAGAGTAGGCTGCAACTTGCCCTCCCAGACAAAAGCTAATGCTCTGAAACAAAAAAAATTC,10,30,14,27,27,34,27,49,27,31,31,34,46,49,13.37,0.216450216
hek293t,15006,1,13,AGGTGAAACAGAGCTCCTGATCTGCTGATTGGATGCTTATTTCATGTCAAAATATGCCATTCTTTTTAACAGCCCAAAAAAATTCTAGTTGGTTTAACG,AGGTGAAACAGAGCTCCTGATCTGCTGATTGGCCAGCTGGGTCTGATGCTTATTTCATGTCAAAATATGCCATTCTTTTTAACAGCCCAAAAAAATTCT,10,30,14,27,27,35,27,48,27,32,32,35,45,48,55.94,0.178253119
hek293t,15006,1,13,ATGTCAAACAGAGCTCCTGATCTGCTGATTGGATGCTTATTTCATGTCAAAATATGCCATTCTTTTTAAAAAAAATTCTAGTTGGTTTAACGCGTAACT,ATGTCAAACAGAGCTCCTGATCTGCTGATTGGCCAGCTGGGTCTGATGCTTATTTCATGTCAAAATATGCCATTCTTTTTAAAAAAAATTCTAGTTGGT,10,30,14,27,27,42,27,55,27,32,32,42,45,55,55.94,7.463086845
hek293t,15008,1,8,AATCAACTTCTAGTTCTGTCAGGGAGCTATGGTGTAGACGGTTAAGTAGCTGAAAATAGCATTGGTTTGCAAAAAAAATTCTAGTTGGTTTAACGCGTA,AATCAACTTCTAGTTCTGTCAGGGAGCTATGGTGTAGACGGCCTCGAAGTTAAGTAGCTGAAAATAGCATTGGTTTGCAAAAAAAATTCTAGTTGGTTT,10,30,14,27,27,44,27,52,27,41,41,44,49,52,57.54,0.558419244
hek293t,15009,1,9,ATGAGGTCAGGTGTGAACAGCAGGATATGTGGATACGTGACTGCACATTTTGTTCACAGAGAGGCAGATATTATTGAAAAAAATTCTAGTTGGTTTAAC,ATGAGGTCAGGTGTGAACAGCAGGATATGTCCAAGGTACGGATACGTGACTGCACATTTTGTTCACAGAGAGGCAGATATTATTGAAAAAAATTCTAGT,10,30,14,27,27,38,27,47,27,31,31,38,40,47,61.91,21.8389272
hek293t,15009,1,9,AATATGTCAGGTGTGAACAGCAGGATATGTGGATACGTGACTGCACATTTTGTTCACAGAGAGGCAGAAAAAAAATTCTAGTTGGTTTAACGCGTAACT,AATATGTCAGGTGTGAACAGCAGGATATGTCCAAGGTACGGATACGTGACTGCACATTTTGTTCACAGAGAGGCAGAAAAAAAATTCTAGTTGGTTTAA,10,30,14,27,27,46,27,55,27,31,31,46,40,55,61.91,39.01632573
hek293t,15011,1,2,AGCTAAAGCACAGTCACAGCATAAGAACTAGGTAAACAGGATTTGTCGTGGACCAGCTGGCCTCAGTGATAAAAAAATTCTAGTTGGTTTAACGCGTAA,AGCTAAAGCACAGTCACAGCATAAGAACTAGGTAAGGACAGGATTTGTCGTGGACCAGCTGGCCTCAGTGATAAAAAAATTCTAGTTGGTTTAACGCGT,10,30,14,27,27,51,27,53,27,36,36,51,38,53,71.93,40.92151695
hek293t,15011,1,2,CTAAAAAGCACAGTCACAGCATAAGAACTAGGTAAACAGGATTTGTCGTGGACCAGCTGGCCTCAGTGATAGCATAAAAAAATTCTAGTTGGTTTAACG,CTAAAAAGCACAGTCACAGCATAAGAACTAGGTAAGGACAGGATTTGTCGTGGACCAGCTGGCCTCAGTGATAGCATAAAAAAATTCTAGTTGGTTTAA,10,30,14,27,27,46,27,48,27,36,36,46,38,48,71.93,44.86758782
hek293t,15013,1,15,ACGGGGTGTGTGCACGGCGCAGTTCCCAGTGGTGCTGTGTGAGAGGCCCTCACTGCAAACGCCTGTAAAAAAATTCTAGTTGGTTTAACGCGTAACTAG,ACGGGGTGTGTGCACGGCGCAGTTCCCAGTGGTGCTGTGAACGATTAACAAATGTGAGAGGCCCTCACTGCAAACGCCTGTAAAAAAATTCTAGTTGGT,10,30,14,27,27,42,27,57,27,39,39,42,54,57,67.99,0.555555556
hek293t,15014,1,13,TCGGGGGATTGGCTTAACAGGCATCCAGTAGGTATTATTGTATGCCATAAGTTTTGCTTTCCTTAGAAAAAAAATTCTAGTTGGTTTAACGCGTAACTA,TCGGGGGATTGGCTTAACAGGCATCCAGTAGGTATTATTACCAGCAGCAAAGGTATGCCATAAGTTTTGCTTTCCTTAGAAAAAAAATTCTAGTTGGTT,10,30,14,27,27,43,27,56,27,40,40,43,53,56,56.01,0.0
hek293t,15015,1,5,ACACACTTCTGTTGTGAGAGTAGGACCTGTGGAAATAAAAGCATCCAACATCCTGATACCTACATGTAAAAAAAATTCTAGTTGGTTTAACGCGTAACT,ACACACTTCTGTTGTGAGAGTAGGACCTGTGGAAATAAAAAAGCAGCATCCAACATCCTGATACCTACATGTAAAAAAAATTCTAGTTGGTTTAACGCG,10,30,14,27,27,50,27,55,27,40,40,50,45,55,52.36,1.001404854
hek293t,15016,1,5,TCACGTGAGAAGTGACTGGGAATGAGTTGTGGAGCAGAAGGCGGAAGCAGTTTATGTAGCCAGACTAGAGAATGAGCACAAAAAAAAATTCTAGTTGGT,TCACGTGAGAAGTGACTGGGAATGAGTCGGTTTGTGGAGCAGAAGGCGGAAGCAGTTTATGTAGCCAGACTAGAGAATGAGCACAAAAAAAAATTCTAG,10,30,14,27,27,37,27,42,27,27,27,37,32,42,49.3,71.65177139
hek293t,15016,1,5,TAGTCTGAGAAGTGACTGGGAATGAGTTGTGGAGCAGAAGGCGGAAGCAGTTTATGTAGCCAGACTAGAGAATGAGCACAAAAGATGTAAAAAAATTCT,TAGTCTGAGAAGTGACTGGGAATGAGTCGGTTTGTGGAGCAGAAGGCGGAAGCAGTTTATGTAGCCAGACTAGAGAATGAGCACAAAAGATGTAAAAAA,10,30,14,27,27,30,27,35,27,27,27,30,32,35,49.3,1.22605364
hek293t,15018,1,12,AGATTACAGTTCTGTTCTCAGATGGGGGCAGGCTGCAGTTATTATCTATAGGTGTAAACAGTCCTCTGCTGCAAAAAAATTCTAGTTGGTTTAACGCGT,AGATTACAGTTCTGTTCTCAGATGGGGGTCCTCGAAATGCCAGGCTGCAGTTATTATCTATAGGTGTAAACAGTCCTCTGCTGCAAAAAAATTCTAGTT,10,30,14,27,27,39,27,51,27,29,29,39,41,51,22.12,7.230046154
hek293t,15018,1,12,CCAAGACAGTTCTGTTCTCAGATGGGGGCAGGCTGCAGTTATTATCTATAGGTGTAAACAGTCCTCTGCTGCCCAAAAGAAAAAAATTCTAGTTGGTTT,CCAAGACAGTTCTGTTCTCAGATGGGGGTCCTCGAAATGCCAGGCTGCAGTTATTATCTATAGGTGTAAACAGTCCTCTGCTGCCCAAAAGAAAAAAAT,10,30,14,27,27,32,27,44,27,29,29,32,41,44,22.12,0.0
hek293t,15020,1,5,ACCGGATAGCGTATTATTTTGTGTTGCTATGGTGTAAAATGGGTAGAAATCATGAATAGAGGTTTCTGGGTTGTTTAGAGTACTAAAAAAATTCTAGTT,ACCGGATAGCGTATTATTTTGTGTTGTAATGCTATGGTGTAAAATGGGTAGAAATCATGAATAGAGGTTTCTGGGTTGTTTAGAGTACTAAAAAAATTC,10,30,14,27,27,34,27,39,27,27,27,34,32,39,6.5,4.913133452
hek293t,15022,1,4,CCTTCATGTGGTAAATGTAGTGTGTACTGTGGTTTTGGTAAGGAAGTCACGTGCTGGTGGCAGGGTGCCCCTGTAAAAAAATTCTAGTTGGTTTAACGC,CCTTCATGTGGTAAATGTAGTGTGTACTGTGGTTCGTTTTGGTAAGGAAGTCACGTGCTGGTGGCAGGGTGCCCCTGTAAAAAAATTCTAGTTGGTTTA,10,30,14,27,27,45,27,49,27,35,35,45,39,49,68.02,60.19929283
hek293t,15022,1,4,TCTACATGTGGTAAATGTAGTGTGTACTGTGGTTTTGGTAAGGAAGTCACGTGCTGGTGGCAGGGTGCCCCTGTTTGAAAAAAATTCTAGTTGGTTTAA,TCTACATGTGGTAAATGTAGTGTGTACTGTGGTTCGTTTTGGTAAGGAAGTCACGTGCTGGTGGCAGGGTGCCCCTGTTTGAAAAAAATTCTAGTTGGT,10,30,14,27,27,42,27,46,27,35,35,42,39,46,68.02,75.56232738
hek293t,15024,1,6,AGAGGTAACATTTCATGCAGCTTGTAGGATGGAGTGTATAATTTATATAAAGTCATGGTTATTCAGCAGTGTTTATTCAAAAAAATTCTAGTTGGTTTA,AGAGGTAACATTTCATGCAGCTTGTAGGTAAATTATGGAGTGTATAATTTATATAAAGTCATGGTTATTCAGCAGTGTTTATTCAAAAAAATTCTAGTT,10,30,14,27,27,39,27,45,27,29,29,39,35,45,50.65,19.55797137
hek293t,15024,1,6,GAGCATAACATTTCATGCAGCTTGTAGGATGGAGTGTATAATTTATATAAAGTCATGGTTATTCAGCAGTGTTTATTCCTGAAAAAAATTCTAGTTGGT,GAGCATAACATTTCATGCAGCTTGTAGGTAAATTATGGAGTGTATAATTTATATAAAGTCATGGTTATTCAGCAGTGTTTATTCCTGAAAAAAATTCTA,10,30,14,27,27,36,27,42,27,29,29,36,35,42,50.65,20.21106534
hek293t,15026,1,10,TCCTCTAACAGTACCACATTGTTCCTAGCAGGTTAAAGGACTGAAATAATGGATTTGAAAGGAGGTTGGTAGAGAGAAAAAAAAATTCTAGTTGGTTTA,TCCTCTAACAGTACCACATTGTTCCTAGTAGGGGACAGCAGGTTAAAGGACTGAAATAATGGATTTGAAAGGAGGTTGGTAGAGAGAAAAAAAAATTCT,10,30,14,27,27,35,27,45,27,28,28,35,38,45,26.7,1.405501676
hek293t,15026,1,10,GATTGTAACAGTACCACATTGTTCCTAGCAGGTTAAAGGACTGAAATAATGGATTTGAAAGGAGGTTGGTAGAGAGAAAACTAAAAAAATTCTAGTTGG,GATTGTAACAGTACCACATTGTTCCTAGTAGGGGACAGCAGGTTAAAGGACTGAAATAATGGATTTGAAAGGAGGTTGGTAGAGAGAAAACTAAAAAAA,10,30,14,27,27,31,27,41,27,28,28,31,38,41,26.7,0.201612903
hek293t,15032,1,8,TTTGGCAGTGAATGTACTGCCACAGGTGCTGGAAAACTCATTACATATTTAGTTGGGTTAAAAGAAAAACATTGCCAAAAAAATTCTAGTTGGTTTAAC,TTTGGCAGTGAATGTACTGCCACAGGTGCTGGAAATCAGGGTCACTCATTACATATTTAGTTGGGTTAAAAGAAAAACATTGCCAAAAAAATTCTAGTT,10,30,14,27,27,39,27,47,27,36,36,39,44,47,39.51,0.098328417
hek293t,15032,1,8,AGTAGCAGTGAATGTACTGCCACAGGTGCTGGAAAACTCATTACATATTTAGTTGGGTTAAAAGAAAAAAATTCTAGTTGGTTTAACGCGTAACTAGAT,AGTAGCAGTGAATGTACTGCCACAGGTGCTGGAAATCAGGGTCACTCATTACATATTTAGTTGGGTTAAAAGAAAAAAATTCTAGTTGGTTTAACGCGT,10,30,14,27,27,51,27,59,27,36,36,51,44,59,39.51,5.166899617
hek293t,15034,1,14,AAGAGCTTCTGGAACAAAGCGCTGTGTTCAGGCTGCAGTAGAATTTACCATTGAAGGATTGCTATGAATTCCTAAAAAAATTCTAGTTGGTTTAACGCG,AAGAGCTTCTGGAACAAAGCGCTGTGTTAGCAGCATCGAGTTCAGGCTGCAGTAGAATTTACCATTGAAGGATTGCTATGAATTCCTAAAAAAATTCTA,10,30,14,27,27,36,27,50,27,29,29,36,43,50,26.59,3.012059117
hek293t,15034,1,14,AGAGGCTTCTGGAACAAAGCGCTGTGTTCAGGCTGCAGTAGAATTTACCATTGAAGGATTGCTATGAATTAAAAAAATTCTAGTTGGTTTAACGCGTAA,AGAGGCTTCTGGAACAAAGCGCTGTGTTAGCAGCATCGAGTTCAGGCTGCAGTAGAATTTACCATTGAAGGATTGCTATGAATTAAAAAAATTCTAGTT,10,30,14,27,27,39,27,53,27,29,29,39,43,53,26.59,6.803100217
hek293t,15036,1,3,TTGTAAAATAGTTCTGTTTCAGCAGAAATAGGAAAACTCATTCTAACAGTGAATGGAGTACTCAGATTATTCTCAAAACACAAAAAAAATTCTAGTTGG,TTGTAAAATAGTTCTGTTTCAGCAGAAGAAATAGGAAAACTCATTCTAACAGTGAATGGAGTACTCAGATTATTCTCAAAACACAAAAAAAATTCTAGT,10,30,14,27,27,38,27,41,27,28,28,38,31,41,18.07,17.79138527
hek293t,15036,1,3,AGCCGAAATAGTTCTGTTTCAGCAGAAATAGGAAAACTCATTCTAACAGTGAATGGAGTACTCAGATTATTCTCAAAACACACTACAAAAAAAAAATTC,AGCCGAAATAGTTCTGTTTCAGCAGAAGAAATAGGAAAACTCATTCTAACAGTGAATGGAGTACTCAGATTATTCTCAAAACACACTACAAAAAAAAAA,10,30,14,27,27,31,27,34,27,28,28,31,31,34,18.07,1.408004494
hek293t,15038,1,14,AGGCCAGAGGAAAACCAGCTCTTTGCAGCTGGTGAGCTAATTCAAGCATCAGAGCAGTGGCAGTGTCTCCCTTGAAAAAAATTCTAGTTGGTTTAACGC,AGGCCAGAGGAAAACCAGCTCTTTGCAGCTGGTGCACAGAGAGTCGTGAGCTAATTCAAGCATCAGAGCAGTGGCAGTGTCTCCCTTGAAAAAAATTCT,10,30,14,27,27,35,27,49,27,32,32,35,46,49,15.87,0.0
hek293t,15039,1,3,CATTGGCAGATGCTGAAGGCAGCTCAGAATGGAAGCTATAAAGTAACGGCAATGAATACTGGAGGGAGATAATGGGCACGCTAAAAAAATTCTAGTTGG,CATTGGCAGATGCTGAAGGCAGCTCAGAATGGAAGCAGCTATAAAGTAACGGCAATGAATACTGGAGGGAGATAATGGGCACGCTAAAAAAATTCTAGT,10,30,14,27,27,38,27,41,27,35,35,38,38,41,48.16,0.0
hek293t,15039,1,3,ATTCCGCAGATGCTGAAGGCAGCTCAGAATGGAAGCTATAAAGTAACGGCAATGAATACTGGAGGGAGATAATGGGCAAAAAAAATTCTAGTTGGTTTA,ATTCCGCAGATGCTGAAGGCAGCTCAGAATGGAAGCAGCTATAAAGTAACGGCAATGAATACTGGAGGGAGATAATGGGCAAAAAAAATTCTAGTTGGT,10,30,14,27,27,42,27,45,27,35,35,42,38,45,48.16,5.446559845
hek293t,15041,1,4,TTGTTTCATAATCCTGGGGTGGAATATAGGGGATGAATTCTTTGGGATCAAAATTCTATTGCCAAAAAAAATTCTAGTTGGTTTAACGCGTAACTAGAT,TTGTTTCATAATCCTGGGGTGGAATATAGGGGATGAATTCTTACTTTGGGATCAAAATTCTATTGCCAAAAAAAATTCTAGTTGGTTTAACGCGTAACT,10,30,14,27,27,55,27,59,27,40,40,55,44,59,45.78,2.853366349
hek293t,15041,1,4,CTGTCTCATAATCCTGGGGTGGAATATAGGGGATGAATTCTTTGGGATCAAAATTCTATTGCCAGAACTAAAAAAAAAATTCTAGTTGGTTTAACGCGT,CTGTCTCATAATCCTGGGGTGGAATATAGGGGATGAATTCTTACTTTGGGATCAAAATTCTATTGCCAGAACTAAAAAAAAAATTCTAGTTGGTTTAAC,10,30,14,27,27,47,27,51,27,40,40,47,44,51,45.78,2.317693568
hek293t,15043,1,5,CGCCACTTGCCCTTTCCTCGGGAATTGCTTGGCCCTCCACATCTTTCCTCCGCTCTGCAGTAGCTCTGGCAGTGAAGGACAAAAAAAATTCTAGTTGGT,CGCCACTTGCCCTTTCCTCGGGAATTGCTAAATGTGGCCCTCCACATCTTTCCTCCGCTCTGCAGTAGCTCTGGCAGTGAAGGACAAAAAAAATTCTAG,10,30,14,27,27,37,27,42,27,30,30,37,35,42,15.51,26.58121273
hek293t,15043,1,5,TCGTGCTTGCCCTTTCCTCGGGAATTGCTTGGCCCTCCACATCTTTCCTCCGCTCTGCAGTAGCTCTGGCAGTGAAGGACACCCTAAAAAAATTCTAGT,TCGTGCTTGCCCTTTCCTCGGGAATTGCTAAATGTGGCCCTCCACATCTTTCCTCCGCTCTGCAGTAGCTCTGGCAGTGAAGGACACCCTAAAAAAATT,10,30,14,27,27,33,27,38,27,30,30,33,35,38,15.51,2.069518717
hek293t,15045,1,3,CGGATGAATAAATGGCATGTTTTATTATTAGGGTCCACACAGACTGCCAGTTTGAACTTGTGATCTTTACTCAAAAAAATTCTAGTTGGTTTAACGCGT,CGGATGAATAAATGGCATGTTTTATTATTAGGGTTGTCCACACAGACTGCCAGTTTGAACTTGTGATCTTTACTCAAAAAAATTCTAGTTGGTTTAACG,10,30,14,27,27,48,27,51,27,33,33,48,36,51,0.07,30.60807879
hek293t,15047,1,3,CCTTTCAATAATGCAAAGTTATATAAATACGGGAGTTATCCAAATGTTGCACTCCTGCTGTTAAAGAATGGGTCTCATTTAAAAAAATTCTAGTTGGTT,CCTTTCAATAATGCAAAGTTATATAAATACCGCGGGAGTTATCCAAATGTTGCACTCCTGCTGTTAAAGAATGGGTCTCATTTAAAAAAATTCTAGTTG,10,30,14,27,27,40,27,43,27,30,30,40,33,43,23.24,1.222816514
hek293t,15047,1,3,AGTCGCAATAATGCAAAGTTATATAAATACGGGAGTTATCCAAATGTTGCACTCCTGCTGTTAAAGAATGGGTCTAAAAAAATTCTAGTTGGTTTAACG,AGTCGCAATAATGCAAAGTTATATAAATACCGCGGGAGTTATCCAAATGTTGCACTCCTGCTGTTAAAGAATGGGTCTAAAAAAATTCTAGTTGGTTTA,10,30,14,27,27,45,27,48,27,30,30,45,33,48,23.24,1.738913196
hek293t,15049,1,11,CAGATAGCTAATTGCTATTTTATAAACAAAGGATTTATACTAAGCACATCTCTTTCCAAATTATTGTTAAAAAAATTCTAGTTGGTTTAACGCGTAACT,CAGATAGCTAATTGCTATTTTATAAACAAAGGATTTATACGCGGAGGGGAATAAGCACATCTCTTTCCAAATTATTGTTAAAAAAATTCTAGTTGGTTT,10,30,14,27,27,44,27,55,27,41,41,44,52,55,18.23,0.0
hek293t,15051,1,2,TCTCAGGTACAGGGTAGTGTTTTTTATTTTGGTCAAGGATAGTATTGTGTGACATAATCATTATTACTATGACACTGTGTTAAAAAAATTCTAGTTGGT,TCTCAGGTACAGGGTAGTGTTTTTTATTTTGGGGTCAAGGATAGTATTGTGTGACATAATCATTATTACTATGACACTGTGTTAAAAAAATTCTAGTTG,10,30,14,27,27,40,27,42,27,33,33,40,35,42,-1.09,6.107354615
hek293t,15051,1,2,AGTTAGGTACAGGGTAGTGTTTTTTATTTTGGTCAAGGATAGTATTGTGTGACATAATCATTATTACTATGACACTGTAAAAAAATTCTAGTTGGTTTA,AGTTAGGTACAGGGTAGTGTTTTTTATTTTGGGGTCAAGGATAGTATTGTGTGACATAATCATTATTACTATGACACTGTAAAAAAATTCTAGTTGGTT,10,30,14,27,27,43,27,45,27,33,33,43,35,45,-1.09,1.614299093
hek293t,15053,1,4,GATAGCCTCCCACCAAATATTTTGCTGCTTGGCTTGGTTCAAGCCTTTTGTTTCAGTGGGATACAGCCTTCTTTGACAGCAGAAAAAAAAAATTCTAGT,GATAGCCTCCCACCAAATATTTTGCTGTGGGCTTGGCTTGGTTCAAGCCTTTTGTTTCAGTGGGATACAGCCTTCTTTGACAGCAGAAAAAAAAAATTC,10,30,14,27,27,34,27,38,27,27,27,34,31,38,11.54,0.0
hek293t,15055,1,7,GGGCACACAAGCGAGAAAATATATTTCCAAGGACTAACATAAAAATGAAGTGGAATCTTTCTTGGTGATGGCTAAATAAAAAAATTCTAGTTGGTTTAA,GGGCACACAAGCGAGAAAATATATTTCCAAGGACTTCCCGGGAACATAAAAATGAAGTGGAATCTTTCTTGGTGATGGCTAAATAAAAAAATTCTAGTT,10,30,14,27,27,39,27,46,27,36,36,39,43,46,34.14,0.0
hek293t,15055,1,7,GTTAACACAAGCGAGAAAATATATTTCCAAGGACTAACATAAAAATGAAGTGGAATCTTTCTTGGTGATGAAAAAAATTCTAGTTGGTTTAACGCGTAA,GTTAACACAAGCGAGAAAATATATTTCCAAGGACTTCCCGGGAACATAAAAATGAAGTGGAATCTTTCTTGGTGATGAAAAAAATTCTAGTTGGTTTAA,10,30,14,27,27,46,27,53,27,36,36,46,43,53,34.14,0.071073205
hek293t,15057,1,12,TCTCGTCCAGACTCTGCTTGGAAAATCTGGGGCCATTTGGAAATCATCTCCAGGAGGTTTATTTTATTTCTCAAAAAAATTCTAGTTGGTTTAACGCGT,TCTCGTCCAGACTCTGCTTGGAAAATCTGCGCCAACTTGCGGGGCCATTTGGAAATCATCTCCAGGAGGTTTATTTTATTTCTCAAAAAAATTCTAGTT,10,30,14,27,27,39,27,51,27,29,29,39,41,51,58.5,30.47541704
hek293t,15059,1,9,AACGCATGTGTGATTAGGAGGAAAAAGGAAGGAACTGGAGTAGATTCAGCTGTCTAAATTCAATGAAGAAAAAAATTCTAGTTGGTTTAACGCGTAACT,AACGCATGTGTGATTAGGAGGAAAAAGGAAGGAACCAAAAAATCTGGAGTAGATTCAGCTGTCTAAATTCAATGAAGAAAAAAATTCTAGTTGGTTTAA,10,30,14,27,27,46,27,55,27,36,36,46,45,55,66.87,0.026434047
hek293t,15059,1,9,GCAGTATGTGTGATTAGGAGGAAAAAGGAAGGAACTGGAGTAGATTCAGCTGTCTAAATTCAATGAAGAATAGATAAAAAAATTCTAGTTGGTTTAACG,GCAGTATGTGTGATTAGGAGGAAAAAGGAAGGAACCAAAAAATCTGGAGTAGATTCAGCTGTCTAAATTCAATGAAGAATAGATAAAAAAATTCTAGTT,10,30,14,27,27,39,27,48,27,36,36,39,45,48,66.87,0.0
hek293t,15061,1,11,AAGTGAGCCCAGACACGTAACCAGCACCGGGGCTGTGGGAGCCCTGGAGACCAGCTGGGGTATTAACATCCAAAAAAATTCTAGTTGGTTTAACGCGTA,AAGTGAGCCCAGACACGTAACCAGCACCGGGGCCGTTTCTTTTGTGTGGGAGCCCTGGAGACCAGCTGGGGTATTAACATCCAAAAAAATTCTAGTTGG,10,30,14,27,27,41,27,52,27,34,34,41,45,52,83.21,9.831163954
hek293t,15062,1,1,TTTCATGAAAGTAACATCTAGTTAAAGCTTGGCATATATGAATGTTTGAAGAACTCTAACTGAATCATGATATAAAAAGGAGAAAAAAATTCTAGTTGG,TTTCATGAAAGTAACATCTAGTTAAAGCTTGGCATAATATGAATGTTTGAAGAACTCTAACTGAATCATGATATAAAAAGGAGAAAAAAATTCTAGTTG,10,30,14,27,27,40,27,41,27,37,37,40,38,41,50.46,17.20125211
hek293t,15062,1,1,AACATTGAAAGTAACATCTAGTTAAAGCTTGGCATATATGAATGTTTGAAGAACTCTAACTGAATCATGATATAAAAAAAAAAAATTCTAGTTGGTTTA,AACATTGAAAGTAACATCTAGTTAAAGCTTGGCATAATATGAATGTTTGAAGAACTCTAACTGAATCATGATATAAAAAAAAAAAATTCTAGTTGGTTT,10,30,14,27,27,44,27,45,27,37,37,44,38,45,50.46,6.062364709
hek293t,15064,1,13,CCTTGAATGTTAATTTGTATCAATTAAGATGGCAGAGGATACTTTAAGATGCTATTCCAGATCATAAAAAAATTCTAGTTGGTTTAACGCGTAACTAGA,CCTTGAATGTTAATTTGTATCAATTAAGATGGCATGCTTAGCTTGCGGAGGATACTTTAAGATGCTATTCCAGATCATAAAAAAATTCTAGTTGGTTTA,10,30,14,27,27,45,27,58,27,35,35,45,48,58,19.55,1.259171378
hek293t,15064,1,13,GGAGCAATGTTAATTTGTATCAATTAAGATGGCAGAGGATACTTTAAGATGCTATTCCAGATCATACTAAAAAAATTCTAGTTGGTTTAACGCGTAACT,GGAGCAATGTTAATTTGTATCAATTAAGATGGCATGCTTAGCTTGCGGAGGATACTTTAAGATGCTATTCCAGATCATACTAAAAAAATTCTAGTTGGT,10,30,14,27,27,42,27,55,27,35,35,42,48,55,19.55,0.35914343
hek293t,15066,1,12,CCTCCCCTCCAATTGCCAGTTCTCTACTAAGGTATATGAGGCCCAATTTCACCATGTGCTGGGCCTAAAAAAATTCTAGTTGGTTTAACGCGTAACTAG,CCTCCCCTCCAATTGCCAGTTCTCTACTACCTTTATTTGTTAGGTATATGAGGCCCAATTTCACCATGTGCTGGGCCTAAAAAAATTCTAGTTGGTTTA,10,30,14,27,27,45,27,57,27,30,30,45,42,57,46.49,22.02093889
hek293t,15066,1,12,ACGAGCCTCCAATTGCCAGTTCTCTACTAAGGTATATGAGGCCCAATTTCACCATGTGCTGGGCCTTTTCTTTGAGAAAAAAAAATTCTAGTTGGTTTA,ACGAGCCTCCAATTGCCAGTTCTCTACTACCTTTATTTGTTAGGTATATGAGGCCCAATTTCACCATGTGCTGGGCCTTTTCTTTGAGAAAAAAAAATT,10,30,14,27,27,33,27,45,27,30,30,33,42,45,46.49,0.085689803
hek293t,15068,1,14,AAAACCATTTACCCCAGTATGCTCTCTCCTGGCAGCTTTACACCACATGAAGTTCTTTCTCAGAGAAAAAAAAATTCTAGTTGGTTTAACGCGTAACTA,AAAACCATTTACCCCAGTATGCTCTCTCCTGGCAAGCATAACTTTCACGCTTTACACCACATGAAGTTCTTTCTCAGAGAAAAAAAAATTCTAGTTGGT,10,30,14,27,27,42,27,56,27,35,35,42,49,56,60.93,0.0
hek293t,15070,1,7,GGGAATTTGATTCCCCCCCCCTAATTAATTGGGCACCCTAGAACATTTTCAACAAGAATTGGCTATATATTTTCATGTCATAAAAAAATTCTAGTTGGT,GGGAATTTGATTCCCCCCCCCTAATTAGATGAGAATTGGGCACCCTAGAACATTTTCAACAAGAATTGGCTATATATTTTCATGTCATAAAAAAATTCT,10,30,14,27,27,35,27,42,27,28,28,35,35,42,4.24,2.613370236
hek293t,15072,1,11,AGTGCCCATCATTTTCTGGCAAACTTAAAAGGTTCATTTGCATCTGTAAGACAGAAATTTTAAGTATAAAAAAAATTCTAGTTGGTTTAACGCGTAACT,AGTGCCCATCATTTTCTGGCAAACTTAAAAGGTTCAGGAAACCGTCTTTTGCATCTGTAAGACAGAAATTTTAAGTATAAAAAAAATTCTAGTTGGTTT,10,30,14,27,27,44,27,55,27,37,37,44,48,55,0.8,0.018066847
hek293t,15072,1,11,CGGCCCCATCATTTTCTGGCAAACTTAAAAGGTTCATTTGCATCTGTAAGACAGAAATTTTAAGTAAAAAAATTCTAGTTGGTTTAACGCGTAACTAGA,CGGCCCCATCATTTTCTGGCAAACTTAAAAGGTTCAGGAAACCGTCTTTTGCATCTGTAAGACAGAAATTTTAAGTAAAAAAATTCTAGTTGGTTTAAC,10,30,14,27,27,47,27,58,27,37,37,47,48,58,0.8,0.024509804
hek293t,15074,1,11,CAGTCGTTCCCTTACTCACATGGGTGAGCTGGCTGTTTAGGCTCTAATTTAAAATATGAGCAAATTTTGAGGGCAAAAAAAATTCTAGTTGGTTTAACG,CAGTCGTTCCCTTACTCACATGGGTGAGCTGGCTACCCTTAACATGTTTAGGCTCTAATTTAAAATATGAGCAAATTTTGAGGGCAAAAAAAATTCTAG,10,30,14,27,27,37,27,48,27,34,34,37,45,48,40.22,0.0
hek293t,15075,1,15,TCTTTGTTTTAGCGTCTTAATCTTGTCATCGGGATTGTAACGAACCCCACCCCCCGATATTGGATCAAAAAAAATTCTAGTTGGTTTAACGCGTAACTA,TCTTTGTTTTAGCGTCTTAATCTTGTCATCGGGACAGTTGCCTTGCCGATTGTAACGAACCCCACCCCCCGATATTGGATCAAAAAAAATTCTAGTTGG,10,30,14,27,27,41,27,56,27,34,34,41,49,56,11.74,0.0
hek293t,15076,1,2,CTACTGGCTTTGAAAAGCAAAGTGCCATTTGGTATCATAAGTGCATATAAAAGATAATATTGTTGAAACAGTAGAGGTGTATAAGAAAAAAATTCTAGT,CTACTGGCTTTGAAAAGCAAAGTGCCATTTTTGGTATCATAAGTGCATATAAAAGATAATATTGTTGAAACAGTAGAGGTGTATAAGAAAAAAATTCTA,10,30,14,27,27,36,27,38,27,29,29,36,31,38,15.0,44.81882008
hek293t,15076,1,2,TTGTGGGCTTTGAAAAGCAAAGTGCCATTTGGTATCATAAGTGCATATAAAAGATAATATTGTTGAAACAGTAGAGGTGTATAAAAAAATTCTAGTTGG,TTGTGGGCTTTGAAAAGCAAAGTGCCATTTTTGGTATCATAAGTGCATATAAAAGATAATATTGTTGAAACAGTAGAGGTGTATAAAAAAATTCTAGTT,10,30,14,27,27,39,27,41,27,29,29,39,31,41,15.0,54.5691529
hek293t,15079,1,3,GCAACCGCCTCCTCACTGCAAAATCCAGCAGGGCAAGTTCTGTTAGCAGCGTAGTCGTCACTGCTGCAACACCTAAAAAAATTCTAGTTGGTTTAACGC,GCAACCGCCTCCTCACTGCAAAATCCAGCATTGGGGCAAGTTCTGTTAGCAGCGTAGTCGTCACTGCTGCAACACCTAAAAAAATTCTAGTTGGTTTAA,10,30,14,27,27,46,27,49,27,31,31,46,34,49,24.71,27.89050059
hek293t,15079,1,3,AGACGCGCCTCCTCACTGCAAAATCCAGCAGGGCAAGTTCTGTTAGCAGCGTAGTCGTCACTGCTGCAACACCTGCCCCAAAAAAATTCTAGTTGGTTT,AGACGCGCCTCCTCACTGCAAAATCCAGCATTGGGGCAAGTTCTGTTAGCAGCGTAGTCGTCACTGCTGCAACACCTGCCCCAAAAAAATTCTAGTTGG,10,30,14,27,27,41,27,44,27,31,31,41,34,44,24.71,33.01258407
hek293t,15081,1,4,ATTTCAATGCGTTTCAAAGTTTAGTTTTTAGGGACTCAAAACTTAATTAAATCTTGAATGTTTGTGGGAAATAGGCACAAAAAAATTCTAGTTGGTTTA,ATTTCAATGCGTTTCAAAGTTTAGTTTTTAGGGACGCACTCAAAACTTAATTAAATCTTGAATGTTTGTGGGAAATAGGCACAAAAAAATTCTAGTTGG,10,30,14,27,27,41,27,45,27,34,34,41,38,45,-4.23,0.0
hek293t,15083,1,1,CGTCTTGCTTGTGGGAGCATCTGACTGCCAGGGCTTCTTCAAATAGGCATTTATTTCAGTTTTTACATATGTTTAGGTCTGACAAAAAAATTCTAGTTG,CGTCTTGCTTGTGGGAGCATCTGACTGCCAGGGCTGTCTTCAAATAGGCATTTATTTCAGTTTTTACATATGTTTAGGTCTGACAAAAAAATTCTAGTT,10,30,14,27,27,39,27,40,27,36,36,39,37,40,31.15,0.122324159
hek293t,15083,1,1,CTCAATGCTTGTGGGAGCATCTGACTGCCAGGGCTTCTTCAAATAGGCATTTATTTCAGTTTTTACATATGAAAAAAATTCTAGTTGGTTTAACGCGTA,CTCAATGCTTGTGGGAGCATCTGACTGCCAGGGCTGTCTTCAAATAGGCATTTATTTCAGTTTTTACATATGAAAAAAATTCTAGTTGGTTTAACGCGT,10,30,14,27,27,51,27,52,27,36,36,51,37,52,31.15,72.13852993
hek293t,15085,1,5,ACGCCTCTTCCACCAACGGTTTTTCTGCATGGAAAAAATGCATTAAAATTCACATTAGCAAATGCCAGACTTGGAAGTAAAAAAATTCTAGTTGGTTTA,ACGCCTCTTCCACCAACGGTTTTTCTGCATGGAAAAAATACAATGCATTAAAATTCACATTAGCAAATGCCAGACTTGGAAGTAAAAAAATTCTAGTTG,10,30,14,27,27,40,27,45,27,37,37,40,42,45,19.05,0.0
hek293t,15085,1,5,GGTAGTCTTCCACCAACGGTTTTTCTGCATGGAAAAAATGCATTAAAATTCACATTAGCAAATGCCAGACTTGGAAAAAAATTCTAGTTGGTTTAACGC,GGTAGTCTTCCACCAACGGTTTTTCTGCATGGAAAAAATACAATGCATTAAAATTCACATTAGCAAATGCCAGACTTGGAAAAAAATTCTAGTTGGTTT,10,30,14,27,27,44,27,49,27,37,37,44,42,49,19.05,0.0
hek293t,15087,1,10,CCTTCTGTTTAGAAATTGAGCACAACATATGGGAAAATGTTGTCTAGAACCCATGATGTTACTTGTATACAATACGAAAAAAATTCTAGTTGGTTTAAC,CCTTCTGTTTAGAAATTGAGCACAACATGATCCGTTATATGGGAAAATGTTGTCTAGAACCCATGATGTTACTTGTATACAATACGAAAAAAATTCTAG,10,30,14,27,27,37,27,47,27,27,27,37,37,47,10.62,0.778524343
hek293t,15087,1,10,TACGATGTTTAGAAATTGAGCACAACATATGGGAAAATGTTGTCTAGAACCCATGATGTTACTTGTATACAATACGTTAAAAAAAATTCTAGTTGGTTT,TACGATGTTTAGAAATTGAGCACAACATGATCCGTTATATGGGAAAATGTTGTCTAGAACCCATGATGTTACTTGTATACAATACGTTAAAAAAAATTC,10,30,14,27,27,34,27,44,27,27,27,34,37,44,10.62,0.0
hek293t,15089,1,13,ACTTAATCATCGCGGAGCAACCAACCACAAGGGGAGCGGAGGTGCGCGGCCGCCATGCTGGCTGCGGGCAAAAAAATTCTAGTTGGTTTAACGCGTAAC,ACTTAATCATCGCGGAGCAACCAACCACAAGGGACCCTGAGTCGGTGAGCGGAGGTGCGCGGCCGCCATGCTGGCTGCGGGCAAAAAAATTCTAGTTGG,10,30,14,27,27,41,27,54,27,34,34,41,47,54,53.99,0.754457651
hek293t,15089,1,13,TAAAGATCATCGCGGAGCAACCAACCACAAGGGGAGCGGAGGTGCGCGGCCGCCATGCTGGCTGCGAAAAAAATTCTAGTTGGTTTAACGCGTAACTAG,TAAAGATCATCGCGGAGCAACCAACCACAAGGGACCCTGAGTCGGTGAGCGGAGGTGCGCGGCCGCCATGCTGGCTGCGAAAAAAATTCTAGTTGGTTT,10,30,14,27,27,44,27,57,27,34,34,44,47,57,53.99,7.295053714
hek293t,15091,1,15,CAGTGCTGAGGCTGTGGGAGTAATGAATCTGGAGCTTTCTTACTTTCCTGAGCTTGGTGCAAAGAAAAAAAATTCTAGTTGGTTTAACGCGTAACTAGA,CAGTGCTGAGGCTGTGGGAGTAATGAATCTGGAGCATCCCCGCCGTAAACTTTCTTACTTTCCTGAGCTTGGTGCAAAGAAAAAAAATTCTAGTTGGTT,10,30,14,27,27,43,27,58,27,36,36,43,51,58,29.42,0.0
hek293t,15092,1,4,TGGTAAACAAGTACGCGTGAAAGGAGAGATGGAAAAAAGATGCAACGAGCAAAAGAAGCACTAACAACACTCCTAAAAAAATTCTAGTTGGTTTAACGC,TGGTAAACAAGTACGCGTGAAAGGAGAGATGGAAAAACGGAAGATGCAACGAGCAAAAGAAGCACTAACAACACTCCTAAAAAAATTCTAGTTGGTTTA,10,30,14,27,27,45,27,49,27,38,38,45,42,49,59.48,7.087588199
hek293t,15092,1,4,TTAGAAACAAGTACGCGTGAAAGGAGAGATGGAAAAAAGATGCAACGAGCAAAAGAAGCACTAACAACACTCCTTTGTAAAAAAATTCTAGTTGGTTTA,TTAGAAACAAGTACGCGTGAAAGGAGAGATGGAAAAACGGAAGATGCAACGAGCAAAAGAAGCACTAACAACACTCCTTTGTAAAAAAATTCTAGTTGG,10,30,14,27,27,41,27,45,27,38,38,41,42,45,59.48,0.321285141
hek293t,15097,1,11,CGTTTCCTGGCTGTAAAAAACATTTCATCAGGAAACGTGGTCTTTCTGATGCTCGGTGCTTCAGCTTAAAAAAATTCTAGTTGGTTTAACGCGTAACTA,CGTTTCCTGGCTGTAAAAAACATTTCATCAGGAATGCTACAGACAACGTGGTCTTTCTGATGCTCGGTGCTTCAGCTTAAAAAAATTCTAGTTGGTTTA,10,30,14,27,27,45,27,56,27,35,35,45,46,56,8.3,0.110253583
hek293t,15100,1,12,CTGACTATAAAACATCTCTGAACTTCTCTTGGATGATTTGATCTCATGCATTCTTCATCTTCTGTAACGCAAAAAAATTCTAGTTGGTTTAACGCGTAA,CTGACTATAAAACATCTCTGAACTTCTCTTGGATCTGCGCAGATTTGATTTGATCTCATGCATTCTTCATCTTCTGTAACGCAAAAAAATTCTAGTTGG,10,30,14,27,27,41,27,53,27,34,34,41,46,53,12.28,0.285381988
hek293t,15101,1,8,GGCCGTTTTCCTTCCTGGATAAGTGCTAAAGGCTCTGTGTTTCTAATTTAACTAGACAAGAATTCACTTCTTTAAAAAAATTCTAGTTGGTTTAACGCG,GGCCGTTTTCCTTCCTGGATAAGTGCTAAAGGCTCAGGATACCTGTGTTTCTAATTTAACTAGACAAGAATTCACTTCTTTAAAAAAATTCTAGTTGGT,10,30,14,27,27,42,27,50,27,35,35,42,43,50,20.54,1.663342667
hek293t,15101,1,8,GGACTTTTTCCTTCCTGGATAAGTGCTAAAGGCTCTGTGTTTCTAATTTAACTAGACAAGAATTCACTTCTTTTGAAAAAAAAATTCTAGTTGGTTTAA,GGACTTTTTCCTTCCTGGATAAGTGCTAAAGGCTCAGGATACCTGTGTTTCTAATTTAACTAGACAAGAATTCACTTCTTTTGAAAAAAAAATTCTAGT,10,30,14,27,27,38,27,46,27,35,35,38,43,46,20.54,0.0
hek293t,15103,1,12,AGGAGAAATTAGCCTTGGTTGCAGCACAATGGTAGGCTTTTCTTTCCCCTACTCTTTTTGTACAGAAAAAAATTCTAGTTGGTTTAACGCGTAACTAGA,AGGAGAAATTAGCCTTGGTTGCAGCACAATGGTAGGCTGAACCTCAAGGGTTTCTTTCCCCTACTCTTTTTGTACAGAAAAAAATTCTAGTTGGTTTAA,10,30,14,27,27,46,27,58,27,39,39,46,51,58,62.01,0.325092998
hek293t,15104,1,7,CCGTGCCAAATAGGAAATGTTATAGCTGCTGGGAGATGAACTTTCTGGAAGCCAGAAAAGGCATTATTGTTATTAAAAAAAATTCTAGTTGGTTTAACG,CCGTGCCAAATAGGAAATGTTATAGCTGCTGGGTTCCTAGAGATGAACTTTCTGGAAGCCAGAAAAGGCATTATTGTTATTAAAAAAAATTCTAGTTGG,10,30,14,27,27,41,27,48,27,34,34,41,41,48,41.35,30.33290378
hek293t,15104,1,7,TAGCACCAAATAGGAAATGTTATAGCTGCTGGGAGATGAACTTTCTGGAAGCCAGAAAAGGCATTATAAAAAAATTCTAGTTGGTTTAACGCGTAACTA,TAGCACCAAATAGGAAATGTTATAGCTGCTGGGTTCCTAGAGATGAACTTTCTGGAAGCCAGAAAAGGCATTATAAAAAAATTCTAGTTGGTTTAACGC,10,30,14,27,27,49,27,56,27,34,34,49,41,56,41.35,16.68416289
hek293t,15106,1,12,GGGCACAGTCTGTGCTGCTTGTTGTCATCTGGTTTTAGAAATATTCTCCCTGCTGCACTATTGAATAATAAAAAAATTCTAGTTGGTTTAACGCGTAAC,GGGCACAGTCTGTGCTGCTTGTTGTCATCTGGTTTTAGAATGCACTCCGCAAATATTCTCCCTGCTGCACTATTGAATAATAAAAAAATTCTAGTTGGT,10,30,14,27,27,42,27,54,27,39,39,42,51,54,9.99,0.0
hek293t,15106,1,12,GTATTCAGTCTGTGCTGCTTGTTGTCATCTGGTTTTAGAAATATTCTCCCTGCTGCACTATTGAAAAAAAAATTCTAGTTGGTTTAACGCGTAACTAGA,GTATTCAGTCTGTGCTGCTTGTTGTCATCTGGTTTTAGAATGCACTCCGCAAATATTCTCCCTGCTGCACTATTGAAAAAAAAATTCTAGTTGGTTTAA,10,30,14,27,27,46,27,58,27,39,39,46,51,58,9.99,0.0
hek293t,15108,1,9,GCGACAAGAGCTACGAAAAATAAGAAAAATGGACTACAGTTGGATATCCAGTTTCTAATCAGAGACACCCCAAAAAAATTCTAGTTGGTTTAACGCGTA,GCGACAAGAGCTACGAAAAATAAGAAAAATGGACTATATCCAGGACAGTTGGATATCCAGTTTCTAATCAGAGACACCCCAAAAAAATTCTAGTTGGTT,10,30,14,27,27,43,27,52,27,36,36,43,45,52,35.68,0.0
hek293t,15108,1,9,CGTCGAAGAGCTACGAAAAATAAGAAAAATGGACTACAGTTGGATATCCAGTTTCTAATCAGAGACACCCCCCCCAAAAAAATTCTAGTTGGTTTAACG,CGTCGAAGAGCTACGAAAAATAAGAAAAATGGACTATATCCAGGACAGTTGGATATCCAGTTTCTAATCAGAGACACCCCCCCCAAAAAAATTCTAGTT,10,30,14,27,27,39,27,48,27,36,36,39,45,48,35.68,0.0
hek293t,15110,1,13,TTTCGCACACGCTTGGTCAAGTCAAACGCTGGAAGGAAGCCGAGTAGCTGTAACTTGCTGAATGCATTAGTTGGAGAAAAAAATTCTAGTTGGTTTAAC,TTTCGCACACGCTTGGTCAAGTCAAATCGAGTGAATTACCGCTGGAAGGAAGCCGAGTAGCTGTAACTTGCTGAATGCATTAGTTGGAGAAAAAAATTC,10,30,14,27,27,34,27,47,27,27,27,34,40,47,60.47,0.260758421
hek293t,15112,1,12,CCCCTGTATTAGTGGGTTCCCTGCATCTGTGGTGTTGAGTTATCCAAGTTCATGAAAAGCCTGCTTTTATAGCTTCTAAAAAAATTCTAGTTGGTTTAA,CCCCTGTATTAGTGGGTTCCCTGCATCTGTAAATCGCCAACGGGTGTTGAGTTATCCAAGTTCATGAAAAGCCTGCTTTTATAGCTTCTAAAAAAATTC,10,30,14,27,27,34,27,46,27,31,31,34,43,46,54.17,0.380952381
hek293t,15114,1,13,GAACATACATGAAGATGAGCTGAAGTATTTGGATAAGGCATTATCAAACAGCTCGCACTTTGTCCATGTGCTTTGCCAGTAAAAAAATTCTAGTTGGTT,GAACATACATGAAGATGAGCTGAAGTATGCCGGCGGCCGATTTGGATAAGGCATTATCAAACAGCTCGCACTTTGTCCATGTGCTTTGCCAGTAAAAAA,10,30,14,27,27,30,27,43,27,27,27,30,40,43,17.59,0.470809793
hek293t,15114,1,13,TGCCATACATGAAGATGAGCTGAAGTATTTGGATAAGGCATTATCAAACAGCTCGCACTTTGTCCATGTGCTTAAAAAAATTCTAGTTGGTTTAACGCG,TGCCATACATGAAGATGAGCTGAAGTATGCCGGCGGCCGATTTGGATAAGGCATTATCAAACAGCTCGCACTTTGTCCATGTGCTTAAAAAAATTCTAG,10,30,14,27,27,37,27,50,27,27,27,37,40,50,17.59,31.31729543
hek293t,15118,1,1,AAGCCAAGCTATTTTAAGGATCAAGCAGCAGGATAGACTGGATCTCCTGTCCTGAGGCAAAATTACAGTAGTTACAGCTCAAAAAAATTCTAGTTGGTT,AAGCCAAGCTATTTTAAGGATCAAGCAGCAGGATTAGACTGGATCTCCTGTCCTGAGGCAAAATTACAGTAGTTACAGCTCAAAAAAATTCTAGTTGGT,10,30,14,27,27,42,27,43,27,35,35,42,36,43,23.98,70.44172536
hek293t,15118,1,1,TTTATAAGCTATTTTAAGGATCAAGCAGCAGGATAGACTGGATCTCCTGTCCTGAGGCAAAATTACAGTAGTTACAGAAAAAAATTCTAGTTGGTTTAA,TTTATAAGCTATTTTAAGGATCAAGCAGCAGGATTAGACTGGATCTCCTGTCCTGAGGCAAAATTACAGTAGTTACAGAAAAAAATTCTAGTTGGTTTA,10,30,14,27,27,45,27,46,27,35,35,45,36,46,23.98,75.07018239
hek293t,15120,1,8,CTTCCCTAAAACCTTGTCCAAAACTCTTGAGGAAAACTAGCACAACTAGAAATCTGAAGAGATTTCCCAAGAAAAAAATTCTAGTTGGTTTAACGCGTA,CTTCCCTAAAACCTTGTCCAAAACTCTTGAGGAAAACTAGCCAACAGACACAACTAGAAATCTGAAGAGATTTCCCAAGAAAAAAATTCTAGTTGGTTT,10,30,14,27,27,44,27,52,27,41,41,44,49,52,25.01,0.0
hek293t,15124,1,6,TTCTCGTGCATAGAGGGATCACACTTTTATGGGCATTGACTGGATGAATGAAATAAAAATTACTCCTTTGAAGGCAGTAAAAAAATTCTAGTTGGTTTA,TTCTCGTGCATAGAGGGATCACACTTTTAGATTTATGGGCATTGACTGGATGAATGAAATAAAAATTACTCCTTTGAAGGCAGTAAAAAAATTCTAGTT,10,30,14,27,27,39,27,45,27,29,29,39,35,45,8.69,2.375061994
hek293t,15124,1,6,GGGGCGTGCATAGAGGGATCACACTTTTATGGGCATTGACTGGATGAATGAAATAAAAATTACTCCTTTGAAGGCAGTGTTAAATAAAAAAATTCTAGT,GGGGCGTGCATAGAGGGATCACACTTTTAGATTTATGGGCATTGACTGGATGAATGAAATAAAAATTACTCCTTTGAAGGCAGTGTTAAATAAAAAAAT,10,30,14,27,27,32,27,38,27,29,29,32,35,38,8.69,0.271688395
hek293t,15126,1,8,CAAGGCAAGTGGTTAAACAGAAGTACCTATGGTTTCTTTCATATTTTTTGAAAATGTGTATTTCAAGCTAAAAAAAATTCTAGTTGGTTTAACGCGTAA,CAAGGCAAGTGGTTAAACAGAAGTACCTATGGTTTCTGATCATCATTCATATTTTTTGAAAATGTGTATTTCAAGCTAAAAAAAATTCTAGTTGGTTTA,10,30,14,27,27,45,27,53,27,38,38,45,46,53,49.78,0.073099415
hek293t,15126,1,8,CTAACCAAGTGGTTAAACAGAAGTACCTATGGTTTCTTTCATATTTTTTGAAAATGTGTATTTCAAGCTAGAATAAAAAAATTCTAGTTGGTTTAACGC,CTAACCAAGTGGTTAAACAGAAGTACCTATGGTTTCTGATCATCATTCATATTTTTTGAAAATGTGTATTTCAAGCTAGAATAAAAAAATTCTAGTTGG,10,30,14,27,27,41,27,49,27,38,38,41,46,49,49.78,0.0
hek293t,15128,1,11,AGCCACAGCAGTGAGAGAAATGCCTTTAAAGGCAAGTTTTTCTTTTAGAATGATCCTGCTGACATCCATTTTTTAAACTTGAAAAAAATTCTAGTTGGT,AGCCACAGCAGTGAGAGAAATGCCTTTCCTAGACGGCGAAAGGCAAGTTTTTCTTTTAGAATGATCCTGCTGACATCCATTTTTTAAACTTGAAAAAAA,10,30,14,27,27,31,27,42,27,28,28,31,39,42,20.77,1.589715367
hek293t,15128,1,11,CCAAACAGCAGTGAGAGAAATGCCTTTAAAGGCAAGTTTTTCTTTTAGAATGATCCTGCTGACATCCATAAAAAAATTCTAGTTGGTTTAACGCGTAAC,CCAAACAGCAGTGAGAGAAATGCCTTTCCTAGACGGCGAAAGGCAAGTTTTTCTTTTAGAATGATCCTGCTGACATCCATAAAAAAATTCTAGTTGGTT,10,30,14,27,27,43,27,54,27,28,28,43,39,54,20.77,5.670113268
hek293t,15130,1,7,GGTGATGAGAAAGAAGGTAATGGGGGTGCTGGACATCTATGGCTTTGAAATTTTTGAGGTAAGATAAAAAAATTCTAGTTGGTTTAACGCGTAACTAGA,GGTGATGAGAAAGAAGGTAATGGGGGTGCTGGACAATCTTGATCTATGGCTTTGAAATTTTTGAGGTAAGATAAAAAAATTCTAGTTGGTTTAACGCGT,10,30,14,27,27,51,27,58,27,36,36,51,43,58,43.22,3.763883788
hek293t,15132,1,6,CGGTAGGACAGCAGGAGGGCTAGGGAGAGTGGAAAATAAGCTTTCATTTTAACAGAAGAATACTTTTTCATCGAAAAAAATTCTAGTTGGTTTAACGCG,CGGTAGGACAGCAGGAGGGCTAGGGAGAGTGGAAAATGTACTTAAGCTTTCATTTTAACAGAAGAATACTTTTTCATCGAAAAAAATTCTAGTTGGTTT,10,30,14,27,27,44,27,50,27,37,37,44,43,50,36.01,0.023277467
hek293t,15132,1,6,CGGTGGGACAGCAGGAGGGCTAGGGAGAGTGGAAAATAAGCTTTCATTTTAACAGAAGAATACTTTTTCAAAAAAAATTCTAGTTGGTTTAACGCGTAA,CGGTGGGACAGCAGGAGGGCTAGGGAGAGTGGAAAATGTACTTAAGCTTTCATTTTAACAGAAGAATACTTTTTCAAAAAAAATTCTAGTTGGTTTAAC,10,30,14,27,27,47,27,53,27,37,37,47,43,53,36.01,0.77634381
hek293t,15134,1,5,CTTCTTGAGTTGCTGGATTGGCCTAAATGAGGTTAAATGCAAGAGTTTATTATTTTATTTAGAAAAATAAACCAATAAAAAAATTCTAGTTGGTTTAAC,CTTCTTGAGTTGCTGGATTGGCCTAAATGAGGTTTGAATAAATGCAAGAGTTTATTATTTTATTTAGAAAAATAAACCAATAAAAAAATTCTAGTTGGT,10,30,14,27,27,42,27,47,27,35,35,42,40,47,53.88,5.445358065
hek293t,15134,1,5,ACCCCTGAGTTGCTGGATTGGCCTAAATGAGGTTAAATGCAAGAGTTTATTATTTTATTTAGAAAAATAAACCAATTAAAAAAAAAATTCTAGTTGGTT,ACCCCTGAGTTGCTGGATTGGCCTAAATGAGGTTTGAATAAATGCAAGAGTTTATTATTTTATTTAGAAAAATAAACCAATTAAAAAAAAAATTCTAGT,10,30,14,27,27,38,27,43,27,35,35,38,40,43,53.88,0.0
hek293t,15137,1,6,AGCCCGTGCGCCTTCAATTCTGTGCCCACTGGTGGGTTTTTCACGGTTAGCTCACATTAACAGGACGGGGGACTGACCTGTAAAAAAATTCTAGTTGGT,AGCCCGTGCGCCTTCAATTCTGTGCCCAACCCGCCTGGTGGGTTTTTCACGGTTAGCTCACATTAACAGGACGGGGGACTGACCTGTAAAAAAATTCTA,10,30,14,27,27,36,27,42,27,29,29,36,35,42,52.16,67.98726496
hek293t,15137,1,6,TGCCTGTGCGCCTTCAATTCTGTGCCCACTGGTGGGTTTTTCACGGTTAGCTCACATTAACAGGACGGGGGACTGACCTGTCAGCAAAAAAATTCTAGT,TGCCTGTGCGCCTTCAATTCTGTGCCCAACCCGCCTGGTGGGTTTTTCACGGTTAGCTCACATTAACAGGACGGGGGACTGACCTGTCAGCAAAAAAAT,10,30,14,27,27,32,27,38,27,29,29,32,35,38,52.16,6.152718206
hek293t,15139,1,3,ACTTTTGAGCAACTGTGTCTTGGTTAGGCAGGAAAGATGCCTAAACCACACTTTGTCCATTCTTTTAAACCTGGTTTTAAAAAAATTCTAGTTGGTTTA,ACTTTTGAGCAACTGTGTCTTGGTTAGGCAGGAATCAAGATGCCTAAACCACACTTTGTCCATTCTTTTAAACCTGGTTTTAAAAAAATTCTAGTTGGT,10,30,14,27,27,42,27,45,27,35,35,42,38,45,33.98,80.51017918
hek293t,15139,1,3,ACTGTTGAGCAACTGTGTCTTGGTTAGGCAGGAAAGATGCCTAAACCACACTTTGTCCATTCTTTTAAACCTGGTTTTTGCAAAAAAAATTCTAGTTGG,ACTGTTGAGCAACTGTGTCTTGGTTAGGCAGGAATCAAGATGCCTAAACCACACTTTGTCCATTCTTTTAAACCTGGTTTTTGCAAAAAAAATTCTAGT,10,30,14,27,27,38,27,41,27,35,35,38,38,41,33.98,0.0
hek293t,15141,1,4,CGACACTCTGAATTTGATTCCAAGTCCGTTGGGTTCTTTCCCCTTACGCTGCTCCATTGGGAATAAAAGCTCAGGTCAGAAAAAAATTCTAGTTGGTTT,CGACACTCTGAATTTGATTCCAAGTCCGTTGGGTTCGCGATTTCCCCTTACGCTGCTCCATTGGGAATAAAAGCTCAGGTCAGAAAAAAATTCTAGTTG,10,30,14,27,27,40,27,44,27,37,37,40,41,44,30.22,2.136907539
hek293t,15144,1,14,GCGAAATACTGAGAAAATGGAAGGGATATTGGTAGGTCTGGGAGAACAACTTGTATATATATCAAATATTACATTAAAAAAATTCTAGTTGGTTTAACG,GCGAAATACTGAGAAAATGGAAGGGATATTGAGGTCCCGTTACGGGTAGGTCTGGGAGAACAACTTGTATATATATCAAATATTACATTAAAAAAATTC,10,30,14,27,27,34,27,48,27,31,31,34,45,48,29.29,0.0
hek293t,15144,1,14,AAGAAATACTGAGAAAATGGAAGGGATATTGGTAGGTCTGGGAGAACAACTTGTATATATATCAAATAAAAAAAATTCTAGTTGGTTTAACGCGTAACT,AAGAAATACTGAGAAAATGGAAGGGATATTGAGGTCCCGTTACGGGTAGGTCTGGGAGAACAACTTGTATATATATCAAATAAAAAAAATTCTAGTTGG,10,30,14,27,27,41,27,55,27,31,31,41,45,55,29.29,3.020367499
hek293t,15148,1,8,TTACCGAGTCCTCAGGGTGGCTCCTCTGATGGCGCGTCCACGCACACGAAGAGCTTCTGGGTCCTACGAGAAAAAAATTCTAGTTGGTTTAACGCGTAA,TTACCGAGTCCTCAGGGTGGCTCCTCTGATGGCGAGTACCCTCGTCCACGCACACGAAGAGCTTCTGGGTCCTACGAGAAAAAAATTCTAGTTGGTTTA,10,30,14,27,27,45,27,53,27,35,35,45,43,53,51.72,50.89178732
hek293t,15148,1,8,AGGCAGAGTCCTCAGGGTGGCTCCTCTGATGGCGCGTCCACGCACACGAAGAGCTTCTGGGTCCTAAAAAAATTCTAGTTGGTTTAACGCGTAACTAGA,AGGCAGAGTCCTCAGGGTGGCTCCTCTGATGGCGAGTACCCTCGTCCACGCACACGAAGAGCTTCTGGGTCCTAAAAAAATTCTAGTTGGTTTAACGCG,10,30,14,27,27,50,27,58,27,35,35,50,43,58,51.72,39.43444206
hek293t,15150,1,12,AGGGCGGAGCAAGAAGGTTGGCATGCTGAAGGAAGTCTTTTCAGTATTGAATCCTCTGTGTGAAGAGAAAAAAATTCTAGTTGGTTTAACGCGTAACTA,AGGGCGGAGCAAGAAGGTTGGCATGCTGAAGGAAGTGGGACACTCTGACTTTTCAGTATTGAATCCTCTGTGTGAAGAGAAAAAAATTCTAGTTGGTTT,10,30,14,27,27,44,27,56,27,37,37,44,49,56,50.73,2.354850475
hek293t,15150,1,12,ACGATGGAGCAAGAAGGTTGGCATGCTGAAGGAAGTCTTTTCAGTATTGAATCCTCTGTGTGAAGAGGAAAAAAAAAATTCTAGTTGGTTTAACGCGTA,ACGATGGAGCAAGAAGGTTGGCATGCTGAAGGAAGTGGGACACTCTGACTTTTCAGTATTGAATCCTCTGTGTGAAGAGGAAAAAAAAAATTCTAGTTG,10,30,14,27,27,40,27,52,27,37,37,40,49,52,50.73,0.727504639
hek293t,15152,1,12,TAGAATTTCTTACAGCATATTTTACTCTCTGGCAGATCATGTACCTCTCACAGTTTCCCCAGCCATCAGTGAAAAAAATTCTAGTTGGTTTAACGCGTA,TAGAATTTCTTACAGCATATTTTACTCTCTCGGGAATCACGTGGCAGATCATGTACCTCTCACAGTTTCCCCAGCCATCAGTGAAAAAAATTCTAGTTG,10,30,14,27,27,40,27,52,27,30,30,40,42,52,16.5,0.941246506
hek293t,15152,1,12,GCTCCTTTCTTACAGCATATTTTACTCTCTGGCAGATCATGTACCTCTCACAGTTTCCCCAGCCATAAAAAAATTCTAGTTGGTTTAACGCGTAACTAG,GCTCCTTTCTTACAGCATATTTTACTCTCTCGGGAATCACGTGGCAGATCATGTACCTCTCACAGTTTCCCCAGCCATAAAAAAATTCTAGTTGGTTTA,10,30,14,27,27,45,27,57,27,30,30,45,42,57,16.5,1.79966099
hek293t,15154,1,13,CAGCCCCTGGAGTGATTGATTTCTGTCTCTGGGCCTCAGCTTTTCACCTTAAAGAGCAGGTAACGATGAAAAAAATTCTAGTTGGTTTAACGCGTAACT,CAGCCCCTGGAGTGATTGATTTCTGTCTCTGGATATAAGTAGGCGGCCTCAGCTTTTCACCTTAAAGAGCAGGTAACGATGAAAAAAATTCTAGTTGGT,10,30,14,27,27,42,27,55,27,32,32,42,45,55,12.41,3.148007122
hek293t,15155,1,10,TGTCGATGCAATGCCTCCAGCATTCAGCTTGGGCTTTTCAGTCGCCATTCACAGGATCATTAAAGAAAAAAATTCTAGTTGGTTTAACGCGTAACTAGA,TGTCGATGCAATGCCTCCAGCATTCAGCTTGGGCTTTTCACTGGTAGAGCGTCGCCATTCACAGGATCATTAAAGAAAAAAATTCTAGTTGGTTTAACG,10,30,14,27,27,48,27,58,27,41,41,48,51,58,54.41,1.493858728
hek293t,15156,1,9,TGTAGTAAGTCTGAAAGGCTCTTGATGATAGGTGGGGGTCAGGCATCCTCTGAGAGTATTTCTGGATAAAAAAATTCTAGTTGGTTTAACGCGTAACTA,TGTAGTAAGTCTGAAAGGCTCTTGATGATAGGTGGGGGTTACCCCACACAGGCATCCTCTGAGAGTATTTCTGGATAAAAAAATTCTAGTTGGTTTAAC,10,30,14,27,27,47,27,56,27,40,40,47,49,56,45.34,7.983820135
hek293t,15157,1,5,AGCACGTAGCTTACTGCTCACGAGGTCAGTGGCGAAGACAAAGTACACTTCTATTCTGTGGTTACAGGCTGGTGATCGCTTTAGCCTAAAAAAATTCTA,AGCACGTAGCTTACTGCTCACGAGGTCGTCAAAGTGGCGAAGACAAAGTACACTTCTATTCTGTGGTTACAGGCTGGTGATCGCTTTAGCCTAAAAAAA,10,30,14,27,27,31,27,36,27,28,28,31,33,36,56.56,3.301054064
hek293t,15157,1,5,TCAGCGTAGCTTACTGCTCACGAGGTCAGTGGCGAAGACAAAGTACACTTCTATTCTGTGGTTACAGGCTGGTGAAAAAAAATTCTAGTTGGTTTAACG,TCAGCGTAGCTTACTGCTCACGAGGTCGTCAAAGTGGCGAAGACAAAGTACACTTCTATTCTGTGGTTACAGGCTGGTGAAAAAAAATTCTAGTTGGTT,10,30,14,27,27,43,27,48,27,28,28,43,33,48,56.56,85.17500326
hek293t,15159,1,2,AGTGGCATCTGACGTAAGAATGACCATCCTGGCCCATCTGGCCCAGTAGCTTTTCTTTAAGTGGGTCCAGGGCAGAATCAAAAAAATTCTAGTTGGTTT,AGTGGCATCTGACGTAAGAATGACCATCCTGTTGCCCATCTGGCCCAGTAGCTTTTCTTTAAGTGGGTCCAGGGCAGAATCAAAAAAATTCTAGTTGGT,10,30,14,27,27,42,27,44,27,32,32,42,34,44,42.68,85.35771844
hek293t,15159,1,2,GTCCACATCTGACGTAAGAATGACCATCCTGGCCCATCTGGCCCAGTAGCTTTTCTTTAAGTGGGTCCAGGGCAGAATCAGTAAAAAAATTCTAGTTGG,GTCCACATCTGACGTAAGAATGACCATCCTGTTGCCCATCTGGCCCAGTAGCTTTTCTTTAAGTGGGTCCAGGGCAGAATCAGTAAAAAAATTCTAGTT,10,30,14,27,27,39,27,41,27,32,32,39,34,41,42.68,82.83596177
hek293t,15161,1,12,TTTCAGTGGGTCTGCAAAGGGGCTGCCAAAGGAAGGTGTGTGCTGCCGAGAGACCTGTCCTGTGAGGAGTTTCTAAAAAAATTCTAGTTGGTTTAACGC,TTTCAGTGGGTCTGCAAAGGGGCTGCCAACAAACACACGATAGGAAGGTGTGTGCTGCCGAGAGACCTGTCCTGTGAGGAGTTTCTAAAAAAATTCTAG,10,30,14,27,27,37,27,49,27,30,30,37,42,49,38.14,0.830880299
hek293t,15161,1,12,GTGTAGTGGGTCTGCAAAGGGGCTGCCAAAGGAAGGTGTGTGCTGCCGAGAGACCTGTCCTGTGAGGAGTTTCTCATCAAAAAAATTCTAGTTGGTTTA,GTGTAGTGGGTCTGCAAAGGGGCTGCCAACAAACACACGATAGGAAGGTGTGTGCTGCCGAGAGACCTGTCCTGTGAGGAGTTTCTCATCAAAAAAATT,10,30,14,27,27,33,27,45,27,30,30,33,42,45,38.14,0.0
hek293t,15163,1,7,CATGTAGGTCTCTTTTTTCAGACGTGCAATGGAAATCTGAGTTTGAGACAAGCAGAAAATACTTCTTGCAAAAAAAATTCTAGTTGGTTTAACGCGTAA,CATGTAGGTCTCTTTTTTCAGACGTGCAATGGAAACGACTTCTCTGAGTTTGAGACAAGCAGAAAATACTTCTTGCAAAAAAAATTCTAGTTGGTTTAA,10,30,14,27,27,46,27,53,27,36,36,46,43,53,0.1,0.0
hek293t,15163,1,7,AATAGAGGTCTCTTTTTTCAGACGTGCAATGGAAATCTGAGTTTGAGACAAGCAGAAAATACTTCTTGCAGAGAAAAAAATTCTAGTTGGTTTAACGCG,AATAGAGGTCTCTTTTTTCAGACGTGCAATGGAAACGACTTCTCTGAGTTTGAGACAAGCAGAAAATACTTCTTGCAGAGAAAAAAATTCTAGTTGGTT,10,30,14,27,27,43,27,50,27,36,36,43,43,50,0.1,0.0
hek293t,15165,1,13,ATTTTACTTCTTCAGTCTATGCAGCCTGAAGGCAAGAAGTCCCAGGACAAAAAGCTTTCAAAGAGTGCTTCAGCCCAAAAAAATTCTAGTTGGTTTAAC,ATTTTACTTCTTCAGTCTATGCAGCCGGTTGCTTATCCTTGAAGGCAAGAAGTCCCAGGACAAAAAGCTTTCAAAGAGTGCTTCAGCCCAAAAAAATTC,10,30,14,27,27,34,27,47,27,27,27,34,40,47,38.27,0.639954533
hek293t,15165,1,13,GGGTGACTTCTTCAGTCTATGCAGCCTGAAGGCAAGAAGTCCCAGGACAAAAAGCTTTCAAAGAGTGCTTCAGCCCAATTAAAAAAATTCTAGTTGGTT,GGGTGACTTCTTCAGTCTATGCAGCCGGTTGCTTATCCTTGAAGGCAAGAAGTCCCAGGACAAAAAGCTTTCAAAGAGTGCTTCAGCCCAATTAAAAAA,10,30,14,27,27,30,27,43,27,27,27,30,40,43,38.27,0.078895464
hek293t,15167,1,5,TTATTACCTCATATCAAGAGAGTTGACAAAGGAGTTCTAGGATCAAACATTAGAAAGCGCAAGGTAAATGTTGCTGTTCCCCAAAAAAATTCTAGTTGG,TTATTACCTCATATCAAGAGAGTTGACAAAGGTCCGCAGTTCTAGGATCAAACATTAGAAAGCGCAAGGTAAATGTTGCTGTTCCCCAAAAAAATTCTA,10,30,14,27,27,36,27,41,27,33,33,36,38,41,61.39,0.0
hek293t,15167,1,5,GCGTCACCTCATATCAAGAGAGTTGACAAAGGAGTTCTAGGATCAAACATTAGAAAGCGCAAGGTAAATGTTGCTAAAAAAATTCTAGTTGGTTTAACG,GCGTCACCTCATATCAAGAGAGTTGACAAAGGTCCGCAGTTCTAGGATCAAACATTAGAAAGCGCAAGGTAAATGTTGCTAAAAAAATTCTAGTTGGTT,10,30,14,27,27,43,27,48,27,33,33,43,38,48,61.39,28.80746382
hek293t,15169,1,12,AATAATTCCTTGGAAATAAAGATTGTCTAAGGTGTTTCACACCAGTTAATTATGATTTTATTGCGACTGCCCAAAAAAATTCTAGTTGGTTTAACGCGT,AATAATTCCTTGGAAATAAAGATTGTCTAAGCGGTAATCCGTGGTGTTTCACACCAGTTAATTATGATTTTATTGCGACTGCCCAAAAAAATTCTAGTT,10,30,14,27,27,39,27,51,27,32,32,39,44,51,23.93,0.0
hek293t,15169,1,12,CTTCGTTCCTTGGAAATAAAGATTGTCTAAGGTGTTTCACACCAGTTAATTATGATTTTATTGCGACTGAAAAAAATTCTAGTTGGTTTAACGCGTAAC,CTTCGTTCCTTGGAAATAAAGATTGTCTAAGCGGTAATCCGTGGTGTTTCACACCAGTTAATTATGATTTTATTGCGACTGAAAAAAATTCTAGTTGGT,10,30,14,27,27,42,27,54,27,32,32,42,44,54,23.93,0.0
hek293t,15171,1,9,CGCACAAGCACTGATAAACACCACACACCTGGAATCTCTTCAGCTGCATTTCACTGAGTACAGGAAACAGTTTAAAAAAATTCTAGTTGGTTTAACGCG,CGCACAAGCACTGATAAACACCACACACCTACCACTAACGGAATCTCTTCAGCTGCATTTCACTGAGTACAGGAAACAGTTTAAAAAAATTCTAGTTGG,10,30,14,27,27,41,27,50,27,31,31,41,40,50,63.67,25.56319449
hek293t,15173,1,5,TTACCGAAGCAAAGGGAAGACTGATAAGTAGGAAAAAGAAGGAACAGATTTTGAGACATACTTCTGAAAGAATAAATAAAAAAATTCTAGTTGGTTTAA,TTACCGAAGCAAAGGGAAGACTGATAAGTAGGATAGTTAAAAGAAGGAACAGATTTTGAGACATACTTCTGAAAGAATAAATAAAAAAATTCTAGTTGG,10,30,14,27,27,41,27,46,27,34,34,41,39,46,47.51,0.810312408
hek293t,15173,1,5,AAAGGGAAGCAAAGGGAAGACTGATAAGTAGGAAAAAGAAGGAACAGATTTTGAGACATACTTCTGAAAAAAAAAATTCTAGTTGGTTTAACGCGTAAC,AAAGGGAAGCAAAGGGAAGACTGATAAGTAGGATAGTTAAAAGAAGGAACAGATTTTGAGACATACTTCTGAAAAAAAAAATTCTAGTTGGTTTAACGC,10,30,14,27,27,49,27,54,27,34,34,49,39,54,47.51,0.26195646
hek293t,15175,1,8,CTTGATCTATGTTGGGTCTGAAGTGCATCTGGGTTTCTTAAGAGGGCTGTTGGCATTTAACCAGCTTAAAAAAATTCTAGTTGGTTTAACGCGTAACTA,CTTGATCTATGTTGGGTCTGAAGTGCATCTGGGTTTCTTATATACGTCAGAGGGCTGTTGGCATTTAACCAGCTTAAAAAAATTCTAGTTGGTTTAACG,10,30,14,27,27,48,27,56,27,41,41,48,49,56,18.27,19.82106111
hek293t,15176,1,13,CGTGTGAAAGAGATTTTGCATTAGTTTTTTGGAAGAGGAAACTTAGTGATTTGGTTAAGTAACTTGCCCAAAAAAAATTCTAGTTGGTTTAACGCGTAA,CGTGTGAAAGAGATTTTGCATTAGTTTTTGTTACCTGCAGTGTGGAAGAGGAAACTTAGTGATTTGGTTAAGTAACTTGCCCAAAAAAAATTCTAGTTG,10,30,14,27,27,40,27,53,27,30,30,40,43,53,-2.66,0.0
hek293t,15176,1,13,TCCGCGAAAGAGATTTTGCATTAGTTTTTTGGAAGAGGAAACTTAGTGATTTGGTTAAGTAACTTGCCCAATGCTGCAAAAAAATTCTAGTTGGTTTAA,TCCGCGAAAGAGATTTTGCATTAGTTTTTGTTACCTGCAGTGTGGAAGAGGAAACTTAGTGATTTGGTTAAGTAACTTGCCCAATGCTGCAAAAAAATT,10,30,14,27,27,33,27,46,27,30,30,33,43,46,-2.66,0.0
hek293t,15178,1,1,TGCTCAGCCAAACAGAGATTGCGTATTTCAGGAAGTGTACTTAATTGAATTTCTATATTACTAATGTGACTTCTTCAATCTTAGTTAAAAAAATTCTAG,TGCTCAGCCAAACAGAGATTGCGTATTTTCAGGAAGTGTACTTAATTGAATTTCTATATTACTAATGTGACTTCTTCAATCTTAGTTAAAAAAATTCTA,10,30,14,27,27,36,27,37,27,29,29,36,30,37,9.74,56.24860041
hek293t,15178,1,1,GCTCAAGCCAAACAGAGATTGCGTATTTCAGGAAGTGTACTTAATTGAATTTCTATATTACTAATGTGACTTCTTCAAAAAAAAATTCTAGTTGGTTTA,GCTCAAGCCAAACAGAGATTGCGTATTTTCAGGAAGTGTACTTAATTGAATTTCTATATTACTAATGTGACTTCTTCAAAAAAAAATTCTAGTTGGTTT,10,30,14,27,27,44,27,45,27,29,29,44,30,45,9.74,66.06795079
hek293t,15184,1,6,CGGCTAGCTGCATCTTCCACACTGCAGGTAGGTCCTAATCACAAACAACTACCTCATTTATCTTGGAGCTGTTCCAGTTTAAAAAAATTCTAGTTGGTT,CGGCTAGCTGCATCTTCCACACTGCAGGTTCATCCAGGTCCTAATCACAAACAACTACCTCATTTATCTTGGAGCTGTTCCAGTTTAAAAAAATTCTAG,10,30,14,27,27,37,27,43,27,30,30,37,36,43,67.26,7.510292931
hek293t,15184,1,6,GGTGCAGCTGCATCTTCCACACTGCAGGTAGGTCCTAATCACAAACAACTACCTCATTTATCTTGGAGCTGTAAAAAAATTCTAGTTGGTTTAACGCGT,GGTGCAGCTGCATCTTCCACACTGCAGGTTCATCCAGGTCCTAATCACAAACAACTACCTCATTTATCTTGGAGCTGTAAAAAAATTCTAGTTGGTTTA,10,30,14,27,27,45,27,51,27,30,30,45,36,51,67.26,19.12692539
hek293t,15186,1,3,TCTCACATCACCTAAACTACTATACACTCAGGTACTCTGAGGTGTGAGGTTAGTAACAAAACTGGAAATGGCCTGGAAAAAAATTCTAGTTGGTTTAAC,TCTCACATCACCTAAACTACTATACACTCAGGTACTCTGAAGCGGTGTGAGGTTAGTAACAAAACTGGAAATGGCCTGGAAAAAAATTCTAGTTGGTTT,10,30,14,27,27,44,27,47,27,41,41,44,44,47,61.49,0.339610313
hek293t,15186,1,3,CGCCTCATCACCTAAACTACTATACACTCAGGTACTCTGAGGTGTGAGGTTAGTAACAAAACTGGAAATAAAAAAATTCTAGTTGGTTTAACGCGTAAC,CGCCTCATCACCTAAACTACTATACACTCAGGTACTCTGAAGCGGTGTGAGGTTAGTAACAAAACTGGAAATAAAAAAATTCTAGTTGGTTTAACGCGT,10,30,14,27,27,51,27,54,27,41,41,51,44,54,61.49,30.49423428
hek293t,15188,1,9,GTACGAATTTCTGTGAGTCATTCAAAGGGAGGGTAGAGATACATGAAGGGGAGCTTTTGCCAAAAAAGAAAAAAATTCTAGTTGGTTTAACGCGTAACT,GTACGAATTTCTGTGAGTCATTCAAAGGGAGGGTAGAGAGGTATCCGATACATGAAGGGGAGCTTTTGCCAAAAAAGAAAAAAATTCTAGTTGGTTTAA,10,30,14,27,27,46,27,55,27,39,39,46,48,55,62.42,0.0
hek293t,15189,1,1,ATTGGTGTATTTCACCTCTTCCTCACTTTTGGTGAACTACATTCAGACTTCTCTCTAAAGTATTTTAATCTCTATTGTCAGCAAAAAAAATTCTAGTTG,ATTGGTGTATTTCACCTCTTCCTCACTTTTGGTGAAACTACATTCAGACTTCTCTCTAAAGTATTTTAATCTCTATTGTCAGCAAAAAAAATTCTAGTT,10,30,14,27,27,39,27,40,27,36,36,39,37,40,10.05,5.949252661
hek293t,15189,1,1,AGACATGTATTTCACCTCTTCCTCACTTTTGGTGAACTACATTCAGACTTCTCTCTAAAGTATTTTAATCTCTATTAAAAAAATTCTAGTTGGTTTAAC,AGACATGTATTTCACCTCTTCCTCACTTTTGGTGAAACTACATTCAGACTTCTCTCTAAAGTATTTTAATCTCTATTAAAAAAATTCTAGTTGGTTTAA,10,30,14,27,27,46,27,47,27,36,36,46,37,47,10.05,73.63478528
hek293t,15191,1,1,TACCGGGCATAACTTACATCAACATCATTTGGAGGACCGAGGCAAATGTTCTTGGCTTAGGGATGAGTTTGGATACACTCAAAAAAATTCTAGTTGGTT,TACCGGGCATAACTTACATCAACATCATTTGGAGGACCGGAGGCAAATGTTCTTGGCTTAGGGATGAGTTTGGATACACTCAAAAAAATTCTAGTTGGT,10,30,14,27,27,42,27,43,27,39,39,42,40,43,10.08,59.87926411
hek293t,15191,1,1,CAACTGGCATAACTTACATCAACATCATTTGGAGGACCGAGGCAAATGTTCTTGGCTTAGGGATGAGTTTGGATACAAAAAAATTCTAGTTGGTTTAAC,CAACTGGCATAACTTACATCAACATCATTTGGAGGACCGGAGGCAAATGTTCTTGGCTTAGGGATGAGTTTGGATACAAAAAAATTCTAGTTGGTTTAA,10,30,14,27,27,46,27,47,27,39,39,46,40,47,10.08,70.38520789
hek293t,15193,1,15,TACTTCCGAGCCTGAGGGCAGTTCAAGTGTGGGCCCTGTGAGAGGACCAGAACACCACAGCCCAAAAAAAATTCTAGTTGGTTTAACGCGTAACTAGAT,TACTTCCGAGCCTGAGGGCAGTTCAAGTGTGGGCCCGGACGAATAATAGCCTGTGAGAGGACCAGAACACCACAGCCCAAAAAAAATTCTAGTTGGTTT,10,30,14,27,27,44,27,59,27,37,37,44,52,59,61.85,0.277200277
hek293t,15194,1,1,CTCAAACTAAAAGAGTTGCAAAAGAACGTAGGCACCAGAAATAAGACTATGATAGAACTTCTACATAAAAATCCCTGACAAAAAAATTCTAGTTGGTTT,CTCAAACTAAAAGAGTTGCAAAAGAACGTAGGTCACCAGAAATAAGACTATGATAGAACTTCTACATAAAAATCCCTGACAAAAAAATTCTAGTTGGTT,10,30,14,27,27,43,27,44,27,33,33,43,34,44,67.27,15.09968657
hek293t,15194,1,1,GAGAAACTAAAAGAGTTGCAAAAGAACGTAGGCACCAGAAATAAGACTATGATAGAACTTCTACATAAAAATCCCTGACTTCAAAAAAATTCTAGTTGG,GAGAAACTAAAAGAGTTGCAAAAGAACGTAGGTCACCAGAAATAAGACTATGATAGAACTTCTACATAAAAATCCCTGACTTCAAAAAAATTCTAGTTG,10,30,14,27,27,40,27,41,27,33,33,40,34,41,67.27,17.25817433
hek293t,15196,1,2,GCGTTTCCCATGTTGTGTTACAGCATCTTTGGCCAGTGATGAGGATATGATCATAGGCTGGTGAAATGTTGAAAAAAATTCTAGTTGGTTTAACGCGTA,GCGTTTCCCATGTTGTGTTACAGCATCTTTGGCCCTAGTGATGAGGATATGATCATAGGCTGGTGAAATGTTGAAAAAAATTCTAGTTGGTTTAACGCG,10,30,14,27,27,50,27,52,27,35,35,50,37,52,24.1,73.02901324
hek293t,15196,1,2,TGAACTCCCATGTTGTGTTACAGCATCTTTGGCCAGTGATGAGGATATGATCATAGGCTGGTGAAATGTTGGAAAGCTGAAAAAAATTCTAGTTGGTTT,TGAACTCCCATGTTGTGTTACAGCATCTTTGGCCCTAGTGATGAGGATATGATCATAGGCTGGTGAAATGTTGGAAAGCTGAAAAAAATTCTAGTTGGT,10,30,14,27,27,42,27,44,27,35,35,42,37,44,24.1,79.01384016
hek293t,15198,1,14,CAACATTGATATTAATAGGAAGTCGCATTAGGCTAATCATATAATTAGGAGTATCTTACTGATTTAAAAAAAATTCTAGTTGGTTTAACGCGTAACTAG,CAACATTGATATTAATAGGAAGTCGCATTAGGCTAATCACCTGAACCCGTCGATATAATTAGGAGTATCTTACTGATTTAAAAAAAATTCTAGTTGGTT,10,30,14,27,27,43,27,57,27,40,40,43,54,57,21.29,0.0
hek293t,15199,1,4,GCGACTGAGAAACTTTTCATCTCTTTTATTGGTACACATTGCTGGAAATAAGGACAACAAAATATTAAAAAAATTCTAGTTGGTTTAACGCGTAACTAG,GCGACTGAGAAACTTTTCATCTCTTTTATTGGTACACATTGATTGCTGGAAATAAGGACAACAAAATATTAAAAAAATTCTAGTTGGTTTAACGCGTAA,10,30,14,27,27,53,27,57,27,38,38,53,42,57,0.69,1.316112371
hek293t,15199,1,4,TCTAGTGAGAAACTTTTCATCTCTTTTATTGGTACACATTGCTGGAAATAAGGACAACAAAATATTGCTGTTGTAAAAAAATTCTAGTTGGTTTAACGC,TCTAGTGAGAAACTTTTCATCTCTTTTATTGGTACACATTGATTGCTGGAAATAAGGACAACAAAATATTGCTGTTGTAAAAAAATTCTAGTTGGTTTA,10,30,14,27,27,45,27,49,27,38,38,45,42,49,0.69,0.0
hek293t,15201,1,11,TTTAGTACTAGGATGATACATGTTTTTAGAGGAATCAGATGCCTCAGTATGACGCAGTAAGTTTATTTTTCTCAAAAAAATTCTAGTTGGTTTAACGCG,TTTAGTACTAGGATGATACATGTTTTTAGAGGAATTATGTGCTACGCAGATGCCTCAGTATGACGCAGTAAGTTTATTTTTCTCAAAAAAATTCTAGTT,10,30,14,27,27,39,27,50,27,36,36,39,47,50,29.01,0.0
hek293t,15201,1,11,AATGGTACTAGGATGATACATGTTTTTAGAGGAATCAGATGCCTCAGTATGACGCAGTAAGTTTATAAAAAAATTCTAGTTGGTTTAACGCGTAACTAG,AATGGTACTAGGATGATACATGTTTTTAGAGGAATTATGTGCTACGCAGATGCCTCAGTATGACGCAGTAAGTTTATAAAAAAATTCTAGTTGGTTTAA,10,30,14,27,27,46,27,57,27,36,36,46,47,57,29.01,0.230083405
hek293t,15203,1,2,TACTAAGGTGCATTCTGAAAATGTTATAGAGGAAAACACTTTGCTAAGCAGTCACTTAGTGCTTCAGTGTATCTTAAAAAAATTCTAGTTGGTTTAACG,TACTAAGGTGCATTCTGAAAATGTTATAGAGGGGAAAACACTTTGCTAAGCAGTCACTTAGTGCTTCAGTGTATCTTAAAAAAATTCTAGTTGGTTTAA,10,30,14,27,27,46,27,48,27,31,31,46,33,48,37.36,0.632706231
hek293t,15203,1,2,CGGGAAGGTGCATTCTGAAAATGTTATAGAGGAAAACACTTTGCTAAGCAGTCACTTAGTGCTTCAGTGTATCTTGGAAAATGGCTTAAAAAAATTCTA,CGGGAAGGTGCATTCTGAAAATGTTATAGAGGGGAAAACACTTTGCTAAGCAGTCACTTAGTGCTTCAGTGTATCTTGGAAAATGGCTTAAAAAAATTC,10,30,14,27,27,34,27,36,27,31,31,34,33,36,37.36,0.550519788
hek293t,15205,1,2,GCTGCAGGAGTGTCAAATCTCAAAGTAATTGGCTGGTTTCCTGGAATTCCCAGAGGAGTTAACATAGCTTCCAGTACAAAAAAATTCTAGTTGGTTTAA,GCTGCAGGAGTGTCAAATCTCAAAGTAATTGGCTGGCCTTTCCTGGAATTCCCAGAGGAGTTAACATAGCTTCCAGTACAAAAAAATTCTAGTTGGTTT,10,30,14,27,27,44,27,46,27,37,37,44,39,46,9.15,54.33312614
hek293t,15205,1,2,GTACGAGGAGTGTCAAATCTCAAAGTAATTGGCTGGTTTCCTGGAATTCCCAGAGGAGTTAACATAGCTTCCAGAAAAAAATTCTAGTTGGTTTAACGC,GTACGAGGAGTGTCAAATCTCAAAGTAATTGGCTGGCCTTTCCTGGAATTCCCAGAGGAGTTAACATAGCTTCCAGAAAAAAATTCTAGTTGGTTTAAC,10,30,14,27,27,47,27,49,27,37,37,47,39,49,9.15,69.38911602
hek293t,15207,1,1,TATCGACTGTATTTCTATTTTGGAAGAAGAGGGTTGAAAATACTTCAACTTTGCTGCTGAACACCTGTTTTTGAGACAAAAAAATTCTAGTTGGTTTAA,TATCGACTGTATTTCTATTTTGGAAGAAGAAGGGTTGAAAATACTTCAACTTTGCTGCTGAACACCTGTTTTTGAGACAAAAAAATTCTAGTTGGTTTA,10,30,14,27,27,45,27,46,27,30,30,45,31,46,15.09,1.668981905
hek293t,15207,1,1,GCCTAACTGTATTTCTATTTTGGAAGAAGAGGGTTGAAAATACTTCAACTTTGCTGCTGAACACCTGTTTTTGAGACCTCTTAAAAAAATTCTAGTTGG,GCCTAACTGTATTTCTATTTTGGAAGAAGAAGGGTTGAAAATACTTCAACTTTGCTGCTGAACACCTGTTTTTGAGACCTCTTAAAAAAATTCTAGTTG,10,30,14,27,27,40,27,41,27,30,30,40,31,41,15.09,2.877666365
hek293t,15209,1,9,GGTGGACTGATGGTCAATGAAACCATCAGTGGTCCTTAGGTGATCTGCAAAAACAGATCTAGTGTTTACTTGAAAAAAAAATTCTAGTTGGTTTAACGC,GGTGGACTGATGGTCAATGAAACCATCAGTGGTCCTGGCCAGAATTAGGTGATCTGCAAAAACAGATCTAGTGTTTACTTGAAAAAAAAATTCTAGTTG,10,30,14,27,27,40,27,49,27,37,37,40,46,49,56.4,0.0
hek293t,15209,1,9,TCGCCACTGATGGTCAATGAAACCATCAGTGGTCCTTAGGTGATCTGCAAAAACAGATCTAGTGTTTAAAAAAATTCTAGTTGGTTTAACGCGTAACTA,TCGCCACTGATGGTCAATGAAACCATCAGTGGTCCTGGCCAGAATTAGGTGATCTGCAAAAACAGATCTAGTGTTTAAAAAAATTCTAGTTGGTTTAAC,10,30,14,27,27,47,27,56,27,37,37,47,46,56,56.4,12.37307869
hek293t,15211,1,2,TTTATGCTGTGGTAATTATCTCTCTTCAAAGGGAGGCAACCAAATAGGGAGGGGTTAAACACTGAAAAATACCTTTCTGAGGTTTGAAAAAAATTCTAG,TTTATGCTGTGGTAATTATCTCTCTTCAAAGGCGGAGGCAACCAAATAGGGAGGGGTTAAACACTGAAAAATACCTTTCTGAGGTTTGAAAAAAATTCT,10,30,14,27,27,35,27,37,27,32,32,35,34,37,25.4,0.657831264
hek293t,15211,1,2,TTACCGCTGTGGTAATTATCTCTCTTCAAAGGGAGGCAACCAAATAGGGAGGGGTTAAACACTGAAAAATACCTTTCTGAAAAAAATTCTAGTTGGTTT,TTACCGCTGTGGTAATTATCTCTCTTCAAAGGCGGAGGCAACCAAATAGGGAGGGGTTAAACACTGAAAAATACCTTTCTGAAAAAAATTCTAGTTGGT,10,30,14,27,27,42,27,44,27,32,32,42,34,44,25.4,80.33439437
hek293t,15215,1,9,CCTACCCTTTCTCTCAGCTTATGCTAAAGAGGCAGATTTGCATAGCAACATATGTGCATCACACATACTCAAGAGCAAAAAAATTCTAGTTGGTTTAAC,CCTACCCTTTCTCTCAGCTTATGCTAAAGAACTATCCATGGCAGATTTGCATAGCAACATATGTGCATCACACATACTCAAGAGCAAAAAAATTCTAGT,10,30,14,27,27,38,27,47,27,31,31,38,40,47,49.03,2.843687948
hek293t,15215,1,9,GGCATCCTTTCTCTCAGCTTATGCTAAAGAGGCAGATTTGCATAGCAACATATGTGCATCACACATACAAAAAAATTCTAGTTGGTTTAACGCGTAACT,GGCATCCTTTCTCTCAGCTTATGCTAAAGAACTATCCATGGCAGATTTGCATAGCAACATATGTGCATCACACATACAAAAAAATTCTAGTTGGTTTAA,10,30,14,27,27,46,27,55,27,31,31,46,40,55,49.03,4.208757834
hek293t,15217,1,14,AAGTGAAGAAAAGATTTGACTGATATGTTAGGTTCTGAAAAGAAAAGGAAGTTAATTTGGTTCCCCAAAAAAATTCTAGTTGGTTTAACGCGTAACTAG,AAGTGAAGAAAAGATTTGACTGATATGTCGTTGACTAAGAGTTAGGTTCTGAAAAGAAAAGGAAGTTAATTTGGTTCCCCAAAAAAATTCTAGTTGGTT,10,30,14,27,27,43,27,57,27,28,28,43,42,57,37.2,0.455889496
hek293t,15217,1,14,ATTTCAAGAAAAGATTTGACTGATATGTTAGGTTCTGAAAAGAAAAGGAAGTTAATTTGGTTCCCCCCCCCCCCGTATAAAAAAATTCTAGTTGGTTTA,ATTTCAAGAAAAGATTTGACTGATATGTCGTTGACTAAGAGTTAGGTTCTGAAAAGAAAAGGAAGTTAATTTGGTTCCCCCCCCCCCCGTATAAAAAAA,10,30,14,27,27,31,27,45,27,28,28,31,42,45,37.2,0.0
hek293t,15219,1,9,TCACAGAAGTACATAGTGATGAAAAGTAGTGGCACACCTTAGAAATCTCAAATGACTTAATAAAAACAAGCAAGAAAAGAAACCAAAAAAATTCTAGTT,TCACAGAAGTACATAGTGATGAAAAGCGTACTCACTAGTGGCACACCTTAGAAATCTCAAATGACTTAATAAAAACAAGCAAGAAAAGAAACCAAAAAA,10,30,14,27,27,30,27,39,27,27,27,30,36,39,50.44,0.0
hek293t,15219,1,9,AGGTAGAAGTACATAGTGATGAAAAGTAGTGGCACACCTTAGAAATCTCAAATGACTTAATAAAAACAAGCAAGAAAAGAAAAAAAATTCTAGTTGGTT,AGGTAGAAGTACATAGTGATGAAAAGCGTACTCACTAGTGGCACACCTTAGAAATCTCAAATGACTTAATAAAAACAAGCAAGAAAAGAAAAAAAATTC,10,30,14,27,27,34,27,43,27,27,27,34,36,43,50.44,1.201033593
hek293t,15223,1,11,TAAACGAGGAGCAATGTCATGCGCTTTTCTGGTAAAATCAGAAAGGGGGAGCAGGAGCAGATGTCTTTGGCTCCTGTTTCAAAAAAATTCTAGTTGGTT,TAAACGAGGAGCAATGTCATGCGCTTTTTAATAGGAAGTCTGGTAAAATCAGAAAGGGGGAGCAGGAGCAGATGTCTTTGGCTCCTGTTTCAAAAAAAT,10,30,14,27,27,32,27,43,27,29,29,32,40,43,3.65,0.074404762
hek293t,15223,1,11,AGGTGGAGGAGCAATGTCATGCGCTTTTCTGGTAAAATCAGAAAGGGGGAGCAGGAGCAGATGTCTTTGGCTCCTGAAAAAAATTCTAGTTGGTTTAAC,AGGTGGAGGAGCAATGTCATGCGCTTTTTAATAGGAAGTCTGGTAAAATCAGAAAGGGGGAGCAGGAGCAGATGTCTTTGGCTCCTGAAAAAAATTCTA,10,30,14,27,27,36,27,47,27,29,29,36,40,47,3.65,1.732348503
hek293t,15225,1,14,GATGTTTTTTCTGATTTGTTTCACTCTCCAGGAACAGTATTTCTTTTAAACACTAGCAGAAGGAAAGACCCCAAAAAAATTCTAGTTGGTTTAACGCGT,GATGTTTTTTCTGATTTGTTTCACTCTCCAAGGACCCGTTTTGAGGAACAGTATTTCTTTTAAACACTAGCAGAAGGAAAGACCCCAAAAAAATTCTAG,10,30,14,27,27,37,27,51,27,30,30,37,44,51,15.2,0.425985091
hek293t,15227,1,2,TCCTCAGACTAGGCCTCAATTTCTTATACTGGTATTCCCTGCTGTTCAGTTTGCAGTTTTTCTTTAGCTTAGAAAAAAATTCTAGTTGGTTTAACGCGT,TCCTCAGACTAGGCCTCAATTTCTTATACTGGTATTCCAGCTGCTGTTCAGTTTGCAGTTTTTCTTTAGCTTAGAAAAAAATTCTAGTTGGTTTAACGC,10,30,14,27,27,49,27,51,27,39,39,49,41,51,18.15,47.32077678
hek293t,15229,1,7,GGCTCACTGATCTTTCCATTCATCCCTTTTGGTCTCTACTGAGAGCATCCTGATCTTCACAAAACATGCTTCCAAAAAAAAAATTCTAGTTGGTTTAAC,GGCTCACTGATCTTTCCATTCATCCCTTTTGGGATTGATTCTCTACTGAGAGCATCCTGATCTTCACAAAACATGCTTCCAAAAAAAAAATTCTAGTTG,10,30,14,27,27,40,27,47,27,33,33,40,40,47,3.67,0.342759212
hek293t,15229,1,7,ACCCAACTGATCTTTCCATTCATCCCTTTTGGTCTCTACTGAGAGCATCCTGATCTTCACAAAACATGCTTCCAAAAACAAAAAAAATTCTAGTTGGTT,ACCCAACTGATCTTTCCATTCATCCCTTTTGGGATTGATTCTCTACTGAGAGCATCCTGATCTTCACAAAACATGCTTCCAAAAACAAAAAAAATTCTA,10,30,14,27,27,36,27,43,27,33,33,36,40,43,3.67,1.728451797
hek293t,15231,1,4,AAGCCCTACTCAAATATGATCCCATGTCAAGGCTGATCCTTCTTTTTGCTGAAAAGCAAGATCATTCTAAAAAGTTTAAAAAAATTCTAGTTGGTTTAA,AAGCCCTACTCAAATATGATCCCATGTCAAGGCTGATCCCCTCTTCTTTTTGCTGAAAAGCAAGATCATTCTAAAAAGTTTAAAAAAATTCTAGTTGGT,10,30,14,27,27,42,27,46,27,39,39,42,43,46,57.21,0.054734537
hek293t,15231,1,4,TATTTCTACTCAAATATGATCCCATGTCAAGGCTGATCCTTCTTTTTGCTGAAAAGCAAGATCATTCTAAAAAAAAAAAATTCTAGTTGGTTTAACGCG,TATTTCTACTCAAATATGATCCCATGTCAAGGCTGATCCCCTCTTCTTTTTGCTGAAAAGCAAGATCATTCTAAAAAAAAAAAATTCTAGTTGGTTTAA,10,30,14,27,27,46,27,50,27,39,39,46,43,50,57.21,5.186048623
hek293t,15233,1,14,TATGACAGTCACCCGCTCCATTAAGACGCTGGAAGTGCAAGGATCAGAGCTGACCCTGAGTGTGAGAAAAAAATTCTAGTTGGTTTAACGCGTAACTAG,TATGACAGTCACCCGCTCCATTAAGACGCTGGAAGTGCAAATCATGACAATTAAGGATCAGAGCTGACCCTGAGTGTGAGAAAAAAATTCTAGTTGGTT,10,30,14,27,27,43,27,57,27,40,40,43,54,57,52.01,0.0
hek293t,15234,1,5,TTGGGGGATATTTGCTCGAGCATTTTTGGTGGCCTTTTTCCTTTAAAAGATTGAGTTAGCTCTGGAGCTTCAACAAGCAAAAAAATTCTAGTTGGTTTA,TTGGGGGATATTTGCTCGAGCATTTTTGGTGGACATGCCTTTTTCCTTTAAAAGATTGAGTTAGCTCTGGAGCTTCAACAAGCAAAAAAATTCTAGTTG,10,30,14,27,27,40,27,45,27,33,33,40,38,45,27.51,0.543900544
hek293t,15234,1,5,TACCCGGATATTTGCTCGAGCATTTTTGGTGGCCTTTTTCCTTTAAAAGATTGAGTTAGCTCTGGAGCTTCAACAAAAAAAATTCTAGTTGGTTTAACG,TACCCGGATATTTGCTCGAGCATTTTTGGTGGACATGCCTTTTTCCTTTAAAAGATTGAGTTAGCTCTGGAGCTTCAACAAAAAAAATTCTAGTTGGTT,10,30,14,27,27,43,27,48,27,33,33,43,38,48,27.51,2.036255527
hek293t,15236,1,8,CATTGGTTTGCTGTGAAGAGGGTCTTCCCAGGTGACACCCAGGGAAGTAACCACAGGAGCACTCGGAACAGTCACAGTAAAAAAATTCTAGTTGGTTTA,CATTGGTTTGCTGTGAAGAGGGTCTTGGTAGGTACCCAGGTGACACCCAGGGAAGTAACCACAGGAGCACTCGGAACAGTCACAGTAAAAAAATTCTAG,10,30,14,27,27,37,27,45,27,27,27,37,35,45,48.39,59.41350892
hek293t,15236,1,8,CCAGTGTTTGCTGTGAAGAGGGTCTTCCCAGGTGACACCCAGGGAAGTAACCACAGGAGCACTCGGAACAGTCACAGTCCTAAAAAAATTCTAGTTGGT,CCAGTGTTTGCTGTGAAGAGGGTCTTGGTAGGTACCCAGGTGACACCCAGGGAAGTAACCACAGGAGCACTCGGAACAGTCACAGTCCTAAAAAAATTC,10,30,14,27,27,34,27,42,27,27,27,34,35,42,48.39,38.07688458
hek293t,15238,1,5,AATTATCCTCCAGCTGATGAGCTGGAATTTGGAAAAGAAAGAGAAACTGTGCAGATGTTGGTATGCCATTGTTACAAAAAAATTCTAGTTGGTTTAACG,AATTATCCTCCAGCTGATGAGCTGGAATTTGGAATCGAAAAGAAAGAGAAACTGTGCAGATGTTGGTATGCCATTGTTACAAAAAAATTCTAGTTGGTT,10,30,14,27,27,43,27,48,27,33,33,43,38,48,22.49,2.744650712
hek293t,15238,1,5,CTTATTCCTCCAGCTGATGAGCTGGAATTTGGAAAAGAAAGAGAAACTGTGCAGATGTTGGTATGCCATTAAAAAAATTCTAGTTGGTTTAACGCGTAA,CTTATTCCTCCAGCTGATGAGCTGGAATTTGGAATCGAAAAGAAAGAGAAACTGTGCAGATGTTGGTATGCCATTAAAAAAATTCTAGTTGGTTTAACG,10,30,14,27,27,48,27,53,27,33,33,48,38,53,22.49,1.59716085
hek293t,15240,1,10,GCGGAAGAAGATAGGACTAGATAATCTTCAGGCTAGGTAAGGGACTTAAAATTTCTGACATTTACTCCATAAAAAAATTCTAGTTGGTTTAACGCGTAA,GCGGAAGAAGATAGGACTAGATAATCTATACTCAAGGTCAGGCTAGGTAAGGGACTTAAAATTTCTGACATTTACTCCATAAAAAAATTCTAGTTGGTT,10,30,14,27,27,43,27,53,27,28,28,43,38,53,48.06,32.07716992
hek293t,15240,1,10,GCCAGAGAAGATAGGACTAGATAATCTTCAGGCTAGGTAAGGGACTTAAAATTTCTGACATTTACTCCATAGCCTAAAAAAATTCTAGTTGGTTTAACG,GCCAGAGAAGATAGGACTAGATAATCTATACTCAAGGTCAGGCTAGGTAAGGGACTTAAAATTTCTGACATTTACTCCATAGCCTAAAAAAATTCTAGT,10,30,14,27,27,38,27,48,27,28,28,38,38,48,48.06,22.01326556
hek293t,15242,1,12,CATACTGAATTTTTTCTCCGATCACGTGATGGGACTAGTTTTCTGCCTGTAGGTCATACTCTAATTGCCAATAAAAAAATTCTAGTTGGTTTAACGCGT,CATACTGAATTTTTTCTCCGATCACGTGCCGCGCATTTCAATGGGACTAGTTTTCTGCCTGTAGGTCATACTCTAATTGCCAATAAAAAAATTCTAGTT,10,30,14,27,27,39,27,51,27,29,29,39,41,51,3.61,0.140944327
hek293t,15242,1,12,TGACTTGAATTTTTTCTCCGATCACGTGATGGGACTAGTTTTCTGCCTGTAGGTCATACTCTAATTGCCAATATGAAAAAAATTCTAGTTGGTTTAACG,TGACTTGAATTTTTTCTCCGATCACGTGCCGCGCATTTCAATGGGACTAGTTTTCTGCCTGTAGGTCATACTCTAATTGCCAATATGAAAAAAATTCTA,10,30,14,27,27,36,27,48,27,29,29,36,41,48,3.61,0.073099415
hek293t,17545,1,1,GGGAACAAAAGCTTACTAGAAGCTCTGGAAGGTATCATTCAGCACTGAAGAGAATAAGAGGCTGGTTTCTTAGAATTAGAAAAAAAATTCTAGTTGGTT,GGGAACAAAAGCTTACTAGAAGCTCTGGAAGAGTATCATTCAGCACTGAAGAGAATAAGAGGCTGGTTTCTTAGAATTAGAAAAAAAATTCTAGTTGGT,10,30,14,27,27,42,27,43,27,32,32,42,33,43,64.58,82.80359821
hek293t,17545,1,1,GAACTCAAAAGCTTACTAGAAGCTCTGGAAGGTATCATTCAGCACTGAAGAGAATAAGAGGCTGGTTTCTTAGAAAAAAAAATTCTAGTTGGTTTAACG,GAACTCAAAAGCTTACTAGAAGCTCTGGAAGAGTATCATTCAGCACTGAAGAGAATAAGAGGCTGGTTTCTTAGAAAAAAAAATTCTAGTTGGTTTAAC,10,30,14,27,27,47,27,48,27,32,32,47,33,48,64.58,82.67286603
hek293t,15246,1,14,ACAGCCCACCATCACCCAGGAGTTTCAAGAGGAGCTTAGCTAAAAGGTAACTGCAAGGTGCTGTAAAAAAAATTCTAGTTGGTTTAACGCGTAACTAGA,ACAGCCCACCATCACCCAGGAGTTTCAAGAGGAGCTTAGCCCAGGGCATTGATTTAAAAGGTAACTGCAAGGTGCTGTAAAAAAAATTCTAGTTGGTTT,10,30,14,27,27,44,27,58,27,41,41,44,55,58,54.31,0.0
hek293t,15247,1,2,ATATCATGCTGATCTTGGGGGAAAACATGGGGACTAAATCTTGCCATGGACCTCTATGACTGCCCTAAAAAAATTCTAGTTGGTTTAACGCGTAACTAG,ATATCATGCTGATCTTGGGGGAAAACATGGGGACTAAATCCCTTGCCATGGACCTCTATGACTGCCCTAAAAAAATTCTAGTTGGTTTAACGCGTAACT,10,30,14,27,27,55,27,57,27,40,40,55,42,57,48.46,66.45153705
hek293t,15247,1,2,GCTGAATGCTGATCTTGGGGGAAAACATGGGGACTAAATCTTGCCATGGACCTCTATGACTGCCCTCATTAAAACAGAAAAAAAATTCTAGTTGGTTTA,GCTGAATGCTGATCTTGGGGGAAAACATGGGGACTAAATCCCTTGCCATGGACCTCTATGACTGCCCTCATTAAAACAGAAAAAAAATTCTAGTTGGTT,10,30,14,27,27,43,27,45,27,40,40,43,42,45,48.46,5.297122831
hek293t,15249,1,6,CCTTCGCTATCAATGTTTACAGACAGTAGGGGTAAATCCATGGAAAATGAGGGTCACGAAGTCTCTTAAAAAAATTCTAGTTGGTTTAACGCGTAACTA,CCTTCGCTATCAATGTTTACAGACAGTAGGGGTACGTCAGAATCCATGGAAAATGAGGGTCACGAAGTCTCTTAAAAAAATTCTAGTTGGTTTAACGCG,10,30,14,27,27,50,27,56,27,35,35,50,41,56,50.15,0.296296296
hek293t,15249,1,6,TCCATGCTATCAATGTTTACAGACAGTAGGGGTAAATCCATGGAAAATGAGGGTCACGAAGTCTCTTCTGAGTTAAAAAAAATTCTAGTTGGTTTAACG,TCCATGCTATCAATGTTTACAGACAGTAGGGGTACGTCAGAATCCATGGAAAATGAGGGTCACGAAGTCTCTTCTGAGTTAAAAAAAATTCTAGTTGGT,10,30,14,27,27,42,27,48,27,35,35,42,41,48,50.15,21.49969425
hek293t,15251,1,15,ACACATGGCATCTTTCCAAATGGCCACAGTGGTATAGGTTCCCACATGAAGATGTTTGCAGTGAAGGAGGAAAAAAAAAAAATTCTAGTTGGTTTAACG,ACACATGGCATCTTTCCAAATGGCCACAGAAAATAAAATAGCTGTGGTATAGGTTCCCACATGAAGATGTTTGCAGTGAAGGAGGAAAAAAAAAAAATT,10,30,14,27,27,33,27,48,27,30,30,33,45,48,61.07,0.0
hek293t,15252,1,3,GTAGGCAGCAGAAGTGGGACTCAACATTATGGACACGCTGCTGATTTCTGCATCAAATGACAACTCTATTTACAAAAAAATTCTAGTTGGTTTAACGCG,GTAGGCAGCAGAAGTGGGACTCAACATTATGGACACGCTTGTGCTGATTTCTGCATCAAATGACAACTCTATTTACAAAAAAATTCTAGTTGGTTTAAC,10,30,14,27,27,47,27,50,27,40,40,47,43,50,28.0,70.70972628
hek293t,15252,1,3,GAAACCAGCAGAAGTGGGACTCAACATTATGGACACGCTGCTGATTTCTGCATCAAATGACAACTAAAAAAATTCTAGTTGGTTTAACGCGTAACTAGA,GAAACCAGCAGAAGTGGGACTCAACATTATGGACACGCTTGTGCTGATTTCTGCATCAAATGACAACTAAAAAAATTCTAGTTGGTTTAACGCGTAACT,10,30,14,27,27,55,27,58,27,40,40,55,43,58,28.0,72.67054183
hek293t,15254,1,14,GGGGGGCAGCTGACTTCCTTCTCCTGTTGGGGCTCAGGGCCAGTCACATCTTTCTCAACAATTAACTGCAAAAAAAATTCTAGTTGGTTTAACGCGTAA,GGGGGGCAGCTGACTTCCTTCTCCTGTTGGGTCGTGACTGTTGAGGCTCAGGGCCAGTCACATCTTTCTCAACAATTAACTGCAAAAAAAATTCTAGTT,10,30,14,27,27,39,27,53,27,32,32,39,46,53,48.54,7.555332731
hek293t,15254,1,14,TAGAGGCAGCTGACTTCCTTCTCCTGTTGGGGCTCAGGGCCAGTCACATCTTTCTCAACAATTAACTGCACTCCAAAAAAATTCTAGTTGGTTTAACGC,TAGAGGCAGCTGACTTCCTTCTCCTGTTGGGTCGTGACTGTTGAGGCTCAGGGCCAGTCACATCTTTCTCAACAATTAACTGCACTCCAAAAAAATTCT,10,30,14,27,27,35,27,49,27,32,32,35,46,49,48.54,0.075075075
hek293t,15256,1,7,AGGGGAAGAGACATTCTCTTCCAAGTTTGGGGGGCCCCCCCAGAGTGATAAAATTAACTGTAGATTTTTAATAAAAAAATTCTAGTTGGTTTAACGCGT,AGGGGAAGAGACATTCTCTTCCAAGTTTGGTATCCGGGGGGCCCCCCCAGAGTGATAAAATTAACTGTAGATTTTTAATAAAAAAATTCTAGTTGGTTT,10,30,14,27,27,44,27,51,27,29,29,44,36,51,31.81,16.27212437
hek293t,15258,1,15,CAGGCTTGTTCTGTTTTTCTAAAATAGTGTGGTTCAGATAACAAATGTATTCTGAGTAGTAAATACCTCCTTAAAAAAAAATTCTAGTTGGTTTAACGC,CAGGCTTGTTCTGTTTTTCTAAAATAGTGTAAGTGCGATAAAGTAGGTTCAGATAACAAATGTATTCTGAGTAGTAAATACCTCCTTAAAAAAAAATTC,10,30,14,27,27,34,27,49,27,31,31,34,46,49,26.17,0.0
hek293t,15258,1,15,AATAGTTGTTCTGTTTTTCTAAAATAGTGTGGTTCAGATAACAAATGTATTCTGAGTAGTAAATACCAAAAAAATTCTAGTTGGTTTAACGCGTAACTA,AATAGTTGTTCTGTTTTTCTAAAATAGTGTAAGTGCGATAAAGTAGGTTCAGATAACAAATGTATTCTGAGTAGTAAATACCAAAAAAATTCTAGTTGG,10,30,14,27,27,41,27,56,27,31,31,41,46,56,26.17,0.0
hek293t,15260,1,8,TCGTCCATATATCAAAAAGGGTTTAATAAAGGTGCTTTTCCTAAACTTTGAGTAGCCAAGGCCCACGTGCAGATGAAAAAAAAATTCTAGTTGGTTTAA,TCGTCCATATATCAAAAAGGGTTTAATATTCGACAAAAGGTGCTTTTCCTAAACTTTGAGTAGCCAAGGCCCACGTGCAGATGAAAAAAAAATTCTAGT,10,30,14,27,27,38,27,46,27,28,28,38,36,46,14.95,0.127862973
hek293t,15260,1,8,ACGGCCATATATCAAAAAGGGTTTAATAAAGGTGCTTTTCCTAAACTTTGAGTAGCCAAGGCCCACGTGCAGATGAAATGCAGAAAAAAAATTCTAGTT,ACGGCCATATATCAAAAAGGGTTTAATATTCGACAAAAGGTGCTTTTCCTAAACTTTGAGTAGCCAAGGCCCACGTGCAGATGAAATGCAGAAAAAAAA,10,30,14,27,27,31,27,39,27,28,28,31,36,39,14.95,0.0
hek293t,15263,1,9,GGACTAAGGTGTGTGCAGCCTGTGATCAGAGGTAGTGGCCTCTCAGAGGATCCTGGCTGTCATCAGGGTGTAAAAAAATTCTAGTTGGTTTAACGCGTA,GGACTAAGGTGTGTGCAGCCTGTGATCAGAGGTAGACGTTACCCTGGCCTCTCAGAGGATCCTGGCTGTCATCAGGGTGTAAAAAAATTCTAGTTGGTT,10,30,14,27,27,43,27,52,27,36,36,43,45,52,75.21,0.912740741
hek293t,15263,1,9,TTCTTAAGGTGTGTGCAGCCTGTGATCAGAGGTAGTGGCCTCTCAGAGGATCCTGGCTGTCATCAGGGTGTTCTGAAAAAAATTCTAGTTGGTTTAACG,TTCTTAAGGTGTGTGCAGCCTGTGATCAGAGGTAGACGTTACCCTGGCCTCTCAGAGGATCCTGGCTGTCATCAGGGTGTTCTGAAAAAAATTCTAGTT,10,30,14,27,27,39,27,48,27,36,36,39,45,48,75.21,0.745236639
hek293t,15265,1,1,GGGTAGCTATGGGGATGATGCTCTAGCTGAGGTAGGTCTGGTAATGGAAAGGCAAGTGTGGAGGTGGGGACTCAAAAAAATTCTAGTTGGTTTAACGCG,GGGTAGCTATGGGGATGATGCTCTAGCTGAGGTAAGGTCTGGTAATGGAAAGGCAAGTGTGGAGGTGGGGACTCAAAAAAATTCTAGTTGGTTTAACGC,10,30,14,27,27,49,27,50,27,34,34,49,35,50,65.27,83.52713445
hek293t,15265,1,1,TATGGGCTATGGGGATGATGCTCTAGCTGAGGTAGGTCTGGTAATGGAAAGGCAAGTGTGGAGGTGGGGACTCGGGCATTTAAAAAAATTCTAGTTGGT,TATGGGCTATGGGGATGATGCTCTAGCTGAGGTAAGGTCTGGTAATGGAAAGGCAAGTGTGGAGGTGGGGACTCGGGCATTTAAAAAAATTCTAGTTGG,10,30,14,27,27,41,27,42,27,34,34,41,35,42,65.27,73.54543229
hek293t,15267,1,6,CGGAATCTTTACTCTTCCAGTATTATTTTTGGCCTCATCAAGGAAGGGAAAATGCAACAGGAAGGAAAAAAAAATTCTAGTTGGTTTAACGCGTAACTA,CGGAATCTTTACTCTTCCAGTATTATTTTTGGCCAGTCCATCATCAAGGAAGGGAAAATGCAACAGGAAGGAAAAAAAAATTCTAGTTGGTTTAACGCG,10,30,14,27,27,50,27,56,27,35,35,50,41,56,2.79,0.0
hek293t,15267,1,6,AGGGTTCTTTACTCTTCCAGTATTATTTTTGGCCTCATCAAGGAAGGGAAAATGCAACAGGAAGGAAGGAGCTAAAAAAAAATTCTAGTTGGTTTAACG,AGGGTTCTTTACTCTTCCAGTATTATTTTTGGCCAGTCCATCATCAAGGAAGGGAAAATGCAACAGGAAGGAAGGAGCTAAAAAAAAATTCTAGTTGGT,10,30,14,27,27,42,27,48,27,35,35,42,41,48,2.79,0.0
hek293t,15270,1,13,AACTGGTCCTAAATTAAAAGGAGATTGGGAGGAAGGATGATGCTCATGCATAAATCAAATGGTGAGAAAAAAATTCTAGTTGGTTTAACGCGTAACTAG,AACTGGTCCTAAATTAAAAGGAGATTGGGAGGAAGGATGCACTCATAGGATGATGCTCATGCATAAATCAAATGGTGAGAAAAAAATTCTAGTTGGTTT,10,30,14,27,27,44,27,57,27,34,34,44,47,57,58.32,0.0
hek293t,15270,1,13,CGGACGTCCTAAATTAAAAGGAGATTGGGAGGAAGGATGATGCTCATGCATAAATCAAATGGTGAGGTGAGTAAAAAAAATTCTAGTTGGTTTAACGCG,CGGACGTCCTAAATTAAAAGGAGATTGGGAGGAAGGATGCACTCATAGGATGATGCTCATGCATAAATCAAATGGTGAGGTGAGTAAAAAAAATTCTAG,10,30,14,27,27,37,27,50,27,34,34,37,47,50,58.32,0.0
hek293t,15272,1,6,CTACCGTTTATGTCTCAGCTTAACTACCATGGATGTGAATTTTAGCTAATGCTTGTTTACTATCTGAAAAAAATTCTAGTTGGTTTAACGCGTAACTAG,CTACCGTTTATGTCTCAGCTTAACTACCATGGATGTGAATACTAAGTTTAGCTAATGCTTGTTTACTATCTGAAAAAAATTCTAGTTGGTTTAACGCGT,10,30,14,27,27,51,27,57,27,41,41,51,47,57,62.34,4.422586686
hek293t,15272,1,6,AGAAAGTTTATGTCTCAGCTTAACTACCATGGATGTGAATTTTAGCTAATGCTTGTTTACTATCTGAGAGCATAAAAAAATTCTAGTTGGTTTAACGCG,AGAAAGTTTATGTCTCAGCTTAACTACCATGGATGTGAATACTAAGTTTAGCTAATGCTTGTTTACTATCTGAGAGCATAAAAAAATTCTAGTTGGTTT,10,30,14,27,27,44,27,50,27,41,41,44,47,50,62.34,0.0
hek293t,15274,1,7,GCTTTTCTCTGTGGAAAAGAGGACTGGAGGGGGAAAAATAAGTTATGTAAGGCTTCTTAAAGTACTTGGTTTGTTAAGAAAAAAAATTCTAGTTGGTTT,GCTTTTCTCTGTGGAAAAGAGGACTGGAGGGGGCCGATAAAAAAATAAGTTATGTAAGGCTTCTTAAAGTACTTGGTTTGTTAAGAAAAAAAATTCTAG,10,30,14,27,27,37,27,44,27,34,34,37,41,44,43.21,0.026298488
hek293t,15274,1,7,GTCGTTCTCTGTGGAAAAGAGGACTGGAGGGGGAAAAATAAGTTATGTAAGGCTTCTTAAAGTACTTGGTTTGTTAAAAAAATTCTAGTTGGTTTAACG,GTCGTTCTCTGTGGAAAAGAGGACTGGAGGGGGCCGATAAAAAAATAAGTTATGTAAGGCTTCTTAAAGTACTTGGTTTGTTAAAAAAATTCTAGTTGG,10,30,14,27,27,41,27,48,27,34,34,41,41,48,43.21,0.0
hek293t,15276,1,14,TACACCAATTATGCTTTTATTTCCCCTCCTGGCCTTTTCAGAAGCACACTGAACATTAGCCACATCCACCTAAAAAAATTCTAGTTGGTTTAACGCGTA,TACACCAATTATGCTTTTATTTCCCCTCCTGGCCAACGTACTAATTTGTTTTCAGAAGCACACTGAACATTAGCCACATCCACCTAAAAAAATTCTAGT,10,30,14,27,27,38,27,52,27,35,35,38,49,52,16.39,0.0
hek293t,15276,1,14,CGCGCCAATTATGCTTTTATTTCCCCTCCTGGCCTTTTCAGAAGCACACTGAACATTAGCCACAAAAAAAATTCTAGTTGGTTTAACGCGTAACTAGAT,CGCGCCAATTATGCTTTTATTTCCCCTCCTGGCCAACGTACTAATTTGTTTTCAGAAGCACACTGAACATTAGCCACAAAAAAAATTCTAGTTGGTTTA,10,30,14,27,27,45,27,59,27,35,35,45,49,59,16.39,0.807539942
hek293t,15278,1,3,AGCAACCTTGTTTCGGTATTAGCGCTATGTGGGGCCCAAACTAACGTGCCCTGTGGAGCATGTGGAGTATTAGCTGAAAAAAATTCTAGTTGGTTTAAC,AGCAACCTTGTTTCGGTATTAGCGCTATGTGGGGCCTCTCAAACTAACGTGCCCTGTGGAGCATGTGGAGTATTAGCTGAAAAAAATTCTAGTTGGTTT,10,30,14,27,27,44,27,47,27,37,37,44,40,47,43.0,74.59360373
hek293t,15280,1,15,TGCGGACTTAAAGGTGGTGATGCAGCAAAAGGGAAAGTATTCAAATTTATACCAGATGTTTCCCTGTTAAAAAAAATTCTAGTTGGTTTAACGCGTAAC,TGCGGACTTAAAGGTGGTGATGCAGCAAAAGCTTCCGATCGTCTTCGGAAAGTATTCAAATTTATACCAGATGTTTCCCTGTTAAAAAAAATTCTAGTT,10,30,14,27,27,39,27,54,27,32,32,39,47,54,36.82,1.26202442
hek293t,15281,1,14,CGTTTAGGGTTGAGCCGTTGTGCTCAAGACGGGTGGCAGAGCGCGGAGCTGCCCTGCCAGGCGAGGCAGAAAAAAATTCTAGTTGGTTTAACGCGTAAC,CGTTTAGGGTTGAGCCGTTGTGCTCAAGATTTCGGTATGGTGCCGGGTGGCAGAGCGCGGAGCTGCCCTGCCAGGCGAGGCAGAAAAAAATTCTAGTTG,10,30,14,27,27,40,27,54,27,30,30,40,44,54,55.58,5.502893533
hek293t,15281,1,14,CGTAGAGGGTTGAGCCGTTGTGCTCAAGACGGGTGGCAGAGCGCGGAGCTGCCCTGCCAGGCGAGGCAGGGTAAAAAAATTCTAGTTGGTTTAACGCGT,CGTAGAGGGTTGAGCCGTTGTGCTCAAGATTTCGGTATGGTGCCGGGTGGCAGAGCGCGGAGCTGCCCTGCCAGGCGAGGCAGGGTAAAAAAATTCTAG,10,30,14,27,27,37,27,51,27,30,30,37,44,51,55.58,0.184956238
hek293t,15283,1,15,TCAGGCTTAGACTAACTATAACTGTTCCCAGGTTTTGGCTAGAGAAAATAAAAATGACATCAGCAAACCAATCCCAAAAAAATTCTAGTTGGTTTAACG,TCAGGCTTAGACTAACTATAACTGTTCCCTATTTTCCAGGGCTCAGGTTTTGGCTAGAGAAAATAAAAATGACATCAGCAAACCAATCCCAAAAAAATT,10,30,14,27,27,33,27,48,27,30,30,33,45,48,55.62,0.0
hek293t,15284,1,3,TCCGGAAATAAGGGGTGCTAATTCTAGATTGGCTTTACTCCTTACTAGAAGGACTACATGCAATGTTTAGCCTCAGAGAGAGAAAAAAAATTCTAGTTG,TCCGGAAATAAGGGGTGCTAATTCTAGATACGTGGCTTTACTCCTTACTAGAAGGACTACATGCAATGTTTAGCCTCAGAGAGAGAAAAAAAATTCTAG,10,30,14,27,27,37,27,40,27,30,30,37,33,40,20.85,66.97655051
hek293t,15284,1,3,ATACTAAATAAGGGGTGCTAATTCTAGATTGGCTTTACTCCTTACTAGAAGGACTACATGCAATGTTTAGCCTCAGAGAGAAAAAAATTCTAGTTGGTT,ATACTAAATAAGGGGTGCTAATTCTAGATACGTGGCTTTACTCCTTACTAGAAGGACTACATGCAATGTTTAGCCTCAGAGAGAAAAAAATTCTAGTTG,10,30,14,27,27,40,27,43,27,30,30,40,33,43,20.85,72.75620108
hek293t,15286,1,1,TCGGACAGGAACAAGAGGCAGCGGTGATGTGGTGGGATGCTGTTACGATTTGTTCTTTGAGTTACGGTACCACCTAGGAGAAAAAAATTCTAGTTGGTT,TCGGACAGGAACAAGAGGCAGCGGTGAATGTGGTGGGATGCTGTTACGATTTGTTCTTTGAGTTACGGTACCACCTAGGAGAAAAAAATTCTAGTTGGT,10,30,14,27,27,42,27,43,27,27,27,42,28,43,50.6,85.38167017
hek293t,15286,1,1,GCCTCCAGGAACAAGAGGCAGCGGTGATGTGGTGGGATGCTGTTACGATTTGTTCTTTGAGTTACGGTACCACCTAGGAGGATGGATGAGGGAAAAAAA,GCCTCCAGGAACAAGAGGCAGCGGTGAATGTGGTGGGATGCTGTTACGATTTGTTCTTTGAGTTACGGTACCACCTAGGAGGATGGATGAGGGAAAAAA,10,30,14,27,27,30,27,31,27,27,27,30,28,31,50.6,4.997853455
hek293t,15288,1,8,GCTCCGGAGTTGGAGCACTACATTGCAGGTGGCTGAGCAGCCAAGCAGACTGTGGGAGTCGGGTTCTGTAACAAAAAAATTCTAGTTGGTTTAACGCGT,GCTCCGGAGTTGGAGCACTACATTGCAGGTGGCGCAAAGGCTGAGCAGCCAAGCAGACTGTGGGAGTCGGGTTCTGTAACAAAAAAATTCTAGTTGGTT,10,30,14,27,27,43,27,51,27,33,33,43,41,51,45.14,48.06036746
hek293t,15288,1,8,AAGAAGGAGTTGGAGCACTACATTGCAGGTGGCTGAGCAGCCAAGCAGACTGTGGGAGTCGGGTTCTGTAACTCGAGTGAAAAAAATTCTAGTTGGTTT,AAGAAGGAGTTGGAGCACTACATTGCAGGTGGCGCAAAGGCTGAGCAGCCAAGCAGACTGTGGGAGTCGGGTTCTGTAACTCGAGTGAAAAAAATTCTA,10,30,14,27,27,36,27,44,27,33,33,36,41,44,45.14,1.068246206
hek293t,15290,1,10,ACAAATAAACTCACAAAAATCCTTCTTTATGGAAGCCCCCCCTAGCAGTGTCATCCATGAAACACCATCAAAAAAAATTCTAGTTGGTTTAACGCGTAA,ACAAATAAACTCACAAAAATCCTTCTTTATGGAAGGAAACCATCCCCCCCCCTAGCAGTGTCATCCATGAAACACCATCAAAAAAAATTCTAGTTGGTT,10,30,14,27,27,43,27,53,27,36,36,43,46,53,8.93,0.0
hek293t,15291,1,10,TGACTGATTTGTTTATGTTGTTTCAGGTATGGATGTCCTTACAGGCCAAAGAGGGATGAACACCCAAAAAAAATTCTAGTTGGTTTAACGCGTAACTAG,TGACTGATTTGTTTATGTTGTTTCAGGTATGGATGTCCTGTTATCGCTCTACAGGCCAAAGAGGGATGAACACCCAAAAAAAATTCTAGTTGGTTTAAC,10,30,14,27,27,47,27,57,27,40,40,47,50,57,19.27,0.574712644
hek293t,15292,1,5,TGGTACAAGGGCCAGAGAAGGTTCAAGGCAGGAAGTGATGGGTGGGGAGGTAGGAGGTATATGTCTCAGGGAGAAGTTCAGAAAAAAAATTCTAGTTGG,TGGTACAAGGGCCAGAGAAGGTTCAAGGTCGATCAGGAAGTGATGGGTGGGGAGGTAGGAGGTATATGTCTCAGGGAGAAGTTCAGAAAAAAAATTCTA,10,30,14,27,27,36,27,41,27,29,29,36,34,41,62.87,45.11351279
hek293t,15292,1,5,GCACTCAAGGGCCAGAGAAGGTTCAAGGCAGGAAGTGATGGGTGGGGAGGTAGGAGGTATATGTCTCAGGGAGAAGTTCAAAAAAATTCTAGTTGGTTT,GCACTCAAGGGCCAGAGAAGGTTCAAGGTCGATCAGGAAGTGATGGGTGGGGAGGTAGGAGGTATATGTCTCAGGGAGAAGTTCAAAAAAATTCTAGTT,10,30,14,27,27,39,27,44,27,29,29,39,34,44,62.87,56.62805761
hek293t,15294,1,2,GTCGCTGAAAGAGAACACATCTTTTGCTAAGGATTATAGTTATGATACTGGACTTAATTAGAAGGATGGTTAAAAAAATTCTAGTTGGTTTAACGCGTA,GTCGCTGAAAGAGAACACATCTTTTGCTAAGGATTATAGATTTATGATACTGGACTTAATTAGAAGGATGGTTAAAAAAATTCTAGTTGGTTTAACGCG,10,30,14,27,27,50,27,52,27,40,40,50,42,52,20.74,9.144655046
hek293t,15294,1,2,ACAGTTGAAAGAGAACACATCTTTTGCTAAGGATTATAGTTATGATACTGGACTTAATTAGAAGGATGGTTACAAAAAAAATTCTAGTTGGTTTAACGC,ACAGTTGAAAGAGAACACATCTTTTGCTAAGGATTATAGATTTATGATACTGGACTTAATTAGAAGGATGGTTACAAAAAAAATTCTAGTTGGTTTAAC,10,30,14,27,27,47,27,49,27,40,40,47,42,49,20.74,5.518775551
hek293t,15296,1,11,GCCGTTCCGCAGCCTGGGCAACCCATTCACGGTTAATGGAGGGTTGACTACGCTTCCTGAAACTCTTAGGCAAAAAAATTCTAGTTGGTTTAACGCGTA,GCCGTTCCGCAGCCTGGGCAACCCATTCACCCTCTGTGGAAGGTTAATGGAGGGTTGACTACGCTTCCTGAAACTCTTAGGCAAAAAAATTCTAGTTGG,10,30,14,27,27,41,27,52,27,31,31,41,42,52,36.61,22.0810313
hek293t,15296,1,11,TGTTTTCCGCAGCCTGGGCAACCCATTCACGGTTAATGGAGGGTTGACTACGCTTCCTGAAACTCTTAGGCCAAAAAAAAATTCTAGTTGGTTTAACGC,TGTTTTCCGCAGCCTGGGCAACCCATTCACCCTCTGTGGAAGGTTAATGGAGGGTTGACTACGCTTCCTGAAACTCTTAGGCCAAAAAAAAATTCTAGT,10,30,14,27,27,38,27,49,27,31,31,38,42,49,36.61,18.28892473
hek293t,15298,1,8,CAGCTAATAGTCTTTACTGCGATTACATCTGGTCACCTTCAGTTTTAACACAGCATTAACGAGACAAGCAGTGATCTAAAAAAATTCTAGTTGGTTTAA,CAGCTAATAGTCTTTACTGCGATTACATCTGGTCATACATTTACCTTCAGTTTTAACACAGCATTAACGAGACAAGCAGTGATCTAAAAAAATTCTAGT,10,30,14,27,27,38,27,46,27,35,35,38,43,46,10.91,0.0
hek293t,15300,1,6,TCTCTTTGTTTTTAGGTTTTATTCTGTGAAGGTTTAAAAATCACCACTATGAGGGAAATGTGCCTTTGTGAGTAATAAAAAAAAATTCTAGTTGGTTTA,TCTCTTTGTTTTTAGGTTTTATTCTGTGAAGGTTTTCAGCCAAAAATCACCACTATGAGGGAAATGTGCCTTTGTGAGTAATAAAAAAAAATTCTAGTT,10,30,14,27,27,39,27,45,27,36,36,39,42,45,3.79,0.0
hek293t,15300,1,6,TTTAGTTGTTTTTAGGTTTTATTCTGTGAAGGTTTAAAAATCACCACTATGAGGGAAATGTGCCTTTGTGAAAAAAAATTCTAGTTGGTTTAACGCGTA,TTTAGTTGTTTTTAGGTTTTATTCTGTGAAGGTTTTCAGCCAAAAATCACCACTATGAGGGAAATGTGCCTTTGTGAAAAAAAATTCTAGTTGGTTTAA,10,30,14,27,27,46,27,52,27,36,36,46,42,52,3.79,1.319159208
hek293t,15302,1,3,TGATTTTTAAGAAATGAGTTTGAGAAGGCAGGGTTGGCACTGCAACAGGAAAACCAGGAATTAAACTGGTGGAGGAGAAAAAAATTCTAGTTGGTTTAA,TGATTTTTAAGAAATGAGTTTGAGAAGGCAGGGTTGGCAGCACTGCAACAGGAAAACCAGGAATTAAACTGGTGGAGGAGAAAAAAATTCTAGTTGGTT,10,30,14,27,27,43,27,46,27,40,40,43,43,46,30.35,1.877547415
hek293t,15302,1,3,ATGCATTTAAGAAATGAGTTTGAGAAGGCAGGGTTGGCACTGCAACAGGAAAACCAGGAATTAAACTGGTAAAAAAATTCTAGTTGGTTTAACGCGTAA,ATGCATTTAAGAAATGAGTTTGAGAAGGCAGGGTTGGCAGCACTGCAACAGGAAAACCAGGAATTAAACTGGTAAAAAAATTCTAGTTGGTTTAACGCG,10,30,14,27,27,50,27,53,27,40,40,50,43,53,30.35,60.08551507
hek293t,15304,1,5,GAGACTCATTTGAATAGCTAGCCCTCTTCAGGAGGCTTTTAAAACAGGTTAGACAAATCCCTGTCAGGAGTGGTCTGGGTAAAAAAATTCTAGTTGGTT,GAGACTCATTTGAATAGCTAGCCCTCTTCAGGAGACAGTGCTTTTAAAACAGGTTAGACAAATCCCTGTCAGGAGTGGTCTGGGTAAAAAAATTCTAGT,10,30,14,27,27,38,27,43,27,35,35,38,40,43,14.36,0.0
hek293t,15304,1,5,GACGGTCATTTGAATAGCTAGCCCTCTTCAGGAGGCTTTTAAAACAGGTTAGACAAATCCCTGTCAGGAGTGGAAAAAAATTCTAGTTGGTTTAACGCG,GACGGTCATTTGAATAGCTAGCCCTCTTCAGGAGACAGTGCTTTTAAAACAGGTTAGACAAATCCCTGTCAGGAGTGGAAAAAAATTCTAGTTGGTTTA,10,30,14,27,27,45,27,50,27,35,35,45,40,50,14.36,37.87782755
hek293t,15306,1,4,ATTTGCAGAAAATTAAATCTACTTACAGGTGGACCCTGAGTTCCTCGACCACCTTTCAGACCAGGAACACCAGGAGGAAAAAAAATTCTAGTTGGTTTA,ATTTGCAGAAAATTAAATCTACTTACAGGTGGAGAACCCCTGAGTTCCTCGACCACCTTTCAGACCAGGAACACCAGGAGGAAAAAAAATTCTAGTTGG,10,30,14,27,27,41,27,45,27,34,34,41,38,45,29.02,32.13114021
hek293t,15306,1,4,TCACCCAGAAAATTAAATCTACTTACAGGTGGACCCTGAGTTCCTCGACCACCTTTCAGACCAGGAACACCAGGAAAAAAAATTCTAGTTGGTTTAACG,TCACCCAGAAAATTAAATCTACTTACAGGTGGAGAACCCCTGAGTTCCTCGACCACCTTTCAGACCAGGAACACCAGGAAAAAAAATTCTAGTTGGTTT,10,30,14,27,27,44,27,48,27,34,34,44,38,48,29.02,46.58915101
hek293t,15308,1,9,CCCCCTTTCATCTGATCACGTGTCCTAGCTGGACACTTTGGAGTGGTAAGGGAACCCTGAAATCTCTCATTTCCAGTCAAAAAAAATTCTAGTTGGTTT,CCCCCTTTCATCTGATCACGTGTCCTAGCTGGGATCCATCGACACTTTGGAGTGGTAAGGGAACCCTGAAATCTCTCATTTCCAGTCAAAAAAAATTCT,10,30,14,27,27,35,27,44,27,32,32,35,41,44,11.11,0.0
hek293t,15308,1,9,GCAAGTTTCATCTGATCACGTGTCCTAGCTGGACACTTTGGAGTGGTAAGGGAACCCTGAAATCTCTCATTTCCAAAAAAAATTCTAGTTGGTTTAACG,GCAAGTTTCATCTGATCACGTGTCCTAGCTGGGATCCATCGACACTTTGGAGTGGTAAGGGAACCCTGAAATCTCTCATTTCCAAAAAAAATTCTAGTT,10,30,14,27,27,39,27,48,27,32,32,39,41,48,11.11,0.583251201
hek293t,15310,1,14,TGGAGTTAAAAATCCTTTTCCATGTCACTTGGATTGTCAGTAGCAAAGTGACAGTCACTTTTATTTGGGTAAAAAAATTCTAGTTGGTTTAACGCGTAA,TGGAGTTAAAAATCCTTTTCCATGTCACACTGATGTGCCATATTGGATTGTCAGTAGCAAAGTGACAGTCACTTTTATTTGGGTAAAAAAATTCTAGTT,10,30,14,27,27,39,27,53,27,29,29,39,43,53,22.08,6.420584806
hek293t,15310,1,14,CCTGCTTAAAAATCCTTTTCCATGTCACTTGGATTGTCAGTAGCAAAGTGACAGTCACTTTTATTAAAAAAATTCTAGTTGGTTTAACGCGTAACTAGA,CCTGCTTAAAAATCCTTTTCCATGTCACACTGATGTGCCATATTGGATTGTCAGTAGCAAAGTGACAGTCACTTTTATTAAAAAAATTCTAGTTGGTTT,10,30,14,27,27,44,27,58,27,29,29,44,43,58,22.08,9.656461814
hek293t,15312,1,15,GCTCGGAGTGATAAAGGGTACAGATTTGTTGGTCGGCTTCATGGTCTTAGAATGATTTGTTGTTCAAAAAAAATTCTAGTTGGTTTAACGCGTAACTAG,GCTCGGAGTGATAAAGGGTACAGATTTGTTGGTCGGCTCCTGGGTCCGTGTAGTCATGGTCTTAGAATGATTTGTTGTTCAAAAAAAATTCTAGTTGGT,10,30,14,27,27,42,27,57,27,39,39,42,54,57,30.29,0.04100041
hek293t,15313,1,2,GGTCTCCCTGCACTTCGCTAAGGGGTGCACGGATGCATAAGGAAGAGTCATCCTAACAAGATGCTTAAAAAAATTCTAGTTGGTTTAACGCGTAACTAG,GGTCTCCCTGCACTTCGCTAAGGGGTGCACGGATGCATATCAGGAAGAGTCATCCTAACAAGATGCTTAAAAAAATTCTAGTTGGTTTAACGCGTAACT,10,30,14,27,27,55,27,57,27,40,40,55,42,57,70.33,73.53588177
hek293t,15313,1,2,GACTGCCCTGCACTTCGCTAAGGGGTGCACGGATGCATAAGGAAGAGTCATCCTAACAAGATGCTTTCAGGAAAAAAATTCTAGTTGGTTTAACGCGTA,GACTGCCCTGCACTTCGCTAAGGGGTGCACGGATGCATATCAGGAAGAGTCATCCTAACAAGATGCTTTCAGGAAAAAAATTCTAGTTGGTTTAACGCG,10,30,14,27,27,50,27,52,27,40,40,50,42,52,70.33,78.17566623
hek293t,15315,1,7,AGGCTTCCATGCCTTAGTTTCTCTCAGTGTGGAAAAAATCTGTGGAGTTTGCTGAAGTAGTATTCTTTCATACCAAAAAAATTCTAGTTGGTTTAACGC,AGGCTTCCATGCCTTAGTTTCTCTCAGTGTGGAAAGCCTTCAAAATCTGTGGAGTTTGCTGAAGTAGTATTCTTTCATACCAAAAAAATTCTAGTTGGT,10,30,14,27,27,42,27,49,27,35,35,42,42,49,54.25,1.378647171
hek293t,15315,1,7,AAAAATCCATGCCTTAGTTTCTCTCAGTGTGGAAAAAATCTGTGGAGTTTGCTGAAGTAGTATTCTAAAAAAATTCTAGTTGGTTTAACGCGTAACTAG,AAAAATCCATGCCTTAGTTTCTCTCAGTGTGGAAAGCCTTCAAAATCTGTGGAGTTTGCTGAAGTAGTATTCTAAAAAAATTCTAGTTGGTTTAACGCG,10,30,14,27,27,50,27,57,27,35,35,50,42,57,54.25,0.0
hek293t,15317,1,3,AGGTAAGCAGAGTACAGAAGGCTTATGACAGGCAGGGGTTAAGGTACACAAGACAGCAACAGAAAATAAGATAAAAAAATTCTAGTTGGTTTAACGCGT,AGGTAAGCAGAGTACAGAAGGCTTATGACAGGGAACAGGGGTTAAGGTACACAAGACAGCAACAGAAAATAAGATAAAAAAATTCTAGTTGGTTTAACG,10,30,14,27,27,48,27,51,27,33,33,48,36,51,75.39,79.89533281
hek293t,15317,1,3,ATCAGAGCAGAGTACAGAAGGCTTATGACAGGCAGGGGTTAAGGTACACAAGACAGCAACAGAAAATAAGATTCAAAAAAAAAATTCTAGTTGGTTTAA,ATCAGAGCAGAGTACAGAAGGCTTATGACAGGGAACAGGGGTTAAGGTACACAAGACAGCAACAGAAAATAAGATTCAAAAAAAAAATTCTAGTTGGTT,10,30,14,27,27,43,27,46,27,33,33,43,36,46,75.39,80.80479479
hek293t,15319,1,10,GGCCATCCTTGCACTGGTCTTCATGGCATAGGAAATGGTGGGACTGCAGCAGCCCTGAGTACGGAAAAAAATTCTAGTTGGTTTAACGCGTAACTAGAT,GGCCATCCTTGCACTGGTCTTCATGGCATAGGACCGCACGCTTAATGGTGGGACTGCAGCAGCCCTGAGTACGGAAAAAAATTCTAGTTGGTTTAACGC,10,30,14,27,27,49,27,59,27,34,34,49,44,59,38.94,54.78644833
hek293t,15319,1,10,GTCGTTCCTTGCACTGGTCTTCATGGCATAGGAAATGGTGGGACTGCAGCAGCCCTGAGTACGGTTGATTTAAAAAAAATTCTAGTTGGTTTAACGCGT,GTCGTTCCTTGCACTGGTCTTCATGGCATAGGACCGCACGCTTAATGGTGGGACTGCAGCAGCCCTGAGTACGGTTGATTTAAAAAAAATTCTAGTTGG,10,30,14,27,27,41,27,51,27,34,34,41,44,51,38.94,6.369495804
hek293t,15321,1,1,TAGACTTTCAGATTTTTAAATCTTACAGTTGGGTTAAGTCTCTGCAAGCACATATTAAGCTTGGTAAGACTATGAAAAAAATTCTAGTTGGTTTAACGC,TAGACTTTCAGATTTTTAAATCTTACAGTTGGGTTAAGTCATCTGCAAGCACATATTAAGCTTGGTAAGACTATGAAAAAAATTCTAGTTGGTTTAACG,10,30,14,27,27,48,27,49,27,41,41,48,42,49,5.3,46.16246735
hek293t,15323,1,4,CCGCCCTAAGTGTAATTATGCCTTAAAATTGGCATTCATTTACTGAGTTAGAAGCTGGGCTTAAGTGTTTCTCAGTCATCTTAAAAAAATTCTAGTTGG,CCGCCCTAAGTGTAATTATGCCTTAAAATAGACTGGCATTCATTTACTGAGTTAGAAGCTGGGCTTAAGTGTTTCTCAGTCATCTTAAAAAAATTCTAG,10,30,14,27,27,37,27,41,27,30,30,37,34,41,13.48,6.797959921
hek293t,15323,1,4,CTCGACTAAGTGTAATTATGCCTTAAAATTGGCATTCATTTACTGAGTTAGAAGCTGGGCTTAAGTGTTTCTCAAAAAAAATTCTAGTTGGTTTAACGC,CTCGACTAAGTGTAATTATGCCTTAAAATAGACTGGCATTCATTTACTGAGTTAGAAGCTGGGCTTAAGTGTTTCTCAAAAAAAATTCTAGTTGGTTTA,10,30,14,27,27,45,27,49,27,30,30,45,34,49,13.48,7.557791661
hek293t,15325,1,4,AGCCGTTCAGAGCTACACACACATTACCATGGGGCTAACAAATTACCTTGTCAGTGCTCTACAGTAATTCTTCATGGGCGTAAAAAAATTCTAGTTGGT,AGCCGTTCAGAGCTACACACACATTACGTTACATGGGGCTAACAAATTACCTTGTCAGTGCTCTACAGTAATTCTTCATGGGCGTAAAAAAATTCTAGT,10,30,14,27,27,38,27,42,27,28,28,38,32,42,68.37,81.62431079
hek293t,15325,1,4,TGTTGTTCAGAGCTACACACACATTACCATGGGGCTAACAAATTACCTTGTCAGTGCTCTACAGTAATTCTTCATGGGCGTATTTGTAAAAAAAATTCT,TGTTGTTCAGAGCTACACACACATTACGTTACATGGGGCTAACAAATTACCTTGTCAGTGCTCTACAGTAATTCTTCATGGGCGTATTTGTAAAAAAAA,10,30,14,27,27,31,27,35,27,28,28,31,32,35,68.37,6.382109891
hek293t,15327,1,3,GCCTCAGATTTTATGGTGGCAAAAGACACTGGGCGGAAGCAGTGAGGAAGGTGGTGAAAATGCAAAAACTAATATGGGTTTTAGTTAAAAAAATTCTAG,GCCTCAGATTTTATGGTGGCAAAAGAGGCCACTGGGCGGAAGCAGTGAGGAAGGTGGTGAAAATGCAAAAACTAATATGGGTTTTAGTTAAAAAAATTC,10,30,14,27,27,34,27,37,27,27,27,34,30,37,40.36,0.169779287
hek293t,15327,1,3,GGGGCAGATTTTATGGTGGCAAAAGACACTGGGCGGAAGCAGTGAGGAAGGTGGTGAAAATGCAAAAACTAATATGGGTTTTAAAAAAAATTCTAGTTG,GGGGCAGATTTTATGGTGGCAAAAGAGGCCACTGGGCGGAAGCAGTGAGGAAGGTGGTGAAAATGCAAAAACTAATATGGGTTTTAAAAAAAATTCTAG,10,30,14,27,27,37,27,40,27,27,27,37,30,40,40.36,0.937438069
hek293t,15330,1,10,GAGTCTTAAAAGCACTCAGGGAAGTGAGCTGGCAAAATCCAAATGGAGTAGTCAGATGTATTAAAAAAAAATTCTAGTTGGTTTAACGCGTAACTAGAT,GAGTCTTAAAAGCACTCAGGGAAGTGAGCTGGCAAAATCCCGAGGCGTCCAAATGGAGTAGTCAGATGTATTAAAAAAAAATTCTAGTTGGTTTAACGC,10,30,14,27,27,49,27,59,27,39,39,49,49,59,43.96,0.26560425
hek293t,15331,1,8,GTGCGTTATTGCTGCCAGTACAGACAAGCTGGCATTTCTTTCTCCAATATCTGTGAAGTAGATGGCAACCAAGGGGAGAAAAAAATTCTAGTTGGTTTA,GTGCGTTATTGCTGCCAGTACAGACACACTGAAAAGCTGGCATTTCTTTCTCCAATATCTGTGAAGTAGATGGCAACCAAGGGGAGAAAAAAATTCTAG,10,30,14,27,27,37,27,45,27,27,27,37,35,45,34.35,2.355119999
hek293t,15331,1,8,GGTGATTATTGCTGCCAGTACAGACAAGCTGGCATTTCTTTCTCCAATATCTGTGAAGTAGATGGCAACCAAGAAAAAAATTCTAGTTGGTTTAACGCG,GGTGATTATTGCTGCCAGTACAGACACACTGAAAAGCTGGCATTTCTTTCTCCAATATCTGTGAAGTAGATGGCAACCAAGAAAAAAATTCTAGTTGGT,10,30,14,27,27,42,27,50,27,27,27,42,35,50,34.35,2.914030126
hek293t,15333,1,14,TATAGCATGCATTCCCAATAGCTTGTGTCAGGTAAGGGTGGATGTGGGATGAAGGGTGGGGGGTGAAAAAAATTCTAGTTGGTTTAACGCGTAACTAGA,TATAGCATGCATTCCCAATAGCTTGTGTCAGGTAAGCATCAACGGAGGTGGGTGGATGTGGGATGAAGGGTGGGGGGTGAAAAAAATTCTAGTTGGTTT,10,30,14,27,27,44,27,58,27,37,37,44,51,58,47.98,3.86550219
hek293t,15336,1,15,ATCTTCAGATCTGAAGCCTTTCAGGCAAGAGGTTTGATTACAGTCACCTGCAGCAAAGTGCAAACTTCTACAAAAAAAATTCTAGTTGGTTTAACGCGT,ATCTTCAGATCTGAAGCCTTTCAGGCAAGAGGCAGATACCATTGCACTTTGATTACAGTCACCTGCAGCAAAGTGCAAACTTCTACAAAAAAAATTCTA,10,30,14,27,27,36,27,51,27,33,33,36,48,51,45.72,0.144144144
hek293t,15337,1,10,GTGGAAACCCACATCGTGGGTCTAAGGGCTGGGTGTGTAAAATATGCAAGTAAGGCAATTGTTGACACTACATCCAAAAAAATTCTAGTTGGTTTAACG,GTGGAAACCCACATCGTGGGTCTAAGGGCTGGGTTCAATTGACCGTGTAAAATATGCAAGTAAGGCAATTGTTGACACTACATCCAAAAAAATTCTAGT,10,30,14,27,27,38,27,48,27,35,35,38,45,48,46.65,0.0
hek293t,15338,1,11,AAAGAGGCATGATCTCCCTTGTGTCTGGAAGGATTCGGGTTTTGGGGGACGGGGCATTGCCTGTTTTTAGTAAACAAAAAAATTCTAGTTGGTTTAACG,AAAGAGGCATGATCTCCCTTGTGTCTGATGTCATAATGGAAGGATTCGGGTTTTGGGGGACGGGGCATTGCCTGTTTTTAGTAAACAAAAAAATTCTAG,10,30,14,27,27,37,27,48,27,27,27,37,38,48,57.68,21.50370315
hek293t,15338,1,11,CAATCGGCATGATCTCCCTTGTGTCTGGAAGGATTCGGGTTTTGGGGGACGGGGCATTGCCTGTTTTTAGTAAACAGTCAGGAAAAAAATTCTAGTTGG,CAATCGGCATGATCTCCCTTGTGTCTGATGTCATAATGGAAGGATTCGGGTTTTGGGGGACGGGGCATTGCCTGTTTTTAGTAAACAGTCAGGAAAAAA,10,30,14,27,27,30,27,41,27,27,27,30,38,41,57.68,0.0
hek293t,15340,1,8,GCCGGTGCCATTGTTGCTCAAATTAAAAAAGGAAAACCTTTACTTAAATAGATCTGTCAAACCTTTTCTAAAAAAATTCTAGTTGGTTTAACGCGTAAC,GCCGGTGCCATTGTTGCTCAAATTAAAAAACATTATCAGGAAAACCTTTACTTAAATAGATCTGTCAAACCTTTTCTAAAAAAATTCTAGTTGGTTTAA,10,30,14,27,27,46,27,54,27,31,31,46,39,54,2.39,0.0
hek293t,15340,1,8,TACGATGCCATTGTTGCTCAAATTAAAAAAGGAAAACCTTTACTTAAATAGATCTGTCAAACCTTTTCTGCCAAAAAAAAATTCTAGTTGGTTTAACGC,TACGATGCCATTGTTGCTCAAATTAAAAAACATTATCAGGAAAACCTTTACTTAAATAGATCTGTCAAACCTTTTCTGCCAAAAAAAAATTCTAGTTGG,10,30,14,27,27,41,27,49,27,31,31,41,39,49,2.39,0.0
hek293t,15342,1,15,CTAAGATGACAGTGACAAATACTGAATATTGGAAGTTCAAATTAAGCTCTCTTGGGAAGAAAAGAGGTAGCAAAAAAATTCTAGTTGGTTTAACGCGTA,CTAAGATGACAGTGACAAATACTGAATATTGGACTAGGGCACACAACGAGTTCAAATTAAGCTCTCTTGGGAAGAAAAGAGGTAGCAAAAAAATTCTAG,10,30,14,27,27,37,27,52,27,34,34,37,49,52,34.2,0.067992521
hek293t,15343,1,9,AGGCTGTCTTAGGACCAGCAAAAGATCATAGGAACATGGTGTGCTGAAGCACATTGCTGCTTCCATTTCTAAATAATTTGTGCCAAAAAAATTCTAGTT,AGGCTGTCTTAGGACCAGCAAAAGATATTGCAGTACATAGGAACATGGTGTGCTGAAGCACATTGCTGCTTCCATTTCTAAATAATTTGTGCCAAAAAA,10,30,14,27,27,30,27,39,27,27,27,30,36,39,61.93,2.770622205
hek293t,15343,1,9,TGGGGGTCTTAGGACCAGCAAAAGATCATAGGAACATGGTGTGCTGAAGCACATTGCTGCTTCCATTTCTAAATAATAAAAAAATTCTAGTTGGTTTAA,TGGGGGTCTTAGGACCAGCAAAAGATATTGCAGTACATAGGAACATGGTGTGCTGAAGCACATTGCTGCTTCCATTTCTAAATAATAAAAAAATTCTAG,10,30,14,27,27,37,27,46,27,27,27,37,36,46,61.93,0.930303067
hek293t,15345,1,1,AGGACGGAATAAATAGCAGTATGTAGATAAGGTAGTAGCCGCACGGGATCAGAAGCAGTGATGATGGGAACTTGAAAAAAAATTCTAGTTGGTTTAACG,AGGACGGAATAAATAGCAGTATGTAGATAAGGTAGTAGCACGCACGGGATCAGAAGCAGTGATGATGGGAACTTGAAAAAAAATTCTAGTTGGTTTAAC,10,30,14,27,27,47,27,48,27,40,40,47,41,48,29.78,73.52165773
hek293t,15345,1,1,ACGTTGGAATAAATAGCAGTATGTAGATAAGGTAGTAGCCGCACGGGATCAGAAGCAGTGATGATGGGAACTAAAAAAATTCTAGTTGGTTTAACGCGT,ACGTTGGAATAAATAGCAGTATGTAGATAAGGTAGTAGCACGCACGGGATCAGAAGCAGTGATGATGGGAACTAAAAAAATTCTAGTTGGTTTAACGCG,10,30,14,27,27,50,27,51,27,40,40,50,41,51,29.78,78.86374852
hek293t,0,1,7,GTTTTGTCTCTTTGGCCCCAGTTAGCCACTGGCAACTGGGGCCTGAGGGCAGCGAGCCAGCTGCCCTGCTCAGAGGCACTGCAAAAAAAATTCTAGTTG,GTTTTGTCTCTTTGGCCCCAGTTAGCCACCGCGTAATGGCAACTGGGGCCTGAGGGCAGCGAGCCAGCTGCCCTGCTCAGAGGCACTGCAAAAAAAATT,10,30,14,27,27,33,27,40,27,30,30,33,37,40,55.16,25.34384589
hek293t,15349,1,4,CAGTAATCCATGGAAGTCAGGGAATGTGTCGGTCTCCGTAAATCAGAATTTACAGGCTATTTCCTAAAAAAATTCTAGTTGGTTTAACGCGTAACTAGA,CAGTAATCCATGGAAGTCAGGGAATGTGTCGGTCTCCGGACATAAATCAGAATTTACAGGCTATTTCCTAAAAAAATTCTAGTTGGTTTAACGCGTAAC,10,30,14,27,27,54,27,58,27,39,39,54,43,58,68.72,6.508819322
hek293t,15349,1,4,CTTCGATCCATGGAAGTCAGGGAATGTGTCGGTCTCCGTAAATCAGAATTTACAGGCTATTTCCTAACTCGCAGTGTAAAAAAATTCTAGTTGGTTTAA,CTTCGATCCATGGAAGTCAGGGAATGTGTCGGTCTCCGGACATAAATCAGAATTTACAGGCTATTTCCTAACTCGCAGTGTAAAAAAATTCTAGTTGGT,10,30,14,27,27,42,27,46,27,39,39,42,43,46,68.72,2.612120077
hek293t,15351,1,10,AAGTCTCTTTTACAAAAGGAAAGCAGGGGAGGTGAGTAAAAGCACTACATGTACTTGAGCAAAGTATAAAAAAAATTCTAGTTGGTTTAACGCGTAACT,AAGTCTCTTTTACAAAAGGAAAGCAGGGGAGGTGCGAGCGAAGGAGTAAAAGCACTACATGTACTTGAGCAAAGTATAAAAAAAATTCTAGTTGGTTTA,10,30,14,27,27,45,27,55,27,35,35,45,45,55,31.69,0.0
hek293t,15351,1,10,GACCGTCTTTTACAAAAGGAAAGCAGGGGAGGTGAGTAAAAGCACTACATGTACTTGAGCAAAGTATAAAACGTGAAAAAAATTCTAGTTGGTTTAACG,GACCGTCTTTTACAAAAGGAAAGCAGGGGAGGTGCGAGCGAAGGAGTAAAAGCACTACATGTACTTGAGCAAAGTATAAAACGTGAAAAAAATTCTAGT,10,30,14,27,27,38,27,48,27,35,35,38,45,48,31.69,0.0
hek293t,15353,1,15,TCGCCCCTATAGTTTAGTAGCATACTCAGTGGAAAGACTGAACCATCTCTAATAGCATTGCTGATGAGAAAAAAATTCTAGTTGGTTTAACGCGTAACT,TCGCCCCTATAGTTTAGTAGCATACTCAGTGGAAAGAGAGTGACATGGTACACTGAACCATCTCTAATAGCATTGCTGATGAGAAAAAAATTCTAGTTG,10,30,14,27,27,40,27,55,27,37,37,40,52,55,65.01,0.056116723
hek293t,15353,1,15,CCGAGCCTATAGTTTAGTAGCATACTCAGTGGAAAGACTGAACCATCTCTAATAGCATTGCTGAAAAAAAATTCTAGTTGGTTTAACGCGTAACTAGAT,CCGAGCCTATAGTTTAGTAGCATACTCAGTGGAAAGAGAGTGACATGGTACACTGAACCATCTCTAATAGCATTGCTGAAAAAAAATTCTAGTTGGTTT,10,30,14,27,27,44,27,59,27,37,37,44,52,59,65.01,0.0
hek293t,15355,1,11,GCAACAAAGCTGCAATAGTAGAACACCACTGGTTAGGTGTGAGTCAGCCCCCCCCACTCAGGAAGGCAAAAAAATTCTAGTTGGTTTAACGCGTAACTA,GCAACAAAGCTGCAATAGTAGAACACCACTGGTTACGGTTCGAAGAGGTGTGAGTCAGCCCCCCCCACTCAGGAAGGCAAAAAAATTCTAGTTGGTTTA,10,30,14,27,27,45,27,56,27,35,35,45,46,56,49.25,2.324183663
hek293t,15356,1,2,CTTATGCAGCAGAGCCATACATAAGCATCAGGTTTAAGATGATGGTGATGAGGGAAAGGCATTTGTGAGGGAATGAAAAAAAATTCTAGTTGGTTTAAC,CTTATGCAGCAGAGCCATACATAAGCATCAGGTTTAAGCGATGATGGTGATGAGGGAAAGGCATTTGTGAGGGAATGAAAAAAAATTCTAGTTGGTTTA,10,30,14,27,27,45,27,47,27,38,38,45,40,47,48.23,70.53932156
hek293t,15356,1,2,ACGGAGCAGCAGAGCCATACATAAGCATCAGGTTTAAGATGATGGTGATGAGGGAAAGGCATTTGTGAGGGAAAAAAAAATTCTAGTTGGTTTAACGCG,ACGGAGCAGCAGAGCCATACATAAGCATCAGGTTTAAGCGATGATGGTGATGAGGGAAAGGCATTTGTGAGGGAAAAAAAAATTCTAGTTGGTTTAACG,10,30,14,27,27,48,27,50,27,38,38,48,40,50,48.23,63.02335819
hek293t,15360,1,8,CACGGCGTCACCGCGCCGTGTTTAGCTGATGGCGGCATCGTAAGAGGGGTATTATAGCACCACGTAGGTACTAGTTTAAAAAAATTCTAGTTGGTTTAA,CACGGCGTCACCGCGCCGTGTTTAGCTGATGGCGGTGTGGACGCATCGTAAGAGGGGTATTATAGCACCACGTAGGTACTAGTTTAAAAAAATTCTAGT,10,30,14,27,27,38,27,46,27,35,35,38,43,46,49.72,0.0
hek293t,15361,1,4,CGAGGATACTTCATAGTTAGTTAAAAGCAAGGTGAAGCTGCGTTATTTTTTCTTGAACTTTTCAGCCTTATAAAAAAATTCTAGTTGGTTTAACGCGTA,CGAGGATACTTCATAGTTAGTTAAAAGCAAGGTGAAGCTGTTGGCGTTATTTTTTCTTGAACTTTTCAGCCTTATAAAAAAATTCTAGTTGGTTTAACG,10,30,14,27,27,48,27,52,27,41,41,48,45,52,41.99,0.843516207
hek293t,15362,1,8,ACCCGCAACACAAAGCTCACCATATTTCTAGGAAAACTACTTATTTAAATGTTTCTTGTTTGTTTGGAAAAAAAAATTCTAGTTGGTTTAACGCGTAAC,ACCCGCAACACAAAGCTCACCATATTTCTACGGCGTCTGGAAAACTACTTATTTAAATGTTTCTTGTTTGTTTGGAAAAAAAAATTCTAGTTGGTTTAA,10,30,14,27,27,46,27,54,27,31,31,46,39,54,2.87,2.74574123
hek293t,15362,1,8,GGTATCAACACAAAGCTCACCATATTTCTAGGAAAACTACTTATTTAAATGTTTCTTGTTTGTTTGGAATCAACAAAAAAATTCTAGTTGGTTTAACGC,GGTATCAACACAAAGCTCACCATATTTCTACGGCGTCTGGAAAACTACTTATTTAAATGTTTCTTGTTTGTTTGGAATCAACAAAAAAATTCTAGTTGG,10,30,14,27,27,41,27,49,27,31,31,41,39,49,2.87,13.47805286
hek293t,15364,1,4,CCCTAAATCCTGTCCAACTGAAACAGCAAAGGATCCATTGTCCTCCGATAATCTTCAGTGAACTGAAAAAAATTCTAGTTGGTTTAACGCGTAACTAGA,CCCTAAATCCTGTCCAACTGAAACAGCAAAGGATCCATAATGTGTCCTCCGATAATCTTCAGTGAACTGAAAAAAATTCTAGTTGGTTTAACGCGTAAC,10,30,14,27,27,54,27,58,27,39,39,54,43,58,38.26,25.85823761
hek293t,15364,1,4,CGAATAATCCTGTCCAACTGAAACAGCAAAGGATCCATTGTCCTCCGATAATCTTCAGTGAACTGTGTGCAAAAAGCAAAAAAATTCTAGTTGGTTTAA,CGAATAATCCTGTCCAACTGAAACAGCAAAGGATCCATAATGTGTCCTCCGATAATCTTCAGTGAACTGTGTGCAAAAAGCAAAAAAATTCTAGTTGGT,10,30,14,27,27,42,27,46,27,39,39,42,43,46,38.26,0.09039548
hek293t,15366,1,1,CCATACATCCAGGCTCTTCTAACCCTGGGAGGTCAAAATGTACCACTGTCCCAAGGCCAGTGTGAAGGACAAAAAAAAATTCTAGTTGGTTTAACGCGT,CCATACATCCAGGCTCTTCTAACCCTGGGAGGTCAAAATGGTACCACTGTCCCAAGGCCAGTGTGAAGGACAAAAAAAAATTCTAGTTGGTTTAACGCG,10,30,14,27,27,50,27,51,27,40,40,50,41,51,58.34,4.636648037
hek293t,15366,1,1,CCCCACATCCAGGCTCTTCTAACCCTGGGAGGTCAAAATGTACCACTGTCCCAAGGCCAGTGTGAAGAAAAAAATTCTAGTTGGTTTAACGCGTAACTA,CCCCACATCCAGGCTCTTCTAACCCTGGGAGGTCAAAATGGTACCACTGTCCCAAGGCCAGTGTGAAGAAAAAAATTCTAGTTGGTTTAACGCGTAACT,10,30,14,27,27,55,27,56,27,40,40,55,41,56,58.34,9.094178598
hek293t,15368,1,8,CGTCTGGGAGCAGCGGGAACGCCTAGAATCGGGGGGCTCAAACTCGAGAATTCTGAAGGGTTCCGAGAAAAAAATTCTAGTTGGTTTAACGCGTAACTA,CGTCTGGGAGCAGCGGGAACGCCTAGAATCGGGGGGCTCATACACATGAACTCGAGAATTCTGAAGGGTTCCGAGAAAAAAATTCTAGTTGGTTTAACG,10,30,14,27,27,48,27,56,27,41,41,48,49,56,32.37,7.00932411
hek293t,15369,1,5,ACTGCTGGCTTCCTCCCAACACTCACAAATGGAAGAAAATTGGTGGAACAGCCTAGTGAGTGGGCAAGAAAAAAATTCTAGTTGGTTTAACGCGTAACT,ACTGCTGGCTTCCTCCCAACACTCACAAATGGAAGAAAAGGTTATTGGTGGAACAGCCTAGTGAGTGGGCAAGAAAAAAATTCTAGTTGGTTTAACGCG,10,30,14,27,27,50,27,55,27,40,40,50,45,55,48.1,0.280987666
hek293t,15370,1,6,GGAGCGCCTAACCATGTGTTAGACCCCTCTGGAAGGTCGAGTCCTGTGATGTTTCTCACCTGATGCAGCACTAAAAAAAAATTCTAGTTGGTTTAACGC,GGAGCGCCTAACCATGTGTTAGACCCCTCTGGATTGGTAAGGTCGAGTCCTGTGATGTTTCTCACCTGATGCAGCACTAAAAAAAAATTCTAGTTGGTT,10,30,14,27,27,43,27,49,27,33,33,43,39,49,46.3,77.71239511
hek293t,15370,1,6,CCACCGCCTAACCATGTGTTAGACCCCTCTGGAAGGTCGAGTCCTGTGATGTTTCTCACCTGATGCAGCACTAAGTAGCTTAAAAAAATTCTAGTTGGT,CCACCGCCTAACCATGTGTTAGACCCCTCTGGATTGGTAAGGTCGAGTCCTGTGATGTTTCTCACCTGATGCAGCACTAAGTAGCTTAAAAAAATTCTA,10,30,14,27,27,36,27,42,27,33,33,36,39,42,46.3,3.322749846
hek293t,15372,1,9,TTGGAATGCGCTACTGGTAACTACGTTTGAGGACAGTCTTCAACTTTTGCACTCCTTTTCCCCCCCCCTGCTTAAAAAAATTCTAGTTGGTTTAACGCG,TTGGAATGCGCTACTGGTAACTACGTTTGAGGATTTGGCCGCCAGTCTTCAACTTTTGCACTCCTTTTCCCCCCCCCTGCTTAAAAAAATTCTAGTTGG,10,30,14,27,27,41,27,50,27,34,34,41,43,50,66.41,8.017067778
hek293t,15374,1,10,TCGACCCGAGATGTCAAGCTGCTTTCCTGGGGATGAGCACAGAACACGTAGGACTGGAAGGGAACAGTTTTCCCTAAAAAAATTCTAGTTGGTTTAACG,TCGACCCGAGATGTCAAGCTGCTTTCCTGGCAGATGCGTGGGATGAGCACAGAACACGTAGGACTGGAAGGGAACAGTTTTCCCTAAAAAAATTCTAGT,10,30,14,27,27,38,27,48,27,31,31,38,41,48,65.74,12.22984926
hek293t,15374,1,10,ATACGCCGAGATGTCAAGCTGCTTTCCTGGGGATGAGCACAGAACACGTAGGACTGGAAGGGAACAGTTTTCCCTGTTGAAAAAAATTCTAGTTGGTTT,ATACGCCGAGATGTCAAGCTGCTTTCCTGGCAGATGCGTGGGATGAGCACAGAACACGTAGGACTGGAAGGGAACAGTTTTCCCTGTTGAAAAAAATTC,10,30,14,27,27,34,27,44,27,31,31,34,41,44,65.74,4.76384999
hek293t,15376,1,6,TCCTGTTCTCCCTTTTAGCATTTCATGAATGGTTTTAAGCTTGTGATTAATTGCTGGAGAAATGCTATGCCAAAAAAAAATTCTAGTTGGTTTAACGCG,TCCTGTTCTCCCTTTTAGCATTTCATGAATGGTTTTAAGCGTTCGATTGTGATTAATTGCTGGAGAAATGCTATGCCAAAAAAAAATTCTAGTTGGTTT,10,30,14,27,27,44,27,50,27,41,41,44,47,50,9.37,0.12300123
hek293t,15377,1,2,GAGGTCCGAGCGCTCCACATTTCCAGCTCTGGAGGGAAAAAGCAAGGACATGGGGACTTCTGAGATGAAAAAATAAAAAAATTCTAGTTGGTTTAACGC,GAGGTCCGAGCGCTCCACATTTCCAGCTCTGGAGGGGGAAAAAGCAAGGACATGGGGACTTCTGAGATGAAAAAATAAAAAAATTCTAGTTGGTTTAAC,10,30,14,27,27,47,27,49,27,37,37,47,39,49,42.66,9.300886904
hek293t,15377,1,2,TCTCACCGAGCGCTCCACATTTCCAGCTCTGGAGGGAAAAAGCAAGGACATGGGGACTTCTGAGATGAAAAAATCACTGGTAAAAAAATTCTAGTTGGT,TCTCACCGAGCGCTCCACATTTCCAGCTCTGGAGGGGGAAAAAGCAAGGACATGGGGACTTCTGAGATGAAAAAATCACTGGTAAAAAAATTCTAGTTG,10,30,14,27,27,40,27,42,27,37,37,40,39,42,42.66,71.231739
hek293t,15379,1,15,CCGTCCCGATGGTATGGGTTGCATTATGCAGGAATGATTCTTTTCAATGTTGTATACTACAGATTAGAGACTAAAAAAATTCTAGTTGGTTTAACGCGT,CCGTCCCGATGGTATGGGTTGCATTATGCAGGGAGTAGATGGTGTGAAATGATTCTTTTCAATGTTGTATACTACAGATTAGAGACTAAAAAAATTCTA,10,30,14,27,27,36,27,51,27,33,33,36,48,51,54.76,1.333525067
hek293t,15379,1,15,CTAAGCCGATGGTATGGGTTGCATTATGCAGGAATGATTCTTTTCAATGTTGTATACTACAGATTAGAAAAAAAATTCTAGTTGGTTTAACGCGTAACT,CTAAGCCGATGGTATGGGTTGCATTATGCAGGGAGTAGATGGTGTGAAATGATTCTTTTCAATGTTGTATACTACAGATTAGAAAAAAAATTCTAGTTG,10,30,14,27,27,40,27,55,27,33,33,40,48,55,54.76,0.11554015
hek293t,15381,1,5,GCCCACCGGAGCAGAGCTAACGCCTCGAGCGGTGGCAGGGCACCAGGCGCTTTTTTGGGGCCACAGGGAATGCAGCTAGAAAAAAATTCTAGTTGGTTT,GCCCACCGGAGCAGAGCTAACGCCTCGAGCGCCGATGTGGCAGGGCACCAGGCGCTTTTTTGGGGCCACAGGGAATGCAGCTAGAAAAAAATTCTAGTT,10,30,14,27,27,39,27,44,27,32,32,39,37,44,53.82,86.58191624
hek293t,15383,1,10,CTCGTTGGAAACTTTCTTTTCTTGCCTTTTGGTTTGCAGATGGGATAAATAATCTACATGGAAACTAACTACACTTTAAAAAAATTCTAGTTGGTTTAA,CTCGTTGGAAACTTTCTTTTCTTGCCTTATCGAGTCAGTTGGTTTGCAGATGGGATAAATAATCTACATGGAAACTAACTACACTTTAAAAAAATTCTA,10,30,14,27,27,36,27,46,27,29,29,36,39,46,1.39,0.646175884
hek293t,15385,1,9,CTATTGCCAATTGGCAGCCTTTCAAATGTAGGCTATCACATTGGCAAATTCTCCATTTCCTACAAGTCTATGTGATAAAAAAATTCTAGTTGGTTTAAC,CTATTGCCAATTGGCAGCCTTTCAAATTGGCTTAAAGTAGGCTATCACATTGGCAAATTCTCCATTTCCTACAAGTCTATGTGATAAAAAAATTCTAGT,10,30,14,27,27,38,27,47,27,28,28,38,37,47,39.27,15.89609001
hek293t,15385,1,9,GCTTCGCCAATTGGCAGCCTTTCAAATGTAGGCTATCACATTGGCAAATTCTCCATTTCCTACAAGTCTATGTGATATACAGAAAAAAAATTCTAGTTG,GCTTCGCCAATTGGCAGCCTTTCAAATTGGCTTAAAGTAGGCTATCACATTGGCAAATTCTCCATTTCCTACAAGTCTATGTGATATACAGAAAAAAAA,10,30,14,27,27,31,27,40,27,28,28,31,37,40,39.27,1.043246862
hek293t,15387,1,11,GTGGGTAGAGATTTATATGCAGGTTGCTGTGGGCTGTATGAGGTCAGCATGATACAGTATTCTGAACATAAAAAAAATTCTAGTTGGTTTAACGCGTAA,GTGGGTAGAGATTTATATGCAGGTTGCTGTGTCCGATCTACTGGCTGTATGAGGTCAGCATGATACAGTATTCTGAACATAAAAAAAATTCTAGTTGGT,10,30,14,27,27,42,27,53,27,32,32,42,43,53,41.77,6.637701777
hek293t,15387,1,11,CTGGTTAGAGATTTATATGCAGGTTGCTGTGGGCTGTATGAGGTCAGCATGATACAGTATTCTGAACATAAGCAAAAAAATTCTAGTTGGTTTAACGCG,CTGGTTAGAGATTTATATGCAGGTTGCTGTGTCCGATCTACTGGCTGTATGAGGTCAGCATGATACAGTATTCTGAACATAAGCAAAAAAATTCTAGTT,10,30,14,27,27,39,27,50,27,32,32,39,43,50,41.77,3.34845866
hek293t,15389,1,7,GGGTCAGTGTTGCAGGTGGCAGACAGCTGCGGTGCACCGTCTTGACCAGCATCCTGCCAGGACAACCCACGAGCTAAGCAAAAAAATTCTAGTTGGTTT,GGGTCAGTGTTGCAGGTGGCAGACAGCTGCGGTCTGTCGCGCACCGTCTTGACCAGCATCCTGCCAGGACAACCCACGAGCTAAGCAAAAAAATTCTAG,10,30,14,27,27,37,27,44,27,34,34,37,41,44,61.63,1.077943615
hek293t,15389,1,7,TCCTAAGTGTTGCAGGTGGCAGACAGCTGCGGTGCACCGTCTTGACCAGCATCCTGCCAGGACAACCCACGAGCTAAAAAAATTCTAGTTGGTTTAACG,TCCTAAGTGTTGCAGGTGGCAGACAGCTGCGGTCTGTCGCGCACCGTCTTGACCAGCATCCTGCCAGGACAACCCACGAGCTAAAAAAATTCTAGTTGG,10,30,14,27,27,41,27,48,27,34,34,41,41,48,61.63,2.611497025
hek293t,15392,1,7,TGTAGCTCTCTAATAAAATACTTCTCTGGTGGAGAGACTAAATTTAAATGTATAGTTACAGAGTTGCAGACTTCAAAAAAATTCTAGTTGGTTTAACGC,TGTAGCTCTCTAATAAAATACTTCTCATGGAGTTGGTGGAGAGACTAAATTTAAATGTATAGTTACAGAGTTGCAGACTTCAAAAAAATTCTAGTTGGT,10,30,14,27,27,42,27,49,27,27,27,42,34,49,42.75,3.236191267
hek293t,15392,1,7,AATGGCTCTCTAATAAAATACTTCTCTGGTGGAGAGACTAAATTTAAATGTATAGTTACAGAGTTGCAGACTTCACCCAGACTATAAAAAAAATTCTAG,AATGGCTCTCTAATAAAATACTTCTCATGGAGTTGGTGGAGAGACTAAATTTAAATGTATAGTTACAGAGTTGCAGACTTCACCCAGACTATAAAAAAA,10,30,14,27,27,30,27,37,27,27,27,30,34,37,42.75,0.0
hek293t,15394,1,3,CACACCCAGAGATATAACAGTAATCCAGGAGGGATTTTGAGAATTACCATATTACTCACAGTAAATGTAAAAAAAATTCTAGTTGGTTTAACGCGTAAC,CACACCCAGAGATATAACAGTAATCCAGGAGGGATTTTGAGTCGAATTACCATATTACTCACAGTAAATGTAAAAAAAATTCTAGTTGGTTTAACGCGT,10,30,14,27,27,51,27,54,27,41,41,51,44,54,57.02,4.365913703
hek293t,15394,1,3,AGTAGCCAGAGATATAACAGTAATCCAGGAGGGATTTTGAGAATTACCATATTACTCACAGTAAAAAAAAATTCTAGTTGGTTTAACGCGTAACTAGAT,AGTAGCCAGAGATATAACAGTAATCCAGGAGGGATTTTGAGTCGAATTACCATATTACTCACAGTAAAAAAAAATTCTAGTTGGTTTAACGCGTAACTA,10,30,14,27,27,56,27,59,27,41,41,56,44,59,57.02,4.642444353
hek293t,15397,1,1,CCTTGTGTTTTAAGTAGCAGTAGAGTCTTTGGAGCTGCCTGCAGACTTGAGATTTTAGACTAATCTATCACCTGGATGTAAAAAAATTCTAGTTGGTTT,CCTTGTGTTTTAAGTAGCAGTAGAGTCTTTGGAGCTGCCCTGCAGACTTGAGATTTTAGACTAATCTATCACCTGGATGTAAAAAAATTCTAGTTGGTT,10,30,14,27,27,43,27,44,27,40,40,43,41,44,18.79,3.502532423
hek293t,15399,1,8,CGAAAAATATGGAAGCCAGTATATTGTCTAGGAAGCAGGCCTCTGGGATCTCAGCCCACCATCACTGAAAAAAAATTCTAGTTGGTTTAACGCGTAACT,CGAAAAATATGGAAGCCAGTATATTGTCTAGGAAGCAGGTCTAAAGGCCTCTGGGATCTCAGCCCACCATCACTGAAAAAAAATTCTAGTTGGTTTAAC,10,30,14,27,27,47,27,55,27,37,37,47,45,55,48.66,5.670892172
hek293t,15400,1,9,TTGTTACAATGCTGGTTTTGTGGATGTAATGGTTGCTCCTGTATGCAACTAGTGCTGAATTTGGAAAAAAAATTCTAGTTGGTTTAACGCGTAACTAGA,TTGTTACAATGCTGGTTTTGTGGATGTAATGGTTCATATACTTGCTCCTGTATGCAACTAGTGCTGAATTTGGAAAAAAAATTCTAGTTGGTTTAACGC,10,30,14,27,27,49,27,58,27,34,34,49,43,58,18.22,0.40376021
hek293t,15400,1,9,AATAAACAATGCTGGTTTTGTGGATGTAATGGTTGCTCCTGTATGCAACTAGTGCTGAATTTGGATCTTTAAAAAAATTCTAGTTGGTTTAACGCGTAA,AATAAACAATGCTGGTTTTGTGGATGTAATGGTTCATATACTTGCTCCTGTATGCAACTAGTGCTGAATTTGGATCTTTAAAAAAATTCTAGTTGGTTT,10,30,14,27,27,44,27,53,27,34,34,44,43,53,18.22,0.535007218
hek293t,15404,1,2,AGGCCTGACTTTCCCCCTGTGTAAGGCAGTGGTGTGATCCCACTTGGGCCATGATCCCTGGGCTTTAAGAAGTTTGACATGAAAAAAATTCTAGTTGGT,AGGCCTGACTTTCCCCCTGTGTAAGGCAGTGGTGTGCTATCCCACTTGGGCCATGATCCCTGGGCTTTAAGAAGTTTGACATGAAAAAAATTCTAGTTG,10,30,14,27,27,40,27,42,27,37,37,40,39,42,43.78,8.001247631
hek293t,15404,1,2,ATGATTGACTTTCCCCCTGTGTAAGGCAGTGGTGTGATCCCACTTGGGCCATGATCCCTGGGCTTTAAGAAAAAAATTCTAGTTGGTTTAACGCGTAAC,ATGATTGACTTTCCCCCTGTGTAAGGCAGTGGTGTGCTATCCCACTTGGGCCATGATCCCTGGGCTTTAAGAAAAAAATTCTAGTTGGTTTAACGCGTA,10,30,14,27,27,52,27,54,27,37,37,52,39,54,43.78,71.17292828
hek293t,15406,1,8,AAGCCAAGTGCGTTCCTGCCCGGAGCAGATGGCTCGGGTCTCCGTGTGGAGCACTAATGAGTAACCCCAGCGCGAAAAAAATTCTAGTTGGTTTAACGC,AAGCCAAGTGCGTTCCTGCCCGGAGCAGATGGCTCGGTAAGAGTAGTCTCCGTGTGGAGCACTAATGAGTAACCCCAGCGCGAAAAAAATTCTAGTTGG,10,30,14,27,27,41,27,49,27,38,38,41,46,49,40.84,0.0
hek293t,15408,1,7,CGAAATCAGAGCTCCACAGAGGCTGACAGAGGTGAGGGGAAGGGGTTGCCAGTCACCGATGGGCAACAGGAGCACCAAAAAAAATTCTAGTTGGTTTAA,CGAAATCAGAGCTCCACAGAGGCTGACATAATGAAGAGGTGAGGGGAAGGGGTTGCCAGTCACCGATGGGCAACAGGAGCACCAAAAAAAATTCTAGTT,10,30,14,27,27,39,27,46,27,29,29,39,36,46,64.17,8.093861946
hek293t,15408,1,7,AAAGATCAGAGCTCCACAGAGGCTGACAGAGGTGAGGGGAAGGGGTTGCCAGTCACCGATGGGCAACAGGAGAAAAAAATTCTAGTTGGTTTAACGCGT,AAAGATCAGAGCTCCACAGAGGCTGACATAATGAAGAGGTGAGGGGAAGGGGTTGCCAGTCACCGATGGGCAACAGGAGAAAAAAATTCTAGTTGGTTT,10,30,14,27,27,44,27,51,27,29,29,44,36,51,64.17,12.27815317
hek293t,15410,1,8,CCTCCCTATCAAAAGGCTACTTACTTTCCAGGCAGGACATGGTAGTATTGCAGGCCCATCTCACAGAAAAAAAATTCTAGTTGGTTTAACGCGTAACTA,CCTCCCTATCAAAAGGCTACTTACTTTCCAGGCAGGATTGAATTCCATGGTAGTATTGCAGGCCCATCTCACAGAAAAAAAATTCTAGTTGGTTTAACG,10,30,14,27,27,48,27,56,27,38,38,48,46,56,14.96,0.896171341
hek293t,15410,1,8,CTATACTATCAAAAGGCTACTTACTTTCCAGGCAGGACATGGTAGTATTGCAGGCCCATCTCACAGACCATGACAAAAAAATTCTAGTTGGTTTAACGC,CTATACTATCAAAAGGCTACTTACTTTCCAGGCAGGATTGAATTCCATGGTAGTATTGCAGGCCCATCTCACAGACCATGACAAAAAAATTCTAGTTGG,10,30,14,27,27,41,27,49,27,38,38,41,46,49,14.96,0.0
hek293t,15414,1,13,ACGACTAAGCCAGAGCCATGATCAGAATATGGAGGAATTCATGATTTGGTGAAATTATTTAAGGAATAAAAAAATTCTAGTTGGTTTAACGCGTAACTA,ACGACTAAGCCAGAGCCATGATCAGAAGAAAGTAATTAAGTATGGAGGAATTCATGATTTGGTGAAATTATTTAAGGAATAAAAAAATTCTAGTTGGTT,10,30,14,27,27,43,27,56,27,28,28,43,41,56,29.4,17.00418263
hek293t,15414,1,13,TGTTCTAAGCCAGAGCCATGATCAGAATATGGAGGAATTCATGATTTGGTGAAATTATTTAAGGAATTAAGGAAATTATAAAAAAATTCTAGTTGGTTT,TGTTCTAAGCCAGAGCCATGATCAGAAGAAAGTAATTAAGTATGGAGGAATTCATGATTTGGTGAAATTATTTAAGGAATTAAGGAAATTATAAAAAAA,10,30,14,27,27,31,27,44,27,28,28,31,41,44,29.4,0.058173357
hek293t,15416,1,1,ATGCGCTTCTATATGGTCAATATCAAATCTGGCTTCATGGAAATTTCTAAAGAGTGAATAGAATAACATCCCCCCAAAAGAAAAAAATTCTAGTTGGTT,ATGCGCTTCTATATGGTCAATATCAAATCTGAGCTTCATGGAAATTTCTAAAGAGTGAATAGAATAACATCCCCCCAAAAGAAAAAAATTCTAGTTGGT,10,30,14,27,27,42,27,43,27,32,32,42,33,43,24.67,79.73879746
hek293t,15418,1,12,GCCGGTCTACTCCAAAGTACACTTATTGAAGGAATATATTCTCTTCTACAGTATATTATATAAGCTGCTACAAAAAAAATTCTAGTTGGTTTAACGCGT,GCCGGTCTACTCCAAAGTACACTTATTGAAGGAATGAGACAAGGCGCATATTCTCTTCTACAGTATATTATATAAGCTGCTACAAAAAAAATTCTAGTT,10,30,14,27,27,39,27,51,27,36,36,39,48,51,41.12,0.0
hek293t,15419,1,8,CGCTCTCTGCTCGGAATGTCCTAATGCCAAGGAGATTAAGACGTTTATTTCTCAGTGTGTTTAGTCCTAGTTTAAAGAAAAAAATTCTAGTTGGTTTAA,CGCTCTCTGCTCGGAATGTCCTAATGCGGATCATTCAAGGAGATTAAGACGTTTATTTCTCAGTGTGTTTAGTCCTAGTTTAAAGAAAAAAATTCTAGT,10,30,14,27,27,38,27,46,27,28,28,38,36,46,49.37,1.213074192
hek293t,15419,1,8,GCATTTCTGCTCGGAATGTCCTAATGCCAAGGAGATTAAGACGTTTATTTCTCAGTGTGTTTAGTCCTAGTTAAAAAAATTCTAGTTGGTTTAACGCGT,GCATTTCTGCTCGGAATGTCCTAATGCGGATCATTCAAGGAGATTAAGACGTTTATTTCTCAGTGTGTTTAGTCCTAGTTAAAAAAATTCTAGTTGGTT,10,30,14,27,27,43,27,51,27,28,28,43,36,51,49.37,2.567678952
hek293t,15422,1,3,TTCGCTGAAATGAGACATTCATTAGCCACAGGTAAAAGAAATGAAGAATTAATAAATTGTTGCATTGCTTAAAAAAATTCTAGTTGGTTTAACGCGTAA,TTCGCTGAAATGAGACATTCATTAGCCACAGGTATTCAAAGAAATGAAGAATTAATAAATTGTTGCATTGCTTAAAAAAATTCTAGTTGGTTTAACGCG,10,30,14,27,27,50,27,53,27,35,35,50,38,53,49.95,31.79196176
hek293t,15422,1,3,GGATCTGAAATGAGACATTCATTAGCCACAGGTAAAAGAAATGAAGAATTAATAAATTGTTGCATTGCTTAGACCATTAAAAAAATTCTAGTTGGTTTA,GGATCTGAAATGAGACATTCATTAGCCACAGGTATTCAAAGAAATGAAGAATTAATAAATTGTTGCATTGCTTAGACCATTAAAAAAATTCTAGTTGGT,10,30,14,27,27,42,27,45,27,35,35,42,38,45,49.95,76.67606443
hek293t,15424,1,5,AAATCTGAGGTTTTCACATTGCTCCTGAATGGGACTACAGGTAGCCCTATTGATGATATCAGAGGGGCAAGTTAAAAAAAATTCTAGTTGGTTTAACGC,AAATCTGAGGTTTTCACATTGCTCCTGAAGGCGATGGGACTACAGGTAGCCCTATTGATGATATCAGAGGGGCAAGTTAAAAAAAATTCTAGTTGGTTT,10,30,14,27,27,44,27,49,27,29,29,44,34,49,27.6,66.096969
hek293t,15424,1,5,GAACGTGAGGTTTTCACATTGCTCCTGAATGGGACTACAGGTAGCCCTATTGATGATATCAGAGGGGCAAGTTAAAGAAAAAAAAATTCTAGTTGGTTT,GAACGTGAGGTTTTCACATTGCTCCTGAAGGCGATGGGACTACAGGTAGCCCTATTGATGATATCAGAGGGGCAAGTTAAAGAAAAAAAAATTCTAGTT,10,30,14,27,27,39,27,44,27,29,29,39,34,44,27.6,44.13902448
hek293t,15426,1,6,GATCTGCATGTGTTACCAGATAGCCAGCGTGGGCTAAGAGCCATTGAATTTTGGAATAAAGCTGATTCGAAAGGTAAAAAAATTCTAGTTGGTTTAACG,GATCTGCATGTGTTACCAGATAGCCAGCGTGGGCTAAGCTGGTCAGCCATTGAATTTTGGAATAAAGCTGATTCGAAAGGTAAAAAAATTCTAGTTGGT,10,30,14,27,27,42,27,48,27,39,39,42,45,48,59.98,0.0
hek293t,15426,1,6,GCATGGCATGTGTTACCAGATAGCCAGCGTGGGCTAAGAGCCATTGAATTTTGGAATAAAGCTGATTCGAAAAAAAAATTCTAGTTGGTTTAACGCGTA,GCATGGCATGTGTTACCAGATAGCCAGCGTGGGCTAAGCTGGTCAGCCATTGAATTTTGGAATAAAGCTGATTCGAAAAAAAAATTCTAGTTGGTTTAA,10,30,14,27,27,46,27,52,27,39,39,46,45,52,59.98,1.042033687
hek293t,15428,1,3,CCAAGGTCAGGTAAAGTTGCAGGGTGTTTAGGAGTTCCTTTCCAATTTCCTTGGTCTCCAGGTTAGCTTGAAAAAAAAATTCTAGTTGGTTTAACGCGT,CCAAGGTCAGGTAAAGTTGCAGGGTGTTTAGGAGTTCCTTATATCCAATTTCCTTGGTCTCCAGGTTAGCTTGAAAAAAAAATTCTAGTTGGTTTAACG,10,30,14,27,27,48,27,51,27,41,41,48,44,51,21.87,67.00342359
hek293t,15428,1,3,ATTGCGTCAGGTAAAGTTGCAGGGTGTTTAGGAGTTCCTTTCCAATTTCCTTGGTCTCCAGGTTAGCTTAAAAAAATTCTAGTTGGTTTAACGCGTAAC,ATTGCGTCAGGTAAAGTTGCAGGGTGTTTAGGAGTTCCTTATATCCAATTTCCTTGGTCTCCAGGTTAGCTTAAAAAAATTCTAGTTGGTTTAACGCGT,10,30,14,27,27,51,27,54,27,41,41,51,44,54,21.87,71.81683759
hek293t,15430,1,2,ACTAATAGCTTACTGATCTGTCACCTAATTGGGTGAAACATTTCATGTGCAACTGCTGTTGCAGTGCTTTATACTTCCAAAAAAATTCTAGTTGGTTTA,ACTAATAGCTTACTGATCTGTCACCTAATTGGATGTGAAACATTTCATGTGCAACTGCTGTTGCAGTGCTTTATACTTCCAAAAAAATTCTAGTTGGTT,10,30,14,27,27,43,27,45,27,33,33,43,35,45,12.76,87.7651499
hek293t,15430,1,2,CGATATAGCTTACTGATCTGTCACCTAATTGGGTGAAACATTTCATGTGCAACTGCTGTTGCAGTGCTTTATACTTCCTTTAAAAAAATTCTAGTTGGT,CGATATAGCTTACTGATCTGTCACCTAATTGGATGTGAAACATTTCATGTGCAACTGCTGTTGCAGTGCTTTATACTTCCTTTAAAAAAATTCTAGTTG,10,30,14,27,27,40,27,42,27,33,33,40,35,42,12.76,89.04660628
hek293t,15432,1,2,GGACTTGAAAGGATTTAAAGGGCCATCTTAGGAATAATTATGATAATAAATTTGCATTTATAAAGCCTGCCTCCACTCATAAAAAAATTCTAGTTGGTT,GGACTTGAAAGGATTTAAAGGGCCATCTTAAAGGAATAATTATGATAATAAATTTGCATTTATAAAGCCTGCCTCCACTCATAAAAAAATTCTAGTTGG,10,30,14,27,27,41,27,43,27,31,31,41,33,43,17.05,14.84484098
hek293t,15432,1,2,ATGCGTGAAAGGATTTAAAGGGCCATCTTAGGAATAATTATGATAATAAATTTGCATTTATAAAGCCTGCCTCCACTCATCCTTGTCAAAAAAATTCTA,ATGCGTGAAAGGATTTAAAGGGCCATCTTAAAGGAATAATTATGATAATAAATTTGCATTTATAAAGCCTGCCTCCACTCATCCTTGTCAAAAAAATTC,10,30,14,27,27,34,27,36,27,31,31,34,33,36,17.05,0.0
hek293t,15434,1,5,TAAGCAAATTACACCAATACAGCCTCTCTTGGTAACCAACAGTGTGGGCGGGAGCACTTCAAAAGGGATCTGAAAAAAATTCTAGTTGGTTTAACGCGT,TAAGCAAATTACACCAATACAGCCTCTCTTTGGGTGGTAACCAACAGTGTGGGCGGGAGCACTTCAAAAGGGATCTGAAAAAAATTCTAGTTGGTTTAA,10,30,14,27,27,46,27,51,27,31,31,46,36,51,39.55,82.88342903
hek293t,15434,1,5,CCCCCAAATTACACCAATACAGCCTCTCTTGGTAACCAACAGTGTGGGCGGGAGCACTTCAAAAGGGATCTGAACGAGCAAAAAAAATTCTAGTTGGTT,CCCCCAAATTACACCAATACAGCCTCTCTTTGGGTGGTAACCAACAGTGTGGGCGGGAGCACTTCAAAAGGGATCTGAACGAGCAAAAAAAATTCTAGT,10,30,14,27,27,38,27,43,27,31,31,38,36,43,39.55,40.01218895
hek293t,15438,1,13,CGGTCTGTTCTGTAAAACAGTCCAGTGTAAGGTGCCATAGGAAAATTGGCACAGTCAAGTTGACCAAAAAAAATTCTAGTTGGTTTAACGCGTAACTAG,CGGTCTGTTCTGTAAAACAGTCCAGTGTAAGGTCCGCGTTAACCAGGCCATAGGAAAATTGGCACAGTCAAGTTGACCAAAAAAAATTCTAGTTGGTTT,10,30,14,27,27,44,27,57,27,34,34,44,47,57,50.16,0.08361204
hek293t,15438,1,13,GCAGCTGTTCTGTAAAACAGTCCAGTGTAAGGTGCCATAGGAAAATTGGCACAGTCAAGTTGACCAATTTGTTAAAAAAATTCTAGTTGGTTTAACGCG,GCAGCTGTTCTGTAAAACAGTCCAGTGTAAGGTCCGCGTTAACCAGGCCATAGGAAAATTGGCACAGTCAAGTTGACCAATTTGTTAAAAAAATTCTAG,10,30,14,27,27,37,27,50,27,34,34,37,47,50,50.16,0.0
hek293t,15440,1,7,CTGGGGCGGTCACTGTTCTAGCCCAGAAGTGGAAGCCCTGTTCAGTTCACCTGAAGTTTAAGAAACTTGGGAAAAAAATTCTAGTTGGTTTAACGCGTA,CTGGGGCGGTCACTGTTCTAGCCCAGAAGTGGAAGAGACTTGCCCTGTTCAGTTCACCTGAAGTTTAAGAAACTTGGGAAAAAAATTCTAGTTGGTTTA,10,30,14,27,27,45,27,52,27,35,35,45,42,52,49.94,69.47057052
hek293t,15440,1,7,TTAGGGCGGTCACTGTTCTAGCCCAGAAGTGGAAGCCCTGTTCAGTTCACCTGAAGTTTAAGAAACTTGGGTTCAAGTAAAAAAATTCTAGTTGGTTTA,TTAGGGCGGTCACTGTTCTAGCCCAGAAGTGGAAGAGACTTGCCCTGTTCAGTTCACCTGAAGTTTAAGAAACTTGGGTTCAAGTAAAAAAATTCTAGT,10,30,14,27,27,38,27,45,27,35,35,38,42,45,49.94,0.648508431
hek293t,15443,1,1,CTCCGTGCTGTAGAGCTGAATTAAATGCCAGGCGTGCGCTGTTGCCTCAGAACAATTACCTGTGCTTAGAGAAACGAAAAAAATTCTAGTTGGTTTAAC,CTCCGTGCTGTAGAGCTGAATTAAATGCCAGGCGTGCGCCTGTTGCCTCAGAACAATTACCTGTGCTTAGAGAAACGAAAAAAATTCTAGTTGGTTTAA,10,30,14,27,27,46,27,47,27,39,39,46,40,47,64.86,68.91731851
hek293t,15447,1,13,ATTGGTCTCTGTGTGGTTCTCCTCGTTAGCGGTATCCAGATCACAGGCAATGCTGCTCAGTTTCACAAAAAAAATTCTAGTTGGTTTAACGCGTAACTA,ATTGGTCTCTGTGTGGTTCTCCTCGTTAAGTAAGTCTCCGAGCGGTATCCAGATCACAGGCAATGCTGCTCAGTTTCACAAAAAAAATTCTAGTTGGTT,10,30,14,27,27,43,27,56,27,28,28,43,41,56,64.63,26.99548259
hek293t,15447,1,13,GATATTCTCTGTGTGGTTCTCCTCGTTAGCGGTATCCAGATCACAGGCAATGCTGCTCAGTTTCACAGCCTATGTAAAAAAATTCTAGTTGGTTTAACG,GATATTCTCTGTGTGGTTCTCCTCGTTAAGTAAGTCTCCGAGCGGTATCCAGATCACAGGCAATGCTGCTCAGTTTCACAGCCTATGTAAAAAAATTCT,10,30,14,27,27,35,27,48,27,28,28,35,41,48,64.63,3.564775717
hek293t,15449,1,7,GCAGTACGACAGTTGCTTTTGTCTGAAATAGGCACAAACTTGAACGTTTCTGTGCTGTTAACTTTTATAAAAAAATTCTAGTTGGTTTAACGCGTAACT,GCAGTACGACAGTTGCTTTTGTCTGAAATAGGCACAATACTACCACTTGAACGTTTCTGTGCTGTTAACTTTTATAAAAAAATTCTAGTTGGTTTAACG,10,30,14,27,27,48,27,55,27,38,38,48,45,55,5.3,3.87590078
hek293t,15450,1,14,CCCAGTTCCTCCTGCAGACAGACCGCATTAGGGAGTTCAGGAATGGAATAGTCTGTATCAGGCATATTCTCAAAAAAATTCTAGTTGGTTTAACGCGTA,CCCAGTTCCTCCTGCAGACAGACCGCATTAGGGAAATAGAGAATTTGTGTTCAGGAATGGAATAGTCTGTATCAGGCATATTCTCAAAAAAATTCTAGT,10,30,14,27,27,38,27,52,27,35,35,38,49,52,27.37,0.0
hek293t,15450,1,14,TGACGTTCCTCCTGCAGACAGACCGCATTAGGGAGTTCAGGAATGGAATAGTCTGTATCAGGCATATAAAAAAATTCTAGTTGGTTTAACGCGTAACTA,TGACGTTCCTCCTGCAGACAGACCGCATTAGGGAAATAGAGAATTTGTGTTCAGGAATGGAATAGTCTGTATCAGGCATATAAAAAAATTCTAGTTGGT,10,30,14,27,27,42,27,56,27,35,35,42,49,56,27.37,0.165945166
hek293t,15452,1,12,AGTAACTGAAGTATTGATTGTAAATAACTTGGTTAGAAAAATAGTTTGTGTTTGCTTATTTGTAGGTCTGTTTAAAAAAATTCTAGTTGGTTTAACGCG,AGTAACTGAAGTATTGATTGTAAATAACTTGGTTAACAGCGCAGACAGAAAAATAGTTTGTGTTTGCTTATTTGTAGGTCTGTTTAAAAAAATTCTAGT,10,30,14,27,27,38,27,50,27,35,35,38,47,50,26.93,0.0
hek293t,15453,1,15,CGCTGTTTTGACAGGTATTTTACCTAAATTGGAACATAACACCAAAGATTTTCCAACTGTGGAAAGGGAGGAGAAAAAAAATTCTAGTTGGTTTAACGC,CGCTGTTTTGACAGGTATTTTACCTAAATTTTGGCCGCGGGTCGCGGAACATAACACCAAAGATTTTCCAACTGTGGAAAGGGAGGAGAAAAAAAATTC,10,30,14,27,27,34,27,49,27,31,31,34,46,49,2.3,0.0
hek293t,15453,1,15,ACCGATTTTGACAGGTATTTTACCTAAATTGGAACATAACACCAAAGATTTTCCAACTGTGGAAAGGGAGAAAAAAATTCTAGTTGGTTTAACGCGTAA,ACCGATTTTGACAGGTATTTTACCTAAATTTTGGCCGCGGGTCGCGGAACATAACACCAAAGATTTTCCAACTGTGGAAAGGGAGAAAAAAATTCTAGT,10,30,14,27,27,38,27,53,27,31,31,38,46,53,2.3,0.212044105
hek293t,15455,1,10,AGGACCTTTGTAATTGGGTATAATCCATCAGGGACTAATGTTTAGATCCTTCTTTGGTTGTCAAAATAAAAAAATTCTAGTTGGTTTAACGCGTAACTA,AGGACCTTTGTAATTGGGTATAATCCATCAGGGACCCAGGGGGAGTAATGTTTAGATCCTTCTTTGGTTGTCAAAATAAAAAAATTCTAGTTGGTTTAA,10,30,14,27,27,46,27,56,27,36,36,46,46,56,23.9,2.095045677
hek293t,15456,1,2,TTCATAAGCAGATGATCTAAACACTATAGTGGTTTTGGCAGACAGGTTTTAAACCTCACAGCAGACAAAATATTTCTGAAAAAAATTCTAGTTGGTTTA,TTCATAAGCAGATGATCTAAACACTATAGTGGGCTTTTGGCAGACAGGTTTTAAACCTCACAGCAGACAAAATATTTCTGAAAAAAATTCTAGTTGGTT,10,30,14,27,27,43,27,45,27,33,33,43,35,45,47.73,64.75248202
hek293t,15456,1,2,AGTGCAAGCAGATGATCTAAACACTATAGTGGTTTTGGCAGACAGGTTTTAAACCTCACAGCAGACAAAATATTTCTGTCCCTTGAAAAAAATTCTAGT,AGTGCAAGCAGATGATCTAAACACTATAGTGGGCTTTTGGCAGACAGGTTTTAAACCTCACAGCAGACAAAATATTTCTGTCCCTTGAAAAAAATTCTA,10,30,14,27,27,36,27,38,27,33,33,36,35,38,47.73,8.292529338
hek293t,15458,1,7,CAAGGGGGGAAGGGGTTGCCAGTCACCGATGGGCAACAGGAGCACCAGAGAGCGTGGGCAGACAAACAGCACCGGAGACCGACTGAAAAAAATTCTAGT,CAAGGGGGGAAGGGGTTGCCAGTCACCGAACTGCGATGGGCAACAGGAGCACCAGAGAGCGTGGGCAGACAAACAGCACCGGAGACCGACTGAAAAAAA,10,30,14,27,27,31,27,38,27,28,28,31,35,38,61.21,4.306038048
hek293t,15458,1,7,TAACCGGGGAAGGGGTTGCCAGTCACCGATGGGCAACAGGAGCACCAGAGAGCGTGGGCAGACAAACAGCACCAAAAAAATTCTAGTTGGTTTAACGCG,TAACCGGGGAAGGGGTTGCCAGTCACCGAACTGCGATGGGCAACAGGAGCACCAGAGAGCGTGGGCAGACAAACAGCACCAAAAAAATTCTAGTTGGTT,10,30,14,27,27,43,27,50,27,28,28,43,35,50,61.21,19.78228325
hek293t,15460,1,6,AATGAAGACAAGCATGGGGGGAGTGGACACGGCTCAGCCCAACACAGAGTATAAAACCGAACAATAAAAAAATTCTAGTTGGTTTAACGCGTAACTAGA,AATGAAGACAAGCATGGGGGGAGTGGACACGGCTCAAGAAGGGCCCAACACAGAGTATAAAACCGAACAATAAAAAAATTCTAGTTGGTTTAACGCGTA,10,30,14,27,27,52,27,58,27,37,37,52,43,58,36.73,7.06860128
hek293t,15460,1,6,CTCTGAGACAAGCATGGGGGGAGTGGACACGGCTCAGCCCAACACAGAGTATAAAACCGAACAATGAACAGAAAAAAAAAAAAATTCTAGTTGGTTTAA,CTCTGAGACAAGCATGGGGGGAGTGGACACGGCTCAAGAAGGGCCCAACACAGAGTATAAAACCGAACAATGAACAGAAAAAAAAAAAAATTCTAGTTG,10,30,14,27,27,40,27,46,27,37,37,40,43,46,36.73,0.553709856
hek293t,15462,1,9,GATGAAGAATGGACAGGGTGGAAAACCAGAGGTGCAAAAATGAAATGGCTTTACGTACCACACCGCAAAAAAAATTCTAGTTGGTTTAACGCGTAACTA,GATGAAGAATGGACAGGGTGGAAAACCAGAGTATCTCCATGTGCAAAAATGAAATGGCTTTACGTACCACACCGCAAAAAAAATTCTAGTTGGTTTAAC,10,30,14,27,27,47,27,56,27,32,32,47,41,56,65.61,0.683859667
hek293t,15462,1,9,TGGGTAGAATGGACAGGGTGGAAAACCAGAGGTGCAAAAATGAAATGGCTTTACGTACCACACCGCATTATAAAAAAAATTCTAGTTGGTTTAACGCGT,TGGGTAGAATGGACAGGGTGGAAAACCAGAGTATCTCCATGTGCAAAAATGAAATGGCTTTACGTACCACACCGCATTATAAAAAAAATTCTAGTTGGT,10,30,14,27,27,42,27,51,27,32,32,42,41,51,65.61,2.070567245
hek293t,15464,1,3,GCTTCAAGATTTATCGCTGTCCAGAGAAGGGGATGATCTCCCGGATAGGTAGGGAAATCTATCCAGACATCCTTTCATTAAAAAAATTCTAGTTGGTTT,GCTTCAAGATTTATCGCTGTCCAGAGAAGGGGATGATAAGCTCCCGGATAGGTAGGGAAATCTATCCAGACATCCTTTCATTAAAAAAATTCTAGTTGG,10,30,14,27,27,41,27,44,27,38,38,41,41,44,50.3,0.738726174
hek293t,15464,1,3,CCTGAAAGATTTATCGCTGTCCAGAGAAGGGGATGATCTCCCGGATAGGTAGGGAAATCTATCCAGACATCCTTTAAAAAAATTCTAGTTGGTTTAACG,CCTGAAAGATTTATCGCTGTCCAGAGAAGGGGATGATAAGCTCCCGGATAGGTAGGGAAATCTATCCAGACATCCTTTAAAAAAATTCTAGTTGGTTTA,10,30,14,27,27,45,27,48,27,38,38,45,41,48,50.3,77.29287839
hek293t,15466,1,12,GATTGATACCTACTCCAGCCCCTATAATTTGGCCATTTCTGGAAGTAAGAGGACATCTTTGAAGACTAACAAAAAAATTCTAGTTGGTTTAACGCGTAA,GATTGATACCTACTCCAGCCCCTATAATTTGGCCATTAGACGACAAGCTTCTGGAAGTAAGAGGACATCTTTGAAGACTAACAAAAAAATTCTAGTTGG,10,30,14,27,27,41,27,53,27,38,38,41,50,53,22.36,0.0
hek293t,15467,1,5,AGAGCACGAAACGAATGTCTCGGTCAAGAAGGAGAGCACTTGCCCCTTGATTGGTTGAATCTGGCTTGAAAAAAATTCTAGTTGGTTTAACGCGTAACT,AGAGCACGAAACGAATGTCTCGGTCAAGAAGGAGCACTCAGCACTTGCCCCTTGATTGGTTGAATCTGGCTTGAAAAAAATTCTAGTTGGTTTAACGCG,10,30,14,27,27,50,27,55,27,35,35,50,40,55,37.99,63.07357381
hek293t,15467,1,5,AGCGTACGAAACGAATGTCTCGGTCAAGAAGGAGAGCACTTGCCCCTTGATTGGTTGAATCTGGCTTGCAGAGGACGGGGAAAAAAATTCTAGTTGGTT,AGCGTACGAAACGAATGTCTCGGTCAAGAAGGAGCACTCAGCACTTGCCCCTTGATTGGTTGAATCTGGCTTGCAGAGGACGGGGAAAAAAATTCTAGT,10,30,14,27,27,38,27,43,27,35,35,38,40,43,37.99,2.338292146
hek293t,15469,1,11,GAGATCGTTGTAGCTTGTGCGCACGCAGGAGGCACAGACGGAGAGGAGACAGGAGCGCAGCGTGGCGACTGCCAGAAAAAAATTCTAGTTGGTTTAACG,GAGATCGTTGTAGCTTGTGCGCACGCAGGCCAAGATCACGAGGCACAGACGGAGAGGAGACAGGAGCGCAGCGTGGCGACTGCCAGAAAAAAATTCTAG,10,30,14,27,27,37,27,48,27,30,30,37,41,48,63.14,16.12976922
hek293t,15469,1,11,TTGCTCGTTGTAGCTTGTGCGCACGCAGGAGGCACAGACGGAGAGGAGACAGGAGCGCAGCGTGGCGAAAAAAATTCTAGTTGGTTTAACGCGTAACTA,TTGCTCGTTGTAGCTTGTGCGCACGCAGGCCAAGATCACGAGGCACAGACGGAGAGGAGACAGGAGCGCAGCGTGGCGAAAAAAATTCTAGTTGGTTTA,10,30,14,27,27,45,27,56,27,30,30,45,41,56,63.14,18.68276556
hek293t,15471,1,15,TGTTTACCCAGCACGGCTGCCTGAAGATGAGGCTGCACAGCATCACAGGGACCAGAGCTGCAGCGTGAAAAAAATTCTAGTTGGTTTAACGCGTAACTA,TGTTTACCCAGCACGGCTGCCTGAAGATGACTACATTATTCGGTGGGCTGCACAGCATCACAGGGACCAGAGCTGCAGCGTGAAAAAAATTCTAGTTGG,10,30,14,27,27,41,27,56,27,31,31,41,46,56,62.88,4.674116975
hek293t,15471,1,15,CGGACACCCAGCACGGCTGCCTGAAGATGAGGCTGCACAGCATCACAGGGACCAGAGCTGCAGCGTGGCAAAAAAAATTCTAGTTGGTTTAACGCGTAA,CGGACACCCAGCACGGCTGCCTGAAGATGACTACATTATTCGGTGGGCTGCACAGCATCACAGGGACCAGAGCTGCAGCGTGGCAAAAAAAATTCTAGT,10,30,14,27,27,38,27,53,27,31,31,38,46,53,62.88,1.965736526
hek293t,15473,1,8,CTCATGAGAGTCCTGAAGCCAAATCTTGCTGGGAATGACGTGGGCACCAAGCTATTAAATGCATCTGGAAAAAAAATTCTAGTTGGTTTAACGCGTAAC,CTCATGAGAGTCCTGAAGCCAAATCTTGCTGGGAAATATTCGTTGACGTGGGCACCAAGCTATTAAATGCATCTGGAAAAAAAATTCTAGTTGGTTTAA,10,30,14,27,27,46,27,54,27,36,36,46,44,54,11.07,25.4091536
hek293t,15475,1,10,TGGCGTGGAATATTACATTCAGGTTTTTGGGGCCCCCCCCCTAGTACATGCAATTGGAAATTAAAATACATTATCTAAAAAAAATTCTAGTTGGTTTAA,TGGCGTGGAATATTACATTCAGGTTTTTGACAACGTTTGGGGCCCCCCCCCTAGTACATGCAATTGGAAATTAAAATACATTATCTAAAAAAAATTCTA,10,30,14,27,27,36,27,46,27,29,29,36,39,46,10.46,4.393658221
hek293t,15481,1,11,TTGGAATTTAGATAATTAGAGTTGAATGTAGGAGCATATGAAATGTCAGGTTGTAGGAGGTTAAAGAAGTAAAAAAATTCTAGTTGGTTTAACGCGTAA,TTGGAATTTAGATAATTAGAGTTGAACGCTGTCCCCTTGTAGGAGCATATGAAATGTCAGGTTGTAGGAGGTTAAAGAAGTAAAAAAATTCTAGTTGGT,10,30,14,27,27,42,27,53,27,27,27,42,38,53,55.95,26.56267581
hek293t,15481,1,11,GAACTATTTAGATAATTAGAGTTGAATGTAGGAGCATATGAAATGTCAGGTTGTAGGAGGTTAAAGAAGTCTTTTAAAAAAATTCTAGTTGGTTTAACG,GAACTATTTAGATAATTAGAGTTGAACGCTGTCCCCTTGTAGGAGCATATGAAATGTCAGGTTGTAGGAGGTTAAAGAAGTCTTTTAAAAAAATTCTAG,10,30,14,27,27,37,27,48,27,27,27,37,38,48,55.95,10.73145234
hek293t,15483,1,2,CGCGGGGAAATTCCTTCACTAGGAAATAATGGTCGCTACTTCTCACTGTTAATTCTTCAAGGTGACACCAAGATAGAACCCAAAAAAATTCTAGTTGGT,CGCGGGGAAATTCCTTCACTAGGAAATAATGGCGTCGCTACTTCTCACTGTTAATTCTTCAAGGTGACACCAAGATAGAACCCAAAAAAATTCTAGTTG,10,30,14,27,27,40,27,42,27,33,33,40,35,42,28.33,85.24165279
hek293t,15483,1,2,CTAGTGGAAATTCCTTCACTAGGAAATAATGGTCGCTACTTCTCACTGTTAATTCTTCAAGGTGACACCAAGATAGAAAAAAAAATTCTAGTTGGTTTA,CTAGTGGAAATTCCTTCACTAGGAAATAATGGCGTCGCTACTTCTCACTGTTAATTCTTCAAGGTGACACCAAGATAGAAAAAAAAATTCTAGTTGGTT,10,30,14,27,27,43,27,45,27,33,33,43,35,45,28.33,85.03014306
hek293t,15485,1,2,CTCATACAGGAGGGATGAGTAAGGCAGTGGGGAAGAGTTTTCAAGAGAAATTTAGATCTACCCCCCCCTTTTAAAGGCTAAAAAAATTCTAGTTGGTTT,CTCATACAGGAGGGATGAGTAAGGCAGTGGGACGAAGAGTTTTCAAGAGAAATTTAGATCTACCCCCCCCTTTTAAAGGCTAAAAAAATTCTAGTTGGT,10,30,14,27,27,42,27,44,27,32,32,42,34,44,62.94,87.97922578
hek293t,15485,1,2,ACTACACAGGAGGGATGAGTAAGGCAGTGGGGAAGAGTTTTCAAGAGAAATTTAGATCTACCCCCCCCTTTTAAAAAAAAATTCTAGTTGGTTTAACGC,ACTACACAGGAGGGATGAGTAAGGCAGTGGGACGAAGAGTTTTCAAGAGAAATTTAGATCTACCCCCCCCTTTTAAAAAAAAATTCTAGTTGGTTTAAC,10,30,14,27,27,47,27,49,27,32,32,47,34,49,62.94,88.24196244
hek293t,15487,1,13,AACAATTCATCTTCATTCTGCAACCATAAAGGAGGCAGTTCTACATGTTTCCTATACAGGTGAACAAAAAAATTCTAGTTGGTTTAACGCGTAACTAGA,AACAATTCATCTTCATTCTGCAACCATAAAGGAGGTCTACACCACCTGCAGTTCTACATGTTTCCTATACAGGTGAACAAAAAAATTCTAGTTGGTTTA,10,30,14,27,27,45,27,58,27,35,35,45,48,58,15.33,3.774625086
hek293t,428,1,10,AGTTCGTGGATTATGGATAGCCTCCATCAAGGAAGCTTCTCCTTTAACAGTAATTGTTCGTATTTGTATAAAAAAATTCTAGTTGGTTTAACGCGTAAC,AGTTCGTGGATTATGGATAGCCTCCATCAAGGAAGCTTCTCCTACTCCCGCCTTTAACAGTAATTGTTCGTATTTGTATAAAAAAATTCTAGTTGGTTT,10,30,14,27,27,44,27,54,27,41,41,44,51,54,72.32,0.0
hek293t,15490,1,9,GGCATCTTAAGGATCTTCTTCCTCTCACATGGCCTTCTTACATGGCTGTAAAAGTCCCAGTTCATGGTTAATGCAAAAAAATTCTAGTTGGTTTAACGC,GGCATCTTAAGGATCTTCTTCCTCTCACATGGCCTTGTTTCGCGGCTTACATGGCTGTAAAAGTCCCAGTTCATGGTTAATGCAAAAAAATTCTAGTTG,10,30,14,27,27,40,27,49,27,37,37,40,46,49,48.53,2.083756317
hek293t,15491,1,6,CCACAGTATACATAGTGCCTCCAGGGCACTGGGTGGTTCCTCCAACTTTCCTTGTTGATAAGACTAAACAGGCTGCTCAGTTAAAAAAATTCTAGTTGG,CCACAGTATACATAGTGCCTCCAGGGCACTGAGAAACGGTGGTTCCTCCAACTTTCCTTGTTGATAAGACTAAACAGGCTGCTCAGTTAAAAAAATTCT,10,30,14,27,27,35,27,41,27,32,32,35,38,41,54.78,1.01010101
hek293t,15491,1,6,CCAGTGTATACATAGTGCCTCCAGGGCACTGGGTGGTTCCTCCAACTTTCCTTGTTGATAAGACTAAACAAAAAAAATTCTAGTTGGTTTAACGCGTAA,CCAGTGTATACATAGTGCCTCCAGGGCACTGAGAAACGGTGGTTCCTCCAACTTTCCTTGTTGATAAGACTAAACAAAAAAAATTCTAGTTGGTTTAAC,10,30,14,27,27,47,27,53,27,32,32,47,38,53,54.78,43.0601699
hek293t,15493,1,15,CCGAGCCGGGTGAAATGCATGTTGGTTGGTGGTTTGGCCTGTTAACTAATTATCATTCAAAGCTGAAACAAAAAAAATTCTAGTTGGTTTAACGCGTAA,CCGAGCCGGGTGAAATGCATGTTGGTTGGTCTCGCTATGGACGCCGGTTTGGCCTGTTAACTAATTATCATTCAAAGCTGAAACAAAAAAAATTCTAGT,10,30,14,27,27,38,27,53,27,31,31,38,46,53,49.08,1.483822601
hek293t,15496,1,13,TCGTTTACACTAATCCTTCAAAACTGGGAAGGCTCTTTGTAATAATACATAAAATCAAATGATAAAAAAAATTCTAGTTGGTTTAACGCGTAACTAGAT,TCGTTTACACTAATCCTTCAAAACTGGGAAGGCTCAGTCGCTTAAGTGTTTGTAATAATACATAAAATCAAATGATAAAAAAAATTCTAGTTGGTTTAA,10,30,14,27,27,46,27,59,27,36,36,46,49,59,29.85,0.30651341
hek293t,15497,1,3,TGCAGGCACGAACGTGCAAGCTCTTGGAGAGGGTGCAGGCTCAGCTATCGCAGCTCTGAGGTGCTGTTTGCCTAAAAAAATTCTAGTTGGTTTAACGCG,TGCAGGCACGAACGTGCAAGCTCTTGGAGAGGGTGCAGGCACCTCAGCTATCGCAGCTCTGAGGTGCTGTTTGCCTAAAAAAATTCTAGTTGGTTTAAC,10,30,14,27,27,47,27,50,27,40,40,47,43,50,47.73,75.46378382
hek293t,15499,1,11,ATGCTGGGATCTTGCGTTAGGAGACAGTCAGGACAGAAGACAGGAGACAGAAGGACAAATTCACTTCTAGCTCAGGCCAAAAAAATTCTAGTTGGTTTA,ATGCTGGGATCTTGCGTTAGGAGACATGCAGCAGCTAGTCAGGACAGAAGACAGGAGACAGAAGGACAAATTCACTTCTAGCTCAGGCCAAAAAAATTC,10,30,14,27,27,34,27,45,27,27,27,34,38,45,46.64,17.04562787
hek293t,15499,1,11,TGTGGGGGATCTTGCGTTAGGAGACAGTCAGGACAGAAGACAGGAGACAGAAGGACAAATTCACTTCTAGCTCAGGCCGGCTAAAAAAATTCTAGTTGG,TGTGGGGGATCTTGCGTTAGGAGACATGCAGCAGCTAGTCAGGACAGAAGACAGGAGACAGAAGGACAAATTCACTTCTAGCTCAGGCCGGCTAAAAAA,10,30,14,27,27,30,27,41,27,27,27,30,38,41,46.64,0.0
hek293t,15501,1,6,TGCTGCTGTGTTTCCTTTTCAGTTAATCTTGGGATTGGAGAATAATCAGATGTCTGTGGTTCTAATGAAAAGGTTAAAAAAAATTCTAGTTGGTTTAAC,TGCTGCTGTGTTTCCTTTTCAGTTAATCTTCGGTTAGGGATTGGAGAATAATCAGATGTCTGTGGTTCTAATGAAAAGGTTAAAAAAAATTCTAGTTGG,10,30,14,27,27,41,27,47,27,31,31,41,37,47,12.75,9.6602749
hek293t,15501,1,6,GACGGCTGTGTTTCCTTTTCAGTTAATCTTGGGATTGGAGAATAATCAGATGTCTGTGGTTCTAATGAAAAAAAAAAATTCTAGTTGGTTTAACGCGTA,GACGGCTGTGTTTCCTTTTCAGTTAATCTTCGGTTAGGGATTGGAGAATAATCAGATGTCTGTGGTTCTAATGAAAAAAAAAAATTCTAGTTGGTTTAA,10,30,14,27,27,46,27,52,27,31,31,46,37,52,12.75,5.710437071
hek293t,15503,1,7,CAGTTTGCAAGGGTTCTGCTTCCCTTTTGAGGGGGTTGTGGAGTAAGGGTCTCCAGGTTACTGAAGGCATAAAAAAAATTCTAGTTGGTTTAACGCGTA,CAGTTTGCAAGGGTTCTGCTTCCCTTTTGAGGGGGCCGATTGTTGTGGAGTAAGGGTCTCCAGGTTACTGAAGGCATAAAAAAAATTCTAGTTGGTTTA,10,30,14,27,27,45,27,52,27,35,35,45,42,52,17.55,0.436994073
hek293t,15503,1,7,AGGTCTGCAAGGGTTCTGCTTCCCTTTTGAGGGGGTTGTGGAGTAAGGGTCTCCAGGTTACTGAAGGCATAAAAAAAAAAATTCTAGTTGGTTTAACGC,AGGTCTGCAAGGGTTCTGCTTCCCTTTTGAGGGGGCCGATTGTTGTGGAGTAAGGGTCTCCAGGTTACTGAAGGCATAAAAAAAAAAATTCTAGTTGGT,10,30,14,27,27,42,27,49,27,35,35,42,42,49,17.55,0.219298246
hek293t,15505,1,14,CCACAAACACTAAAAATGCTGCAATAGGAAGGTTACTATGAGTTACTACTGTACTCTTTAAGCAGATAAAAAAAATTCTAGTTGGTTTAACGCGTAACT,CCACAAACACTAAAAATGCTGCAATAGGAAGGTTACTCCGCAGACTGTGCCATGAGTTACTACTGTACTCTTTAAGCAGATAAAAAAAATTCTAGTTGG,10,30,14,27,27,41,27,55,27,38,38,41,52,55,39.35,0.0
hek293t,15506,1,9,CTAGTGCTTTAAATATTCATGAAGCCCACTGGTGCAAAGTGCATTAAAGGTGGGAATAATGCCAAAAAAAATTCTAGTTGGTTTAACGCGTAACTAGAT,CTAGTGCTTTAAATATTCATGAAGCCCACTGGTGCAAAGCCCACATGATGCATTAAAGGTGGGAATAATGCCAAAAAAAATTCTAGTTGGTTTAACGCG,10,30,14,27,27,50,27,59,27,40,40,50,49,59,26.59,4.055555556
hek293t,15507,1,2,GTAATCAAGGTACAGCTGGAAGTGCTGCAAGGGAAACTGTTCAAAGGTCAGATCACTTTAGGAAAAAAAAAATTCTAGTTGGTTTAACGCGTAACTAGA,GTAATCAAGGTACAGCTGGAAGTGCTGCAAGGGAAACTGTTCTCAAAGGTCAGATCACTTTAGGAAAAAAAAAATTCTAGTTGGTTTAACGCGTAACTA,10,30,14,27,27,56,27,58,27,41,41,56,43,58,71.79,65.08710783
hek293t,15507,1,2,AGCCGCAAGGTACAGCTGGAAGTGCTGCAAGGGAAACTGTTCAAAGGTCAGATCACTTTAGGAAAGGTGAAATAAAAAAATTCTAGTTGGTTTAACGCG,AGCCGCAAGGTACAGCTGGAAGTGCTGCAAGGGAAACTGTTCTCAAAGGTCAGATCACTTTAGGAAAGGTGAAATAAAAAAATTCTAGTTGGTTTAACG,10,30,14,27,27,48,27,50,27,41,41,48,43,50,71.79,44.56885904
hek293t,15509,1,14,GCACTTCTTACCCTTCTTTGTTGTTCCACTGGTCGTAGTCCATCCATAGTCATTGGCTAAGCACGAGTAAAAAAATTCTAGTTGGTTTAACGCGTAACT,GCACTTCTTACCCTTCTTTGTTGTTCCACTGCAGGCCTTATAAAGGTCGTAGTCCATCCATAGTCATTGGCTAAGCACGAGTAAAAAAATTCTAGTTGG,10,30,14,27,27,41,27,55,27,31,31,41,45,55,28.12,19.12335083
hek293t,15510,1,1,TTTTGCTGTATTCTTCTTATTAAAATAAAAGGAGTTAGTCTTCTTTTTTCATGCATGTTACGTATTACCAACCATTGAGCTTTAACACCAAAAAAAATT,TTTTGCTGTATTCTTCTTATTAAAATAATAAGGAGTTAGTCTTCTTTTTTCATGCATGTTACGTATTACCAACCATTGAGCTTTAACACCAAAAAAAAT,10,30,14,27,27,32,27,33,27,29,29,32,30,33,-0.9,0.0
hek293t,15512,1,3,ATAGTCATGCACATTTTGGATTTTTTGAATGGAAAGCTACACTTCTAAAAAGCACTAACCAGAACAGAGCAAGTTTATACACAAAAAAATTCTAGTTGG,ATAGTCATGCACATTTTGGATTTTTTGAATTATGGAAAGCTACACTTCTAAAAAGCACTAACCAGAACAGAGCAAGTTTATACACAAAAAAATTCTAGT,10,30,14,27,27,38,27,41,27,31,31,38,34,41,0.26,0.522992949
hek293t,15512,1,3,TTAATCATGCACATTTTGGATTTTTTGAATGGAAAGCTACACTTCTAAAAAGCACTAACCAGAACAGAGCAAGTTTATACACTCTTAAAAAAATTCTAG,TTAATCATGCACATTTTGGATTTTTTGAATTATGGAAAGCTACACTTCTAAAAAGCACTAACCAGAACAGAGCAAGTTTATACACTCTTAAAAAAATTC,10,30,14,27,27,34,27,37,27,31,31,34,34,37,0.26,0.0
hek293t,15514,1,2,TGGACGGTTGGGCTTGAGATATTTGCCATAGGGATGATGCAGGAGGTTTGTGGTGAGTTGCAAGGTAATTTGAGAAGTTAAGATCCAAAAAAAATTCTA,TGGACGGTTGGGCTTGAGATATTTGCCATACCGGGATGATGCAGGAGGTTTGTGGTGAGTTGCAAGGTAATTTGAGAAGTTAAGATCCAAAAAAAATTC,10,30,14,27,27,34,27,36,27,31,31,34,33,36,29.19,1.360285463
hek293t,15514,1,2,AATCAGGTTGGGCTTGAGATATTTGCCATAGGGATGATGCAGGAGGTTTGTGGTGAGTTGCAAGGTAATTTGAGAAGTTAAAAAAAATTCTAGTTGGTT,AATCAGGTTGGGCTTGAGATATTTGCCATACCGGGATGATGCAGGAGGTTTGTGGTGAGTTGCAAGGTAATTTGAGAAGTTAAAAAAAATTCTAGTTGG,10,30,14,27,27,41,27,43,27,31,31,41,33,43,29.19,78.46693888
hek293t,15516,1,10,TGCGTCACTGCTCCTCCGACGTGCAATAGCGGCTCACGCGTTTCCCTTGGATGGCAACAGGCAAATCATAACAGACAGACAAAAAAAATTCTAGTTGGT,TGCGTCACTGCTCCTCCGACGTGCAATATCTTCCTCGGGCGGCTCACGCGTTTCCCTTGGATGGCAACAGGCAAATCATAACAGACAGACAAAAAAAAT,10,30,14,27,27,32,27,42,27,29,29,32,39,42,64.81,0.257400257
hek293t,15516,1,10,CAATACACTGCTCCTCCGACGTGCAATAGCGGCTCACGCGTTTCCCTTGGATGGCAACAGGCAAATCATAACAGAAAAAAATTCTAGTTGGTTTAACGC,CAATACACTGCTCCTCCGACGTGCAATATCTTCCTCGGGCGGCTCACGCGTTTCCCTTGGATGGCAACAGGCAAATCATAACAGAAAAAAATTCTAGTT,10,30,14,27,27,39,27,49,27,29,29,39,39,49,64.81,11.36204644
hek293t,15518,1,1,ACACTTGCTAACCAATTGCCACTGCAATCAGGAAGTCCTTGCAAATATTTTAGAGACATACTGTGACACTGGCAAAAAGTCTTCTAAAAAAATTCTAGT,ACACTTGCTAACCAATTGCCACTGCAATCAGGAAAGTCCTTGCAAATATTTTAGAGACATACTGTGACACTGGCAAAAAGTCTTCTAAAAAAATTCTAG,10,30,14,27,27,37,27,38,27,34,34,37,35,38,29.21,3.128928703
hek293t,15518,1,1,AAATGTGCTAACCAATTGCCACTGCAATCAGGAAGTCCTTGCAAATATTTTAGAGACATACTGTGACACTGGCAAAAAAAAAAAATTCTAGTTGGTTTA,AAATGTGCTAACCAATTGCCACTGCAATCAGGAAAGTCCTTGCAAATATTTTAGAGACATACTGTGACACTGGCAAAAAAAAAAAATTCTAGTTGGTTT,10,30,14,27,27,44,27,45,27,34,34,44,35,45,29.21,74.79980995
hek293t,15520,1,9,ACCTTAACAGCCTGAACAAGGGAGATGGCAGGTATTTGTGGCTGGGGATAAGCTTGTGGACAGTAAGGAAAAAAATTCTAGTTGGTTTAACGCGTAACT,ACCTTAACAGCCTGAACAAGGGAGATGGCAAATCCTTGCGGTATTTGTGGCTGGGGATAAGCTTGTGGACAGTAAGGAAAAAAATTCTAGTTGGTTTAA,10,30,14,27,27,46,27,55,27,31,31,46,40,55,54.98,11.17913073
hek293t,15520,1,9,TACCCAACAGCCTGAACAAGGGAGATGGCAGGTATTTGTGGCTGGGGATAAGCTTGTGGACAGTAAGGACTTGGATAAAAAAATTCTAGTTGGTTTAAC,TACCCAACAGCCTGAACAAGGGAGATGGCAAATCCTTGCGGTATTTGTGGCTGGGGATAAGCTTGTGGACAGTAAGGACTTGGATAAAAAAATTCTAGT,10,30,14,27,27,38,27,47,27,31,31,38,40,47,54.98,19.9133443
hek293t,15522,1,2,TTGTGTCTGCTAACACATTCGCTGCGCAGAGGAGTATCACAGAACTTCACAAGCTCTCTTTGAATTTCAAAAAAAATTCTAGTTGGTTTAACGCGTAAC,TTGTGTCTGCTAACACATTCGCTGCGCAGAGGAGTAGCTCACAGAACTTCACAAGCTCTCTTTGAATTTCAAAAAAAATTCTAGTTGGTTTAACGCGTA,10,30,14,27,27,52,27,54,27,37,37,52,39,54,60.66,82.76471341
hek293t,15522,1,2,CATGTTCTGCTAACACATTCGCTGCGCAGAGGAGTATCACAGAACTTCACAAGCTCTCTTTGAATTTCAGCCAGGGAAAAAAAATTCTAGTTGGTTTAA,CATGTTCTGCTAACACATTCGCTGCGCAGAGGAGTAGCTCACAGAACTTCACAAGCTCTCTTTGAATTTCAGCCAGGGAAAAAAAATTCTAGTTGGTTT,10,30,14,27,27,44,27,46,27,37,37,44,39,46,60.66,60.55599097
hek293t,15524,1,14,CGCTGAACCAAATGAAAAACAGACATCGTTGGTCTTTATATCAGTTTCGGGGGTGTCATTAGCATTGTAAAAAAATTCTAGTTGGTTTAACGCGTAACT,CGCTGAACCAAATGAAAAACAGACATCGTTATTAATCATCCGGCGGTCTTTATATCAGTTTCGGGGGTGTCATTAGCATTGTAAAAAAATTCTAGTTGG,10,30,14,27,27,41,27,55,27,31,31,41,45,55,42.89,1.184858448
hek293t,15524,1,14,TGGATAACCAAATGAAAAACAGACATCGTTGGTCTTTATATCAGTTTCGGGGGTGTCATTAGCATTGTAATGACTAAAAAAATTCTAGTTGGTTTAACG,TGGATAACCAAATGAAAAACAGACATCGTTATTAATCATCCGGCGGTCTTTATATCAGTTTCGGGGGTGTCATTAGCATTGTAATGACTAAAAAAATTC,10,30,14,27,27,34,27,48,27,31,31,34,45,48,42.89,0.0
hek293t,15526,1,2,TGCCGTTATAGATAGATATTTGCTATCTGTGGCAGTGTTTGTGAAACATGCTGCTGTGGTACGCCTAACCGAAAAAAATTCTAGTTGGTTTAACGCGTA,TGCCGTTATAGATAGATATTTGCTATCTGTGGCAAAGTGTTTGTGAAACATGCTGCTGTGGTACGCCTAACCGAAAAAAATTCTAGTTGGTTTAACGCG,10,30,14,27,27,50,27,52,27,35,35,50,37,52,53.27,77.05293161
hek293t,15528,1,14,ACCTTAACTTTGACAGCCAGTCTTGGCAGAGGATTTCCAGCGGTTAAGATATCAGACAGGACACGTGATGTGGAAAAAAATTCTAGTTGGTTTAACGCG,ACCTTAACTTTGACAGCCAGTCTTGGCAAGTTCACGCCAACGGAGGATTTCCAGCGGTTAAGATATCAGACAGGACACGTGATGTGGAAAAAAATTCTA,10,30,14,27,27,36,27,50,27,29,29,36,43,50,52.57,3.189981946
hek293t,15528,1,14,AGATCAACTTTGACAGCCAGTCTTGGCAGAGGATTTCCAGCGGTTAAGATATCAGACAGGACACGTGATGTGGATTTAAAAAAATTCTAGTTGGTTTAA,AGATCAACTTTGACAGCCAGTCTTGGCAAGTTCACGCCAACGGAGGATTTCCAGCGGTTAAGATATCAGACAGGACACGTGATGTGGATTTAAAAAAAT,10,30,14,27,27,32,27,46,27,29,29,32,43,46,52.57,0.292397661
hek293t,17712,1,15,TGGACAGCATTGCATGTGGCAGCTGCGGAAGGTACTGTCTTCTCCTGTATAACTTGCTATCTGTTAAAAAAAATTCTAGTTGGTTTAACGCGTAACTAG,TGGACAGCATTGCATGTGGCAGCTGCGGAAGGTAGCGGGGCGTAGCAATCTGTCTTCTCCTGTATAACTTGCTATCTGTTAAAAAAAATTCTAGTTGGT,10,30,14,27,27,42,27,57,27,35,35,42,50,57,50.49,0.557255263
hek293t,15531,1,9,CCTGTTTGTGCCACGTTAGAAATAGCCCTAGGAGGCAGCATGTGTCAGGGTTGAGTCTTCTCGGTTGTCAAAAAAAAATTCTAGTTGGTTTAACGCGTA,CCTGTTTGTGCCACGTTAGAAATAGCCCTAGGGGTAACGACAGGCAGCATGTGTCAGGGTTGAGTCTTCTCGGTTGTCAAAAAAAAATTCTAGTTGGTT,10,30,14,27,27,43,27,52,27,33,33,43,42,52,63.8,1.401990535
hek293t,15531,1,9,ACTATTTGTGCCACGTTAGAAATAGCCCTAGGAGGCAGCATGTGTCAGGGTTGAGTCTTCTCGGTTGTCAACATAAAAAAATTCTAGTTGGTTTAACGC,ACTATTTGTGCCACGTTAGAAATAGCCCTAGGGGTAACGACAGGCAGCATGTGTCAGGGTTGAGTCTTCTCGGTTGTCAACATAAAAAAATTCTAGTTG,10,30,14,27,27,40,27,49,27,33,33,40,42,49,63.8,3.490781473
hek293t,15533,1,2,TCAAACACAGTTTTTTGTGACCAAGGCATTGGAGGAACAAAACAAAAATGAAAACAGTAACGGCAGTCACAGTCTCAAAAAAAATTCTAGTTGGTTTAA,TCAAACACAGTTTTTTGTGACCAAGGCATTGGAGGAACAATCAACAAAAATGAAAACAGTAACGGCAGTCACAGTCTCAAAAAAAATTCTAGTTGGTTT,10,30,14,27,27,44,27,46,27,41,41,44,43,46,39.88,0.036791759
hek293t,15535,1,4,ATCCTATTGAGGCAGGCTTCTTGAGCTCTTGGTGGGAGGGAAATGTCCATTGTGTACATACTGAAGTGTGCACAGTAGCCAGGAAAAAAATTCTAGTTG,ATCCTATTGAGGCAGGCTTCTTGAGCTCAGCTTTGGTGGGAGGGAAATGTCCATTGTGTACATACTGAAGTGTGCACAGTAGCCAGGAAAAAAATTCTA,10,30,14,27,27,36,27,40,27,29,29,36,33,40,41.7,77.85933203
hek293t,15535,1,4,TAATGATTGAGGCAGGCTTCTTGAGCTCTTGGTGGGAGGGAAATGTCCATTGTGTACATACTGAAGTGTGCACAGAAAAAAATTCTAGTTGGTTTAACG,TAATGATTGAGGCAGGCTTCTTGAGCTCAGCTTTGGTGGGAGGGAAATGTCCATTGTGTACATACTGAAGTGTGCACAGAAAAAAATTCTAGTTGGTTT,10,30,14,27,27,44,27,48,27,29,29,44,33,48,41.7,77.79935791
hek293t,15539,1,13,CCTGTATGTCCATGAAAAACTGAATATATTGGATGCCAATGACATATTGCATGCAGTGCAGAGTAAAAAAATTCTAGTTGGTTTAACGCGTAACTAGAT,CCTGTATGTCCATGAAAAACTGAATATATTTCCATCTGAAGTTGGATGCCAATGACATATTGCATGCAGTGCAGAGTAAAAAAATTCTAGTTGGTTTAA,10,30,14,27,27,46,27,59,27,31,31,46,44,59,12.22,0.530631934
hek293t,15539,1,13,ACCTGATGTCCATGAAAAACTGAATATATTGGATGCCAATGACATATTGCATGCAGTGCAGAGTCGATCCGCGCACAAAAAAATTCTAGTTGGTTTAAC,ACCTGATGTCCATGAAAAACTGAATATATTTCCATCTGAAGTTGGATGCCAATGACATATTGCATGCAGTGCAGAGTCGATCCGCGCACAAAAAAATTC,10,30,14,27,27,34,27,47,27,31,31,34,44,47,12.22,0.0
hek293t,15541,1,10,TGTACGAACAAAGTCTATACGGAACTGAGAGGCTGGATATTATAATTGATTATTGTATTTTACCAGAGTAAAAAAATTCTAGTTGGTTTAACGCGTAAC,TGTACGAACAAAGTCTATACGGAACTGAGCAGGTAAAAGAGGCTGGATATTATAATTGATTATTGTATTTTACCAGAGTAAAAAAATTCTAGTTGGTTT,10,30,14,27,27,44,27,54,27,29,29,44,39,54,74.28,3.540713334
hek293t,15541,1,10,GGACAGAACAAAGTCTATACGGAACTGAGAGGCTGGATATTATAATTGATTATTGTATTTTACCAGAGTATCCCTGAAAATAAAAAAATTCTAGTTGGT,GGACAGAACAAAGTCTATACGGAACTGAGCAGGTAAAAGAGGCTGGATATTATAATTGATTATTGTATTTTACCAGAGTATCCCTGAAAATAAAAAAAT,10,30,14,27,27,32,27,42,27,29,29,32,39,42,74.28,0.0
hek293t,15543,1,1,CAGAATCGTTTCCGTTTCTCTCGTAATGTCGGTGCGACTTTAAAACGCGGTGCTGTGTTTGCTTGCCCAGTAAAAAAATTCTAGTTGGTTTAACGCGTA,CAGAATCGTTTCCGTTTCTCTCGTAATGTCGGTGCGGACTTTAAAACGCGGTGCTGTGTTTGCTTGCCCAGTAAAAAAATTCTAGTTGGTTTAACGCGT,10,30,14,27,27,51,27,52,27,36,36,51,37,52,25.21,14.64817059
hek293t,15543,1,1,TATTTTCGTTTCCGTTTCTCTCGTAATGTCGGTGCGACTTTAAAACGCGGTGCTGTGTTTGCTTGCCCAGTTCTGTGCGAAAAAAATTCTAGTTGGTTT,TATTTTCGTTTCCGTTTCTCTCGTAATGTCGGTGCGGACTTTAAAACGCGGTGCTGTGTTTGCTTGCCCAGTTCTGTGCGAAAAAAATTCTAGTTGGTT,10,30,14,27,27,43,27,44,27,36,36,43,37,44,25.21,49.66771365
hek293t,15545,1,6,TCCCCAAAATGGGCTGATAGCATTAATTAAGGAACCATAAGAATAAATTGGGAAAAAATTATGCAAGAAATTGGCGAAAAAAATTCTAGTTGGTTTAAC,TCCCCAAAATGGGCTGATAGCATTAATTAAGGACCTTTAACCATAAGAATAAATTGGGAAAAAATTATGCAAGAAATTGGCGAAAAAAATTCTAGTTGG,10,30,14,27,27,41,27,47,27,34,34,41,40,47,31.19,4.539310063
hek293t,15545,1,6,AGAACAAAATGGGCTGATAGCATTAATTAAGGAACCATAAGAATAAATTGGGAAAAAATTATGCAAGAAATTGGCGGGGTAAAAAAATTCTAGTTGGTT,AGAACAAAATGGGCTGATAGCATTAATTAAGGACCTTTAACCATAAGAATAAATTGGGAAAAAATTATGCAAGAAATTGGCGGGGTAAAAAAATTCTAG,10,30,14,27,27,37,27,43,27,34,34,37,40,43,31.19,0.0
hek293t,15547,1,9,GGATGTCTGTGAAGCATTTTTATCCCTTCTGGAAATGGAAAAAAGTCACTTTCATATTCATGCCTCATCTCCAACTCAGTAAAAAAATTCTAGTTGGTT,GGATGTCTGTGAAGCATTTTTATCCCTTCTAGGCATTCGGGAAATGGAAAAAAGTCACTTTCATATTCATGCCTCATCTCCAACTCAGTAAAAAAATTC,10,30,14,27,27,34,27,43,27,31,31,34,40,43,0.97,0.0
hek293t,15549,1,9,CCGAGATAAAGAGTTTGATCCAAAGATTGTGGTTTCTGTTTTAGTTCTGACAGTTGTCTTGTAAGGTGAGATAAAAAAAATTCTAGTTGGTTTAACGCG,CCGAGATAAAGAGTTTGATCCAAAGATTGTGGTTTCTAACTGGGGTGTTTTAGTTCTGACAGTTGTCTTGTAAGGTGAGATAAAAAAAATTCTAGTTGG,10,30,14,27,27,41,27,50,27,38,38,41,47,50,51.84,0.0
hek293t,15549,1,9,AGCAGATAAAGAGTTTGATCCAAAGATTGTGGTTTCTGTTTTAGTTCTGACAGTTGTCTTGTAAGGAAAAAAATTCTAGTTGGTTTAACGCGTAACTAG,AGCAGATAAAGAGTTTGATCCAAAGATTGTGGTTTCTAACTGGGGTGTTTTAGTTCTGACAGTTGTCTTGTAAGGAAAAAAATTCTAGTTGGTTTAACG,10,30,14,27,27,48,27,57,27,38,38,48,47,57,51.84,6.340799329
hek293t,15551,1,14,TACAGTCCATCCTTTTCTCAATCAGGAAAAGGATAAGGGGCCCATCAACCCAGCAAGTCATGGAGAAAAAAATTCTAGTTGGTTTAACGCGTAACTAGA,TACAGTCCATCCTTTTCTCAATCAGGAAAAGGATAAGGGGATTTGGTCATCCGACCCATCAACCCAGCAAGTCATGGAGAAAAAAATTCTAGTTGGTTT,10,30,14,27,27,44,27,58,27,41,41,44,55,58,5.7,0.0
hek293t,15553,1,14,CCCGCGTGCAAAACTCCTGTTGATTTCAGTGGAGGTCAAACTCTGAATCTGTGCAGTAGCTAACAAAAAAATTCTAGTTGGTTTAACGCGTAACTAGAT,CCCGCGTGCAAAACTCCTGTTGATTTCAGGGGCTTGATCGTAATGGAGGTCAAACTCTGAATCTGTGCAGTAGCTAACAAAAAAATTCTAGTTGGTTTA,10,30,14,27,27,45,27,59,27,30,30,45,44,59,34.69,5.575602335
hek293t,15553,1,14,TACCGGTGCAAAACTCCTGTTGATTTCAGTGGAGGTCAAACTCTGAATCTGTGCAGTAGCTAACAGGTCATGTCTTAAAAAAATTCTAGTTGGTTTAAC,TACCGGTGCAAAACTCCTGTTGATTTCAGGGGCTTGATCGTAATGGAGGTCAAACTCTGAATCTGTGCAGTAGCTAACAGGTCATGTCTTAAAAAAATT,10,30,14,27,27,33,27,47,27,30,30,33,44,47,34.69,0.0
hek293t,15555,1,2,AGACCGAAAGATTATGGCACTTACAAAAGGGGACAGAATGTTTCAAACCAGTTGTGCAGCATTTAGGGCATGACTGAGGCCTGAAAAAAAATTCTAGTT,AGACCGAAAGATTATGGCACTTACAAAAGGGGAAACAGAATGTTTCAAACCAGTTGTGCAGCATTTAGGGCATGACTGAGGCCTGAAAAAAAATTCTAG,10,30,14,27,27,37,27,39,27,34,34,37,36,39,53.0,0.359029894
hek293t,15555,1,2,GATAGGAAAGATTATGGCACTTACAAAAGGGGACAGAATGTTTCAAACCAGTTGTGCAGCATTTAGGGCATGAAAAAAATTCTAGTTGGTTTAACGCGT,GATAGGAAAGATTATGGCACTTACAAAAGGGGAAACAGAATGTTTCAAACCAGTTGTGCAGCATTTAGGGCATGAAAAAAATTCTAGTTGGTTTAACGC,10,30,14,27,27,49,27,51,27,34,34,49,36,51,53.0,32.57417065
hek293t,15559,1,6,AGCGCGTAGTTTTACATCAAGAAACATTCAGGTTCTCAAGCAGCTCAAGCAAGGAAGTTTAGGGTTTCAGAAAAAAATTCTAGTTGGTTTAACGCGTAA,AGCGCGTAGTTTTACATCAAGAAACATTCAGCCAACGGTTCTCAAGCAGCTCAAGCAAGGAAGTTTAGGGTTTCAGAAAAAAATTCTAGTTGGTTTAAC,10,30,14,27,27,47,27,53,27,32,32,47,38,53,6.41,0.869242038
hek293t,15559,1,6,TGATAGTAGTTTTACATCAAGAAACATTCAGGTTCTCAAGCAGCTCAAGCAAGGAAGTTTAGGGTTTCAGCTGCTAAAAAAATTCTAGTTGGTTTAACG,TGATAGTAGTTTTACATCAAGAAACATTCAGCCAACGGTTCTCAAGCAGCTCAAGCAAGGAAGTTTAGGGTTTCAGCTGCTAAAAAAATTCTAGTTGGT,10,30,14,27,27,42,27,48,27,32,32,42,38,48,6.41,1.137120389
hek293t,15563,1,7,GCCCCTAGATCAATTGCAGTGTAACAAACAGGTTGAAAAAGAGAGATTTCAACTGCTTATACAGATTGTACAGCACTATAAAAAAATTCTAGTTGGTTT,GCCCCTAGATCAATTGCAGTGTAACAAACCCGTTTGAGGTTGAAAAAGAGAGATTTCAACTGCTTATACAGATTGTACAGCACTATAAAAAAATTCTAG,10,30,14,27,27,37,27,44,27,30,30,37,37,44,28.64,3.061121608
hek293t,15563,1,7,CGAGCTAGATCAATTGCAGTGTAACAAACAGGTTGAAAAAGAGAGATTTCAACTGCTTATACAGATTGTACAAAAAAATTCTAGTTGGTTTAACGCGTA,CGAGCTAGATCAATTGCAGTGTAACAAACCCGTTTGAGGTTGAAAAAGAGAGATTTCAACTGCTTATACAGATTGTACAAAAAAATTCTAGTTGGTTTA,10,30,14,27,27,45,27,52,27,30,30,45,37,52,28.64,0.34882565
hek293t,15565,1,6,ATGCTTGCACTGTCTGCAAGTAAATTAGGAGGGTAAAAGAGCATTTCGAGATGACTGAAAATTTACCTCTCAACAAAAAAATTCTAGTTGGTTTAACGC,ATGCTTGCACTGTCTGCAAGTAAATTAGGCCCCGGAGGGTAAAAGAGCATTTCGAGATGACTGAAAATTTACCTCTCAACAAAAAAATTCTAGTTGGTT,10,30,14,27,27,43,27,49,27,28,28,43,34,49,50.54,0.0
hek293t,15565,1,6,GAGTGTGCACTGTCTGCAAGTAAATTAGGAGGGTAAAAGAGCATTTCGAGATGACTGAAAATTTACCTCTCAACCTGTTTTTAAAAAAATTCTAGTTGG,GAGTGTGCACTGTCTGCAAGTAAATTAGGCCCCGGAGGGTAAAAGAGCATTTCGAGATGACTGAAAATTTACCTCTCAACCTGTTTTTAAAAAAATTCT,10,30,14,27,27,35,27,41,27,28,28,35,34,41,50.54,0.280583614
hek293t,15567,1,6,TCCCAAGGTTTTACATAAATCCTTCAGCTAGGCTGAACAAAGGTTTCAGTGTTGTATCCCTCTACTTTTACAAAAAAATTCTAGTTGGTTTAACGCGTA,TCCCAAGGTTTTACATAAATCCTTCAGCTAGGCTGTGCCGCAACAAAGGTTTCAGTGTTGTATCCCTCTACTTTTACAAAAAAATTCTAGTTGGTTTAA,10,30,14,27,27,46,27,52,27,36,36,46,42,52,55.47,2.821910274
hek293t,15567,1,6,GCGACAGGTTTTACATAAATCCTTCAGCTAGGCTGAACAAAGGTTTCAGTGTTGTATCCCTCTACTTTTACCCAAAGGAAAAAAATTCTAGTTGGTTTA,GCGACAGGTTTTACATAAATCCTTCAGCTAGGCTGTGCCGCAACAAAGGTTTCAGTGTTGTATCCCTCTACTTTTACCCAAAGGAAAAAAATTCTAGTT,10,30,14,27,27,39,27,45,27,36,36,39,42,45,55.47,0.0
hek293t,15569,1,11,GAGGGGAAACACAGAAATATAAGTCTAAATGGAAGATGACATACACATGGGCATTAATATTCTAGACGTTGGTAAAAAAATTCTAGTTGGTTTAACGCG,GAGGGGAAACACAGAAATATAAGTCTAAATGGTCCAAAATGAGAAGATGACATACACATGGGCATTAATATTCTAGACGTTGGTAAAAAAATTCTAGTT,10,30,14,27,27,39,27,50,27,32,32,39,43,50,4.01,0.0
hek293t,15569,1,11,CGATTGAAACACAGAAATATAAGTCTAAATGGAAGATGACATACACATGGGCATTAATATTCTAGACGTTGGTTTCTAAAAAAATTCTAGTTGGTTTAA,CGATTGAAACACAGAAATATAAGTCTAAATGGTCCAAAATGAGAAGATGACATACACATGGGCATTAATATTCTAGACGTTGGTTTCTAAAAAAATTCT,10,30,14,27,27,35,27,46,27,32,32,35,43,46,4.01,0.0
hek293t,15571,1,10,GGCGGACTTACGGGGGAGGCAGATGAAAGAGGTATCGGAGAAGGGCAGTGATAGTCCTAAACAGATGTCAAAAAAATTCTAGTTGGTTTAACGCGTAAC,GGCGGACTTACGGGGGAGGCAGATGAAAGCGGGTGACGGAGGTATCGGAGAAGGGCAGTGATAGTCCTAAACAGATGTCAAAAAAATTCTAGTTGGTTT,10,30,14,27,27,44,27,54,27,29,29,44,39,54,58.72,0.967426894
hek293t,15571,1,10,ACATTACTTACGGGGGAGGCAGATGAAAGAGGTATCGGAGAAGGGCAGTGATAGTCCTAAACAGATGTCTTACTCCCAAAAAAATTCTAGTTGGTTTAA,ACATTACTTACGGGGGAGGCAGATGAAAGCGGGTGACGGAGGTATCGGAGAAGGGCAGTGATAGTCCTAAACAGATGTCTTACTCCCAAAAAAATTCTA,10,30,14,27,27,36,27,46,27,29,29,36,39,46,58.72,0.637142642
hek293t,15573,1,15,TATCACAAAGTCATTGTTAAGCTGTTCCTAGGAGGCAGTTTGGAAGAGATTCCCCAAGGTCAGTCTGGAAAAAAAATTCTAGTTGGTTTAACGCGTAAC,TATCACAAAGTCATTGTTAAGCTGTTCCTAGGGCATCCACGAAGTAGAGGCAGTTTGGAAGAGATTCCCCAAGGTCAGTCTGGAAAAAAAATTCTAGTT,10,30,14,27,27,39,27,54,27,32,32,39,47,54,44.77,4.073179271
hek293t,15573,1,15,CGTTCCAAAGTCATTGTTAAGCTGTTCCTAGGAGGCAGTTTGGAAGAGATTCCCCAAGGTCAGTCTGGAAGGCAAAAAAATTCTAGTTGGTTTAACGCG,CGTTCCAAAGTCATTGTTAAGCTGTTCCTAGGGCATCCACGAAGTAGAGGCAGTTTGGAAGAGATTCCCCAAGGTCAGTCTGGAAGGCAAAAAAATTCT,10,30,14,27,27,35,27,50,27,32,32,35,47,50,44.77,1.383268025
hek293t,15575,1,7,GTTTCTCTAATGATCAAGAGTTTTAATCTTGGCTTTCCAAGTTGTGTGCCTGTTTTCCAACCTTAAGGTTGGGAAAAAAATTCTAGTTGGTTTAACGCG,GTTTCTCTAATGATCAAGAGTTTTAATATCAGTACTTGGCTTTCCAAGTTGTGTGCCTGTTTTCCAACCTTAAGGTTGGGAAAAAAATTCTAGTTGGTT,10,30,14,27,27,43,27,50,27,28,28,43,35,50,15.38,18.18397136
hek293t,15575,1,7,ACATTTCTAATGATCAAGAGTTTTAATCTTGGCTTTCCAAGTTGTGTGCCTGTTTTCCAACCTTAAGGTTGGGAGTCTACAAAAAAAATTCTAGTTGGT,ACATTTCTAATGATCAAGAGTTTTAATATCAGTACTTGGCTTTCCAAGTTGTGTGCCTGTTTTCCAACCTTAAGGTTGGGAGTCTACAAAAAAAATTCT,10,30,14,27,27,35,27,42,27,28,28,35,35,42,15.38,6.616572505
hek293t,15577,1,10,ACACGGCAGCCACTAAGAATGTTGGCAGATGGAAAAATGCATTGGAAACACCTGTTCTTAATCCTCCAAGCAGGAATAATAAAAAAAATTCTAGTTGGT,ACACGGCAGCCACTAAGAATGTTGGCAGCCATTGGAGTATGGAAAAATGCATTGGAAACACCTGTTCTTAATCCTCCAAGCAGGAATAATAAAAAAAAT,10,30,14,27,27,32,27,42,27,29,29,32,39,42,23.51,0.0
hek293t,15577,1,10,CAATAGCAGCCACTAAGAATGTTGGCAGATGGAAAAATGCATTGGAAACACCTGTTCTTAATCCTCCAAGCAGGAATAAAAAAATTCTAGTTGGTTTAA,CAATAGCAGCCACTAAGAATGTTGGCAGCCATTGGAGTATGGAAAAATGCATTGGAAACACCTGTTCTTAATCCTCCAAGCAGGAATAAAAAAATTCTA,10,30,14,27,27,36,27,46,27,29,29,36,39,46,23.51,5.003166306
hek293t,15579,1,9,CCGGAGTCTGGGCCTTCTCTCAGAGGTGTTGGTGGCACCATGGCCTTCGAGCTTCCATCCTTCTCCTCCATTTAAAAAAATTCTAGTTGGTTTAACGCG,CCGGAGTCTGGGCCTTCTCTCAGAGGTGTTCTTCTTCAAGGTGGCACCATGGCCTTCGAGCTTCCATCCTTCTCCTCCATTTAAAAAAATTCTAGTTGG,10,30,14,27,27,41,27,50,27,31,31,41,40,50,53.47,49.07673915
hek293t,15579,1,9,TCCCTGTCTGGGCCTTCTCTCAGAGGTGTTGGTGGCACCATGGCCTTCGAGCTTCCATCCTTCTCCTCCATTTTATTCCTAAAAAAATTCTAGTTGGTT,TCCCTGTCTGGGCCTTCTCTCAGAGGTGTTCTTCTTCAAGGTGGCACCATGGCCTTCGAGCTTCCATCCTTCTCCTCCATTTTATTCCTAAAAAAATTC,10,30,14,27,27,34,27,43,27,31,31,34,40,43,53.47,0.0
hek293t,15582,1,4,GACCATTAAACATACCGATGGCGTTGTTCAGGGTATATTCTTCTCTGAAGAAATCTTGTGTCAGCCTATCTCCAACTAAAAAAATTCTAGTTGGTTTAA,GACCATTAAACATACCGATGGCGTTGTTCAGGGTTAATATATTCTTCTCTGAAGAAATCTTGTGTCAGCCTATCTCCAACTAAAAAAATTCTAGTTGGT,10,30,14,27,27,42,27,46,27,35,35,42,39,46,27.32,42.22977068
hek293t,15582,1,4,CATAGTTAAACATACCGATGGCGTTGTTCAGGGTATATTCTTCTCTGAAGAAATCTTGTGTCAGCCTATAAAAAAATTCTAGTTGGTTTAACGCGTAAC,CATAGTTAAACATACCGATGGCGTTGTTCAGGGTTAATATATTCTTCTCTGAAGAAATCTTGTGTCAGCCTATAAAAAAATTCTAGTTGGTTTAACGCG,10,30,14,27,27,50,27,54,27,35,35,50,39,54,27.32,78.13756517
hek293t,15584,1,5,ACATGTGTAGCTTGTATCTTCAATTGTTTTGGTTGTATCAAATCCATGAGGAGTTTAATTTAATAAAACCATTTAAAAAAATTCTAGTTGGTTTAACGC,ACATGTGTAGCTTGTATCTTCAATTGTTTTGGTTCATATGTATCAAATCCATGAGGAGTTTAATTTAATAAAACCATTTAAAAAAATTCTAGTTGGTTT,10,30,14,27,27,44,27,49,27,34,34,44,39,49,7.41,29.53839505
hek293t,15584,1,5,TGTCATGTAGCTTGTATCTTCAATTGTTTTGGTTGTATCAAATCCATGAGGAGTTTAATTTAATAAAACCATTTTTTAAAAAAATTCTAGTTGGTTTAA,TGTCATGTAGCTTGTATCTTCAATTGTTTTGGTTCATATGTATCAAATCCATGAGGAGTTTAATTTAATAAAACCATTTTTTAAAAAAATTCTAGTTGG,10,30,14,27,27,41,27,46,27,34,34,41,39,46,7.41,0.768578956
hek293t,15586,1,1,TAGACCACCTGGTTTCTATTTTGTAATGTAGGAAAAATACAAAAACTTACTGTATCTCCTTTGACAGCCAAAATACTCAAAAAAAAATTCTAGTTGGTT,TAGACCACCTGGTTTCTATTTTGTAATGTAGGAAGAAATACAAAAACTTACTGTATCTCCTTTGACAGCCAAAATACTCAAAAAAAAATTCTAGTTGGT,10,30,14,27,27,42,27,43,27,35,35,42,36,43,13.91,0.0
hek293t,15586,1,1,CAAGTCACCTGGTTTCTATTTTGTAATGTAGGAAAAATACAAAAACTTACTGTATCTCCTTTGACAGCCAAAATACTCAAATATAAAAAAATTCTAGTT,CAAGTCACCTGGTTTCTATTTTGTAATGTAGGAAGAAATACAAAAACTTACTGTATCTCCTTTGACAGCCAAAATACTCAAATATAAAAAAATTCTAGT,10,30,14,27,27,38,27,39,27,35,35,38,36,39,13.91,0.0
hek293t,15588,1,6,TCTAGAGTAACTCTAAGCACACACTCCCTTGGATACGTCAATATGTCTGGTGGCATTATCCATGACAGACAAGGGCTTGAAAAAAATTCTAGTTGGTTT,TCTAGAGTAACTCTAAGCACACACTCCCTTAAGTAGGGATACGTCAATATGTCTGGTGGCATTATCCATGACAGACAAGGGCTTGAAAAAAATTCTAGT,10,30,14,27,27,38,27,44,27,31,31,38,37,44,44.49,13.61373329
hek293t,15590,1,3,CCCACATGTGGCTATTACACAGATCGTACTGGTAGTTATCAAATCTGACAATGTTTTCAAAAATTACATATTCTTTTATAAAAAAATTCTAGTTGGTTT,CCCACATGTGGCTATTACACAGATCGTACTGGTAGTTGCCATCAAATCTGACAATGTTTTCAAAAATTACATATTCTTTTATAAAAAAATTCTAGTTGG,10,30,14,27,27,41,27,44,27,38,38,41,41,44,48.52,1.0
hek293t,15590,1,3,CGCTAATGTGGCTATTACACAGATCGTACTGGTAGTTATCAAATCTGACAATGTTTTCAAAAATTACATATTCTTAAAAAAATTCTAGTTGGTTTAACG,CGCTAATGTGGCTATTACACAGATCGTACTGGTAGTTGCCATCAAATCTGACAATGTTTTCAAAAATTACATATTCTTAAAAAAATTCTAGTTGGTTTA,10,30,14,27,27,45,27,48,27,38,38,45,41,48,48.52,49.47829948
hek293t,15592,1,9,TTATGAAGCTTTAGCTCTGTGCTTCACCCAGGGCTACTGTCCCTCCACATCACTAAAGTTTTCATATTACAAAAAAATTCTAGTTGGTTTAACGCGTAA,TTATGAAGCTTTAGCTCTGTGCTTCACCCTATTGATACAGGGCTACTGTCCCTCCACATCACTAAAGTTTTCATATTACAAAAAAATTCTAGTTGGTTT,10,30,14,27,27,44,27,53,27,29,29,44,38,53,62.15,21.0260311
hek293t,15594,1,15,CTGCATTCTTGGTGTAAATACATCCTAGTTGGGCAAAATCAGTGGTTTCTTTCTGGAATGTGCTGGTGAAAAAAATTCTAGTTGGTTTAACGCGTAACT,CTGCATTCTTGGTGTAAATACATCCTAGTTGGGCAACATCTAGAAAAACCTAATCAGTGGTTTCTTTCTGGAATGTGCTGGTGAAAAAAATTCTAGTTG,10,30,14,27,27,40,27,55,27,37,37,40,52,55,22.39,0.0
hek293t,15595,1,1,TACTAGTGACGGAAGAAGCATTTGGGGCTTGGCGAGCTCTCCGTTTGTGCAGCTCAGTGAAGTGAGGCGCCTGGCTAGTGGAAAAAAATTCTAGTTGGT,TACTAGTGACGGAAGAAGCATTTGGGGCTTGGCGGAGCTCTCCGTTTGTGCAGCTCAGTGAAGTGAGGCGCCTGGCTAGTGGAAAAAAATTCTAGTTGG,10,30,14,27,27,41,27,42,27,34,34,41,35,42,21.1,74.41493642
hek293t,15597,1,14,GTATCCGACGGCTGAGGAGAGGGTCGAGGCGGAGCGCCTGCACCTTCTGGTGGTTTCGCCCTCTCGCCCGACTCGAAAAAAATTCTAGTTGGTTTAACG,GTATCCGACGGCTGAGGAGAGGGTCGAGGCTGAGGGTAAGACTCGGAGCGCCTGCACCTTCTGGTGGTTTCGCCCTCTCGCCCGACTCGAAAAAAATTC,10,30,14,27,27,34,27,48,27,31,31,34,45,48,58.58,0.0
hek293t,15598,1,8,TAAGCATTCCAGTCTCAAGCCAGACTGGAAGGGAGAAGGGCCGCTTCAGTGCATAAGCCTACTCCTGGGTGCCTCTGAAAAAAAATTCTAGTTGGTTTA,TAAGCATTCCAGTCTCAAGCCAGACTGCTTAGCCGGAAGGGAGAAGGGCCGCTTCAGTGCATAAGCCTACTCCTGGGTGCCTCTGAAAAAAAATTCTAG,10,30,14,27,27,37,27,45,27,27,27,37,35,45,57.93,45.85751439
hek293t,15598,1,8,ATGAAATTCCAGTCTCAAGCCAGACTGGAAGGGAGAAGGGCCGCTTCAGTGCATAAGCCTACTCCTGGGTGCCAAAAAAATTCTAGTTGGTTTAACGCG,ATGAAATTCCAGTCTCAAGCCAGACTGCTTAGCCGGAAGGGAGAAGGGCCGCTTCAGTGCATAAGCCTACTCCTGGGTGCCAAAAAAATTCTAGTTGGT,10,30,14,27,27,42,27,50,27,27,27,42,35,50,57.93,48.50338643
hek293t,15600,1,5,TCGATACTTAATTTATTTTATTATTTTCAAGGGGGAAGGTGAAGGAGGGCTGAGAATGGACAGAAGTTAAAAAAATTCTAGTTGGTTTAACGCGTAACT,TCGATACTTAATTTATTTTATTATTTTCAAGGGGGAAGGATCAATGAAGGAGGGCTGAGAATGGACAGAAGTTAAAAAAATTCTAGTTGGTTTAACGCG,10,30,14,27,27,50,27,55,27,40,40,50,45,55,1.33,0.0
hek293t,15602,1,7,CTCTATTGTGGGAGTGGGGAAAAGAGGAAAGGAGTTAGGATCCTTGAGATACCTATAGTTTTTAATGCCTGTTGATAAAAAAATTCTAGTTGGTTTAAC,CTCTATTGTGGGAGTGGGGAAAAGAGGAAAGGAGTTATGACTCAGGATCCTTGAGATACCTATAGTTTTTAATGCCTGTTGATAAAAAAATTCTAGTTG,10,30,14,27,27,40,27,47,27,37,37,40,44,47,41.56,0.0
hek293t,15602,1,7,TATGCTTGTGGGAGTGGGGAAAAGAGGAAAGGAGTTAGGATCCTTGAGATACCTATAGTTTTTAAAAAAAATTCTAGTTGGTTTAACGCGTAACTAGAT,TATGCTTGTGGGAGTGGGGAAAAGAGGAAAGGAGTTATGACTCAGGATCCTTGAGATACCTATAGTTTTTAAAAAAAATTCTAGTTGGTTTAACGCGTA,10,30,14,27,27,52,27,59,27,37,37,52,44,59,41.56,0.890728707
hek293t,15604,1,13,GTGATTATGATGCAATGCCTTTGTATGAGAGGCCTTACAGGAACAGAAGTAGATGAAATCGGGAAGGATCAAACAAAAAAAAATTCTAGTTGGTTTAAC,GTGATTATGATGCAATGCCTTTGTATAGCCTCAAGACCCGAGAGGCCTTACAGGAACAGAAGTAGATGAAATCGGGAAGGATCAAACAAAAAAAAATTC,10,30,14,27,27,34,27,47,27,27,27,34,40,47,34.6,2.721000249
hek293t,15604,1,13,CCGGCTATGATGCAATGCCTTTGTATGAGAGGCCTTACAGGAACAGAAGTAGATGAAATCGGGAAGGATCAAAAAAAAAATTCTAGTTGGTTTAACGCG,CCGGCTATGATGCAATGCCTTTGTATAGCCTCAAGACCCGAGAGGCCTTACAGGAACAGAAGTAGATGAAATCGGGAAGGATCAAAAAAAAAATTCTAG,10,30,14,27,27,37,27,50,27,27,27,37,40,50,34.6,39.32757826
hek293t,15606,1,8,AGTTCTGCAGTAAGGCGGGCCTTTGCCCCAGGCAGCTTGCAGTCAAATTGAAATGTGGGCAAAAGGCTTGGGACACGATGAAAAAAAATTCTAGTTGGT,AGTTCTGCAGTAAGGCGGGCCTTTGCATCACCTTCCCAGGCAGCTTGCAGTCAAATTGAAATGTGGGCAAAAGGCTTGGGACACGATGAAAAAAAATTC,10,30,14,27,27,34,27,42,27,27,27,34,35,42,60.77,26.62995789
hek293t,15609,1,12,CGCGGCACACGGCTGGCTCTGCCCTTACGAGGCCAAAAGGGATCCTTTTGTGTACGTTACACAAAACAAAAAAATTCTAGTTGGTTTAACGCGTAACTA,CGCGGCACACGGCTGGCTCTGCCCTTACGAGGCCAAGCGACTCAGGGCAAGGGATCCTTTTGTGTACGTTACACAAAACAAAAAAATTCTAGTTGGTTT,10,30,14,27,27,44,27,56,27,37,37,44,49,56,53.47,0.26371308
hek293t,15612,1,3,GAATTTTTCCTAAATGTTTTGAAATCAATAGGAGATTAGCACATCTGAAAACCTTCTAAATGCGTTAAAAAAATTCTAGTTGGTTTAACGCGTAACTAG,GAATTTTTCCTAAATGTTTTGAAATCAATAGGAGATTATCTGCACATCTGAAAACCTTCTAAATGCGTTAAAAAAATTCTAGTTGGTTTAACGCGTAAC,10,30,14,27,27,54,27,57,27,39,39,54,42,57,0.45,0.073746313
hek293t,15612,1,3,ATGATTTTCCTAAATGTTTTGAAATCAATAGGAGATTAGCACATCTGAAAACCTTCTAAATGCGTTTCAAAAAAAAAATTCTAGTTGGTTTAACGCGTA,ATGATTTTCCTAAATGTTTTGAAATCAATAGGAGATTATCTGCACATCTGAAAACCTTCTAAATGCGTTTCAAAAAAAAAATTCTAGTTGGTTTAACGC,10,30,14,27,27,49,27,52,27,39,39,49,42,52,0.45,0.0
hek293t,15615,1,10,CAGACTTTGCTCAAAATGTTATAGAACAGAGGAGGGCATTTGGAAGTAAAGCCATATCTTCTGAATGGTTTCTTCCAAAAAAAATTCTAGTTGGTTTAA,CAGACTTTGCTCAAAATGTTATAGAACAGAGGAGGTTTTCCAAGGGCATTTGGAAGTAAAGCCATATCTTCTGAATGGTTTCTTCCAAAAAAAATTCTA,10,30,14,27,27,36,27,46,27,33,33,36,43,46,42.51,0.0
hek293t,15615,1,10,GTTGTTTTGCTCAAAATGTTATAGAACAGAGGAGGGCATTTGGAAGTAAAGCCATATCTTCTGAATGGTTAAAAAAATTCTAGTTGGTTTAACGCGTAA,GTTGTTTTGCTCAAAATGTTATAGAACAGAGGAGGTTTTCCAAGGGCATTTGGAAGTAAAGCCATATCTTCTGAATGGTTAAAAAAATTCTAGTTGGTT,10,30,14,27,27,43,27,53,27,33,33,43,43,53,42.51,0.051361068
hek293t,15617,1,2,CCAACATCCCTTTAGTCTTTGCCAAAGCCTGGTATCAGGATGATAAAGGAAGAAATAGCATATCAAGTCCTTACCTAAGAAATAAAAAAAATTCTAGTT,CCAACATCCCTTTAGTCTTTGCCAAAGGGCCTGGTATCAGGATGATAAAGGAAGAAATAGCATATCAAGTCCTTACCTAAGAAATAAAAAAAATTCTAG,10,30,14,27,27,37,27,39,27,27,27,37,29,39,24.59,22.28976919
hek293t,15617,1,2,CACTGATCCCTTTAGTCTTTGCCAAAGCCTGGTATCAGGATGATAAAGGAAGAAATAGCATATCAAGTCCTTACCTAAGAAATACTTAAAAAAATTCTA,CACTGATCCCTTTAGTCTTTGCCAAAGGGCCTGGTATCAGGATGATAAAGGAAGAAATAGCATATCAAGTCCTTACCTAAGAAATACTTAAAAAAATTC,10,30,14,27,27,34,27,36,27,27,27,34,29,36,24.59,32.73942767
hek293t,15619,1,15,CAAGGTACTTTTCATTCATGAGAAGTTTTAGGAATTTTACCTATTTTTGGCTACCCGTAGATATAAAAAAATTCTAGTTGGTTTAACGCGTAACTAGAT,CAAGGTACTTTTCATTCATGAGAAGTTTTCAAGTAGATCATGCTAGGAATTTTACCTATTTTTGGCTACCCGTAGATATAAAAAAATTCTAGTTGGTTT,10,30,14,27,27,44,27,59,27,29,29,44,44,59,-0.84,0.033200531
hek293t,15619,1,15,AGTTCTACTTTTCATTCATGAGAAGTTTTAGGAATTTTACCTATTTTTGGCTACCCGTAGATATGTGAAGGAAGGAAAAAAAATTCTAGTTGGTTTAAC,AGTTCTACTTTTCATTCATGAGAAGTTTTCAAGTAGATCATGCTAGGAATTTTACCTATTTTTGGCTACCCGTAGATATGTGAAGGAAGGAAAAAAAAT,10,30,14,27,27,32,27,47,27,29,29,32,44,47,-0.84,0.0
hek293t,15615,1,8,ATTTAGCTCAAAATGTTATAGAACAGAGGAGGGCATTTGGAAGTAAAGCCATATCTTCTGAATGGTTTCTTCCAAAAAAATTCTAGTTGGTTTAACGCG,ATTTAGCTCAAAATGTTATAGAACAGAGGAGATTTGGTTGGCATTTGGAAGTAAAGCCATATCTTCTGAATGGTTTCTTCCAAAAAAATTCTAGTTGGT,10,30,14,27,27,42,27,50,27,32,32,42,40,50,37.43,10.95981399
hek293t,15615,1,8,TCGTCGCTCAAAATGTTATAGAACAGAGGAGGGCATTTGGAAGTAAAGCCATATCTTCTGAATGGTTTAAAAAAATTCTAGTTGGTTTAACGCGTAACT,TCGTCGCTCAAAATGTTATAGAACAGAGGAGATTTGGTTGGCATTTGGAAGTAAAGCCATATCTTCTGAATGGTTTAAAAAAATTCTAGTTGGTTTAAC,10,30,14,27,27,47,27,55,27,32,32,47,40,55,37.43,5.849480433
hek293t,15623,1,9,GTTAATTCACCTCCGGCTCTTGGCTCACTTGGCTCTTACTTGCTGAAATGTTGACATAATCTCTAAATAGCGCATATAAAAAAATTCTAGTTGGTTTAA,GTTAATTCACCTCCGGCTCTTGGCTCACTAGGGAAGATTGGCTCTTACTTGCTGAAATGTTGACATAATCTCTAAATAGCGCATATAAAAAAATTCTAG,10,30,14,27,27,37,27,46,27,30,30,37,39,46,16.95,19.5766253
hek293t,15625,1,9,CTCGGTTAAAGGTTAGCTGCAGGATTAGATGGAATTCACCTCTACAAGCAATTGGATTAGTTTATTCTCAAAAAAATTCTAGTTGGTTTAACGCGTAAC,CTCGGTTAAAGGTTAGCTGCAGGATTAGATGGAATTCCCCCCCCACACCTCTACAAGCAATTGGATTAGTTTATTCTCAAAAAAATTCTAGTTGGTTTA,10,30,14,27,27,45,27,54,27,38,38,45,47,54,34.28,0.0
hek293t,15627,1,11,AAGAATTGCTAATCCCCAGCCTGCAGTTGTGGGTTATGTGAACATTTGAAATGCTGTTCACTAGAGGTCAACATTAAAAAAATTCTAGTTGGTTTAACG,AAGAATTGCTAATCCCCAGCCTGCAGTTGTGTCGATTAAATGGGTTATGTGAACATTTGAAATGCTGTTCACTAGAGGTCAACATTAAAAAAATTCTAG,10,30,14,27,27,37,27,48,27,30,30,37,41,48,51.54,0.086467791
hek293t,15627,1,11,CTTAGTTGCTAATCCCCAGCCTGCAGTTGTGGGTTATGTGAACATTTGAAATGCTGTTCACTAGAGGTCAACAAAAAAATTCTAGTTGGTTTAACGCGT,CTTAGTTGCTAATCCCCAGCCTGCAGTTGTGTCGATTAAATGGGTTATGTGAACATTTGAAATGCTGTTCACTAGAGGTCAACAAAAAAATTCTAGTTG,10,30,14,27,27,40,27,51,27,30,30,40,41,51,51.54,5.365190831
hek293t,15629,1,12,GGTCGGCTAAAGGACTGTTGTCATTGCTTTGGTTCTACAGTGGGGAAAGATATTAATCCTACAATGATGATGAATAAAAAAATTCTAGTTGGTTTAACG,GGTCGGCTAAAGGACTGTTGTCATTGCTACGGCTTCTTGATTGGTTCTACAGTGGGGAAAGATATTAATCCTACAATGATGATGAATAAAAAAATTCTA,10,30,14,27,27,36,27,48,27,29,29,36,41,48,53.37,0.273972603
hek293t,15629,1,12,GGCTAGCTAAAGGACTGTTGTCATTGCTTTGGTTCTACAGTGGGGAAAGATATTAATCCTACAATGAAAAAAAATTCTAGTTGGTTTAACGCGTAACTA,GGCTAGCTAAAGGACTGTTGTCATTGCTACGGCTTCTTGATTGGTTCTACAGTGGGGAAAGATATTAATCCTACAATGAAAAAAAATTCTAGTTGGTTT,10,30,14,27,27,44,27,56,27,29,29,44,41,56,53.37,3.860981833
hek293t,15631,1,7,ACCGTTTGAGCATGTAACTTGGGGAGATGAGGTTTAGTCTGATTGCAGTAAAAATCTGCCTATCCTGTTTAAAAAAAATTCTAGTTGGTTTAACGCGTA,ACCGTTTGAGCATGTAACTTGGGGAGATGAGGTTTAGGTTTAGTTCTGATTGCAGTAAAAATCTGCCTATCCTGTTTAAAAAAAATTCTAGTTGGTTTA,10,30,14,27,27,45,27,52,27,38,38,45,45,52,41.37,27.30035509
hek293t,15633,1,8,CAACAGGGCACTGCCCTTACTGGAGCTCTCGGACACTCAACCTGTTCTATAGGGCTTTAAAGCAGGTTCCTTGGCAGAAAAAAAATTCTAGTTGGTTTA,CAACAGGGCACTGCCCTTACTGGAGCTCTTTGTACGCCGGACACTCAACCTGTTCTATAGGGCTTTAAAGCAGGTTCCTTGGCAGAAAAAAAATTCTAG,10,30,14,27,27,37,27,45,27,30,30,37,38,45,47.36,28.98670933
hek293t,15635,1,4,TTCCGACTTTGTAAAACTTTTTTCCTCTGTGGGTTTTTCTAGTGGTTTGATTTCAGGATCTTGCCACCTTCTCCGAAGCCGCTAAAAAAATTCTAGTTG,TTCCGACTTTGTAAAACTTTTTTCCTCTTCAGGTGGGTTTTTCTAGTGGTTTGATTTCAGGATCTTGCCACCTTCTCCGAAGCCGCTAAAAAAATTCTA,10,30,14,27,27,36,27,40,27,29,29,36,33,40,0.85,0.0
hek293t,15635,1,4,CGTACACTTTGTAAAACTTTTTTCCTCTGTGGGTTTTTCTAGTGGTTTGATTTCAGGATCTTGCCACCTTCTCCGAAAAAAATTCTAGTTGGTTTAACG,CGTACACTTTGTAAAACTTTTTTCCTCTTCAGGTGGGTTTTTCTAGTGGTTTGATTTCAGGATCTTGCCACCTTCTCCGAAAAAAATTCTAGTTGGTTT,10,30,14,27,27,44,27,48,27,29,29,44,33,48,0.85,0.255102041
hek293t,15637,1,9,ACCTGCCCTTTTGGTTGTGACTGTGAATGAGGCACAGACAAAATAAGCACCAAATCCTACTCTTGAGAAACAAAAAAATTCTAGTTGGTTTAACGCGTA,ACCTGCCCTTTTGGTTGTGACTGTGAATGAGGCTCTAAAGCCACAGACAAAATAAGCACCAAATCCTACTCTTGAGAAACAAAAAAATTCTAGTTGGTT,10,30,14,27,27,43,27,52,27,33,33,43,42,52,42.52,5.168191521
hek293t,15637,1,9,GGCTGCCCTTTTGGTTGTGACTGTGAATGAGGCACAGACAAAATAAGCACCAAATCCTACTCTTGAAAAAAAATTCTAGTTGGTTTAACGCGTAACTAG,GGCTGCCCTTTTGGTTGTGACTGTGAATGAGGCTCTAAAGCCACAGACAAAATAAGCACCAAATCCTACTCTTGAAAAAAAATTCTAGTTGGTTTAACG,10,30,14,27,27,48,27,57,27,33,33,48,42,57,42.52,1.890487237
hek293t,15639,1,1,CCGTGTAAAATACCTCGTGTATCATTTATAGGTGTATAAATGATCTATATGAATTGCTTATATGCAAATCTATGTTCAAAAAAAATTCTAGTTGGTTTA,CCGTGTAAAATACCTCGTGTATCATTTAATAGGTGTATAAATGATCTATATGAATTGCTTATATGCAAATCTATGTTCAAAAAAAATTCTAGTTGGTTT,10,30,14,27,27,44,27,45,27,29,29,44,30,45,9.91,12.81134717
hek293t,15639,1,1,GCACATAAAATACCTCGTGTATCATTTATAGGTGTATAAATGATCTATATGAATTGCTTATATGCAAATCTATGTTCAGAAACAAAAAAATTCTAGTTG,GCACATAAAATACCTCGTGTATCATTTAATAGGTGTATAAATGATCTATATGAATTGCTTATATGCAAATCTATGTTCAGAAACAAAAAAATTCTAGTT,10,30,14,27,27,39,27,40,27,29,29,39,30,40,9.91,9.570725971
hek293t,15641,1,5,AGTATAATTCTCTTGAAATAATAGGATACAGGGGGACTCCCTAAAGCATGAGCATAAATAGTTCAGGAACAAAAAAAAAATTCTAGTTGGTTTAACGCG,AGTATAATTCTCTTGAAATAATAGGATACACATAAGGGGGACTCCCTAAAGCATGAGCATAAATAGTTCAGGAACAAAAAAAAAATTCTAGTTGGTTTA,10,30,14,27,27,45,27,50,27,30,30,45,35,50,16.39,1.125505297
hek293t,15641,1,5,CGGGGAATTCTCTTGAAATAATAGGATACAGGGGGACTCCCTAAAGCATGAGCATAAATAGTTCAGGAACAAATCAGAAAAAAAATTCTAGTTGGTTTA,CGGGGAATTCTCTTGAAATAATAGGATACACATAAGGGGGACTCCCTAAAGCATGAGCATAAATAGTTCAGGAACAAATCAGAAAAAAAATTCTAGTTG,10,30,14,27,27,40,27,45,27,30,30,40,35,45,16.39,1.276508013
hek293t,15643,1,5,CCATTAGACTGCTTGGCTCAACATGCTTATGGACACCAAGAATAAAGCAAAAAAGCCTTTAGAAAAACAGAGAAAAATTGCACAAAAAAATTCTAGTTG,CCATTAGACTGCTTGGCTCAACATGCTCAGCCTATGGACACCAAGAATAAAGCAAAAAAGCCTTTAGAAAAACAGAGAAAAATTGCACAAAAAAATTCT,10,30,14,27,27,35,27,40,27,28,28,35,33,40,16.2,29.09520932
hek293t,15643,1,5,GACCCAGACTGCTTGGCTCAACATGCTTATGGACACCAAGAATAAAGCAAAAAAGCCTTTAGAAAAACAGAGAAAAATTGCACTGCAAAAAAAATTCTA,GACCCAGACTGCTTGGCTCAACATGCTCAGCCTATGGACACCAAGAATAAAGCAAAAAAGCCTTTAGAAAAACAGAGAAAAATTGCACTGCAAAAAAAA,10,30,14,27,27,31,27,36,27,28,28,31,33,36,16.2,0.351141351
hek293t,15645,1,15,CTAGGAATGTAAATGTCAGACCAAAAAGAAGGCATTAAAGACGAATGCATACATTCAGATTATTACTTAAAAAAATTCTAGTTGGTTTAACGCGTAACT,CTAGGAATGTAAATGTCAGACCAAAAAGAAGGAGCCGCGTCTGCGACCATTAAAGACGAATGCATACATTCAGATTATTACTTAAAAAAATTCTAGTTG,10,30,14,27,27,40,27,55,27,33,33,40,48,55,69.03,0.286730089
hek293t,15646,1,12,TCAGCTTGGGGGTCCGTATTTCCACTTTGGGGAAACACTCTACACTGAAATAATGTTTATATTTATTCATCTAAAAAAAATTCTAGTTGGTTTAACGCG,TCAGCTTGGGGGTCCGTATTTCCACTTCCGCGTAATACCTGGGGAAACACTCTACACTGAAATAATGTTTATATTTATTCATCTAAAAAAAATTCTAGT,10,30,14,27,27,38,27,50,27,28,28,38,40,50,35.44,6.308163524
hek293t,15646,1,12,TGTGATTGGGGGTCCGTATTTCCACTTTGGGGAAACACTCTACACTGAAATAATGTTTATATTTATTCATCTATAAAAAAAAATTCTAGTTGGTTTAAC,TGTGATTGGGGGTCCGTATTTCCACTTCCGCGTAATACCTGGGGAAACACTCTACACTGAAATAATGTTTATATTTATTCATCTATAAAAAAAAATTCT,10,30,14,27,27,35,27,47,27,28,28,35,40,47,35.44,1.487777175
hek293t,15648,1,4,TAATACCTTATACAAGGCAATCTTAAAATAGGATTACATTCCCTGAAACGTCTGATTCTCCACAATTTAGGCTAATGGATGACGTAAAAAAATTCTAGT,TAATACCTTATACAAGGCAATCTTAACTTCAATAGGATTACATTCCCTGAAACGTCTGATTCTCCACAATTTAGGCTAATGGATGACGTAAAAAAATTC,10,30,14,27,27,34,27,38,27,27,27,34,31,38,12.28,53.58591411
hek293t,15648,1,4,GTCGCCCTTATACAAGGCAATCTTAAAATAGGATTACATTCCCTGAAACGTCTGATTCTCCACAATTTAGGCTAATGAAAAAAATTCTAGTTGGTTTAA,GTCGCCCTTATACAAGGCAATCTTAACTTCAATAGGATTACATTCCCTGAAACGTCTGATTCTCCACAATTTAGGCTAATGAAAAAAATTCTAGTTGGT,10,30,14,27,27,42,27,46,27,27,27,42,31,46,12.28,47.15932217
hek293t,15650,1,8,CCATTGTATGGTGGGAATGCTGCAAAATTTGGACTCAAATTTCCTCTGTCTCTCTGTGAAAATGTGTATGTGAGGATAAAAAAATTCTAGTTGGTTTAA,CCATTGTATGGTGGGAATGCTGCAAAATTTGGACCTAGGGACTCAAATTTCCTCTGTCTCTCTGTGAAAATGTGTATGTGAGGATAAAAAAATTCTAGT,10,30,14,27,27,38,27,46,27,35,35,38,43,46,18.72,0.0
hek293t,15652,1,11,GTAGGGACACCATTTTCAATTTCTGCTCAAGGAAAAATGAGGTTTGTAATGGCCAATGTGTTACAAATAAAAAAATTCTAGTTGGTTTAACGCGTAACT,GTAGGGACACCATTTTCAATTTCTGCTCAAGGAAGTCACTTAAAAAAATGAGGTTTGTAATGGCCAATGTGTTACAAATAAAAAAATTCTAGTTGGTTT,10,30,14,27,27,44,27,55,27,34,34,44,45,55,2.35,0.0
hek293t,15653,1,5,GCGCTGACATCAGTTTAACAGAGCTCAGCTGGCCAAAGATATTTCTGAATTTGGTTTCTTGCCAGCTTAAAAAAATTCTAGTTGGTTTAACGCGTAACT,GCGCTGACATCAGTTTAACAGAGCTCAGCTGGCCAAAGAAGGCATATTTCTGAATTTGGTTTCTTGCCAGCTTAAAAAAATTCTAGTTGGTTTAACGCG,10,30,14,27,27,50,27,55,27,40,40,50,45,55,29.62,45.39968433
hek293t,15654,1,2,TCGCATGCTTCCTAATATTTTGCTGACTATGGTGTTATATATTTCAACAGCAAGAAGTATTAACAAATTTGTAGTAGAAAAAAATTCTAGTTGGTTTAA,TCGCATGCTTCCTAATATTTTGCTGACTATGGTGTTATATCGATTTCAACAGCAAGAAGTATTAACAAATTTGTAGTAGAAAAAAATTCTAGTTGGTTT,10,30,14,27,27,44,27,46,27,41,41,44,43,46,13.19,0.0
hek293t,15654,1,2,CCAACTGCTTCCTAATATTTTGCTGACTATGGTGTTATATATTTCAACAGCAAGAAGTATTAACAAATTTAAAAAAATTCTAGTTGGTTTAACGCGTAA,CCAACTGCTTCCTAATATTTTGCTGACTATGGTGTTATATCGATTTCAACAGCAAGAAGTATTAACAAATTTAAAAAAATTCTAGTTGGTTTAACGCGT,10,30,14,27,27,51,27,53,27,41,41,51,43,53,13.19,1.569002001
hek293t,15656,1,7,CCAGGTTCTTAGTCATGTCACATTCTGCTTGGCAGTATGCACATTGTGTTTGATCCTAATTTTTACATATCAAAAAAATTCTAGTTGGTTTAACGCGTA,CCAGGTTCTTAGTCATGTCACATTCTGCTTGGCAGTAGAGGATTTGCACATTGTGTTTGATCCTAATTTTTACATATCAAAAAAATTCTAGTTGGTTTA,10,30,14,27,27,45,27,52,27,38,38,45,45,52,66.87,1.847917069
hek293t,20329,1,4,TTTTTTCATAGCTTTAAATCAGTGCCAGCTGGACCAAAACGAGGCCTCACAGGGCCCCATTTGAGGTCTATGAAAAAAATTCTAGTTGGTTTAACGCGT,TTTTTTCATAGCTTTAAATCAGTGCCAGCTGGACCAAAACGTCCGAGGCCTCACAGGGCCCCATTTGAGGTCTATGAAAAAAATTCTAGTTGGTTTAAC,10,30,14,27,27,47,27,51,27,40,40,47,44,51,14.99,0.616133866
hek293t,20329,1,4,CCAATTCATAGCTTTAAATCAGTGCCAGCTGGACCAAAACGAGGCCTCACAGGGCCCCATTTGAGGTCTAAAAAAATTCTAGTTGGTTTAACGCGTAAC,CCAATTCATAGCTTTAAATCAGTGCCAGCTGGACCAAAACGTCCGAGGCCTCACAGGGCCCCATTTGAGGTCTAAAAAAATTCTAGTTGGTTTAACGCG,10,30,14,27,27,50,27,54,27,40,40,50,44,54,14.99,11.42948837
hek293t,15659,1,2,AACTGAGCTGGATGCTATTTCTCCATTCTAGGAATTCTCTGTGCTCTTTAGGACACATGAAGCACTTGTGTTCCAGAAGAGAACGTAAAAAAATTCTAG,AACTGAGCTGGATGCTATTTCTCCATTGCCTAGGAATTCTCTGTGCTCTTTAGGACACATGAAGCACTTGTGTTCCAGAAGAGAACGTAAAAAAATTCT,10,30,14,27,27,35,27,37,27,28,28,35,30,37,17.89,58.85484903
hek293t,15659,1,2,AACATAGCTGGATGCTATTTCTCCATTCTAGGAATTCTCTGTGCTCTTTAGGACACATGAAGCACTTGTGTTCCAGAAAAAAAAATTCTAGTTGGTTTA,AACATAGCTGGATGCTATTTCTCCATTGCCTAGGAATTCTCTGTGCTCTTTAGGACACATGAAGCACTTGTGTTCCAGAAAAAAAAATTCTAGTTGGTT,10,30,14,27,27,43,27,45,27,28,28,43,30,45,17.89,80.83231226
hek293t,15661,1,2,TAGATAAAAGTGTATTTATCACGGAAAATTGGATAGAAAATGGAAGTTTTATGACATTTATTGTCTAAAAAAATTCTAGTTGGTTTAACGCGTAACTAG,TAGATAAAAGTGTATTTATCACGGAAAATTGGATAGAAATTATGGAAGTTTTATGACATTTATTGTCTAAAAAAATTCTAGTTGGTTTAACGCGTAACT,10,30,14,27,27,55,27,57,27,40,40,55,42,57,9.44,34.54861987
hek293t,15661,1,2,AGAGGAAAAGTGTATTTATCACGGAAAATTGGATAGAAAATGGAAGTTTTATGACATTTATTGTCTTTTCTTCAAAAAAAATTCTAGTTGGTTTAACGC,AGAGGAAAAGTGTATTTATCACGGAAAATTGGATAGAAATTATGGAAGTTTTATGACATTTATTGTCTTTTCTTCAAAAAAAATTCTAGTTGGTTTAAC,10,30,14,27,27,47,27,49,27,40,40,47,42,49,9.44,16.28638057
hek293t,15663,1,10,TGTAATGAATGGCTTCTTGAAAAATCTTGTGGTCCCTATGTTGCTATATTTAGTTTTTAGGGATAAAATGTCAAAAAAATTCTAGTTGGTTTAACGCGT,TGTAATGAATGGCTTCTTGAAAAATCTTGTCGTCTGTTGAGGTCCCTATGTTGCTATATTTAGTTTTTAGGGATAAAATGTCAAAAAAATTCTAGTTGG,10,30,14,27,27,41,27,51,27,31,31,41,41,51,29.04,0.139762404
hek293t,15663,1,10,TAGGGTGAATGGCTTCTTGAAAAATCTTGTGGTCCCTATGTTGCTATATTTAGTTTTTAGGGATAAAATGTCAGCAAAAAAATTCTAGTTGGTTTAACG,TAGGGTGAATGGCTTCTTGAAAAATCTTGTCGTCTGTTGAGGTCCCTATGTTGCTATATTTAGTTTTTAGGGATAAAATGTCAGCAAAAAAATTCTAGT,10,30,14,27,27,38,27,48,27,31,31,38,41,48,29.04,0.0
hek293t,15665,1,9,GGATTGGCCAGTGATGAGGATATGATCATAGGCTGGTGAAATGTTGGAAAGCTGGAGGGGCTGTGGTAAGGGTTGGTGTAAAAAAATTCTAGTTGGTTT,GGATTGGCCAGTGATGAGGATATGATCATAGTGCGTGCTTGCTGGTGAAATGTTGGAAAGCTGGAGGGGCTGTGGTAAGGGTTGGTGTAAAAAAATTCT,10,30,14,27,27,35,27,44,27,32,32,35,41,44,65.13,2.319427802
hek293t,15665,1,9,GTACAGGCCAGTGATGAGGATATGATCATAGGCTGGTGAAATGTTGGAAAGCTGGAGGGGCTGTGGTAAGGGTTGAAAAAAATTCTAGTTGGTTTAACG,GTACAGGCCAGTGATGAGGATATGATCATAGTGCGTGCTTGCTGGTGAAATGTTGGAAAGCTGGAGGGGCTGTGGTAAGGGTTGAAAAAAATTCTAGTT,10,30,14,27,27,39,27,48,27,32,32,39,41,48,65.13,21.61807148
hek293t,15667,1,3,CATAGAAACAGCCTGAAAATGGTAGCAGTTGGCAGTATCTGGGGCCTTCTCTGGAGATATATATTTGCAGTCTTCTGGTTAAAAAAATTCTAGTTGGTT,CATAGAAACAGCCTGAAAATGGTAGCAGTTGGGAGCAGTATCTGGGGCCTTCTCTGGAGATATATATTTGCAGTCTTCTGGTTAAAAAAATTCTAGTTG,10,30,14,27,27,40,27,43,27,33,33,40,36,43,59.09,56.31154418
hek293t,15667,1,3,CGGGGAAACAGCCTGAAAATGGTAGCAGTTGGCAGTATCTGGGGCCTTCTCTGGAGATATATATTTGCAGTCTTCTGAAAAAAATTCTAGTTGGTTTAA,CGGGGAAACAGCCTGAAAATGGTAGCAGTTGGGAGCAGTATCTGGGGCCTTCTCTGGAGATATATATTTGCAGTCTTCTGAAAAAAATTCTAGTTGGTT,10,30,14,27,27,43,27,46,27,33,33,43,36,46,59.09,78.29156823
hek293t,15669,1,15,GTAATTTAGTTGAGATTTTCAAAGTGGTATGGGCAAATCCTCTGCACATCTCACATTAATTAACAGAAAAAAATTCTAGTTGGTTTAACGCGTAACTAG,GTAATTTAGTTGAGATTTTCAAAGTGGTATGATGTACTATGGTGTAGGCAAATCCTCTGCACATCTCACATTAATTAACAGAAAAAAATTCTAGTTGGT,10,30,14,27,27,42,27,57,27,32,32,42,47,57,8.34,0.0
hek293t,15669,1,15,TCTATTTAGTTGAGATTTTCAAAGTGGTATGGGCAAATCCTCTGCACATCTCACATTAATTAACAGCAAAAAAAAATTCTAGTTGGTTTAACGCGTAAC,TCTATTTAGTTGAGATTTTCAAAGTGGTATGATGTACTATGGTGTAGGCAAATCCTCTGCACATCTCACATTAATTAACAGCAAAAAAAAATTCTAGTT,10,30,14,27,27,39,27,54,27,32,32,39,47,54,8.34,0.0
hek293t,54,1,15,TGGTCCATTAGTATGCACTCAGTGCATCCTGGGGTGAGGGCTGGCTAAAAGAAGCTCCAGCCTCTTTCTAAAAAAAATTCTAGTTGGTTTAACGCGTAA,TGGTCCATTAGTATGCACTCAGTGCATCCTGGGGGAAAATACTTGACAGTGAGGGCTGGCTAAAAGAAGCTCCAGCCTCTTTCTAAAAAAAATTCTAGT,10,30,14,27,27,38,27,53,27,35,35,38,50,53,55.69,0.0
hek293t,15672,1,12,GCACGGATGCTTTTGGTAGTGATTACAAAAGGAAAACTATTCTATTAATAGCCATCTCAAAATCATCTAAAAAAAATTCTAGTTGGTTTAACGCGTAAC,GCACGGATGCTTTTGGTAGTGATTACAAAAGGAAAACTTCTCAATGATAAATTCTATTAATAGCCATCTCAAAATCATCTAAAAAAAATTCTAGTTGGT,10,30,14,27,27,42,27,54,27,39,39,42,51,54,10.56,0.0
hek293t,15673,1,8,GTAAGAGTTCTGCATCTGTCCCACAGGGCTGGAGCTGAGGTTTCACCGGCAGCACGAATGTTCTGGTACATCACCAAAAAAATTCTAGTTGGTTTAACG,GTAAGAGTTCTGCATCTGTCCCACAGGGCTGGTGATAGTCAGCTGAGGTTTCACCGGCAGCACGAATGTTCTGGTACATCACCAAAAAAATTCTAGTTG,10,30,14,27,27,40,27,48,27,33,33,40,41,48,37.34,10.66615108
hek293t,15673,1,8,ATCATAGTTCTGCATCTGTCCCACAGGGCTGGAGCTGAGGTTTCACCGGCAGCACGAATGTTCTGGTACATCACCACCCAAAAAAATTCTAGTTGGTTT,ATCATAGTTCTGCATCTGTCCCACAGGGCTGGTGATAGTCAGCTGAGGTTTCACCGGCAGCACGAATGTTCTGGTACATCACCACCCAAAAAAATTCTA,10,30,14,27,27,36,27,44,27,33,33,36,41,44,37.34,1.241134752
hek293t,15675,1,13,AGTTGAAGTGACACATCAAGAGGGAGACATGGGAAGATGGAAGGCTGTTATGTGACCCTGCACTACAAAAAAAATTCTAGTTGGTTTAACGCGTAACTA,AGTTGAAGTGACACATCAAGAGGGAGACATGGGAAGAGGGGGAAGGAAGATGGAAGGCTGTTATGTGACCCTGCACTACAAAAAAAATTCTAGTTGGTT,10,30,14,27,27,43,27,56,27,36,36,43,49,56,54.34,0.823226384
hek293t,15676,1,5,CTGTGCTCAAGCTCCATCTGAATGCTCCCAGGAAGCTGCAATGTACTGCAGCAGATGTTTAAGTAAAGGTTGAAAAAAATTCTAGTTGGTTTAACGCGT,CTGTGCTCAAGCTCCATCTGAATGCTCCCATCATCGGAAGCTGCAATGTACTGCAGCAGATGTTTAAGTAAAGGTTGAAAAAAATTCTAGTTGGTTTAA,10,30,14,27,27,46,27,51,27,31,31,46,36,51,59.61,43.38979092
hek293t,15678,1,10,GGGTAAGAGCTGCTGAAAGGAAGCAGAAGGGGAGCCGCTGAAAGGAAGCGGCATTGCGCGCAACAGAAAAAAATTCTAGTTGGTTTAACGCGTAACTAG,GGGTAAGAGCTGCTGAAAGGAAGCAGAAGGGGAGCCATTATGTGTCGCTGAAAGGAAGCGGCATTGCGCGCAACAGAAAAAAATTCTAGTTGGTTTAAC,10,30,14,27,27,47,27,57,27,37,37,47,47,57,50.87,1.904728833
hek293t,15678,1,10,GGCCAAGAGCTGCTGAAAGGAAGCAGAAGGGGAGCCGCTGAAAGGAAGCGGCATTGCGCGCAACAGGTTACCTAAAAAAATTCTAGTTGGTTTAACGCG,GGCCAAGAGCTGCTGAAAGGAAGCAGAAGGGGAGCCATTATGTGTCGCTGAAAGGAAGCGGCATTGCGCGCAACAGGTTACCTAAAAAAATTCTAGTTG,10,30,14,27,27,40,27,50,27,37,37,40,47,50,50.87,0.0
hek293t,15680,1,12,GTCAATTGTGGGATTCAGCACAACGTATATGGGTGAGATCTGTGAGCCTTAATGACACTTTATTCTGTGATAAAAAAATTCTAGTTGGTTTAACGCGTA,GTCAATTGTGGGATTCAGCACAACGTATATGGGTGACCGACCCTGCCTGATCTGTGAGCCTTAATGACACTTTATTCTGTGATAAAAAAATTCTAGTTG,10,30,14,27,27,40,27,52,27,37,37,40,49,52,18.18,0.0
hek293t,15680,1,12,CCGTTTTGTGGGATTCAGCACAACGTATATGGGTGAGATCTGTGAGCCTTAATGACACTTTATTAAAAAAATTCTAGTTGGTTTAACGCGTAACTAGAT,CCGTTTTGTGGGATTCAGCACAACGTATATGGGTGACCGACCCTGCCTGATCTGTGAGCCTTAATGACACTTTATTAAAAAAATTCTAGTTGGTTTAAC,10,30,14,27,27,47,27,59,27,37,37,47,49,59,18.18,4.305578717
hek293t,15682,1,6,ATAACAGAGAAAGCTTGCATGATTGCTGGAGGGTTTCACTGCCTAAAATCTGCTGCCATGCACAGAAACATCAAAAAAATTCTAGTTGGTTTAACGCGT,ATAACAGAGAAAGCTTGCATGATTGCTGGTGTGGGAGGGTTTCACTGCCTAAAATCTGCTGCCATGCACAGAAACATCAAAAAAATTCTAGTTGGTTTA,10,30,14,27,27,45,27,51,27,30,30,45,36,51,40.19,67.68589706
hek293t,15682,1,6,GTTGAAGAGAAAGCTTGCATGATTGCTGGAGGGTTTCACTGCCTAAAATCTGCTGCCATGCACAGAAACATCTCTGGTATAAAAAAATTCTAGTTGGTT,GTTGAAGAGAAAGCTTGCATGATTGCTGGTGTGGGAGGGTTTCACTGCCTAAAATCTGCTGCCATGCACAGAAACATCTCTGGTATAAAAAAATTCTAG,10,30,14,27,27,37,27,43,27,30,30,37,36,43,40.19,37.71099166
hek293t,687,1,14,GGGTGGACTGCTTTGATAATTGCAAGTTCTGGTTAAAACCATGATAGCAGGGAACTGATTTTAAAAAATAAAAAAATTCTAGTTGGTTTAACGCGTAAC,GGGTGGACTGCTTTGATAATTGCAAGTTCTGGCAAGTAATAAATCCTTAAAACCATGATAGCAGGGAACTGATTTTAAAAAATAAAAAAATTCTAGTTG,10,30,14,27,27,40,27,54,27,33,33,40,47,54,26.12,0.0
hek293t,15685,1,1,TCCCCAGCCTTCAGAAACAGCTTTCTAATAGGTATTTACCTGCCTTAGGAAAAAACAGGACCTATCCTTTCTTTCTAAAAAAATTCTAGTTGGTTTAAC,TCCCCAGCCTTCAGAAACAGCTTTCTAATAGGTATATTACCTGCCTTAGGAAAAAACAGGACCTATCCTTTCTTTCTAAAAAAATTCTAGTTGGTTTAA,10,30,14,27,27,46,27,47,27,36,36,46,37,47,10.8,44.04401806
hek293t,15685,1,1,GTCAGAGCCTTCAGAAACAGCTTTCTAATAGGTATTTACCTGCCTTAGGAAAAAACAGGACCTATCCTTTCAAAAAAATTCTAGTTGGTTTAACGCGTA,GTCAGAGCCTTCAGAAACAGCTTTCTAATAGGTATATTACCTGCCTTAGGAAAAAACAGGACCTATCCTTTCAAAAAAATTCTAGTTGGTTTAACGCGT,10,30,14,27,27,51,27,52,27,36,36,51,37,52,10.8,23.47482163
hek293t,17485,1,5,CCCACTCATTCAGCACTGAAGAGAATAAGAGGCTGGTTTCTTAGAATTAGATGCAAGTTTGTCAAAGGACCCAGGATTTCAAAAAAATTCTAGTTGGTT,CCCACTCATTCAGCACTGAAGAGAATAGCCGCAGAGGCTGGTTTCTTAGAATTAGATGCAAGTTTGTCAAAGGACCCAGGATTTCAAAAAAATTCTAGT,10,30,14,27,27,38,27,43,27,28,28,38,33,43,73.47,66.45354416
hek293t,17485,1,5,TCTCGTCATTCAGCACTGAAGAGAATAAGAGGCTGGTTTCTTAGAATTAGATGCAAGTTTGTCAAAGGACCCAGGATTTCACCAAAAAAATTCTAGTTG,TCTCGTCATTCAGCACTGAAGAGAATAGCCGCAGAGGCTGGTTTCTTAGAATTAGATGCAAGTTTGTCAAAGGACCCAGGATTTCACCAAAAAAATTCT,10,30,14,27,27,35,27,40,27,28,28,35,33,40,73.47,72.63968916
hek293t,15689,1,7,CTTACTCTGTAAAAGGAGAAAGTACCAAAAGGCATCTGCACTTTCAAGTGATATTATACAGTCAAACATAAAATAAAAAAATTCTAGTTGGTTTAACGC,CTTACTCTGTAAAAGGAGAAAGTACCTGGACTCAAAAGGCATCTGCACTTTCAAGTGATATTATACAGTCAAACATAAAATAAAAAAATTCTAGTTGGT,10,30,14,27,27,42,27,49,27,27,27,42,34,49,55.67,1.110567895
hek293t,15689,1,7,TCCTTTCTGTAAAAGGAGAAAGTACCAAAAGGCATCTGCACTTTCAAGTGATATTATACAGTCAAACATAAAATGGAATAAAAAAATTCTAGTTGGTTT,TCCTTTCTGTAAAAGGAGAAAGTACCTGGACTCAAAAGGCATCTGCACTTTCAAGTGATATTATACAGTCAAACATAAAATGGAATAAAAAAATTCTAG,10,30,14,27,27,37,27,44,27,27,27,37,34,44,55.67,0.855870806
hek293t,15691,1,6,ACAACAAGGGTGAGCCCCCCCTTCAGATTAGGATATTGACATCCAAATATTCATTTGAGACACTAAAAGCAGAGTAAAAAAATTCTAGTTGGTTTAACG,ACAACAAGGGTGAGCCCCCCCTTCAGATTAGTTTTTAGATATTGACATCCAAATATTCATTTGAGACACTAAAAGCAGAGTAAAAAAATTCTAGTTGGT,10,30,14,27,27,42,27,48,27,32,32,42,38,48,26.74,55.57570864
hek293t,15691,1,6,TCATCAAGGGTGAGCCCCCCCTTCAGATTAGGATATTGACATCCAAATATTCATTTGAGACACTAAAAGCAAAAAAATTCTAGTTGGTTTAACGCGTAA,TCATCAAGGGTGAGCCCCCCCTTCAGATTAGTTTTTAGATATTGACATCCAAATATTCATTTGAGACACTAAAAGCAAAAAAATTCTAGTTGGTTTAAC,10,30,14,27,27,47,27,53,27,32,32,47,38,53,26.74,44.5466479
hek293t,17633,1,3,CGGAAGCCAGCTCTCGCAGGGACGGCGTGAGGTGTGTTACATACATTGCCTTCAGACCTCCGAGGGATTCTTTTGCTCAAAAAAATTCTAGTTGGTTTA,CGGAAGCCAGCTCTCGCAGGGACGGCGTGAGGTGACATGTTACATACATTGCCTTCAGACCTCCGAGGGATTCTTTTGCTCAAAAAAATTCTAGTTGGT,10,30,14,27,27,42,27,45,27,35,35,42,38,45,34.87,79.00198682
hek293t,15697,1,3,TGTCTTTCCTAGGACTTCTCTGTTATCATAGGTTTCTTTTGGACTCCCACTTCATTCTTCCCTCCATAAATGTGTAAAAAAAATTCTAGTTGGTTTAAC,TGTCTTTCCTAGGACTTCTCTGTTATCATAGGTTTCTTGTTTTGGACTCCCACTTCATTCTTCCCTCCATAAATGTGTAAAAAAAATTCTAGTTGGTTT,10,30,14,27,27,44,27,47,27,37,37,44,40,47,45.62,8.890945806
hek293t,15697,1,3,GTAAATTCCTAGGACTTCTCTGTTATCATAGGTTTCTTTTGGACTCCCACTTCATTCTTCCCTCCATAAAAAAAATTCTAGTTGGTTTAACGCGTAACT,GTAAATTCCTAGGACTTCTCTGTTATCATAGGTTTCTTGTTTTGGACTCCCACTTCATTCTTCCCTCCATAAAAAAAATTCTAGTTGGTTTAACGCGTA,10,30,14,27,27,52,27,55,27,37,37,52,40,55,45.62,66.65361817
hek293t,15699,1,12,CGTGCAGGAAGACCTCCAATTATAGGCCTTGGAGTAAAGTTTTAAATTGTTTTAAAACGTTTACATAAAAAAATTCTAGTTGGTTTAACGCGTAACTAG,CGTGCAGGAAGACCTCCAATTATAGGCCTTGGAGTAACGCCGTGGTCTCAGTTTTAAATTGTTTTAAAACGTTTACATAAAAAAATTCTAGTTGGTTTA,10,30,14,27,27,45,27,57,27,38,38,45,50,57,48.73,0.063492063
hek293t,15700,1,2,CCAATCTGACCTAGAAAGACAGCTGTCAATGGCTGAAGGTTCATACTGGAAAAAGTTTCTACAATTCCGAGAGGGAAAAAAATTCTAGTTGGTTTAACG,CCAATCTGACCTAGAAAGACAGCTGTCAATGGCTGTAAAGGTTCATACTGGAAAAAGTTTCTACAATTCCGAGAGGGAAAAAAATTCTAGTTGGTTTAA,10,30,14,27,27,46,27,48,27,36,36,46,38,48,58.64,9.962343345
hek293t,15700,1,2,ATAAACTGACCTAGAAAGACAGCTGTCAATGGCTGAAGGTTCATACTGGAAAAAGTTTCTACAATTCCGAAAAAAAATTCTAGTTGGTTTAACGCGTAA,ATAAACTGACCTAGAAAGACAGCTGTCAATGGCTGTAAAGGTTCATACTGGAAAAAGTTTCTACAATTCCGAAAAAAAATTCTAGTTGGTTTAACGCGT,10,30,14,27,27,51,27,53,27,36,36,51,38,53,58.64,17.68283696
hek293t,15702,1,14,TACCGGCACCATCTCTTTCTCCAAACATTCGGTAAACCTAGTTCTTTAATTTCTTTTGCCTTCCTGAAAAAAATTCTAGTTGGTTTAACGCGTAACTAG,TACCGGCACCATCTCTTTCTCCAAACATTCGGTAACAGTCTATATCGGTACCTAGTTCTTTAATTTCTTTTGCCTTCCTGAAAAAAATTCTAGTTGGTT,10,30,14,27,27,43,27,57,27,36,36,43,50,57,14.5,0.834381903
hek293t,15703,1,13,CCATAAGATTTATACTACTAGCAGGCATGTGGGAACAGAGTGCAGAAACTCAACTGCTTATCCCAAAAAAATTCTAGTTGGTTTAACGCGTAACTAGAT,CCATAAGATTTATACTACTAGCAGGCATGTGGGAACAGTATCATCCCTTCCAGTGCAGAAACTCAACTGCTTATCCCAAAAAAATTCTAGTTGGTTTAA,10,30,14,27,27,46,27,59,27,39,39,46,52,59,47.23,0.083963056
hek293t,643,1,4,GCGTCTGTAAACTCAGGATTAGAACATAAAGGCACAGAGTTTTGCTTTCCCTTCCGCCAGGCTTCAAAGAAAAAAATTCTAGTTGGTTTAACGCGTAAC,GCGTCTGTAAACTCAGGATTAGAACATAAAGGCACAGAGCGACTTTTGCTTTCCCTTCCGCCAGGCTTCAAAGAAAAAAATTCTAGTTGGTTTAACGCG,10,30,14,27,27,50,27,54,27,40,40,50,44,54,28.59,77.49881853
hek293t,643,1,4,CATAGTGTAAACTCAGGATTAGAACATAAAGGCACAGAGTTTTGCTTTCCCTTCCGCCAGGCTTCAAAGGGGAAAAAAATTCTAGTTGGTTTAACGCGT,CATAGTGTAAACTCAGGATTAGAACATAAAGGCACAGAGCGACTTTTGCTTTCCCTTCCGCCAGGCTTCAAAGGGGAAAAAAATTCTAGTTGGTTTAAC,10,30,14,27,27,47,27,51,27,40,40,47,44,51,28.59,43.86695848
hek293t,15706,1,13,TATCGTATTCTGATTGATTTTTGCTAATGAGGTCTTCAAAATCTTCCCATAAATCTTGACAGCAAGCAGCTAAAAAAATTCTAGTTGGTTTAACGCGTA,TATCGTATTCTGATTGATTTTTGCTAATGAGGTCTATGACACATGCGCTCAAAATCTTCCCATAAATCTTGACAGCAAGCAGCTAAAAAAATTCTAGTT,10,30,14,27,27,39,27,52,27,36,36,39,49,52,5.54,0.0
hek293t,15706,1,13,CTAGGTATTCTGATTGATTTTTGCTAATGAGGTCTTCAAAATCTTCCCATAAATCTTGACAGCAAGCAAAAAAATTCTAGTTGGTTTAACGCGTAACTA,CTAGGTATTCTGATTGATTTTTGCTAATGAGGTCTATGACACATGCGCTCAAAATCTTCCCATAAATCTTGACAGCAAGCAAAAAAATTCTAGTTGGTT,10,30,14,27,27,43,27,56,27,36,36,43,49,56,5.54,0.0
hek293t,15708,1,9,CATCTGACACCCCCCCCAGTATACTCAGATGGCACTAGTTGAAGGACTAGAGGCCTAAATCATTACTCCAAAGAAAAAAATTCTAGTTGGTTTAACGCG,CATCTGACACCCCCCCCAGTATACTCAGATGGCACTACACTTTCGTGTTGAAGGACTAGAGGCCTAAATCATTACTCCAAAGAAAAAAATTCTAGTTGG,10,30,14,27,27,41,27,50,27,38,38,41,47,50,47.49,0.0
hek293t,19921,1,10,TGGAATCTAGGATAGCCAATACGAAAGGGAGGAGGAATAATGACAATAACTATTTTATAAGTTAATAAAAAAATTCTAGTTGGTTTAACGCGTAACTAG,TGGAATCTAGGATAGCCAATACGAAAGGGAGGAGGATTCATACAGTATAATGACAATAACTATTTTATAAGTTAATAAAAAAATTCTAGTTGGTTTAAC,10,30,14,27,27,47,27,57,27,37,37,47,47,57,64.53,0.0
hek293t,19921,1,10,ATTGCTCTAGGATAGCCAATACGAAAGGGAGGAGGAATAATGACAATAACTATTTTATAAGTTAATAGATGGGAAAAAAATTCTAGTTGGTTTAACGCG,ATTGCTCTAGGATAGCCAATACGAAAGGGAGGAGGATTCATACAGTATAATGACAATAACTATTTTATAAGTTAATAGATGGGAAAAAAATTCTAGTTG,10,30,14,27,27,40,27,50,27,37,37,40,47,50,64.53,0.202092032
hek293t,15713,1,12,GTACGAATATCTCATATGGTAGCTTTAAATGGGAGCTGTAAGCACTGTGCTGCTGGTCACAGCTCTCATAAAAAAATTCTAGTTGGTTTAACGCGTAAC,GTACGAATATCTCATATGGTAGCTTTAAATGGGATCGATTACCTCAGCTGTAAGCACTGTGCTGCTGGTCACAGCTCTCATAAAAAAATTCTAGTTGGT,10,30,14,27,27,42,27,54,27,35,35,42,47,54,8.62,2.875258719
hek293t,15713,1,12,ACCCGAATATCTCATATGGTAGCTTTAAATGGGAGCTGTAAGCACTGTGCTGCTGGTCACAGCTCTAAAAAAATTCTAGTTGGTTTAACGCGTAACTAG,ACCCGAATATCTCATATGGTAGCTTTAAATGGGATCGATTACCTCAGCTGTAAGCACTGTGCTGCTGGTCACAGCTCTAAAAAAATTCTAGTTGGTTTA,10,30,14,27,27,45,27,57,27,35,35,45,47,57,8.62,1.750473976
hek293t,15715,1,1,GAGTTATATTCACATGCTCTCCTGCATTTAGGCCCAATTAGTGGAATGAGACAGATTATGGGAAACAAACCTTTGGGGGTACTGTAAAAAAATTCTAGT,GAGTTATATTCACATGCTCTCCTGCATTTAAGGCCCAATTAGTGGAATGAGACAGATTATGGGAAACAAACCTTTGGGGGTACTGTAAAAAAATTCTAG,10,30,14,27,27,37,27,38,27,30,30,37,31,38,14.84,59.56970975
hek293t,15715,1,1,GGTATATATTCACATGCTCTCCTGCATTTAGGCCCAATTAGTGGAATGAGACAGATTATGGGAAACAAACCTTTGGGAAAAAAATTCTAGTTGGTTTAA,GGTATATATTCACATGCTCTCCTGCATTTAAGGCCCAATTAGTGGAATGAGACAGATTATGGGAAACAAACCTTTGGGAAAAAAATTCTAGTTGGTTTA,10,30,14,27,27,45,27,46,27,30,30,45,31,46,14.84,51.76382353
hek293t,15717,1,3,ATTATCCCAACAGACACTACAAAGCGACAAGGAATGGTTTACAGGAACAGTAGTTTTCTCAGCATGTAGGGTGAGATGTAAAAAAATTCTAGTTGGTTT,ATTATCCCAACAGACACTACAAAGCGACAAGGAATGGTGATTTACAGGAACAGTAGTTTTCTCAGCATGTAGGGTGAGATGTAAAAAAATTCTAGTTGG,10,30,14,27,27,41,27,44,27,38,38,41,41,44,67.66,2.576924539
hek293t,15717,1,3,CAAATCCCAACAGACACTACAAAGCGACAAGGAATGGTTTACAGGAACAGTAGTTTTCTCAGCATGTAGGGTAAAAAAATTCTAGTTGGTTTAACGCGT,CAAATCCCAACAGACACTACAAAGCGACAAGGAATGGTGATTTACAGGAACAGTAGTTTTCTCAGCATGTAGGGTAAAAAAATTCTAGTTGGTTTAACG,10,30,14,27,27,48,27,51,27,38,38,48,41,51,67.66,69.0619133
hek293t,15719,1,15,GGTCATGTCTGCTTACAGACAGAACCTTGCGGCACAAAATTTAAGCAATTGTTGATACTAACATAAAAAAATTCTAGTTGGTTTAACGCGTAACTAGAT,GGTCATGTCTGCTTACAGACAGAACCTTGCGGCCCGGGCATGATACAGACAAAATTTAAGCAATTGTTGATACTAACATAAAAAAATTCTAGTTGGTTT,10,30,14,27,27,44,27,59,27,34,34,44,49,59,65.71,0.125
hek293t,15720,1,7,TTAGAGAACCAAGGGTCCAGAACCAGGACTGGAATGAGGTAACACATTCTCTCTCCCAAATTAATAATCTATCATAAAAAAATTCTAGTTGGTTTAACG,TTAGAGAACCAAGGGTCCAGAACCAGGACTGGAATGAAGCAAAGGGTAACACATTCTCTCTCCCAAATTAATAATCTATCATAAAAAAATTCTAGTTGG,10,30,14,27,27,41,27,48,27,38,38,41,45,48,47.67,0.0
hek293t,15720,1,7,CGTGGGAACCAAGGGTCCAGAACCAGGACTGGAATGAGGTAACACATTCTCTCTCCCAAATTAATAATAAAAAAATTCTAGTTGGTTTAACGCGTAACT,CGTGGGAACCAAGGGTCCAGAACCAGGACTGGAATGAAGCAAAGGGTAACACATTCTCTCTCCCAAATTAATAATAAAAAAATTCTAGTTGGTTTAACG,10,30,14,27,27,48,27,55,27,38,38,48,45,55,47.67,0.407453356
hek293t,15724,1,4,ATGGGCCATGCCTTGGTTAAAGTATGATCTGGGTATTTCTTGCTTTAGGTGTTTTAGCTTTCAATAGCTCCAACCACAAGAATCAAAAAAAATTCTAGT,ATGGGCCATGCCTTGGTTAAAGTATGATCTTCTGGGGTATTTCTTGCTTTAGGTGTTTTAGCTTTCAATAGCTCCAACCACAAGAATCAAAAAAAATTC,10,30,14,27,27,34,27,38,27,31,31,34,35,38,44.7,0.196309384
hek293t,15724,1,4,AGTGTCCATGCCTTGGTTAAAGTATGATCTGGGTATTTCTTGCTTTAGGTGTTTTAGCTTTCAATAGCTCCAAAAAAAAATTCTAGTTGGTTTAACGCG,AGTGTCCATGCCTTGGTTAAAGTATGATCTTCTGGGGTATTTCTTGCTTTAGGTGTTTTAGCTTTCAATAGCTCCAAAAAAAAATTCTAGTTGGTTTAA,10,30,14,27,27,46,27,50,27,31,31,46,35,50,44.7,4.882149559
hek293t,15726,1,5,GCGTCTTTAAAAATAACATGTCTTTGCTTTGGAATTCTTTAGTAAAAATCTTGTATCTAATGCAAGGTGTTTTATAAAAAAATTCTAGTTGGTTTAACG,GCGTCTTTAAAAATAACATGTCTTTGCTTTGGAATTCTTACATTTAGTAAAAATCTTGTATCTAATGCAAGGTGTTTTATAAAAAAATTCTAGTTGGTT,10,30,14,27,27,43,27,48,27,40,40,43,45,48,16.03,0.0
hek293t,15726,1,5,ACATTTTTAAAAATAACATGTCTTTGCTTTGGAATTCTTTAGTAAAAATCTTGTATCTAATGCAAGGTAAAAAAATTCTAGTTGGTTTAACGCGTAACT,ACATTTTTAAAAATAACATGTCTTTGCTTTGGAATTCTTACATTTAGTAAAAATCTTGTATCTAATGCAAGGTAAAAAAATTCTAGTTGGTTTAACGCG,10,30,14,27,27,50,27,55,27,40,40,50,45,55,16.03,1.953578264
hek293t,15728,1,6,TAAGAAACACTATGTTCTGCATCTTGTTGAGGCTGCCTACTTCTCCTTCCTTTATTTACTTTTCCAAATCAATTATAAAAAAATTCTAGTTGGTTTAAC,TAAGAAACACTATGTTCTGCATCTTGTTGAAACATCGGCTGCCTACTTCTCCTTCCTTTATTTACTTTTCCAAATCAATTATAAAAAAATTCTAGTTGG,10,30,14,27,27,41,27,47,27,31,31,41,37,47,48.03,7.924564505
hek293t,15730,1,7,ATTCTTTCATGGTAGTCGATATATTGGAAAGGTGATATATCCAAAAGGTGGCGTTTTCTTAAACTGAGTATTTGTAACAAAAAAAAATTCTAGTTGGTT,ATTCTTTCATGGTAGTCGATATATTGGAAAGGTAGCCCATGATATATCCAAAAGGTGGCGTTTTCTTAAACTGAGTATTTGTAACAAAAAAAAATTCTA,10,30,14,27,27,36,27,43,27,33,33,36,40,43,52.43,0.0
hek293t,15730,1,7,GACGATTCATGGTAGTCGATATATTGGAAAGGTGATATATCCAAAAGGTGGCGTTTTCTTAAACTGAGTATTTGTAAAAAAAATTCTAGTTGGTTTAAC,GACGATTCATGGTAGTCGATATATTGGAAAGGTAGCCCATGATATATCCAAAAGGTGGCGTTTTCTTAAACTGAGTATTTGTAAAAAAAATTCTAGTTG,10,30,14,27,27,40,27,47,27,33,33,40,40,47,52.43,0.434027778
hek293t,15732,1,7,CCGAGAAATAAAATGCACTGCAGGAAATAAGGAGTGATTATTTCAGAAATTAAAGATGCATACTAGTGAAAAAAATTCTAGTTGGTTTAACGCGTAACT,CCGAGAAATAAAATGCACTGCAGGAAATAAGGAGTGATGTGGCATTATTTCAGAAATTAAAGATGCATACTAGTGAAAAAAATTCTAGTTGGTTTAACG,10,30,14,27,27,48,27,55,27,38,38,48,45,55,23.16,2.679939505
hek293t,15732,1,7,CGGTGAAATAAAATGCACTGCAGGAAATAAGGAGTGATTATTTCAGAAATTAAAGATGCATACTAGTGCTAGACAAAAAAAATTCTAGTTGGTTTAACG,CGGTGAAATAAAATGCACTGCAGGAAATAAGGAGTGATGTGGCATTATTTCAGAAATTAAAGATGCATACTAGTGCTAGACAAAAAAAATTCTAGTTGG,10,30,14,27,27,41,27,48,27,38,38,41,45,48,23.16,0.035842294
hek293t,15736,1,15,AATCCAGCCATTCTAATTATAGAATTTCATGGAATTTGTAAGTGATGTCACTCAAGGGGGTACTGCAAAAAAATTCTAGTTGGTTTAACGCGTAACTAG,AATCCAGCCATTCTAATTATAGAATTTCATGGAATGTCTCTGGGCTTTATTTGTAAGTGATGTCACTCAAGGGGGTACTGCAAAAAAATTCTAGTTGGT,10,30,14,27,27,42,27,57,27,35,35,42,50,57,1.84,0.0
hek293t,15737,1,3,GAGCTCAACCCACATCTCAGTCTCTATAGAGGACACTTCTATACTTTGCATTATCATCATCTGTAGCTCTTCACTACTGCAAAAAAAATTCTAGTTGGT,GAGCTCAACCCACATCTCAGTCTCTATAGAGGCTGACACTTCTATACTTTGCATTATCATCATCTGTAGCTCTTCACTACTGCAAAAAAAATTCTAGTT,10,30,14,27,27,39,27,42,27,32,32,39,35,42,45.32,33.64492768
hek293t,15737,1,3,TGTAACAACCCACATCTCAGTCTCTATAGAGGACACTTCTATACTTTGCATTATCATCATCTGTAGCTCTTCAAAAAAAATTCTAGTTGGTTTAACGCG,TGTAACAACCCACATCTCAGTCTCTATAGAGGCTGACACTTCTATACTTTGCATTATCATCATCTGTAGCTCTTCAAAAAAAATTCTAGTTGGTTTAAC,10,30,14,27,27,47,27,50,27,32,32,47,35,50,45.32,51.53926669
hek293t,15739,1,5,CGTACTAAGTAGCCAGAGATGGGGCTGGGAGGGAACCCTAATGTTTATTTGAGGTAACTTACTATGGTACAGAGGTAAAAAAAATTCTAGTTGGTTTAA,CGTACTAAGTAGCCAGAGATGGGGCTGGGAGGGGGTTTAACCCTAATGTTTATTTGAGGTAACTTACTATGGTACAGAGGTAAAAAAAATTCTAGTTGG,10,30,14,27,27,41,27,46,27,34,34,41,39,46,44.42,44.91840619
hek293t,15739,1,5,GAGCATAAGTAGCCAGAGATGGGGCTGGGAGGGAACCCTAATGTTTATTTGAGGTAACTTACTATGGTACAGAGGTAAACTAAAAAAATTCTAGTTGGT,GAGCATAAGTAGCCAGAGATGGGGCTGGGAGGGGGTTTAACCCTAATGTTTATTTGAGGTAACTTACTATGGTACAGAGGTAAACTAAAAAAATTCTAG,10,30,14,27,27,37,27,42,27,34,34,37,39,42,44.42,0.361441488
hek293t,15741,1,14,GACTTCTCCTTCACTAGCTGGAGAACATAAGGTGCCATCATACCCTCATTCCAGCCCGGGTAAAGTCCCAAAAAAATTCTAGTTGGTTTAACGCGTAAC,GACTTCTCCTTCACTAGCTGGAGAACATATCCCCGGTTTAACAAGGTGCCATCATACCCTCATTCCAGCCCGGGTAAAGTCCCAAAAAAATTCTAGTTG,10,30,14,27,27,40,27,54,27,30,30,40,44,54,28.22,12.83158983
hek293t,15741,1,14,ACACTCTCCTTCACTAGCTGGAGAACATAAGGTGCCATCATACCCTCATTCCAGCCCGGGTAAAAAAAAAATTCTAGTTGGTTTAACGCGTAACTAGAT,ACACTCTCCTTCACTAGCTGGAGAACATATCCCCGGTTTAACAAGGTGCCATCATACCCTCATTCCAGCCCGGGTAAAAAAAAAATTCTAGTTGGTTTA,10,30,14,27,27,45,27,59,27,30,30,45,44,59,28.22,49.61431781
hek293t,15743,1,3,CAGGTATTACCTGAGAATTCCCTTCTTACAGGATGATCCCTGAATAGCATATGGCTAATGAAGAAAAAAAAATTCTAGTTGGTTTAACGCGTAACTAGA,CAGGTATTACCTGAGAATTCCCTTCTTACAGGATGATCCTAACTGAATAGCATATGGCTAATGAAGAAAAAAAAATTCTAGTTGGTTTAACGCGTAACT,10,30,14,27,27,55,27,58,27,40,40,55,43,58,19.41,30.23535948
hek293t,15743,1,3,CCACCATTACCTGAGAATTCCCTTCTTACAGGATGATCCCTGAATAGCATATGGCTAATGAAGAAGATCAATGAAAAAAATTCTAGTTGGTTTAACGCG,CCACCATTACCTGAGAATTCCCTTCTTACAGGATGATCCTAACTGAATAGCATATGGCTAATGAAGAAGATCAATGAAAAAAATTCTAGTTGGTTTAAC,10,30,14,27,27,47,27,50,27,40,40,47,43,50,19.41,81.22377497
hek293t,15745,1,2,GACAACCCACCCTGGGGACCAGTGGCTAGAGGTTCTTGAAAGTTGTTTGCAGCACGGGTTGCTGCAAGCCTGCGTTGCAGGTAAAAAAATTCTAGTTGG,GACAACCCACCCTGGGGACCAGTGGCTAGAGGTTCAATTGAAAGTTGTTTGCAGCACGGGTTGCTGCAAGCCTGCGTTGCAGGTAAAAAAATTCTAGTT,10,30,14,27,27,39,27,41,27,36,36,39,38,41,50.96,0.0
hek293t,15747,1,15,TGGAGAACAGGTACACTAAGACAAGACCGTGGCACAGAAACTGAGCCCGATGTTGCACTGCGCTTGGCGAAAAAAAATTCTAGTTGGTTTAACGCGTAA,TGGAGAACAGGTACACTAAGACAAGACCGTGGCATTCTTGTGGGACATTCAGAAACTGAGCCCGATGTTGCACTGCGCTTGGCGAAAAAAAATTCTAGT,10,30,14,27,27,38,27,53,27,35,35,38,50,53,79.23,0.536847243
hek293t,15748,1,6,ACAGTATTTATGCTTTATACATCCACGGACGGGCAAATAGAAACTGAAATGCAGGGTTGCCCACTCTTCTTTCCATCTGCAAAAAAATTCTAGTTGGTT,ACAGTATTTATGCTTTATACATCCACAATCATGGACGGGCAAATAGAAACTGAAATGCAGGGTTGCCCACTCTTCTTTCCATCTGCAAAAAAATTCTAG,10,30,14,27,27,37,27,43,27,27,27,37,33,43,35.45,70.05970545
hek293t,15748,1,6,GCAGGATTTATGCTTTATACATCCACGGACGGGCAAATAGAAACTGAAATGCAGGGTTGCCCACTCTTCTTTCCATCTGCTATTAGGAAAAAAATTCTA,GCAGGATTTATGCTTTATACATCCACAATCATGGACGGGCAAATAGAAACTGAAATGCAGGGTTGCCCACTCTTCTTTCCATCTGCTATTAGGAAAAAA,10,30,14,27,27,30,27,36,27,27,27,30,33,36,35.45,2.46557179
hek293t,15750,1,4,CAGCATTTTTCTGTGGAGGGAGAGATGACTGGTTGAGCTCTGTGTGCAGGGAAGGACTTGTGCGAAAGTCTTGTAACCACAGGTAAAAAAATTCTAGTT,CAGCATTTTTCTGTGGAGGGAGAGATGTACGACTGGTTGAGCTCTGTGTGCAGGGAAGGACTTGTGCGAAAGTCTTGTAACCACAGGTAAAAAAATTCT,10,30,14,27,27,35,27,39,27,28,28,35,32,39,55.1,84.04784055
hek293t,15750,1,4,AGAGTTTTTTCTGTGGAGGGAGAGATGACTGGTTGAGCTCTGTGTGCAGGGAAGGACTTGTGCGAAAGTCTTGTAACCACAGGTTAACAAAAAAATTCT,AGAGTTTTTTCTGTGGAGGGAGAGATGTACGACTGGTTGAGCTCTGTGTGCAGGGAAGGACTTGTGCGAAAGTCTTGTAACCACAGGTTAACAAAAAAA,10,30,14,27,27,31,27,35,27,28,28,31,32,35,55.1,5.438769586
hek293t,15752,1,13,AGGGAGAAATCAGCAACAGGTACAGAAGTTGGCATTTCCCTCCAATTGCCAGTTCTCTACTAAGGTATAAAAAAATTCTAGTTGGTTTAACGCGTAACT,AGGGAGAAATCAGCAACAGGTACAGAAGTTGGCACTGGTGCCACAACTTTCCCTCCAATTGCCAGTTCTCTACTAAGGTATAAAAAAATTCTAGTTGGT,10,30,14,27,27,42,27,55,27,35,35,42,48,55,58.4,0.027012426
hek293t,15752,1,13,GTCGCGAAATCAGCAACAGGTACAGAAGTTGGCATTTCCCTCCAATTGCCAGTTCTCTACTAAGGAAAAAAATTCTAGTTGGTTTAACGCGTAACTAGA,GTCGCGAAATCAGCAACAGGTACAGAAGTTGGCACTGGTGCCACAACTTTCCCTCCAATTGCCAGTTCTCTACTAAGGAAAAAAATTCTAGTTGGTTTA,10,30,14,27,27,45,27,58,27,35,35,45,48,58,58.4,0.723225934
hek293t,15754,1,10,CATGCCACTCAAGAGATGTTTGACATATTCGGATCATAAGTTGTTTGGAGCGGCAGCTGTTTCAGAGCACATAAAAAAATTCTAGTTGGTTTAACGCGT,CATGCCACTCAAGAGATGTTTGACATATTCGGATCATTTACAGCGCGAAGTTGTTTGGAGCGGCAGCTGTTTCAGAGCACATAAAAAAATTCTAGTTGG,10,30,14,27,27,41,27,51,27,38,38,41,48,51,5.2,0.0
hek293t,15754,1,10,AACTTCACTCAAGAGATGTTTGACATATTCGGATCATAAGTTGTTTGGAGCGGCAGCTGTTTCAGAGCAAAAAAATTCTAGTTGGTTTAACGCGTAACT,AACTTCACTCAAGAGATGTTTGACATATTCGGATCATTTACAGCGCGAAGTTGTTTGGAGCGGCAGCTGTTTCAGAGCAAAAAAATTCTAGTTGGTTTA,10,30,14,27,27,45,27,55,27,38,38,45,48,55,5.2,1.088637139
hek293t,15756,1,10,ACTCGCACTGTTCTCCTCCTGCAACAGAGGGGTGATTGTGATTTTAAGCGTGCTGCTCTAAAACGTAAAAAAAATTCTAGTTGGTTTAACGCGTAACTA,ACTCGCACTGTTCTCCTCCTGCAACAGAGGGGTGATTGAATTACAAAATGATTTTAAGCGTGCTGCTCTAAAACGTAAAAAAAATTCTAGTTGGTTTAA,10,30,14,27,27,46,27,56,27,39,39,46,49,56,66.59,0.135832654
hek293t,15756,1,10,GCCATCACTGTTCTCCTCCTGCAACAGAGGGGTGATTGTGATTTTAAGCGTGCTGCTCTAAAACGTAAATGAAAAAAATTCTAGTTGGTTTAACGCGTA,GCCATCACTGTTCTCCTCCTGCAACAGAGGGGTGATTGAATTACAAAATGATTTTAAGCGTGCTGCTCTAAAACGTAAATGAAAAAAATTCTAGTTGGT,10,30,14,27,27,42,27,52,27,39,39,42,49,52,66.59,0.0
hek293t,15758,1,4,ACCGAATAAACTGCAAGTAAAAGACAAAACGGTAGCTTTTGATCTAGTCTCCAGAGCTCTCATCTTCTGTGTAGACCAAAAAAATTCTAGTTGGTTTAA,ACCGAATAAACTGCAAGTAAAAGACATATGAAACGGTAGCTTTTGATCTAGTCTCCAGAGCTCTCATCTTCTGTGTAGACCAAAAAAATTCTAGTTGGT,10,30,14,27,27,42,27,46,27,27,27,42,31,46,46.73,2.861756256
hek293t,15758,1,4,ATTAAATAAACTGCAAGTAAAAGACAAAACGGTAGCTTTTGATCTAGTCTCCAGAGCTCTCATCTTCTGTGTAGACCTCAGGTTCAAAAAAATTCTAGT,ATTAAATAAACTGCAAGTAAAAGACATATGAAACGGTAGCTTTTGATCTAGTCTCCAGAGCTCTCATCTTCTGTGTAGACCTCAGGTTCAAAAAAATTC,10,30,14,27,27,34,27,38,27,27,27,34,31,38,46.73,2.20947
hek293t,15760,1,8,CAGCCCCGTATATTAGGGATATTATGAAGAGGCACTTAAAAGATGGTAGGAAAACTTCAATGACCTTTCTTCTTGTCAGTTCTAAAAAAAAATTCTAGT,CAGCCCCGTATATTAGGGATATTATGCTGTCTAGAAGAGGCACTTAAAAGATGGTAGGAAAACTTCAATGACCTTTCTTCTTGTCAGTTCTAAAAAAAA,10,30,14,27,27,30,27,38,27,27,27,30,35,38,55.98,2.282943047
hek293t,15760,1,8,CAGTCCCGTATATTAGGGATATTATGAAGAGGCACTTAAAAGATGGTAGGAAAACTTCAATGACCTTTCTTCTTGTCAAAAAAAATTCTAGTTGGTTTA,CAGTCCCGTATATTAGGGATATTATGCTGTCTAGAAGAGGCACTTAAAAGATGGTAGGAAAACTTCAATGACCTTTCTTCTTGTCAAAAAAAATTCTAG,10,30,14,27,27,37,27,45,27,27,27,37,35,45,55.98,35.65855362
hek293t,15764,1,2,TAGGGAGCAAACCTTGCTCCACCTGAGCGCGGAGGCCGATTCTGCCAAAGCCTCTCCCGGGCAGGGCCCTGGCTAACAAAAAAATTCTAGTTGGTTTAA,TAGGGAGCAAACCTTGCTCCACCTGAGCGCGGAGGCTTCGATTCTGCCAAAGCCTCTCCCGGGCAGGGCCCTGGCTAACAAAAAAATTCTAGTTGGTTT,10,30,14,27,27,44,27,46,27,37,37,44,39,46,61.3,54.35986354
hek293t,15766,1,3,CCACCTGGACATGTGAAAATGGAAGAAAATGGCATGGAATTCATTCACGTCTAGGGAGGAAACTGAGGAATAATGAATAGAGGGTCTCCAAAAAAATTC,CCACCTGGACATGTGAAAATGGAAGAAGGAAATGGCATGGAATTCATTCACGTCTAGGGAGGAAACTGAGGAATAATGAATAGAGGGTCTCCAAAAAAA,10,30,14,27,27,31,27,34,27,28,28,31,31,34,33.78,0.03192848
hek293t,15766,1,3,TATTGTGGACATGTGAAAATGGAAGAAAATGGCATGGAATTCATTCACGTCTAGGGAGGAAACTGAGGAATAATGAAAAAAAAATTCTAGTTGGTTTAA,TATTGTGGACATGTGAAAATGGAAGAAGGAAATGGCATGGAATTCATTCACGTCTAGGGAGGAAACTGAGGAATAATGAAAAAAAAATTCTAGTTGGTT,10,30,14,27,27,43,27,46,27,28,28,43,31,46,33.78,3.35050172
hek293t,15768,1,14,TCAATGTACTACACGCCAAAGCAAAGAAAAGGTGGGGTTTATACAGAAGGCTAGCTTCCATTGCTGCCAAAAAAATTCTAGTTGGTTTAACGCGTAACT,TCAATGTACTACACGCCAAAGCAAAGAAAAGGTCCGGCGGCGCTATAGGGGTTTATACAGAAGGCTAGCTTCCATTGCTGCCAAAAAAATTCTAGTTGG,10,30,14,27,27,41,27,55,27,34,34,41,48,55,50.5,0.224800534
hek293t,15769,1,2,GACCGTTCAAGAAAAGAAGCATTTACTTAAGGGAAAGACACATTTATTTGATGGCTTATAATTTGAAAAAAATTCTAGTTGGTTTAACGCGTAACTAGA,GACCGTTCAAGAAAAGAAGCATTTACTTAAGGGAAAGACACGCATTTATTTGATGGCTTATAATTTGAAAAAAATTCTAGTTGGTTTAACGCGTAACTA,10,30,14,27,27,56,27,58,27,41,41,56,43,58,5.49,19.87254086
hek293t,15769,1,2,CGACTTTCAAGAAAAGAAGCATTTACTTAAGGGAAAGACACATTTATTTGATGGCTTATAATTTGTGTATAAGAAAAAAATTCTAGTTGGTTTAACGCG,CGACTTTCAAGAAAAGAAGCATTTACTTAAGGGAAAGACACGCATTTATTTGATGGCTTATAATTTGTGTATAAGAAAAAAATTCTAGTTGGTTTAACG,10,30,14,27,27,48,27,50,27,41,41,48,43,50,5.49,8.789058503
hek293t,15771,1,12,CGAAGAGTTTCCTTCAAACCTTCCATTATAGGGTGGGAGTTTGCGCCCTTTCTGAAGAATAAGTAAAAAAAATTCTAGTTGGTTTAACGCGTAACTAGA,CGAAGAGTTTCCTTCAAACCTTCCATTATAGGGTGGGAAGCGGCTCTCAGGTTTGCGCCCTTTCTGAAGAATAAGTAAAAAAAATTCTAGTTGGTTTAA,10,30,14,27,27,46,27,58,27,39,39,46,51,58,11.92,0.278834165
hek293t,15772,1,5,ACTCTACATGATTCATAAGACTGAAGACACGGGCAGAGCTGAGGACATTACAAGGATGAAACTGAGTAGGAAAAAAATTCTAGTTGGTTTAACGCGTAA,ACTCTACATGATTCATAAGACTGAAGACACGGGCAGAAGAAGGCTGAGGACATTACAAGGATGAAACTGAGTAGGAAAAAAATTCTAGTTGGTTTAACG,10,30,14,27,27,48,27,53,27,38,38,48,43,53,57.68,42.82362426
hek293t,15772,1,5,CGCGCACATGATTCATAAGACTGAAGACACGGGCAGAGCTGAGGACATTACAAGGATGAAACTGAGTAGGCATAAAAAAATTCTAGTTGGTTTAACGCG,CGCGCACATGATTCATAAGACTGAAGACACGGGCAGAAGAAGGCTGAGGACATTACAAGGATGAAACTGAGTAGGCATAAAAAAATTCTAGTTGGTTTA,10,30,14,27,27,45,27,50,27,38,38,45,43,50,57.68,8.58015917
hek293t,15774,1,11,TGGTACAGATACAGCCCTTTCCCCAGACCTGGCTAAATATCAGTTAAGGACATCCACTGAATCTCAGTAAAAAAATTCTAGTTGGTTTAACGCGTAACT,TGGTACAGATACAGCCCTTTCCCCAGACCTGGCTAACAGATTATATGATATCAGTTAAGGACATCCACTGAATCTCAGTAAAAAAATTCTAGTTGGTTT,10,30,14,27,27,44,27,55,27,37,37,44,48,55,55.89,0.0
hek293t,15776,1,10,CTGGAGCTGTGACAGTATAGCAGGAGGACAGGTTCATCTGCCAAATGCCACGCGATTAGTCTGTCGAAAAAAATTCTAGTTGGTTTAACGCGTAACTAG,CTGGAGCTGTGACAGTATAGCAGGAGGACAGGTTCAGCGGATGGAATCTGCCAAATGCCACGCGATTAGTCTGTCGAAAAAAATTCTAGTTGGTTTAAC,10,30,14,27,27,47,27,57,27,37,37,47,47,57,47.87,12.73570935
hek293t,15777,1,13,TTGCATTTATCACTCCAGCTGAGTCTCTGTGGAGAGTGACCTGCTCATATTTGCCCACCCCCCCAAAAAAATTCTAGTTGGTTTAACGCGTAACTAGAT,TTGCATTTATCACTCCAGCTGAGTCTCTGTAGGCAGAGGTCTGGGAGAGTGACCTGCTCATATTTGCCCACCCCCCCAAAAAAATTCTAGTTGGTTTAA,10,30,14,27,27,46,27,59,27,31,31,46,44,59,58.69,58.86891312
hek293t,5102,1,9,GCGGGGAATCACATTTACACAGCTCTAAGGGGAAAATAGGAAAGGGATTCACATGCTAGAGACAGCTAAAAAAAAAATTCTAGTTGGTTTAACGCGTAA,GCGGGGAATCACATTTACACAGCTCTAAGGGGAAAATAGGCTAGACAAAAAAGGGATTCACATGCTAGAGACAGCTAAAAAAAAAATTCTAGTTGGTTT,10,30,14,27,27,44,27,53,27,41,41,44,50,53,45.97,0.0
hek293t,15780,1,4,AAGACGGAGGCACGTGGCGAGGGTTGAGGAGGATGCCGATCTGTACTTTAATTTTCTTTATTGCATTTAAGAGGACTTACAAATAAAAAAATTCTAGTT,AAGACGGAGGCACGTGGCGAGGGTTGAGGAGTCGGGATGCCGATCTGTACTTTAATTTTCTTTATTGCATTTAAGAGGACTTACAAATAAAAAAATTCT,10,30,14,27,27,35,27,39,27,32,32,35,36,39,60.17,21.59229061
hek293t,15782,1,1,CTACAAGGCACTTCCTGAAGTAAGTTGATAGGGAAGTGACTAGTAGTGAATGGTGTAAAATATCCATGAAAAAAATTCTAGTTGGTTTAACGCGTAACT,CTACAAGGCACTTCCTGAAGTAAGTTGATAGGGAAGTGTACTAGTAGTGAATGGTGTAAAATATCCATGAAAAAAATTCTAGTTGGTTTAACGCGTAAC,10,30,14,27,27,54,27,55,27,39,39,54,40,55,45.97,43.79914104
hek293t,15782,1,1,GGCGTAGGCACTTCCTGAAGTAAGTTGATAGGGAAGTGACTAGTAGTGAATGGTGTAAAATATCCATGTCGAATGTTGGGAAAAAAATTCTAGTTGGTT,GGCGTAGGCACTTCCTGAAGTAAGTTGATAGGGAAGTGTACTAGTAGTGAATGGTGTAAAATATCCATGTCGAATGTTGGGAAAAAAATTCTAGTTGGT,10,30,14,27,27,42,27,43,27,39,39,42,40,43,45.97,3.416187378
hek293t,15784,1,1,GGTCCAAGGGAAAAATCTATAAGCTTTATAGGCAGGATTACATCCCTGGACACATGGTGAATTTTGCTGTAATTGTAGGGTTGGAAAAAAATTCTAGTT,GGTCCAAGGGAAAAATCTATAAGCTTTATAGGCATGGATTACATCCCTGGACACATGGTGAATTTTGCTGTAATTGTAGGGTTGGAAAAAAATTCTAGT,10,30,14,27,27,38,27,39,27,35,35,38,36,39,3.74,1.092666862
hek293t,15784,1,1,GAACGAAGGGAAAAATCTATAAGCTTTATAGGCAGGATTACATCCCTGGACACATGGTGAATTTTGCTGTAAAAAAAAATTCTAGTTGGTTTAACGCGT,GAACGAAGGGAAAAATCTATAAGCTTTATAGGCATGGATTACATCCCTGGACACATGGTGAATTTTGCTGTAAAAAAAAATTCTAGTTGGTTTAACGCG,10,30,14,27,27,50,27,51,27,35,35,50,36,51,3.74,35.89511195
hek293t,15788,1,14,GACCGTAAAGTAAACATAAAACAACTGACTGGTTGAAACAGTCATTTTTAGCTTTTCACTAGGAGACTAAAAAAAAATTCTAGTTGGTTTAACGCGTAA,GACCGTAAAGTAAACATAAAACAACTGACTGGTTGGAGCAATTGAAGGGAAACAGTCATTTTTAGCTTTTCACTAGGAGACTAAAAAAAAATTCTAGTT,10,30,14,27,27,39,27,53,27,36,36,39,50,53,43.65,0.0
hek293t,15788,1,14,AAGTTTAAAGTAAACATAAAACAACTGACTGGTTGAAACAGTCATTTTTAGCTTTTCACTAGGAGAAAAAAAATTCTAGTTGGTTTAACGCGTAACTAG,AAGTTTAAAGTAAACATAAAACAACTGACTGGTTGGAGCAATTGAAGGGAAACAGTCATTTTTAGCTTTTCACTAGGAGAAAAAAAATTCTAGTTGGTT,10,30,14,27,27,43,27,57,27,36,36,43,50,57,43.65,0.0
hek293t,15790,1,14,GACCGGGCAGTTGCTATGCAACAAGTAGGAGGATCTGGGAGCGGTTTAAACCGTGAGCTCTCCACTTGTCTGCAACGAAAAAAATTCTAGTTGGTTTAA,GACCGGGCAGTTGCTATGCAACAAGTAGTCTGGTGTAAGGTTGAGGATCTGGGAGCGGTTTAAACCGTGAGCTCTCCACTTGTCTGCAACGAAAAAAAT,10,30,14,27,27,32,27,46,27,29,29,32,43,46,71.24,0.355926741
hek293t,15790,1,14,TCTGGGGCAGTTGCTATGCAACAAGTAGGAGGATCTGGGAGCGGTTTAAACCGTGAGCTCTCCACTTGTCTGCAAAAAAATTCTAGTTGGTTTAACGCG,TCTGGGGCAGTTGCTATGCAACAAGTAGTCTGGTGTAAGGTTGAGGATCTGGGAGCGGTTTAAACCGTGAGCTCTCCACTTGTCTGCAAAAAAATTCTA,10,30,14,27,27,36,27,50,27,29,29,36,43,50,71.24,0.897297863
hek293t,15792,1,2,AAAAGCTACTCTGAACCAAATAACGCAGTAGGTTTTTTGGCCTGGGTTTTCCATTCACTGACTTCTCGCTGTTTATAAAAAAATTCTAGTTGGTTTAAC,AAAAGCTACTCTGAACCAAATAACGCAGTAGGTTTTTCTTGGCCTGGGTTTTCCATTCACTGACTTCTCGCTGTTTATAAAAAAATTCTAGTTGGTTTA,10,30,14,27,27,45,27,47,27,38,38,45,40,47,47.01,52.48531351
hek293t,15792,1,2,GACTCCTACTCTGAACCAAATAACGCAGTAGGTTTTTTGGCCTGGGTTTTCCATTCACTGACTTCTCGCTGTTAAAAAAATTCTAGTTGGTTTAACGCG,GACTCCTACTCTGAACCAAATAACGCAGTAGGTTTTTCTTGGCCTGGGTTTTCCATTCACTGACTTCTCGCTGTTAAAAAAATTCTAGTTGGTTTAACG,10,30,14,27,27,48,27,50,27,38,38,48,40,50,47.01,66.61005096
hek293t,15794,1,3,TCATATACGATGTAGCTATCTTTCCAACATGGTAAATGAGAAATTAACCATTTATTTTCCCTGAGATAAACTGTTCTCTTCTTTATGAAAAAAATTCTA,TCATATACGATGTAGCTATCTTTCCAACAGGGTGGTAAATGAGAAATTAACCATTTATTTTCCCTGAGATAAACTGTTCTCTTCTTTATGAAAAAAATT,10,30,14,27,27,33,27,36,27,30,30,33,33,36,59.74,1.860556982
hek293t,15794,1,3,TCATTTACGATGTAGCTATCTTTCCAACATGGTAAATGAGAAATTAACCATTTATTTTCCCTGAGATAAACTGTTAAAAAAATTCTAGTTGGTTTAACG,TCATTTACGATGTAGCTATCTTTCCAACAGGGTGGTAAATGAGAAATTAACCATTTATTTTCCCTGAGATAAACTGTTAAAAAAATTCTAGTTGGTTTA,10,30,14,27,27,45,27,48,27,30,30,45,33,48,59.74,2.527751682
hek293t,15796,1,14,TGACACAATCCAAGTAATGAAGTATTCTTAGGTATAGGGTCAATAACACAGCCAAAAAAGGGCTTTATTTCCTTGTGAAAAAAATTCTAGTTGGTTTAA,TGACACAATCCAAGTAATGAAGTATTCTAAATGTGCTGAGGGTAGGTATAGGGTCAATAACACAGCCAAAAAAGGGCTTTATTTCCTTGTGAAAAAAAT,10,30,14,27,27,32,27,46,27,29,29,32,43,46,16.17,0.031715826
hek293t,15796,1,14,GTCACCAATCCAAGTAATGAAGTATTCTTAGGTATAGGGTCAATAACACAGCCAAAAAAGGGCTTTATTTCCTAAAAAAATTCTAGTTGGTTTAACGCG,GTCACCAATCCAAGTAATGAAGTATTCTAAATGTGCTGAGGGTAGGTATAGGGTCAATAACACAGCCAAAAAAGGGCTTTATTTCCTAAAAAAATTCTA,10,30,14,27,27,36,27,50,27,29,29,36,43,50,16.17,0.0
hek293t,15798,1,3,CACCCTCTCTGGAGCAGCCATCTTTCGCATGGATTTAGTGGGGCAGGGGCATCCCTTATTTTGTCATCTTTGGTGAAAAAAAATTCTAGTTGGTTTAAC,CACCCTCTCTGGAGCAGCCATCTTTCGCATGGATATTTTAGTGGGGCAGGGGCATCCCTTATTTTGTCATCTTTGGTGAAAAAAAATTCTAGTTGGTTT,10,30,14,27,27,44,27,47,27,34,34,44,37,47,37.91,57.96155237
hek293t,15801,1,1,CCGCCAACGAAGGCATCACCTTTGGAACCAGGGTTGTTGGCCGTGAAATCCTGTTTAATAGAAAGCTTAGAATTAAAAAAATTCTAGTTGGTTTAACGC,CCGCCAACGAAGGCATCACCTTTGGAACCAGGGTTGTTGGACCGTGAAATCCTGTTTAATAGAAAGCTTAGAATTAAAAAAATTCTAGTTGGTTTAACG,10,30,14,27,27,48,27,49,27,41,41,48,42,49,42.16,81.1681301
hek293t,15801,1,1,AAGCCAACGAAGGCATCACCTTTGGAACCAGGGTTGTTGGCCGTGAAATCCTGTTTAATAGAAAGCTTAGAAAAAAAATTCTAGTTGGTTTAACGCGTA,AAGCCAACGAAGGCATCACCTTTGGAACCAGGGTTGTTGGACCGTGAAATCCTGTTTAATAGAAAGCTTAGAAAAAAAATTCTAGTTGGTTTAACGCGT,10,30,14,27,27,51,27,52,27,41,41,51,42,52,42.16,78.48352994
hek293t,15803,1,10,TCGCGTTATAGTCTGGGACCAAGTGGGAGGGGATGGATTCTTTCATTCTGACAACATCAACTCAAAATCAAAAAAATTCTAGTTGGTTTAACGCGTAAC,TCGCGTTATAGTCTGGGACCAAGTGGGAGGGGATCTTACTATTTGGATTCTTTCATTCTGACAACATCAACTCAAAATCAAAAAAATTCTAGTTGGTTT,10,30,14,27,27,44,27,54,27,34,34,44,44,54,44.89,11.16226693
hek293t,15803,1,10,TGACGTTATAGTCTGGGACCAAGTGGGAGGGGATGGATTCTTTCATTCTGACAACATCAACTCAAAATCTCTCCCAAAAAAAATTCTAGTTGGTTTAAC,TGACGTTATAGTCTGGGACCAAGTGGGAGGGGATCTTACTATTTGGATTCTTTCATTCTGACAACATCAACTCAAAATCTCTCCCAAAAAAAATTCTAG,10,30,14,27,27,37,27,47,27,34,34,37,44,47,44.89,1.968323596
hek293t,15805,1,11,TGTTACCTCTAGAAAACCCTGAAGAGGGATGGGAACAAAGAGTAGCAGACGCACAGCTACTGGATGTCCTTACCAGCAAAAAAAATTCTAGTTGGTTTA,TGTTACCTCTAGAAAACCCTGAAGAGCCCAGTCTCTGGGATGGGAACAAAGAGTAGCAGACGCACAGCTACTGGATGTCCTTACCAGCAAAAAAAATTC,10,30,14,27,27,34,27,45,27,27,27,34,38,45,31.57,3.466866857
hek293t,15805,1,11,AAGGACCTCTAGAAAACCCTGAAGAGGGATGGGAACAAAGAGTAGCAGACGCACAGCTACTGGATGTCCTTACCAGCAAAGGAAAAAAATTCTAGTTGG,AAGGACCTCTAGAAAACCCTGAAGAGCCCAGTCTCTGGGATGGGAACAAAGAGTAGCAGACGCACAGCTACTGGATGTCCTTACCAGCAAAGGAAAAAA,10,30,14,27,27,30,27,41,27,27,27,30,38,41,31.57,0.204746782
hek293t,15807,1,4,CAGCTAATGATTGGGAGCATAATGAGAGGCGGCACACTACAGGAACTGCAGCAACTGAAGAGGGCCTTCCCAAATTCTTAGGGCTTGTAAAAAAAATTC,CAGCTAATGATTGGGAGCATAATGAGCGGGAGGCGGCACACTACAGGAACTGCAGCAACTGAAGAGGGCCTTCCCAAATTCTTAGGGCTTGTAAAAAAA,10,30,14,27,27,30,27,34,27,27,27,30,31,34,58.19,3.523763543
hek293t,15807,1,4,CTAGCAATGATTGGGAGCATAATGAGAGGCGGCACACTACAGGAACTGCAGCAACTGAAGAGGGCCTTCCCAAATTCTTAGGAAAAAAATTCTAGTTGG,CTAGCAATGATTGGGAGCATAATGAGCGGGAGGCGGCACACTACAGGAACTGCAGCAACTGAAGAGGGCCTTCCCAAATTCTTAGGAAAAAAATTCTAG,10,30,14,27,27,37,27,41,27,27,27,37,31,41,58.19,82.91468265
hek293t,15809,1,11,AGCATCTTCTGCAGTGAGAAAGCAAGGTAAGGGATGTTGATACTATCATACTCAGTTCTCAGGTGTTAAAAAAATTCTAGTTGGTTTAACGCGTAACTA,AGCATCTTCTGCAGTGAGAAAGCAAGGTAAGGGATGTACCTTATGATTTGATACTATCATACTCAGTTCTCAGGTGTTAAAAAAATTCTAGTTGGTTTA,10,30,14,27,27,45,27,56,27,38,38,45,49,56,43.57,0.087489064
hek293t,15809,1,11,GCTACCTTCTGCAGTGAGAAAGCAAGGTAAGGGATGTTGATACTATCATACTCAGTTCTCAGGTGTTTCCTAAAAAAATTCTAGTTGGTTTAACGCGTA,GCTACCTTCTGCAGTGAGAAAGCAAGGTAAGGGATGTACCTTATGATTTGATACTATCATACTCAGTTCTCAGGTGTTTCCTAAAAAAATTCTAGTTGG,10,30,14,27,27,41,27,52,27,38,38,41,49,52,43.57,0.0
hek293t,15811,1,15,TTCAATAACATCTAAGAGCATGCTTGTCTTGGAGCGTCTGCAGCCTTTTCTGTAAAAAATAAACAAAAAAATTCTAGTTGGTTTAACGCGTAACTAGAT,TTCAATAACATCTAAGAGCATGCTTGTCTTGGAGCGTCTGGAATAAGGAAGAAGCCAGCCTTTTCTGTAAAAAATAAACAAAAAAATTCTAGTTGGTTT,10,30,14,27,27,44,27,59,27,41,41,44,56,59,31.42,0.0
hek293t,15812,1,13,CGAGGTTAGCCACAAATGAAAGCGGGTAGGGGATGCAAATGCTTGTGTGCCTTAGTTGTTTAACTGGATAAAAAAATTCTAGTTGGTTTAACGCGTAAC,CGAGGTTAGCCACAAATGAAAGCGGGTAGGGGATGCAGAAGCTTTATCTAAATGCTTGTGTGCCTTAGTTGTTTAACTGGATAAAAAAATTCTAGTTGG,10,30,14,27,27,41,27,54,27,38,38,41,51,54,27.78,0.0
hek293t,15812,1,13,TACGGTTAGCCACAAATGAAAGCGGGTAGGGGATGCAAATGCTTGTGTGCCTTAGTTGTTTAACTAAAAAAATTCTAGTTGGTTTAACGCGTAACTAGA,TACGGTTAGCCACAAATGAAAGCGGGTAGGGGATGCAGAAGCTTTATCTAAATGCTTGTGTGCCTTAGTTGTTTAACTAAAAAAATTCTAGTTGGTTTA,10,30,14,27,27,45,27,58,27,38,38,45,51,58,27.78,0.174442433
hek293t,15814,1,6,ATTCGAAAAGAGGGAGTAGTGACAGAAACTGGACCACCACGCTAGAGGAGGACATTCCTCTTCCTGTTCAAAAAAATTCTAGTTGGTTTAACGCGTAAC,ATTCGAAAAGAGGGAGTAGTGACAGAAACTGGACCACCACCCCTCCGCTAGAGGAGGACATTCCTCTTCCTGTTCAAAAAAATTCTAGTTGGTTTAACG,10,30,14,27,27,48,27,54,27,41,41,48,47,54,40.4,15.93436195
hek293t,15816,1,3,CTTTAAGCAGGTTCTCCACTAGAATAATATGGATATTAATCAAGATGCATCATTTTGAGGTCCTTAATGCTTATGTAAAAAAATTCTAGTTGGTTTAAC,CTTTAAGCAGGTTCTCCACTAGAATAATAGGATGGATATTAATCAAGATGCATCATTTTGAGGTCCTTAATGCTTATGTAAAAAAATTCTAGTTGGTTT,10,30,14,27,27,44,27,47,27,29,29,44,32,47,20.05,16.79242638
hek293t,15816,1,3,GAACGAGCAGGTTCTCCACTAGAATAATATGGATATTAATCAAGATGCATCATTTTGAGGTCCTTAATGCTTATGTTCTCAAGCATGAAAAAAAATTCT,GAACGAGCAGGTTCTCCACTAGAATAATAGGATGGATATTAATCAAGATGCATCATTTTGAGGTCCTTAATGCTTATGTTCTCAAGCATGAAAAAAAAT,10,30,14,27,27,32,27,35,27,29,29,32,32,35,20.05,0.0
hek293t,15818,1,4,TTCGGGTTTTTAAAAGCACGTAGTGCTCTTGGGCTCTGCGATTCTTAGCAGCATTAGTATTAGAACAAAAGTAAAAAAAATTCTAGTTGGTTTAACGCG,TTCGGGTTTTTAAAAGCACGTAGTGCTCTTGGGCTGTCACTGCGATTCTTAGCAGCATTAGTATTAGAACAAAAGTAAAAAAAATTCTAGTTGGTTTAA,10,30,14,27,27,46,27,50,27,36,36,46,40,50,10.16,5.330276849
hek293t,15818,1,4,TTCACGTTTTTAAAAGCACGTAGTGCTCTTGGGCTCTGCGATTCTTAGCAGCATTAGTATTAGAACAAAAAAAAATTCTAGTTGGTTTAACGCGTAACT,TTCACGTTTTTAAAAGCACGTAGTGCTCTTGGGCTGTCACTGCGATTCTTAGCAGCATTAGTATTAGAACAAAAAAAAATTCTAGTTGGTTTAACGCGT,10,30,14,27,27,51,27,55,27,36,36,51,40,55,10.16,2.67609785
hek293t,15820,1,3,CCTCGTTCCCCAGCTTGTAAACAGTGGAAAGGTGAGGCAAAGGTGTGATGTGCTGAATGTGCTCCAAGGGGCTTGTGGAAAAAAAATTCTAGTTGGTTT,CCTCGTTCCCCAGCTTGTAAACAGTGGAAAGGTAGGGAGGCAAAGGTGTGATGTGCTGAATGTGCTCCAAGGGGCTTGTGGAAAAAAAATTCTAGTTGG,10,30,14,27,27,41,27,44,27,34,34,41,37,44,52.27,10.5705328
hek293t,15820,1,3,ATCTGTTCCCCAGCTTGTAAACAGTGGAAAGGTGAGGCAAAGGTGTGATGTGCTGAATGTGCTCCAAGGGGCTTGTGGAGGAAAAAAAAATTCTAGTTG,ATCTGTTCCCCAGCTTGTAAACAGTGGAAAGGTAGGGAGGCAAAGGTGTGATGTGCTGAATGTGCTCCAAGGGGCTTGTGGAGGAAAAAAAAATTCTAG,10,30,14,27,27,37,27,40,27,34,34,37,37,40,52.27,0.849658236
hek293t,15822,1,2,CGAGCAATGCAGGCATGAATTTCGGATTTCGGGAGCTGACATCCCACTCCAACAGTGCGTAGCAAAAAAAAATTCTAGTTGGTTTAACGCGTAACTAGA,CGAGCAATGCAGGCATGAATTTCGGATTTCGGGAGCTGACGGATCCCACTCCAACAGTGCGTAGCAAAAAAAAATTCTAGTTGGTTTAACGCGTAACTA,10,30,14,27,27,56,27,58,27,41,41,56,43,58,9.62,78.14378967
hek293t,15822,1,2,TACAGAATGCAGGCATGAATTTCGGATTTCGGGAGCTGACATCCCACTCCAACAGTGCGTAGCAAGGTATTAAAAAAAAATTCTAGTTGGTTTAACGCG,TACAGAATGCAGGCATGAATTTCGGATTTCGGGAGCTGACGGATCCCACTCCAACAGTGCGTAGCAAGGTATTAAAAAAAAATTCTAGTTGGTTTAACG,10,30,14,27,27,48,27,50,27,41,41,48,43,50,9.62,76.81639555
hek293t,5692,1,8,ACCCCGGCTAACGCCCGCACTCGCCTTTGCGGGTCGCCTGGCTGACGCTGGGCCATCCCAGGATCCCACGCGGCTCTCGTAAAAAAATTCTAGTTGGTT,ACCCCGGCTAACGCCCGCACTCGCCTTTGCGAGTCGTTGGGTCGCCTGGCTGACGCTGGGCCATCCCAGGATCCCACGCGGCTCTCGTAAAAAAATTCT,10,30,14,27,27,35,27,43,27,32,32,35,40,43,20.09,0.0
hek293t,15826,1,4,TTATAGACATGGGGAAATGAATGTTTCTCAGGACTAATATCACTGTTAAAGAGCATGCACGAAATGAAATTTTAAAAAAAATTCTAGTTGGTTTAACGC,TTATAGACATGGGGAAATGAATGTTTCTCAGGACTAACCTCTATCACTGTTAAAGAGCATGCACGAAATGAAATTTTAAAAAAAATTCTAGTTGGTTTA,10,30,14,27,27,45,27,49,27,38,38,45,42,49,17.88,9.245014175
hek293t,15826,1,4,TGCCCGACATGGGGAAATGAATGTTTCTCAGGACTAATATCACTGTTAAAGAGCATGCACGAAATGAAATTTTAATTGAAAAAAATTCTAGTTGGTTTA,TGCCCGACATGGGGAAATGAATGTTTCTCAGGACTAACCTCTATCACTGTTAAAGAGCATGCACGAAATGAAATTTTAATTGAAAAAAATTCTAGTTGG,10,30,14,27,27,41,27,45,27,38,38,41,42,45,17.88,0.025157233
hek293t,15830,1,13,GAATTTGGCTCAGGCTGCAGAAATGTTGCAGGTATCGTACTGCTGTCTGGGAATGACACTGCATCCAAAAAAATTCTAGTTGGTTTAACGCGTAACTAG,GAATTTGGCTCAGGCTGCAGAAATGTTGTTTTACTGACATTCAGGTATCGTACTGCTGTCTGGGAATGACACTGCATCCAAAAAAATTCTAGTTGGTTT,10,30,14,27,27,44,27,57,27,29,29,44,42,57,53.59,25.51522747
hek293t,15830,1,13,CCTATTGGCTCAGGCTGCAGAAATGTTGCAGGTATCGTACTGCTGTCTGGGAATGACACTGCATCCTGTAGAAAAAAATTCTAGTTGGTTTAACGCGTA,CCTATTGGCTCAGGCTGCAGAAATGTTGTTTTACTGACATTCAGGTATCGTACTGCTGTCTGGGAATGACACTGCATCCTGTAGAAAAAAATTCTAGTT,10,30,14,27,27,39,27,52,27,29,29,39,42,52,53.59,28.82703879
hek293t,15832,1,11,GTCTTTTGCAACAGTTTGTACTTTTCAGCTGGTGGAAAAATCGGTCTTTGACAAATGGCAAATTCAAAAAAATTCTAGTTGGTTTAACGCGTAACTAGA,GTCTTTTGCAACAGTTTGTACTTTTCAGCTGGTGGACATTCCTGCTAAAAATCGGTCTTTGACAAATGGCAAATTCAAAAAAATTCTAGTTGGTTTAAC,10,30,14,27,27,47,27,58,27,37,37,47,48,58,5.45,0.224466891
hek293t,15834,1,10,TCATGTCTGTTTTTTGCTCTAGGACTAACTGGAGACCTGAGAAGCAGCAATTGTGCATGTTAGTGGGCTTTAAAAAAATTCTAGTTGGTTTAACGCGTA,TCATGTCTGTTTTTTGCTCTAGGACTAACTGGAGCTCGCGACCCACCTGAGAAGCAGCAATTGTGCATGTTAGTGGGCTTTAAAAAAATTCTAGTTGGT,10,30,14,27,27,42,27,52,27,35,35,42,45,52,5.25,0.0
hek293t,15834,1,10,TAACCTCTGTTTTTTGCTCTAGGACTAACTGGAGACCTGAGAAGCAGCAATTGTGCATGTTAGTGGGCAAAAAAATTCTAGTTGGTTTAACGCGTAACT,TAACCTCTGTTTTTTGCTCTAGGACTAACTGGAGCTCGCGACCCACCTGAGAAGCAGCAATTGTGCATGTTAGTGGGCAAAAAAATTCTAGTTGGTTTA,10,30,14,27,27,45,27,55,27,35,35,45,45,55,5.25,0.0
hek293t,15836,1,3,CACGTACAGCTCTAAGGGGAAAATAGGAAAGGGATTCACATGCTAGAGACAGCTAAAGAGAAACACAAGCTGACAGCAAAAAAATTCTAGTTGGTTTAA,CACGTACAGCTCTAAGGGGAAAATAGGAAAGGGATCAATCACATGCTAGAGACAGCTAAAGAGAAACACAAGCTGACAGCAAAAAAATTCTAGTTGGTT,10,30,14,27,27,43,27,46,27,36,36,43,39,46,24.02,3.862142153
hek293t,15837,1,12,GAGAGCCACCCCAGAAGTAATTGGTTATTTGGGGATAATAAATGATACAGAAATTCCTTTGAAATGTAAAAAAATTCTAGTTGGTTTAACGCGTAACTA,GAGAGCCACCCCAGAAGTAATTGGTTATTTGGGATAAAAGTAAACGATAATAAATGATACAGAAATTCCTTTGAAATGTAAAAAAATTCTAGTTGGTTT,10,30,14,27,27,44,27,56,27,34,34,44,46,56,3.91,0.096575182
hek293t,15838,1,7,CTACAATTATGGCATTAAAAGGAAAACTGGGGAAAGCTGCTTTCTATTCTTTATCCATTTAAGCAATAAAAAAATTCTAGTTGGTTTAACGCGTAACTA,CTACAATTATGGCATTAAAAGGAAAACTGGGGAAGAGTACAAGCTGCTTTCTATTCTTTATCCATTTAAGCAATAAAAAAATTCTAGTTGGTTTAACGC,10,30,14,27,27,49,27,56,27,34,34,49,41,56,65.63,0.030525031
hek293t,15838,1,7,GCACGATTATGGCATTAAAAGGAAAACTGGGGAAAGCTGCTTTCTATTCTTTATCCATTTAAGCAATGACTCCAGAAAAAAATTCTAGTTGGTTTAACG,GCACGATTATGGCATTAAAAGGAAAACTGGGGAAGAGTACAAGCTGCTTTCTATTCTTTATCCATTTAAGCAATGACTCCAGAAAAAAATTCTAGTTGG,10,30,14,27,27,41,27,48,27,34,34,41,41,48,65.63,0.0
hek293t,15840,1,1,AAAGTCATATTATCAGTATTTTCATGAAAAGGACAGATTGAGTAGACACACCTGGTTGAGGTGGAAAAAAAAAATTCTAGTTGGTTTAACGCGTAACTA,AAAGTCATATTATCAGTATTTTCATGAAAAGGACAGATTGGAGTAGACACACCTGGTTGAGGTGGAAAAAAAAAATTCTAGTTGGTTTAACGCGTAACT,10,30,14,27,27,55,27,56,27,40,40,55,41,56,0.17,0.446160542
hek293t,15840,1,1,CCCACCATATTATCAGTATTTTCATGAAAAGGACAGATTGAGTAGACACACCTGGTTGAGGTGGAAATAGGAGAAAAAAAAATTCTAGTTGGTTTAACG,CCCACCATATTATCAGTATTTTCATGAAAAGGACAGATTGGAGTAGACACACCTGGTTGAGGTGGAAATAGGAGAAAAAAAAATTCTAGTTGGTTTAAC,10,30,14,27,27,47,27,48,27,40,40,47,41,48,0.17,1.688740358
hek293t,15842,1,8,TAGGGCTGGCATGGGCCAGGCCCGTGAGGAGGCAGTACCTTCCCCTGAAACCTCAAGGAGCGGGGAAAAAAAAATTCTAGTTGGTTTAACGCGTAACTA,TAGGGCTGGCATGGGCCAGGCCCGTGAGGAGGGCAATCATCAGTACCTTCCCCTGAAACCTCAAGGAGCGGGGAAAAAAAAATTCTAGTTGGTTTAACG,10,30,14,27,27,48,27,56,27,33,33,48,41,56,48.76,4.873693037
hek293t,15844,1,6,GCCCAACTGCTTGAAGAACAGGCTGGTGAAGGCAAGCATAATGGAAACACGAGCGAAGGAAAGACCATGCAGCATGGCAGGGAAGAAAAAAATTCTAGT,GCCCAACTGCTTGAAGAACAGGCTGGTGACCGCAAAGGCAAGCATAATGGAAACACGAGCGAAGGAAAGACCATGCAGCATGGCAGGGAAGAAAAAAAT,10,30,14,27,27,32,27,38,27,29,29,32,35,38,50.75,2.367143413
hek293t,15844,1,6,CCTTTACTGCTTGAAGAACAGGCTGGTGAAGGCAAGCATAATGGAAACACGAGCGAAGGAAAGACCATGCAGCATGGCAGGAAAAAAATTCTAGTTGGT,CCTTTACTGCTTGAAGAACAGGCTGGTGACCGCAAAGGCAAGCATAATGGAAACACGAGCGAAGGAAAGACCATGCAGCATGGCAGGAAAAAAATTCTA,10,30,14,27,27,36,27,42,27,29,29,36,35,42,50.75,73.27830941
hek293t,15846,1,8,TCCAACTAAAATAGATTGCAGTACGATTAAGGGCTTGATCCTGGTCGGTGCAGGTTATCCTTAGCTTGTTAAAAAAATTCTAGTTGGTTTAACGCGTAA,TCCAACTAAAATAGATTGCAGTACGATTAACCACTATAGGGCTTGATCCTGGTCGGTGCAGGTTATCCTTAGCTTGTTAAAAAAATTCTAGTTGGTTTA,10,30,14,27,27,45,27,53,27,30,30,45,38,53,15.48,24.53571776
hek293t,15846,1,8,AGTATCTAAAATAGATTGCAGTACGATTAAGGGCTTGATCCTGGTCGGTGCAGGTTATCCTTAGCTTGTTCAGACTGTTGTTAAAAAAATTCTAGTTGG,AGTATCTAAAATAGATTGCAGTACGATTAACCACTATAGGGCTTGATCCTGGTCGGTGCAGGTTATCCTTAGCTTGTTCAGACTGTTGTTAAAAAAATT,10,30,14,27,27,33,27,41,27,30,30,33,38,41,15.48,0.255770858
hek293t,15848,1,9,GACCATGAAAAGGCAGAAACCCAGGATATTGGCTTGAGAGTCAATACTTCACATATCACGCGATGCCTATAAAAAAATTCTAGTTGGTTTAACGCGTAA,GACCATGAAAAGGCAGAAACCCAGGATATTGGCTCCTTCTATTTGAGAGTCAATACTTCACATATCACGCGATGCCTATAAAAAAATTCTAGTTGGTTT,10,30,14,27,27,44,27,53,27,34,34,44,43,53,36.97,23.76958432
hek293t,15848,1,9,CAGCCTGAAAAGGCAGAAACCCAGGATATTGGCTTGAGAGTCAATACTTCACATATCACGCGATGAAAAAAATTCTAGTTGGTTTAACGCGTAACTAGA,CAGCCTGAAAAGGCAGAAACCCAGGATATTGGCTCCTTCTATTTGAGAGTCAATACTTCACATATCACGCGATGAAAAAAATTCTAGTTGGTTTAACGC,10,30,14,27,27,49,27,58,27,34,34,49,43,58,36.97,18.50999909
hek293t,15850,1,15,GAAACGAATTAAGACTTGAACCCAGCAGAAGGATTGGTAGGGCATAGTTCTTAAATCAAATATTTTTGAAAAAAATTCTAGTTGGTTTAACGCGTAACT,GAAACGAATTAAGACTTGAACCCAGCAGAAGGTCTATGACAAGACTGATTGGTAGGGCATAGTTCTTAAATCAAATATTTTTGAAAAAAATTCTAGTTG,10,30,14,27,27,40,27,55,27,33,33,40,48,55,50.23,3.793631279
hek293t,15851,1,1,ACCGGCAAAAACCCTTTTTGTAGCTCTGCAGGCAGCTATATTTCAACCGTGACATTATGGGTGATGGCAAGTTCTTCTAAAAAAATTCTAGTTGGTTTA,ACCGGCAAAAACCCTTTTTGTAGCTCTGCAGGCTAGCTATATTTCAACCGTGACATTATGGGTGATGGCAAGTTCTTCTAAAAAAATTCTAGTTGGTTT,10,30,14,27,27,44,27,45,27,34,34,44,35,45,23.64,73.84499211
hek293t,15853,1,6,TAAAACAAATGAGCGGTTACACACTGACATGGCTAGTATCTTAGAGATACTGTCTTGTAAATGTGGCCAAAAAAATTCTAGTTGGTTTAACGCGTAACT,TAAAACAAATGAGCGGTTACACACTGACATGGCAGACGGTAGTATCTTAGAGATACTGTCTTGTAAATGTGGCCAAAAAAATTCTAGTTGGTTTAACGC,10,30,14,27,27,49,27,55,27,34,34,49,40,55,65.29,7.746499157
hek293t,15853,1,6,AGGACCAAATGAGCGGTTACACACTGACATGGCTAGTATCTTAGAGATACTGTCTTGTAAATGTGGCCATCAGAAAAAAATTCTAGTTGGTTTAACGCG,AGGACCAAATGAGCGGTTACACACTGACATGGCAGACGGTAGTATCTTAGAGATACTGTCTTGTAAATGTGGCCATCAGAAAAAAATTCTAGTTGGTTT,10,30,14,27,27,44,27,50,27,34,34,44,40,50,65.29,14.36149038
hek293t,15856,1,15,TCTGCACAACTATGAACAAGCAGAATCAATGGGACTACACTGATGCGCTCTGGATCAGAATTATACATTCAAAAAAATTCTAGTTGGTTTAACGCGTAA,TCTGCACAACTATGAACAAGCAGAATCTTTCAGCTTCGGTGCAATGGGACTACACTGATGCGCTCTGGATCAGAATTATACATTCAAAAAAATTCTAGT,10,30,14,27,27,38,27,53,27,28,28,38,43,53,37.92,0.760009636
hek293t,15856,1,15,CACTTACAACTATGAACAAGCAGAATCAATGGGACTACACTGATGCGCTCTGGATCAGAATTATACATTCTCTAAAAAAATTCTAGTTGGTTTAACGCG,CACTTACAACTATGAACAAGCAGAATCTTTCAGCTTCGGTGCAATGGGACTACACTGATGCGCTCTGGATCAGAATTATACATTCTCTAAAAAAATTCT,10,30,14,27,27,35,27,50,27,28,28,35,43,50,37.92,0.358494193
hek293t,15858,1,9,CCCGGCCCCCCCGAATTTTGAAAACCTTTCGGGGTAGATCTATTCACTGCTCTGCATTCGTTACAGAAGAAAAAAAAATTCTAGTTGGTTTAACGCGTA,CCCGGCCCCCCCGAATTTTGAAAACCTCTTCAAAATTTCGGGGTAGATCTATTCACTGCTCTGCATTCGTTACAGAAGAAAAAAAAATTCTAGTTGGTT,10,30,14,27,27,43,27,52,27,28,28,43,37,52,3.11,0.071377587
hek293t,15862,1,14,ACCTTAAAACATTGGTCTGAGCTCCCACCTGGAAATTTAGGAAAATTAAACCACACTACTTGGTGCAAAAAAATTCTAGTTGGTTTAACGCGTAACTAG,ACCTTAAAACATTGGTCTGAGCTCCCACGAGAATAGAATAGCCTGGAAATTTAGGAAAATTAAACCACACTACTTGGTGCAAAAAAATTCTAGTTGGTT,10,30,14,27,27,43,27,57,27,28,28,43,42,57,52.62,5.446137904
hek293t,15864,1,9,GGAGCAGCAGACGACCTGTGGATGCTTCCTGGCTCTAACTTGTTGGGGGTTCGCTGCAGTAACCAAAAAAAAATTCTAGTTGGTTTAACGCGTAACTAG,GGAGCAGCAGACGACCTGTGGATGCTTCCTGGCTCTAACTCCTGACTACTGTTGGGGGTTCGCTGCAGTAACCAAAAAAAAATTCTAGTTGGTTTAACG,10,30,14,27,27,48,27,57,27,41,41,48,50,57,34.54,1.07366234
